precinct_county_nce,precinct_county_name,precinct_name,precinct_nr,uat_name,uat_siruta,report_version,report_stage_code,report_type_scope_code,report_type_category_code,report_type_code,created_at,a,b,b1,b2,b3,c,d,e,f,"GEORGE-NICOLAE SIMION-voturi","NICUȘOR-DANIEL DAN-voturi"
1,ALBA,"CENTRUL DE ZI PENTRU PERSOANE VÂRSTNICE",1,"MUNICIPIUL ALBA IULIA",1017,1,PART,PRCNCT,PRSD,PRSD_SV,"2025-05-18 22:32:21",1777,1144,1061,83,0,1127,17,1800,656,356,771
1,ALBA,"ŞCOALA GIMNAZIALĂ „VASILE GOLDIŞ”",2,"MUNICIPIUL ALBA IULIA",1017,1,PART,PRCNCT,PRSD,PRSD_SV,"2025-05-18 21:58:18",985,696,566,130,0,690,6,1100,404,214,476
1,ALBA,"ŞCOALA GIMNAZIALĂ „VASILE GOLDIŞ”",3,"MUNICIPIUL ALBA IULIA",1017,1,PART,PRCNCT,PRSD,PRSD_SV,"2025-05-18 22:15:40",1279,760,690,70,0,749,11,1300,540,229,520
1,ALBA,"ŞCOALA GIMNAZIALĂ „AVRAM IANCU”",4,"MUNICIPIUL ALBA IULIA",1017,1,PART,PRCNCT,PRSD,PRSD_SV,"2025-05-18 22:27:17",1255,881,782,79,20,870,11,1300,419,265,605
1,ALBA,"ŞCOALA GIMNAZIALĂ „AVRAM IANCU”",5,"MUNICIPIUL ALBA IULIA",1017,1,PART,PRCNCT,PRSD,PRSD_SV,"2025-05-18 22:03:54",966,644,568,76,0,638,6,1000,356,253,385
1,ALBA,"CASA DE CULTURĂ A STUDENŢILOR",6,"MUNICIPIUL ALBA IULIA",1017,1,PART,PRCNCT,PRSD,PRSD_SV,"2025-05-18 21:49:01",705,497,349,148,0,490,7,800,303,138,352
1,ALBA,"COLEGIUL ECONOMIC „DIONISIE POP MARŢIAN”",7,"MUNICIPIUL ALBA IULIA",1017,1,PART,PRCNCT,PRSD,PRSD_SV,"2025-05-18 22:18:23",1540,1204,986,204,14,1190,14,1600,396,338,852
1,ALBA,"COLEGIUL NAŢIONAL „HOREA CLOŞCA ŞI CRIŞAN”",8,"MUNICIPIUL ALBA IULIA",1017,1,PART,PRCNCT,PRSD,PRSD_SV,"2025-05-18 21:46:26",901,658,489,147,22,649,9,1000,342,176,473
1,ALBA,"COLEGIUL NAŢIONAL „HOREA CLOŞCA ŞI CRIŞAN”",9,"MUNICIPIUL ALBA IULIA",1017,2,PART,PRCNCT,PRSD,PRSD_SV,"2025-05-19 00:40:19",1867,1380,1245,135,0,1357,23,1900,520,382,975
1,ALBA,"COLEGIUL NAŢIONAL „HOREA CLOŞCA ŞI CRIŞAN”",10,"MUNICIPIUL ALBA IULIA",1017,1,PART,PRCNCT,PRSD,PRSD_SV,"2025-05-18 22:23:10",1307,872,661,211,0,857,15,1400,528,297,560
1,ALBA,"COLEGIUL NAŢIONAL „HOREA CLOŞCA ŞI CRIŞAN”",11,"MUNICIPIUL ALBA IULIA",1017,1,PART,PRCNCT,PRSD,PRSD_SV,"2025-05-18 21:45:55",894,577,430,147,0,570,7,1000,423,238,332
1,ALBA,"COLEGIUL TEHNIC „APULUM”",12,"MUNICIPIUL ALBA IULIA",1017,1,PART,PRCNCT,PRSD,PRSD_SV,"2025-05-18 21:49:10",1085,559,497,62,0,551,8,1100,541,247,304
1,ALBA,"COLEGIUL TEHNIC „APULUM”",13,"MUNICIPIUL ALBA IULIA",1017,1,PART,PRCNCT,PRSD,PRSD_SV,"2025-05-18 22:05:55",940,487,445,42,0,482,5,1000,513,172,310
1,ALBA,"COLEGIUL TEHNIC „APULUM”",14,"MUNICIPIUL ALBA IULIA",1017,1,PART,PRCNCT,PRSD,PRSD_SV,"2025-05-18 22:14:04",1041,499,459,39,1,494,5,1100,601,157,337
1,ALBA,"GRĂDINIŢA CU PROGRAM PRELUNGIT NR. 9",15,"MUNICIPIUL ALBA IULIA",1017,1,PART,PRCNCT,PRSD,PRSD_SV,"2025-05-18 21:35:57",1267,819,601,218,0,806,13,1300,481,343,463
1,ALBA,"SEMINARUL TEOLOGIC ORTODOX „SFÂNTUL SIMION ŞTEFAN”",16,"MUNICIPIUL ALBA IULIA",1017,1,PART,PRCNCT,PRSD,PRSD_SV,"2025-05-18 22:07:15",1253,784,662,122,0,776,8,1300,516,304,472
1,ALBA,"ŞCOALA GIMNAZIALĂ „ION AGÂRBICEANU”",17,"MUNICIPIUL ALBA IULIA",1017,1,PART,PRCNCT,PRSD,PRSD_SV,"2025-05-18 21:33:03",813,566,419,89,58,557,9,900,334,222,335
1,ALBA,"ŞCOALA GIMNAZIALĂ „ION AGÂRBICEANU”",18,"MUNICIPIUL ALBA IULIA",1017,1,PART,PRCNCT,PRSD,PRSD_SV,"2025-05-18 21:56:20",798,600,425,111,64,593,7,900,300,225,368
1,ALBA,"GRĂDINIŢA CU PROGRAM PRELUNGIT NR. 11",19,"MUNICIPIUL ALBA IULIA",1017,1,PART,PRCNCT,PRSD,PRSD_SV,"2025-05-18 21:56:13",1055,713,494,219,0,703,10,1100,387,313,390
1,ALBA,"GRĂDINIŢA CU PROGRAM PRELUNGIT STEP BY STEP NR. 12",20,"MUNICIPIUL ALBA IULIA",1017,1,PART,PRCNCT,PRSD,PRSD_SV,"2025-05-18 22:36:20",973,569,512,57,0,561,8,1100,531,198,363
1,ALBA,"GRĂDINIŢA CU PROGRAM PRELUNGIT STEP BY STEP NR. 12",21,"MUNICIPIUL ALBA IULIA",1017,1,PART,PRCNCT,PRSD,PRSD_SV,"2025-05-18 22:28:41",1012,627,556,71,0,620,7,1100,473,188,432
1,ALBA,"ŞCOALA GIMNAZIALĂ „MIHAI EMINESCU”",22,"MUNICIPIUL ALBA IULIA",1017,1,PART,PRCNCT,PRSD,PRSD_SV,"2025-05-18 21:52:57",1143,846,645,201,0,838,8,1200,354,318,520
1,ALBA,"ŞCOALA GIMNAZIALĂ „MIHAI EMINESCU”",23,"MUNICIPIUL ALBA IULIA",1017,1,PART,PRCNCT,PRSD,PRSD_SV,"2025-05-19 00:29:36",1618,1040,947,93,0,1027,13,1700,660,346,681
1,ALBA,"GRĂDINIŢA CU PROGRAM PRELUNGIT NR. 13",24,"MUNICIPIUL ALBA IULIA",1017,1,PART,PRCNCT,PRSD,PRSD_SV,"2025-05-18 22:00:02",995,591,529,62,0,583,8,1100,509,230,353
1,ALBA,"GRĂDINIŢA CU PROGRAM PRELUNGIT NR. 13",25,"MUNICIPIUL ALBA IULIA",1017,1,PART,PRCNCT,PRSD,PRSD_SV,"2025-05-18 22:02:32",1157,682,621,61,0,669,13,1200,518,258,411
1,ALBA,"LICEUL CU PROGRAM SPORTIV",26,"MUNICIPIUL ALBA IULIA",1017,1,PART,PRCNCT,PRSD,PRSD_SV,"2025-05-18 21:47:06",1289,811,690,121,0,799,12,1400,589,292,507
1,ALBA,"LICEUL CU PROGRAM SPORTIV",27,"MUNICIPIUL ALBA IULIA",1017,1,PART,PRCNCT,PRSD,PRSD_SV,"2025-05-18 21:50:58",1278,783,688,95,0,772,11,1400,617,284,488
1,ALBA,"LICEUL CU PROGRAM SPORTIV",28,"MUNICIPIUL ALBA IULIA",1017,1,PART,PRCNCT,PRSD,PRSD_SV,"2025-05-18 22:51:33",1394,889,784,105,0,876,13,1500,611,288,588
1,ALBA,"LICEUL CU PROGRAM SPORTIV",29,"MUNICIPIUL ALBA IULIA",1017,1,PART,PRCNCT,PRSD,PRSD_SV,"2025-05-18 22:24:25",912,555,485,70,0,549,6,1000,445,197,352
1,ALBA,"BAZIN OLIMPIC",30,"MUNICIPIUL ALBA IULIA",1017,2,PART,PRCNCT,PRSD,PRSD_SV,"2025-05-19 02:12:34",1061,621,557,64,0,611,10,1200,579,207,404
1,ALBA,"BAZIN OLIMPIC",31,"MUNICIPIUL ALBA IULIA",1017,1,PART,PRCNCT,PRSD,PRSD_SV,"2025-05-18 22:15:37",1210,704,531,173,0,698,6,1300,596,291,407
1,ALBA,"STADION MUNICIPAL „CETATE”",32,"MUNICIPIUL ALBA IULIA",1017,1,PART,PRCNCT,PRSD,PRSD_SV,"2025-05-18 21:59:50",1311,856,750,105,1,851,5,1400,544,299,552
1,ALBA,"GRĂDINIȚA CU PROGRAM NORMAL NR. 10",33,"MUNICIPIUL ALBA IULIA",1017,1,PART,PRCNCT,PRSD,PRSD_SV,"2025-05-18 21:48:56",1673,920,836,83,1,911,9,1700,780,477,434
1,ALBA,"GRĂDINIŢA CU PROGRAM NORMAL NR. 10",34,"MUNICIPIUL ALBA IULIA",1017,1,PART,PRCNCT,PRSD,PRSD_SV,"2025-05-18 22:06:46",1444,773,705,68,0,768,5,1500,727,418,350
1,ALBA,"COLEGIUL TEHNIC „DORIN PAVEL” ȘCOALA GENERALĂ NR. 9",35,"MUNICIPIUL ALBA IULIA",1017,1,PART,PRCNCT,PRSD,PRSD_SV,"2025-05-18 22:27:48",1451,966,839,125,2,951,15,1500,534,286,665
1,ALBA,"COLEGIUL TEHNIC „DORIN PAVEL”",36,"MUNICIPIUL ALBA IULIA",1017,1,PART,PRCNCT,PRSD,PRSD_SV,"2025-05-18 22:32:53",1425,933,796,137,0,927,6,1500,567,341,586
1,ALBA,"GRĂDINIŢA CU PROGRAM PRELUNGIT NR. 16",37,"MUNICIPIUL ALBA IULIA",1017,1,PART,PRCNCT,PRSD,PRSD_SV,"2025-05-18 22:19:43",1517,979,773,204,2,964,15,1600,621,415,549
1,ALBA,"COLEGIUL TEHNIC „ALEXANDRU DOMȘA”",38,"MUNICIPIUL ALBA IULIA",1017,1,PART,PRCNCT,PRSD,PRSD_SV,"2025-05-18 22:12:27",1440,929,807,122,0,920,9,1500,571,325,595
1,ALBA,"COLEGIUL TEHNIC „ALEXANDRU DOMȘA”",39,"MUNICIPIUL ALBA IULIA",1017,1,PART,PRCNCT,PRSD,PRSD_SV,"2025-05-18 21:50:15",1479,843,746,97,0,832,11,1500,657,349,483
1,ALBA,"COLEGIUL TEHNIC „ALEXANDRU DOMȘA”",40,"MUNICIPIUL ALBA IULIA",1017,1,PART,PRCNCT,PRSD,PRSD_SV,"2025-05-18 22:07:50",1311,668,637,31,0,656,12,1400,732,298,358
1,ALBA,"FLORIDA GOLD SRL",41,"MUNICIPIUL ALBA IULIA",1017,1,PART,PRCNCT,PRSD,PRSD_SV,"2025-05-18 22:29:16",1503,1053,974,78,1,1042,11,1600,547,300,742
1,ALBA,"FLORIDA GOLD SRL",42,"MUNICIPIUL ALBA IULIA",1017,1,PART,PRCNCT,PRSD,PRSD_SV,"2025-05-18 22:10:14",1331,1037,948,87,2,1028,9,1400,363,690,338
1,ALBA,"GRĂDINIŢA CU PROGRAM NORMAL NR. 5 PARTOŞ",43,"MUNICIPIUL ALBA IULIA",1017,1,PART,PRCNCT,PRSD,PRSD_SV,"2025-05-18 21:46:29",849,563,520,42,1,552,11,900,337,204,348
1,ALBA,"CĂMINUL PENTRU PERSOANE VÂRSTNICE",44,"MUNICIPIUL ALBA IULIA",1017,1,PART,PRCNCT,PRSD,PRSD_SV,"2025-05-18 22:01:20",1263,957,803,154,0,948,9,1300,343,265,683
1,ALBA,"GRĂDINIŢA CU PROGRAM NORMAL BĂRĂBANŢ",45,"MUNICIPIUL ALBA IULIA",1017,1,PART,PRCNCT,PRSD,PRSD_SV,"2025-05-18 21:56:25",1025,658,581,70,7,645,13,1100,442,321,324
1,ALBA,"GRĂDINIŢA CU PROGRAM NORMAL BĂRĂBANŢ",46,"MUNICIPIUL ALBA IULIA",1017,1,PART,PRCNCT,PRSD,PRSD_SV,"2025-05-18 22:08:28",1286,777,742,35,0,766,11,1300,523,357,409
1,ALBA,"ŞCOALA GIMNAZIALĂ MICEŞTI - SALA DE SPORT",47,"MUNICIPIUL ALBA IULIA",1017,1,PART,PRCNCT,PRSD,PRSD_SV,"2025-05-18 22:07:27",1280,914,821,93,0,904,10,1300,386,314,590
1,ALBA,"ŞCOALA GIMNAZIALĂ MICEŞTI",48,"MUNICIPIUL ALBA IULIA",1017,1,PART,PRCNCT,PRSD,PRSD_SV,"2025-05-18 21:52:04",1486,1012,930,79,3,1003,9,1600,588,404,599
1,ALBA,"CĂMINUL CULTURAL OARDA DE JOS",49,"MUNICIPIUL ALBA IULIA",1017,1,PART,PRCNCT,PRSD,PRSD_SV,"2025-05-18 22:13:21",1296,895,821,74,0,881,14,1400,505,401,480
1,ALBA,"GRĂDINIŢA CU PROGRAM NORMAL OARDA DE SUS",50,"MUNICIPIUL ALBA IULIA",1017,1,PART,PRCNCT,PRSD,PRSD_SV,"2025-05-18 21:44:38",733,463,410,53,0,456,7,800,337,225,231
1,ALBA,"ŞCOALA PRIMARĂ PÂCLIŞA",51,"MUNICIPIUL ALBA IULIA",1017,1,PART,PRCNCT,PRSD,PRSD_SV,"2025-05-18 21:53:45",841,441,417,24,0,438,3,900,459,244,194
1,ALBA,"ȘCOALA GIMNAZIALĂ ”OVIDIU HULEA” AIUD",52,"MUNICIPIUL AIUD",1213,1,PART,PRCNCT,PRSD,PRSD_SV,"2025-05-18 22:06:20",1296,729,645,81,3,721,8,1400,671,213,508
1,ALBA,"ȘCOALA GIMNAZIALĂ ”OVIDIU HULEA” AIUD",53,"MUNICIPIUL AIUD",1213,1,PART,PRCNCT,PRSD,PRSD_SV,"2025-05-18 22:41:40",1450,840,723,115,2,832,8,1500,660,301,531
1,ALBA,"ŞCOALA GIMNAZIALĂ ”OVIDIU HULEA” AIUD",54,"MUNICIPIUL AIUD",1213,1,PART,PRCNCT,PRSD,PRSD_SV,"2025-05-18 21:58:22",950,544,462,82,0,541,3,1000,456,225,316
1,ALBA,"ŞCOALA GIMNAZIALĂ ”OVIDIU HULEA” AIUD",55,"MUNICIPIUL AIUD",1213,2,PART,PRCNCT,PRSD,PRSD_SV,"2025-05-19 02:44:05",1123,627,573,54,0,614,13,1200,573,215,399
1,ALBA,"GRĂDINIŢA CU PROGRAM PRELUNGIT ”PRIMII PAŞI” AIUD",56,"MUNICIPIUL AIUD",1213,1,PART,PRCNCT,PRSD,PRSD_SV,"2025-05-18 21:50:38",874,522,451,70,1,516,6,1000,478,162,354
1,ALBA,"GRĂDINIŢA CU PROGRAM PRELUNGIT ”PRIMII PAŞI” AIUD",57,"MUNICIPIUL AIUD",1213,1,PART,PRCNCT,PRSD,PRSD_SV,"2025-05-18 22:04:53",1061,591,531,60,0,584,7,1100,509,235,349
1,ALBA,"ȘCOALA GIMNAZIALĂ ”AXENTE SEVER” AIUD",58,"MUNICIPIUL AIUD",1213,1,PART,PRCNCT,PRSD,PRSD_SV,"2025-05-18 22:15:41",1197,813,574,100,139,804,9,1300,487,387,417
1,ALBA,"ŞCOALA GIMNAZIALĂ ”AXENTE SEVER” AIUD",59,"MUNICIPIUL AIUD",1213,1,PART,PRCNCT,PRSD,PRSD_SV,"2025-05-19 00:03:36",1094,676,498,37,141,663,13,1200,524,316,347
1,ALBA,"ŞCOALA GIMNAZIALĂ ”AXENTE SEVER” AIUD",60,"MUNICIPIUL AIUD",1213,1,PART,PRCNCT,PRSD,PRSD_SV,"2025-05-18 22:09:01",1086,639,487,46,106,631,8,1200,561,298,333
1,ALBA,"ŞCOALA GIMNAZIALĂ ”AXENTE SEVER” AIUD",61,"MUNICIPIUL AIUD",1213,1,PART,PRCNCT,PRSD,PRSD_SV,"2025-05-18 22:02:38",1060,676,523,23,130,667,9,1100,424,328,339
1,ALBA,"ȘCOALA GIMNAZIALĂ „AXENTE SEVER” AIUD",62,"MUNICIPIUL AIUD",1213,1,PART,PRCNCT,PRSD,PRSD_SV,"2025-05-18 22:00:09",1184,735,582,26,127,729,6,1300,565,326,403
1,ALBA,"COLEGIUL NAŢIONAL ”TITU MAIORESCU” AIUD",63,"MUNICIPIUL AIUD",1213,1,PART,PRCNCT,PRSD,PRSD_SV,"2025-05-18 22:01:50",1398,903,750,82,71,896,7,1500,597,319,577
1,ALBA,"LICEUL TEHNOLOGIC AIUD",64,"MUNICIPIUL AIUD",1213,1,PART,PRCNCT,PRSD,PRSD_SV,"2025-05-18 21:37:41",704,382,355,26,1,373,9,800,418,106,267
1,ALBA,"LICEUL TEHNOLOGIC AIUD",65,"MUNICIPIUL AIUD",1213,1,PART,PRCNCT,PRSD,PRSD_SV,"2025-05-18 22:05:21",622,323,294,27,2,320,3,700,377,84,236
1,ALBA,"ŞCOALA GIMNAZIALĂ ”LIVIU REBREANU” AIUDUL DE SUS",66,"MUNICIPIUL AIUD",1213,1,PART,PRCNCT,PRSD,PRSD_SV,"2025-05-18 22:03:30",862,403,374,28,1,400,3,900,497,202,198
1,ALBA,"ŞCOALA GIMNAZIALĂ ”LIVIU REBREANU” AIUDUL DE SUS",67,"MUNICIPIUL AIUD",1213,1,PART,PRCNCT,PRSD,PRSD_SV,"2025-05-18 21:57:02",1089,471,444,27,0,465,6,1200,729,223,242
1,ALBA,"FOSTA ŞCOALĂ GENERALĂ GÎMBAŞ",68,"MUNICIPIUL AIUD",1213,1,PART,PRCNCT,PRSD,PRSD_SV,"2025-05-18 21:37:51",402,234,214,20,0,232,2,500,266,99,133
1,ALBA,"GRĂDINIŢA CU PROGRAM NORMAL MĂGINA",69,"MUNICIPIUL AIUD",1213,1,PART,PRCNCT,PRSD,PRSD_SV,"2025-05-18 21:33:47",458,279,252,26,1,276,3,500,221,112,164
1,ALBA,"CĂMINUL CULTURAL PĂGIDA",70,"MUNICIPIUL AIUD",1213,1,PART,PRCNCT,PRSD,PRSD_SV,"2025-05-18 21:21:02",89,59,46,13,0,59,0,100,41,42,17
1,ALBA,"LICEUL TEHNOLOGIC AGRICOL ”ALEXANDRU BORZA” CIUMBRUD",71,"MUNICIPIUL AIUD",1213,1,PART,PRCNCT,PRSD,PRSD_SV,"2025-05-18 22:16:14",1061,574,538,36,0,570,4,1100,526,271,299
1,ALBA,"ŞCOALA PRIMARĂ GÎRBOVA DE JOS",72,"MUNICIPIUL AIUD",1213,1,PART,PRCNCT,PRSD,PRSD_SV,"2025-05-18 21:43:39",386,215,177,38,0,214,1,500,285,115,99
1,ALBA,"FOSTA ŞCOALĂ GENERALĂ GÎRBOVA DE SUS",73,"MUNICIPIUL AIUD",1213,1,PART,PRCNCT,PRSD,PRSD_SV,"2025-05-18 21:19:15",193,141,109,32,0,141,0,300,159,86,55
1,ALBA,"FOSTA ŞCOALĂ GENERALĂ GÎRBOVIŢA",74,"MUNICIPIUL AIUD",1213,1,PART,PRCNCT,PRSD,PRSD_SV,"2025-05-18 21:25:03",98,56,42,14,0,55,1,100,44,27,28
1,ALBA,"SALA DE FESTIVITĂŢI DIN SÎNCRAI",75,"MUNICIPIUL AIUD",1213,1,PART,PRCNCT,PRSD,PRSD_SV,"2025-05-18 21:44:35",550,340,299,41,0,337,3,600,260,141,196
1,ALBA,"PIAŢA AGROALIMENTARĂ",76,"MUNICIPIUL BLAJ",1348,1,PART,PRCNCT,PRSD,PRSD_SV,"2025-05-18 21:42:51",937,518,481,37,0,516,2,1000,482,227,289
1,ALBA,"GRĂDINIŢA CU PROGRAM PRELUNGIT ”LUMEA COPIILOR” BLAJ",77,"MUNICIPIUL BLAJ",1348,1,PART,PRCNCT,PRSD,PRSD_SV,"2025-05-18 22:01:20",556,337,274,62,1,335,2,600,263,131,204
1,ALBA,"BAZA DE AGREMENT A MUNICIPIULUI BLAJ",78,"MUNICIPIUL BLAJ",1348,1,PART,PRCNCT,PRSD,PRSD_SV,"2025-05-18 21:54:35",740,387,320,66,1,383,4,800,413,294,89
1,ALBA,"AŞEZĂMÂNTUL SOCIAL - GRĂDINIŢA ”SFÂNTA IRINA”",79,"MUNICIPIUL BLAJ",1348,1,PART,PRCNCT,PRSD,PRSD_SV,"2025-05-18 21:50:58",1138,629,572,54,3,623,6,1200,571,231,392
1,ALBA,"ŞCOALA GIMNAZIALĂ ”TOMA COCIŞIU” BLAJ",80,"MUNICIPIUL BLAJ",1348,1,PART,PRCNCT,PRSD,PRSD_SV,"2025-05-18 22:00:37",1099,593,523,67,3,587,6,1200,607,210,377
1,ALBA,"CENTRUL CULTURAL ”IACOB MUREŞIANU’’",81,"MUNICIPIUL BLAJ",1348,1,PART,PRCNCT,PRSD,PRSD_SV,"2025-05-18 21:55:51",768,549,427,107,15,542,7,799,250,174,368
1,ALBA,"LICEUL TEHNOLOGIC ”ŞTEFAN MANCIULEA” BLAJ",82,"MUNICIPIUL BLAJ",1348,1,PART,PRCNCT,PRSD,PRSD_SV,"2025-05-18 21:48:31",618,382,293,76,13,378,4,700,318,135,243
1,ALBA,"SERVICIUL PUBLIC DE ASISTENŢĂ SOCIALĂ BLAJ",83,"MUNICIPIUL BLAJ",1348,1,PART,PRCNCT,PRSD,PRSD_SV,"2025-05-18 21:51:38",499,306,263,42,1,305,1,600,294,93,212
1,ALBA,"ASOCIAŢIA JUDEŢEANĂ A VÂNĂTORILOR SI PESCARILOR SPORTIVI ALBA - CLUBUL BLAJ",84,"MUNICIPIUL BLAJ",1348,1,PART,PRCNCT,PRSD,PRSD_SV,"2025-05-18 21:41:50",317,187,168,19,0,184,3,400,213,97,87
1,ALBA,"LICEUL TEHNOLOGIC ”TIMOTEI CIPARIU”",85,"MUNICIPIUL BLAJ",1348,1,PART,PRCNCT,PRSD,PRSD_SV,"2025-05-18 22:06:53",1376,914,832,78,4,907,7,1500,586,331,576
1,ALBA,"COLEGIUL NAŢIONAL ”INOCHENTIE MICU CLAIN’’",86,"MUNICIPIUL BLAJ",1348,1,PART,PRCNCT,PRSD,PRSD_SV,"2025-05-18 21:55:12",1301,878,730,99,49,867,11,1400,522,233,634
1,ALBA,"ŞCOALA GIMNAZIALĂ ”PETRU PAVEL ARON” BLAJ",87,"MUNICIPIUL BLAJ",1348,1,PART,PRCNCT,PRSD,PRSD_SV,"2025-05-18 22:10:20",1661,1015,851,161,3,1002,13,1700,685,437,565
1,ALBA,"ŞCOALA GIMNAZIALĂ ”ION MICU MOLDOVAN” BLAJ",88,"MUNICIPIUL BLAJ",1348,1,PART,PRCNCT,PRSD,PRSD_SV,"2025-05-18 21:41:39",1588,592,561,31,0,586,6,1700,1108,433,153
1,ALBA,"GRĂDINIŢA CU PROGRAM NORMAL ”IZVOARELE” BLAJ",89,"MUNICIPIUL BLAJ",1348,1,PART,PRCNCT,PRSD,PRSD_SV,"2025-05-18 21:49:12",1275,697,653,43,1,690,7,1400,703,321,369
1,ALBA,"ŞCOALA PRIMARĂ PETRISAT",90,"MUNICIPIUL BLAJ",1348,1,PART,PRCNCT,PRSD,PRSD_SV,"2025-05-18 21:31:38",455,282,260,21,1,280,2,500,218,87,193
1,ALBA,"ŞCOALA GIMNAZIALĂ ”SIMION BĂRNUŢIU” TIUR",91,"MUNICIPIUL BLAJ",1348,1,PART,PRCNCT,PRSD,PRSD_SV,"2025-05-18 21:44:06",1261,719,693,25,1,710,9,1300,581,351,359
1,ALBA,"ŞCOALA GIMNAZIALĂ ”AXENTE SEVER” MĂNĂRADE",92,"MUNICIPIUL BLAJ",1348,1,PART,PRCNCT,PRSD,PRSD_SV,"2025-05-18 21:42:58",883,434,394,40,0,433,1,1000,566,249,184
1,ALBA,"SERVICIUL PUBLIC DE ADMINISTRARE A PATRIMONIULUI SEBEŞ",93,"MUNICIPIUL SEBEŞ",1874,1,PART,PRCNCT,PRSD,PRSD_SV,"2025-05-18 22:24:21",1662,950,902,47,1,940,10,1700,750,341,599
1,ALBA,"LICEUL TEHNOLOGIC SEBEŞ",94,"MUNICIPIUL SEBEŞ",1874,1,PART,PRCNCT,PRSD,PRSD_SV,"2025-05-18 21:49:53",1511,554,493,58,3,546,8,1600,1046,453,93
1,ALBA,"LICEUL TEHNOLOGIC SEBEŞ",95,"MUNICIPIUL SEBEŞ",1874,1,PART,PRCNCT,PRSD,PRSD_SV,"2025-05-18 22:30:01",1593,1015,869,135,11,1008,7,1700,685,335,673
1,ALBA,"LICEUL TEHNOLOGIC SEBEŞ",96,"MUNICIPIUL SEBEŞ",1874,1,PART,PRCNCT,PRSD,PRSD_SV,"2025-05-18 22:01:31",1036,640,561,78,1,630,10,1100,460,318,312
1,ALBA,"LICEUL TEHNOLOGIC SEBEŞ",97,"MUNICIPIUL SEBEŞ",1874,1,PART,PRCNCT,PRSD,PRSD_SV,"2025-05-18 22:20:33",1045,581,539,42,0,571,10,1100,519,267,304
1,ALBA,"LICEUL CU PROGRAM SPORTIV SEBEŞ",98,"MUNICIPIUL SEBEŞ",1874,1,PART,PRCNCT,PRSD,PRSD_SV,"2025-05-18 21:51:49",1415,786,730,53,3,777,9,1500,714,281,496
1,ALBA,"LICEUL CU PROGRAM SPORTIV SEBEŞ",99,"MUNICIPIUL SEBEŞ",1874,1,PART,PRCNCT,PRSD,PRSD_SV,"2025-05-18 22:05:23",1453,830,777,45,8,821,9,1500,670,342,479
1,ALBA,"LICEUL CU PROGRAM SPORTIV SEBEŞ",100,"MUNICIPIUL SEBEŞ",1874,1,PART,PRCNCT,PRSD,PRSD_SV,"2025-05-18 22:08:52",1257,748,621,127,0,740,8,1400,652,258,482
1,ALBA,"ŞCOALA GIMNAZIALĂ NR. 2 SEBEŞ",101,"MUNICIPIUL SEBEŞ",1874,1,PART,PRCNCT,PRSD,PRSD_SV,"2025-05-18 22:20:48",1442,919,807,80,32,902,17,1500,581,303,599
1,ALBA,"COLEGIUL NAŢIONAL ”LUCIAN BLAGA” SEBEŞ",102,"MUNICIPIUL SEBEŞ",1874,1,PART,PRCNCT,PRSD,PRSD_SV,"2025-05-18 21:55:19",1237,804,697,92,15,793,11,1300,496,246,547
1,ALBA,"COLEGIUL NAŢIONAL ”LUCIAN BLAGA” SEBEŞ",103,"MUNICIPIUL SEBEŞ",1874,1,PART,PRCNCT,PRSD,PRSD_SV,"2025-05-18 21:39:38",1622,1015,959,56,0,999,16,1700,685,332,667
1,ALBA,"ŞCOALA GIMNAZIALĂ ”MIHAIL KOGĂLNICEANU” SEBEŞ",104,"MUNICIPIUL SEBEŞ",1874,1,PART,PRCNCT,PRSD,PRSD_SV,"2025-05-18 21:40:50",993,535,473,62,0,529,6,1100,565,238,291
1,ALBA,"ŞCOALA GIMNAZIALĂ ”MIHAIL KOGĂLNICEANU” SEBEŞ",105,"MUNICIPIUL SEBEŞ",1874,1,PART,PRCNCT,PRSD,PRSD_SV,"2025-05-18 21:36:04",948,486,432,54,0,481,5,1000,514,225,256
1,ALBA,"ŞCOALA GIMNAZIALĂ ”MIHAIL KOGĂLNICEANU” SEBEŞ",106,"MUNICIPIUL SEBEŞ",1874,1,PART,PRCNCT,PRSD,PRSD_SV,"2025-05-18 21:35:50",1050,501,457,44,0,499,2,1100,599,271,228
1,ALBA,"ŞCOALA GIMNAZIALĂ ”MIHAIL KOGĂLNICEANU” SEBEŞ",107,"MUNICIPIUL SEBEŞ",1874,1,PART,PRCNCT,PRSD,PRSD_SV,"2025-05-18 21:34:43",1022,504,458,46,0,498,6,1100,596,241,257
1,ALBA,"ŞCOALA GIMNAZIALĂ LANCRĂM",108,"MUNICIPIUL SEBEŞ",1874,1,PART,PRCNCT,PRSD,PRSD_SV,"2025-05-18 22:07:26",1413,890,798,91,1,878,12,1500,610,410,468
1,ALBA,"ŞCOALA GIMNAZIALĂ PETREŞTI",109,"MUNICIPIUL SEBEŞ",1874,1,PART,PRCNCT,PRSD,PRSD_SV,"2025-05-18 21:44:35",1505,793,743,50,0,781,12,1600,807,403,378
1,ALBA,"ŞCOALA GIMNAZIALĂ PETREŞTI",110,"MUNICIPIUL SEBEŞ",1874,1,PART,PRCNCT,PRSD,PRSD_SV,"2025-05-18 21:49:49",1460,800,706,94,0,792,8,1500,700,447,345
1,ALBA,"ŞCOALA GIMNAZIALĂ PETREŞTI",111,"MUNICIPIUL SEBEŞ",1874,1,PART,PRCNCT,PRSD,PRSD_SV,"2025-05-18 22:03:35",1573,840,779,54,7,834,6,1600,760,439,395
1,ALBA,"ŞCOALA GIMNAZIALĂ RĂHĂU",112,"MUNICIPIUL SEBEŞ",1874,1,PART,PRCNCT,PRSD,PRSD_SV,"2025-05-18 21:47:19",853,488,447,41,0,485,3,900,412,258,227
1,ALBA,"ŞCOALA GIMNAZIALĂ ”AVRAM IANCU” ABRUD",113,"ORAŞ ABRUD",1151,1,PART,PRCNCT,PRSD,PRSD_SV,"2025-05-18 22:20:27",1092,551,500,48,3,538,13,1200,649,308,230
1,ALBA,"ŞCOALA GIMNAZIALĂ ”AVRAM IANCU” GRADINIȚA CU PROGRAM NORMAL NR. 1 ABRUD",114,"ORAŞ ABRUD",1151,1,PART,PRCNCT,PRSD,PRSD_SV,"2025-05-18 21:54:02",1024,527,489,37,1,514,13,1100,573,264,250
1,ALBA,"ȘCOALA GIMNAZIALĂ ”AVRAM IANCU” GRĂDINIŢA CU PROGRAM PRELUNGIT NR.1 ABRUD",115,"ORAŞ ABRUD",1151,1,PART,PRCNCT,PRSD,PRSD_SV,"2025-05-18 21:52:35",1216,572,513,55,4,564,8,1300,728,311,253
1,ALBA,"LICEUL ”HOREA, CLOŞCA ŞI CRIŞAN” ABRUD",116,"ORAŞ ABRUD",1151,1,PART,PRCNCT,PRSD,PRSD_SV,"2025-05-18 21:51:10",978,529,436,93,0,516,13,1100,571,316,200
1,ALBA,"ŞCOALA GENERALĂ CU CLASELE I-VIII",117,"ORAŞ BAIA DE ARIEŞ",2915,1,PART,PRCNCT,PRSD,PRSD_SV,"2025-05-18 21:41:57",878,485,394,66,25,480,5,1000,515,311,169
1,ALBA,"ŞCOALA GENERALĂ CU CLASELE I-VIII",118,"ORAŞ BAIA DE ARIEŞ",2915,1,PART,PRCNCT,PRSD,PRSD_SV,"2025-05-18 21:34:22",760,301,276,24,1,294,7,800,499,186,108
1,ALBA,"LICEUL ”DR. LAZĂR CHIRILĂ”",119,"ORAŞ BAIA DE ARIEŞ",2915,1,PART,PRCNCT,PRSD,PRSD_SV,"2025-05-18 21:41:12",565,304,266,37,1,302,2,600,296,185,117
1,ALBA,"ŞCOALA PRIMARĂ BRĂZEŞTI",120,"ORAŞ BAIA DE ARIEŞ",2915,1,PART,PRCNCT,PRSD,PRSD_SV,"2025-05-18 21:35:25",198,117,101,16,0,114,3,300,183,55,59
1,ALBA,"CĂMINUL CULTURAL CIOARA DE SUS",121,"ORAŞ BAIA DE ARIEŞ",2915,1,PART,PRCNCT,PRSD,PRSD_SV,"2025-05-18 21:42:37",180,108,87,15,6,108,0,200,92,89,19
1,ALBA,"CĂMINUL CULTURAL MUNCELU",122,"ORAŞ BAIA DE ARIEŞ",2915,1,PART,PRCNCT,PRSD,PRSD_SV,"2025-05-18 21:32:35",275,163,138,21,4,162,1,300,137,123,39
1,ALBA,"CĂMINUL CULTURAL SARTĂŞ",123,"ORAŞ BAIA DE ARIEŞ",2915,1,PART,PRCNCT,PRSD,PRSD_SV,"2025-05-18 21:29:35",285,145,118,26,1,143,2,300,155,86,57
1,ALBA,"PRIMĂRIA ORAŞULUI CÂMPENI",124,"ORAŞ CÂMPENI",1455,1,PART,PRCNCT,PRSD,PRSD_SV,"2025-05-18 22:45:33",1210,736,619,117,0,724,12,1300,564,463,261
1,ALBA,"ŞCOALA GIMNAZIALĂ CÂMPENI",125,"ORAŞ CÂMPENI",1455,1,PART,PRCNCT,PRSD,PRSD_SV,"2025-05-18 21:37:29",789,548,440,84,24,539,9,900,352,275,264
1,ALBA,"ȘCOALA GIMNAZIALĂ CÂMPENI",126,"ORAŞ CÂMPENI",1455,1,PART,PRCNCT,PRSD,PRSD_SV,"2025-05-18 22:02:46",752,472,421,49,2,464,8,800,328,240,224
1,ALBA,"COLEGIUL NAŢIONAL ”AVRAM IANCU” CÂMPENI",127,"ORAŞ CÂMPENI",1455,1,PART,PRCNCT,PRSD,PRSD_SV,"2025-05-18 21:44:04",803,469,413,54,2,458,11,900,431,279,179
1,ALBA,"COLEGIUL NAŢIONAL ”AVRAM IANCU” CÂMPENI",128,"ORAŞ CÂMPENI",1455,1,PART,PRCNCT,PRSD,PRSD_SV,"2025-05-18 21:39:19",860,555,464,62,29,547,8,900,345,303,244
1,ALBA,"ŞCOALA PRIMARĂ VÂRŞI",129,"ORAŞ CÂMPENI",1455,1,PART,PRCNCT,PRSD,PRSD_SV,"2025-05-18 21:31:30",512,306,272,34,0,305,1,600,294,221,84
1,ALBA,"ŞCOALA PRIMARĂ CERTEGE",130,"ORAŞ CÂMPENI",1455,1,PART,PRCNCT,PRSD,PRSD_SV,"2025-05-18 21:32:13",305,112,98,14,0,111,1,400,288,74,37
1,ALBA,"ŞCOALA PRIMARĂ MIHOEŞTI",131,"ORAŞ CÂMPENI",1455,1,PART,PRCNCT,PRSD,PRSD_SV,"2025-05-18 21:25:14",263,156,135,21,0,154,2,300,144,111,43
1,ALBA,"ŞCOALA PRIMARĂ VALEA BISTRII",132,"ORAŞ CÂMPENI",1455,1,PART,PRCNCT,PRSD,PRSD_SV,"2025-05-18 21:19:25",357,210,181,29,0,208,2,400,190,139,69
1,ALBA,"ŞCOALA GIMNAZIALĂ NR. 3 - CUGIR",133,"ORAŞ CUGIR",1696,1,PART,PRCNCT,PRSD,PRSD_SV,"2025-05-18 21:24:53",952,448,425,23,0,446,2,1000,552,198,248
1,ALBA,"ŞCOALA GIMNAZIALĂ NR. 3 - CUGIR",134,"ORAŞ CUGIR",1696,1,PART,PRCNCT,PRSD,PRSD_SV,"2025-05-18 21:35:53",1321,652,619,31,2,637,15,1400,748,321,316
1,ALBA,"ŞCOALA GIMNAZIALĂ NR. 3 - CUGIR",135,"ORAŞ CUGIR",1696,1,PART,PRCNCT,PRSD,PRSD_SV,"2025-05-18 21:30:19",1174,548,509,39,0,533,15,1300,752,211,322
1,ALBA,"ŞCOALA GIMNAZIALĂ NR. 3 - CUGIR",136,"ORAŞ CUGIR",1696,1,PART,PRCNCT,PRSD,PRSD_SV,"2025-05-18 22:03:18",1040,514,478,33,3,508,6,1100,586,221,287
1,ALBA,"ȘCOALA GIMNAZIALĂ NR.3 CUGIR",137,"ORAŞ CUGIR",1696,1,PART,PRCNCT,PRSD,PRSD_SV,"2025-05-18 21:37:20",966,506,480,26,0,498,8,1000,494,176,322
1,ALBA,"COLEGIUL NAŢIONAL ”DAVID PRODAN” CUGIR",138,"ORAŞ CUGIR",1696,1,PART,PRCNCT,PRSD,PRSD_SV,"2025-05-18 21:33:53",1014,500,470,30,0,490,10,1100,600,224,266
1,ALBA,"COLEGIUL NAŢIONAL ”DAVID PRODAN” CUGIR",139,"ORAŞ CUGIR",1696,1,PART,PRCNCT,PRSD,PRSD_SV,"2025-05-18 21:47:14",985,461,426,35,0,453,8,1100,639,157,296
1,ALBA,"ŞCOALA GIMNAZIALĂ ”SINGIDAVA” CUGIR",140,"ORAŞ CUGIR",1696,1,PART,PRCNCT,PRSD,PRSD_SV,"2025-05-18 21:42:34",1030,489,466,23,0,480,9,1100,611,232,248
1,ALBA,"ŞCOALA GIMNAZIALĂ ”SINGIDAVA” CUGIR",141,"ORAŞ CUGIR",1696,1,PART,PRCNCT,PRSD,PRSD_SV,"2025-05-18 21:48:04",1284,673,622,27,24,669,4,1400,727,304,365
1,ALBA,"ŞCOALA GIMNAZIALĂ ”SINGIDAVA” CUGIR",142,"ORAŞ CUGIR",1696,1,PART,PRCNCT,PRSD,PRSD_SV,"2025-05-18 21:40:20",1144,443,415,27,1,437,6,1200,757,346,91
1,ALBA,"ȘCOALA GIMNAZIALĂ ”SINGIDAVA” CUGIR",143,"ORAŞ CUGIR",1696,1,PART,PRCNCT,PRSD,PRSD_SV,"2025-05-18 21:34:21",1169,605,571,33,1,601,4,1200,595,220,381
1,ALBA,"LICEUL TEHNOLOGIC „ION D.LĂZĂRESCU” CUGIR",144,"ORAŞ CUGIR",1696,1,PART,PRCNCT,PRSD,PRSD_SV,"2025-05-18 21:55:48",975,420,402,18,0,414,6,1100,680,188,226
1,ALBA,"CENTRUL CULTURAL ”VALENTIN URITESCU” AL ORAŞULUI CUGIR",145,"ORAŞ CUGIR",1696,1,PART,PRCNCT,PRSD,PRSD_SV,"2025-05-18 22:03:42",1250,662,613,48,1,654,8,1300,638,269,385
1,ALBA,"GRĂDINIŢA CU PROGRAM PRELUNGIT ”PITICOT” CUGIR",146,"ORAŞ CUGIR",1696,1,PART,PRCNCT,PRSD,PRSD_SV,"2025-05-18 21:53:33",1123,604,567,37,0,597,7,1200,596,229,368
1,ALBA,"ŞCOALA GIMNAZIALĂ ”IOSIF PERVAIN” CUGIR",147,"ORAŞ CUGIR",1696,1,PART,PRCNCT,PRSD,PRSD_SV,"2025-05-18 22:29:32",997,529,482,40,7,522,7,1100,571,250,272
1,ALBA,"ŞCOALA GIMNAZIALĂ ”IOSIF PERVAIN” CUGIR",148,"ORAŞ CUGIR",1696,1,PART,PRCNCT,PRSD,PRSD_SV,"2025-05-18 21:58:38",1108,604,567,36,1,599,5,1200,596,246,353
1,ALBA,"ȘCOALA GIMNAZIALĂ IOSIF PERVAIN CUGIR",149,"ORAŞ CUGIR",1696,1,PART,PRCNCT,PRSD,PRSD_SV,"2025-05-18 21:56:40",1104,529,484,44,1,516,13,1200,671,268,248
1,ALBA,"ŞCOALA PRIMARĂ - BUCURU",150,"ORAŞ CUGIR",1696,1,PART,PRCNCT,PRSD,PRSD_SV,"2025-05-18 21:29:12",84,48,34,14,0,47,1,100,52,29,18
1,ALBA,"ŞCOALA PRIMARĂ - CĂLENE",151,"ORAŞ CUGIR",1696,1,PART,PRCNCT,PRSD,PRSD_SV,"2025-05-18 21:19:35",43,31,17,14,0,30,1,100,69,20,10
1,ALBA,"ŞCOALA PRIMARĂ - MUGEŞTI",152,"ORAŞ CUGIR",1696,1,PART,PRCNCT,PRSD,PRSD_SV,"2025-05-18 21:12:40",75,43,32,11,0,43,0,100,57,31,12
1,ALBA,"ȘCOALA GIMNAZIALĂ IOAN MIHU - VINEREA",153,"ORAŞ CUGIR",1696,1,PART,PRCNCT,PRSD,PRSD_SV,"2025-05-18 21:57:14",1057,582,551,31,0,578,4,1100,518,261,317
1,ALBA,"ŞCOALA GIMNAZIALĂ ”IOAN MIHU” VINEREA",154,"ORAŞ CUGIR",1696,1,PART,PRCNCT,PRSD,PRSD_SV,"2025-05-18 22:04:40",899,560,522,38,0,554,6,1000,440,222,332
1,ALBA,"GRĂDINIŢA CU PROGRAM NORMAL NR. 5",155,"ORAŞ OCNA MUREŞ",1794,1,PART,PRCNCT,PRSD,PRSD_SV,"2025-05-18 22:16:38",1285,621,590,30,1,609,12,1400,779,317,292
1,ALBA,"ȘCOALA GIMNAZIALĂ ”LUCIAN BLAGA”",156,"ORAŞ OCNA MUREŞ",1794,1,PART,PRCNCT,PRSD,PRSD_SV,"2025-05-18 22:42:26",1086,608,531,77,0,603,5,1200,592,233,370
1,ALBA,"CASA DE CULTURĂ ”ION SÂNGEREANU”",157,"ORAŞ OCNA MUREŞ",1794,1,PART,PRCNCT,PRSD,PRSD_SV,"2025-05-18 22:03:42",1170,638,535,91,12,633,5,1200,562,224,409
1,ALBA,"DIRECŢIA SANITAR-VETERINARĂ ŞI PENTRU SIGURANŢA ALIMENTELOR OCNA MUREŞ",158,"ORAŞ OCNA MUREŞ",1794,1,PART,PRCNCT,PRSD,PRSD_SV,"2025-05-18 22:09:23",1066,499,457,41,1,488,11,1100,601,191,297
1,ALBA,"LICEUL TEORETIC ”PETRU MAIOR”",159,"ORAŞ OCNA MUREŞ",1794,1,PART,PRCNCT,PRSD,PRSD_SV,"2025-05-18 21:59:18",1271,634,551,82,1,628,6,1400,766,295,333
1,ALBA,"GRĂDINIŢA CU PROGRAM NORMAL NR. 3",160,"ORAŞ OCNA MUREŞ",1794,1,PART,PRCNCT,PRSD,PRSD_SV,"2025-05-18 22:05:51",1397,733,686,45,2,727,6,1500,767,306,421
1,ALBA,"ŞCOALA PRIMARĂ UIOARA DE JOS",161,"ORAŞ OCNA MUREŞ",1794,1,PART,PRCNCT,PRSD,PRSD_SV,"2025-05-18 22:02:46",820,388,338,50,0,384,4,900,512,186,198
1,ALBA,"ŞCOALA PRIMARĂ UIOARA DE SUS, SALA NR. 1",162,"ORAŞ OCNA MUREŞ",1794,1,PART,PRCNCT,PRSD,PRSD_SV,"2025-05-18 21:57:02",1320,649,581,67,1,642,7,1400,751,307,335
1,ALBA,"ŞCOALA GENERALĂ CISTEIU DE MUREŞ",163,"ORAŞ OCNA MUREŞ",1794,1,PART,PRCNCT,PRSD,PRSD_SV,"2025-05-18 21:40:33",553,262,235,27,0,258,4,600,338,171,87
1,ALBA,"GRĂDINIŢA CU PROGRAM NORMAL MICOŞLACA",164,"ORAŞ OCNA MUREŞ",1794,1,PART,PRCNCT,PRSD,PRSD_SV,"2025-05-18 21:41:02",235,140,108,32,0,140,0,300,160,82,58
1,ALBA,"CĂMINUL CULTURAL RĂZBOIENI-CETATE",165,"ORAŞ OCNA MUREŞ",1794,1,PART,PRCNCT,PRSD,PRSD_SV,"2025-05-18 22:52:44",1030,518,457,59,2,514,4,1100,582,228,286
1,ALBA,"CASA DE CULTURĂ TEIUŞ",166,"ORAŞ TEIUŞ",8096,1,PART,PRCNCT,PRSD,PRSD_SV,"2025-05-18 22:37:56",1517,957,812,142,3,948,9,1600,643,461,487
1,ALBA,"ŞCOALA GIMNAZIALĂ TEIUŞ",167,"ORAŞ TEIUŞ",8096,1,PART,PRCNCT,PRSD,PRSD_SV,"2025-05-18 21:48:48",1278,605,545,60,0,596,9,1400,795,323,273
1,ALBA,"LICEUL TEORETIC TEIUŞ",168,"ORAŞ TEIUŞ",8096,1,PART,PRCNCT,PRSD,PRSD_SV,"2025-05-18 22:44:51",1353,830,738,89,3,820,10,1400,570,386,434
1,ALBA,"GARA CFR TEIUŞ",169,"ORAŞ TEIUŞ",8096,1,PART,PRCNCT,PRSD,PRSD_SV,"2025-05-18 21:53:46",979,550,458,91,1,540,10,1100,550,302,238
1,ALBA,"ŞCOALA PRIMARĂ BELDIU",170,"ORAŞ TEIUŞ",8096,1,PART,PRCNCT,PRSD,PRSD_SV,"2025-05-18 21:43:04",202,131,102,29,0,130,1,300,169,72,58
1,ALBA,"CĂMIN CULTURAL CĂPUD",171,"ORAŞ TEIUŞ",8096,1,PART,PRCNCT,PRSD,PRSD_SV,"2025-05-18 21:41:11",256,147,128,18,1,145,2,300,153,89,56
1,ALBA,"ŞCOALA PRIMARĂ PEŢELCA",172,"ORAŞ TEIUŞ",8096,1,PART,PRCNCT,PRSD,PRSD_SV,"2025-05-18 21:21:22",92,78,51,27,0,78,0,100,22,44,34
1,ALBA,"ŞCOALA GIMNAZIALĂ „ AVRAM IANCU” ZLATNA",173,"ORAŞ ZLATNA",1936,1,PART,PRCNCT,PRSD,PRSD_SV,"2025-05-18 22:10:05",1148,620,579,37,4,615,5,1200,580,333,282
1,ALBA,"ŞCOALA GIMNAZIALĂ „ AVRAM IANCU” ZLATNA",174,"ORAŞ ZLATNA",1936,1,PART,PRCNCT,PRSD,PRSD_SV,"2025-05-18 22:00:20",940,531,488,40,3,522,9,1000,469,305,217
1,ALBA,"LICEUL ”CORNELIU MEDREA” ZLATNA",175,"ORAŞ ZLATNA",1936,1,PART,PRCNCT,PRSD,PRSD_SV,"2025-05-18 22:12:43",1298,654,606,47,1,641,13,1400,746,418,223
1,ALBA,"ŞCOALA GIMNAZIALĂ ” SAVA ALBESCU ” SAT FENEŞ",176,"ORAŞ ZLATNA",1936,2,PART,PRCNCT,PRSD,PRSD_SV,"2025-05-18 23:58:27",727,441,401,38,2,438,3,800,359,258,180
1,ALBA,"ŞCOALA PRIMARĂ , SAT GALAŢI",177,"ORAŞ ZLATNA",1936,1,PART,PRCNCT,PRSD,PRSD_SV,"2025-05-18 21:21:39",280,148,135,13,0,148,0,300,152,116,32
1,ALBA,"CĂMIN CULTURAL, SAT IZVORUL AMPOIULUI",178,"ORAŞ ZLATNA",1936,1,PART,PRCNCT,PRSD,PRSD_SV,"2025-05-18 21:35:32",370,190,170,20,0,187,3,400,210,130,57
1,ALBA,"ŞCOALA PRIMARĂ , SAT PĂTRÂNGENI",179,"ORAŞ ZLATNA",1936,1,PART,PRCNCT,PRSD,PRSD_SV,"2025-05-18 21:33:52",485,255,230,25,0,251,4,600,345,157,94
1,ALBA,"ŞCOALA PRIMARĂ , SAT PIRITA",180,"ORAŞ ZLATNA",1936,1,PART,PRCNCT,PRSD,PRSD_SV,"2025-05-18 21:31:39",372,174,158,16,0,174,0,400,226,127,47
1,ALBA,"ŞCOALA PRIMARĂ , SAT TRÂMPOIELE",181,"ORAŞ ZLATNA",1936,1,PART,PRCNCT,PRSD,PRSD_SV,"2025-05-18 21:36:20",300,142,131,11,0,142,0,400,258,113,29
1,ALBA,"ŞCOALA PRIMARĂ , SAT VALEA MICĂ",182,"ORAŞ ZLATNA",1936,1,PART,PRCNCT,PRSD,PRSD_SV,"2025-05-18 21:41:22",323,223,203,20,0,218,5,400,177,161,57
1,ALBA,"CĂMIN CULTURAL, SAT VÂLTORI",183,"ORAŞ ZLATNA",1936,1,PART,PRCNCT,PRSD,PRSD_SV,"2025-05-18 21:21:11",150,99,83,16,0,98,1,200,101,75,23
1,ALBA,"CĂMINUL CULTURAL ALBAC",184,ALBAC,2130,1,PART,PRCNCT,PRSD,PRSD_SV,"2025-05-18 21:57:14",717,497,375,119,3,492,5,800,303,294,198
1,ALBA,"ŞCOALA PRIMARĂ CIONEŞTI",185,ALBAC,2130,1,PART,PRCNCT,PRSD,PRSD_SV,"2025-05-18 21:38:37",496,248,226,18,4,247,1,600,352,193,54
1,ALBA,"ŞCOALA PRIMARĂ COSTEŞTI",186,ALBAC,2130,1,PART,PRCNCT,PRSD,PRSD_SV,"2025-05-18 21:21:19",75,46,37,9,0,45,1,100,54,38,7
1,ALBA,"ŞCOALA PRIMARĂ POTIONCI",187,ALBAC,2130,1,PART,PRCNCT,PRSD,PRSD_SV,"2025-05-18 21:14:16",51,30,19,11,0,29,1,100,70,22,7
1,ALBA,"ŞCOALA PRIMARĂ ROGOZ",188,ALBAC,2130,1,PART,PRCNCT,PRSD,PRSD_SV,"2025-05-18 21:25:25",235,142,121,18,3,141,1,300,158,115,26
1,ALBA,"PRIMĂRIA COMUNEI ALMAȘU MARE",189,"ALMAŞU MARE",2309,1,PART,PRCNCT,PRSD,PRSD_SV,"2025-05-18 22:02:19",299,164,142,22,0,163,1,400,236,115,48
1,ALBA,"CĂMINUL CULTURAL ALMAȘU MARE - SUSENI",190,"ALMAŞU MARE",2309,1,PART,PRCNCT,PRSD,PRSD_SV,"2025-05-18 21:36:57",200,128,94,33,1,126,2,300,172,73,53
1,ALBA,"ŞCOALA PRIMARĂ ALMAŞU DE MIJLOC",191,"ALMAŞU MARE",2309,1,PART,PRCNCT,PRSD,PRSD_SV,"2025-05-18 21:20:25",117,55,40,15,0,55,0,200,145,30,25
1,ALBA,"ŞCOALA PRIMARĂ CIB",192,"ALMAŞU MARE",2309,1,PART,PRCNCT,PRSD,PRSD_SV,"2025-05-18 21:54:19",225,148,125,16,7,145,3,300,152,73,72
1,ALBA,"ŞCOALA PRIMARĂ GLOD",193,"ALMAŞU MARE",2309,2,PART,PRCNCT,PRSD,PRSD_SV,"2025-05-19 00:43:28",152,104,82,22,0,102,2,200,96,81,21
1,ALBA,"GRUP ȘCOLAR DE TURISM ARIEȘENI",194,ARIEŞENI,2381,1,PART,PRCNCT,PRSD,PRSD_SV,"2025-05-18 21:45:16",533,429,333,80,16,418,11,600,171,175,243
1,ALBA,"GRUP ȘCOLAR DE TURISM ARIEȘENI",195,ARIEŞENI,2381,1,PART,PRCNCT,PRSD,PRSD_SV,"2025-05-18 21:46:54",482,376,284,77,15,372,4,600,224,176,196
1,ALBA,"ȘCOALA PRIMARĂ CASA DE PIATRĂ",196,ARIEŞENI,2381,1,PART,PRCNCT,PRSD,PRSD_SV,"2025-05-18 21:12:39",81,58,48,10,0,58,0,100,42,29,29
1,ALBA,"ȘCOALA PRIMARĂ COBLEȘ",197,ARIEŞENI,2381,1,PART,PRCNCT,PRSD,PRSD_SV,"2025-05-18 21:17:27",170,98,83,6,9,97,1,200,102,62,35
1,ALBA,"CĂMINUL CULTURAL AVRAM IANCU",198,"AVRAM IANCU",2577,1,PART,PRCNCT,PRSD,PRSD_SV,"2025-05-18 21:56:58",543,312,258,49,5,309,3,600,288,179,130
1,ALBA,"ŞCOALA PRIMARĂ I-IV TÎRSA",199,"AVRAM IANCU",2577,1,PART,PRCNCT,PRSD,PRSD_SV,"2025-05-18 21:37:53",592,316,290,25,1,309,7,700,384,225,84
1,ALBA,"CLĂDIRE CĂMIN CULTURAL BERGHIN",200,BERGHIN,2988,1,PART,PRCNCT,PRSD,PRSD_SV,"2025-05-18 21:34:28",674,290,248,42,0,287,3,700,410,197,90
1,ALBA,"CLĂDIRE CĂMIN CULTURAL GHIRBOM",201,BERGHIN,2988,1,PART,PRCNCT,PRSD,PRSD_SV,"2025-05-18 21:31:26",394,249,215,34,0,249,0,500,251,118,131
1,ALBA,"CLĂDIRE CĂMIN CULTURAL HENIG",202,BERGHIN,2988,1,PART,PRCNCT,PRSD,PRSD_SV,"2025-05-18 21:32:01",217,162,108,53,1,160,2,300,138,81,79
1,ALBA,"CLĂDIRE CĂMIN CULTURAL STRAJA",203,BERGHIN,2988,1,PART,PRCNCT,PRSD,PRSD_SV,"2025-05-18 21:22:18",262,175,129,46,0,174,1,300,125,95,79
1,ALBA,"ŞCOALA GIMNAZIALĂ ” NICODIM GANEA” BISTRA",204,BISTRA,3039,1,PART,PRCNCT,PRSD,PRSD_SV,"2025-05-18 21:45:36",798,426,391,35,0,417,9,900,474,238,179
1,ALBA,"ŞCOALA GIMNAZIALĂ ”NICODIM GANEA” BISTRA",205,BISTRA,3039,1,PART,PRCNCT,PRSD,PRSD_SV,"2025-05-18 22:05:02",1055,632,578,53,1,623,9,1100,468,431,192
1,ALBA,"ŞCOALA GIMNAZIALĂ ”NICODIM GANEA” BISTRA",206,BISTRA,3039,1,PART,PRCNCT,PRSD,PRSD_SV,"2025-05-18 21:31:10",744,347,298,49,0,346,1,800,453,241,105
1,ALBA,"ŞCOALA PRIMARĂ CIULDEŞTI - COMUNA BISTRA",207,BISTRA,3039,1,PART,PRCNCT,PRSD,PRSD_SV,"2025-05-18 21:36:39",567,272,251,21,0,269,3,600,328,188,81
1,ALBA,"ŞCOALA GIMNAZIALĂ GÎRDE I - COMUNA BISTRA",208,BISTRA,3039,1,PART,PRCNCT,PRSD,PRSD_SV,"2025-05-18 21:53:39",573,297,253,44,0,297,0,600,303,206,91
1,ALBA,"PRIMARIA COMUNEI BLANDIANA",209,BLANDIANA,3397,1,PART,PRCNCT,PRSD,PRSD_SV,"2025-05-18 21:32:31",445,257,206,51,0,255,2,500,243,139,116
1,ALBA,"ŞCOALA PRIMARĂ ACMARIU",210,BLANDIANA,3397,1,PART,PRCNCT,PRSD,PRSD_SV,"2025-05-18 21:23:54",273,179,149,30,0,175,4,300,121,85,90
1,ALBA,"ŞCOALA CU CLASELE I-IV RĂCĂTĂU",211,BLANDIANA,3397,1,PART,PRCNCT,PRSD,PRSD_SV,"2025-05-18 21:20:02",28,21,12,9,0,21,0,100,79,10,11
1,ALBA,"CĂMINUL CULTURAL BUCERDEA GRÂNOASĂ",212,"BUCERDEA GRÂNOASĂ",9026,1,PART,PRCNCT,PRSD,PRSD_SV,"2025-05-18 21:52:51",1049,675,625,45,5,666,9,1100,425,389,277
1,ALBA,"ŞCOALA GIMNAZIALĂ IOAN MAIORESCU BUCERDEA GRANOASĂ",213,"BUCERDEA GRÂNOASĂ",9026,1,PART,PRCNCT,PRSD,PRSD_SV,"2025-05-18 21:35:07",762,332,303,25,4,327,5,800,468,228,99
1,ALBA,"ŞCOALA PRIMARĂ BUCIUM-SAT",214,BUCIUM,3459,1,PART,PRCNCT,PRSD,PRSD_SV,"2025-05-18 21:27:53",367,216,186,29,1,212,4,400,184,118,94
1,ALBA,"ŞCOALA PRIMARĂ CERBU",215,BUCIUM,3459,1,PART,PRCNCT,PRSD,PRSD_SV,"2025-05-18 21:37:16",237,142,110,26,6,140,2,300,158,83,57
1,ALBA,"ŞCOALA PRIMARĂ CIUCULEŞTI",216,BUCIUM,3459,2,PART,PRCNCT,PRSD,PRSD_SV,"2025-05-19 00:37:12",321,190,144,36,10,189,1,400,210,90,99
1,ALBA,"ŞCOALA PRIMARĂ POIENI",217,BUCIUM,3459,1,PART,PRCNCT,PRSD,PRSD_SV,"2025-05-18 21:35:53",247,173,133,30,10,171,2,300,127,92,79
1,ALBA,"CĂMINUL CULTURAL CÂLNIC",218,CÂLNIC,4106,1,PART,PRCNCT,PRSD,PRSD_SV,"2025-05-18 21:48:45",1203,585,533,52,0,577,8,1300,715,376,201
1,ALBA,"ŞCOALA PRIMARĂ DEAL",219,CÂLNIC,4106,1,PART,PRCNCT,PRSD,PRSD_SV,"2025-05-18 21:34:45",308,220,169,50,1,220,0,400,180,120,100
1,ALBA,"PRIMĂRIA CENADE",220,CENADE,3761,1,PART,PRCNCT,PRSD,PRSD_SV,"2025-05-18 21:32:14",811,381,326,35,20,377,4,900,519,223,154
1,ALBA,"ŞCOALA GIMNAZIALĂ ”ARON COTRUŞ” CERGĂU MARE",221,CERGĂU,3805,1,PART,PRCNCT,PRSD,PRSD_SV,"2025-05-18 21:41:11",785,469,420,31,18,465,4,900,431,306,159
1,ALBA,"GRĂDINIȚA CU PROGRAM NORMAL CERGĂU MIC",222,CERGĂU,3805,1,PART,PRCNCT,PRSD,PRSD_SV,"2025-05-18 21:19:53",265,148,111,31,6,148,0,300,152,96,52
1,ALBA,"CLĂDIRE CĂMIN CULTURAL LUPU",223,CERGĂU,3805,1,PART,PRCNCT,PRSD,PRSD_SV,"2025-05-18 21:21:02",189,157,106,43,8,154,3,300,143,69,85
1,ALBA,"CĂMINUL CULTURAL",224,CERU-BĂCĂINŢI,3841,1,PART,PRCNCT,PRSD,PRSD_SV,"2025-05-18 21:28:17",197,143,86,57,0,139,4,300,157,62,77
1,ALBA,"CĂMIN CULTURAL",225,"CETATEA DE BALTĂ",3958,1,PART,PRCNCT,PRSD,PRSD_SV,"2025-05-18 21:33:40",575,198,169,27,2,186,12,700,502,97,89
1,ALBA,"CĂMIN CULTURAL",226,"CETATEA DE BALTĂ",3958,1,PART,PRCNCT,PRSD,PRSD_SV,"2025-05-18 22:00:55",870,430,370,45,15,423,7,1000,570,238,185
1,ALBA,"SCOALA GENERALA CRĂCIUNELU DE SUS",227,"CETATEA DE BALTĂ",3958,1,PART,PRCNCT,PRSD,PRSD_SV,"2025-05-18 21:12:06",54,45,23,19,3,44,1,100,55,17,27
1,ALBA,"SCOALA GENERALA SÎNTĂMĂRIE",228,"CETATEA DE BALTĂ",3958,1,PART,PRCNCT,PRSD,PRSD_SV,"2025-05-18 21:33:43",232,119,95,24,0,119,0,300,181,72,47
1,ALBA,"ȘCOALA GIMNAZIALĂ TĂTÂRLAUA",229,"CETATEA DE BALTĂ",3958,1,PART,PRCNCT,PRSD,PRSD_SV,"2025-05-18 21:15:31",646,166,144,22,0,162,4,700,534,133,29
1,ALBA,"ŞCOALĂ GIMNAZIALĂ CIUGUD",230,CIUGUD,1071,1,PART,PRCNCT,PRSD,PRSD_SV,"2025-05-18 22:03:33",592,471,378,84,9,464,7,700,229,196,268
1,ALBA,"CĂMIN CULTURAL DRÎMBAR",231,CIUGUD,1071,1,PART,PRCNCT,PRSD,PRSD_SV,"2025-05-18 21:49:34",337,264,211,44,9,264,0,400,136,106,158
1,ALBA,"CĂMIN CULTURAL HĂPRIA",232,CIUGUD,1071,1,PART,PRCNCT,PRSD,PRSD_SV,"2025-05-18 21:46:01",520,400,328,65,7,394,6,600,200,155,239
1,ALBA,"CĂMIN CULTURAL LIMBA",233,CIUGUD,1071,1,PART,PRCNCT,PRSD,PRSD_SV,"2025-05-18 21:31:50",342,237,187,45,5,236,1,400,163,69,167
1,ALBA,"CĂMIN CULTURAL ȘEUȘA",234,CIUGUD,1071,1,PART,PRCNCT,PRSD,PRSD_SV,"2025-05-18 21:50:54",699,510,425,64,21,498,12,800,290,217,281
1,ALBA,"CĂMIN CULTURAL TELEAC",235,CIUGUD,1071,1,PART,PRCNCT,PRSD,PRSD_SV,"2025-05-18 21:39:40",348,283,231,45,7,279,4,400,117,103,176
1,ALBA,"PRIMĂRIA COMUNEI CIURULEASA",236,CIURULEASA,4008,1,PART,PRCNCT,PRSD,PRSD_SV,"2025-05-18 21:38:40",551,345,305,38,2,331,14,600,255,215,116
1,ALBA,"ŞCOALA PRIMARĂ BUNINGINEA",237,CIURULEASA,4008,1,PART,PRCNCT,PRSD,PRSD_SV,"2025-05-18 21:34:58",362,202,182,20,0,196,6,400,198,144,52
1,ALBA,"PRIMĂRIA COMUNEI CRĂCIUNELU DE JOS",238,"CRĂCIUNELU DE JOS",4188,1,PART,PRCNCT,PRSD,PRSD_SV,"2025-05-18 22:11:58",845,547,479,64,4,545,2,902,355,289,256
1,ALBA,"ŞCOALA GIMNAZIALĂ - CRĂCIUNELU DE JOS",239,"CRĂCIUNELU DE JOS",4188,1,PART,PRCNCT,PRSD,PRSD_SV,"2025-05-18 21:59:27",910,511,468,42,1,507,4,1000,489,322,185
1,ALBA,"BIBLIOTECA COMUNALĂ",240,CRICĂU,4142,1,PART,PRCNCT,PRSD,PRSD_SV,"2025-05-18 21:55:34",1035,649,531,103,15,645,4,1100,451,360,285
1,ALBA,"ȘCOALA PRIMARĂ CRAIVA",241,CRICĂU,4142,1,PART,PRCNCT,PRSD,PRSD_SV,"2025-05-18 21:20:59",287,193,164,25,4,192,1,400,207,111,81
1,ALBA,"SALA DE ÎNTRUNIRI",242,CRICĂU,4142,1,PART,PRCNCT,PRSD,PRSD_SV,"2025-05-18 21:20:38",305,226,187,38,1,223,3,400,174,114,109
1,ALBA,"ŞCOALA GIMNAZIALĂ ”SEPTIMIU ALBINI”",243,CUT,9019,1,PART,PRCNCT,PRSD,PRSD_SV,"2025-05-18 22:10:27",1062,590,529,59,2,582,8,1100,510,278,304
1,ALBA,"CĂMINUL CULTURAL DAIA ROMÂNĂ",244,"DAIA ROMÂNĂ",4240,1,PART,PRCNCT,PRSD,PRSD_SV,"2025-05-18 21:38:25",1262,743,690,51,2,738,5,1300,557,351,387
1,ALBA,"CĂMINUL CULTURAL DAIA ROMÂNĂ",245,"DAIA ROMÂNĂ",4240,1,PART,PRCNCT,PRSD,PRSD_SV,"2025-05-18 21:37:04",1292,679,628,40,11,668,11,1400,721,343,325
1,ALBA,"ȘCOALA GIMAZIALĂ DOȘTAT",246,DOŞTAT,4268,1,PART,PRCNCT,PRSD,PRSD_SV,"2025-05-18 21:55:12",410,311,215,78,18,311,0,500,189,118,193
1,ALBA,"CĂMINUL CULTURAL BOZ",247,DOŞTAT,4268,1,PART,PRCNCT,PRSD,PRSD_SV,"2025-05-18 22:09:25",397,246,211,32,3,242,4,499,253,157,85
1,ALBA,"GRĂDINIȚA CU PROGRAM NORMAL ”PRICHINDELUL”",248,FĂRĂU,4302,1,PART,PRCNCT,PRSD,PRSD_SV,"2025-05-18 21:41:56",439,313,214,77,22,306,7,500,187,81,225
1,ALBA,"GRĂDINIŢA CU PROGRAM NORMAL HERIA",249,FĂRĂU,4302,1,PART,PRCNCT,PRSD,PRSD_SV,"2025-05-18 21:18:43",205,119,94,24,1,119,0,300,181,66,53
1,ALBA,"CĂMIN CULTURAL",250,FĂRĂU,4302,1,PART,PRCNCT,PRSD,PRSD_SV,"2025-05-18 21:50:31",136,93,68,25,0,93,0,200,107,22,71
1,ALBA,"CĂMIN CULTURAL SÂNBENEDIC",251,FĂRĂU,4302,1,PART,PRCNCT,PRSD,PRSD_SV,"2025-05-18 21:17:04",184,117,90,25,2,117,0,200,83,68,49
1,ALBA,"CĂMIN CULTURAL ȘILEA",252,FĂRĂU,4302,1,PART,PRCNCT,PRSD,PRSD_SV,"2025-05-18 21:25:57",238,145,115,28,2,145,0,300,155,76,69
1,ALBA,"CĂMINUL CULTURAL GALDA DE JOS",253,"GALDA DE JOS",4366,1,PART,PRCNCT,PRSD,PRSD_SV,"2025-05-18 21:59:27",1550,938,812,125,1,932,6,1600,662,502,430
1,ALBA,"ŞCOALA GIMNAZIALĂ BENIC",254,"GALDA DE JOS",4366,1,PART,PRCNCT,PRSD,PRSD_SV,"2025-05-18 21:26:02",437,285,225,50,10,282,3,500,215,141,141
1,ALBA,"ŞCOALA PRIMARĂ CETEA",255,"GALDA DE JOS",4366,1,PART,PRCNCT,PRSD,PRSD_SV,"2025-05-18 21:25:48",334,202,157,45,0,197,5,400,198,107,90
1,ALBA,"ŞCOALA PRIMARĂ GALDA DE SUS",256,"GALDA DE JOS",4366,1,PART,PRCNCT,PRSD,PRSD_SV,"2025-05-18 21:18:12",303,208,158,50,0,205,3,400,192,123,82
1,ALBA,"SALA DE FESTIVITĂŢI MESENTEA",257,"GALDA DE JOS",4366,1,PART,PRCNCT,PRSD,PRSD_SV,"2025-05-18 21:14:05",220,152,117,35,0,151,1,300,148,89,62
1,ALBA,"CĂMINUL CULTURAL OIEJDEA",258,"GALDA DE JOS",4366,1,PART,PRCNCT,PRSD,PRSD_SV,"2025-05-18 22:06:22",659,396,329,67,0,390,6,700,304,185,205
1,ALBA,"CLĂDIRE ADMINISTRATIVĂ (FOSTĂ ŞCOALA GENERALĂ POIANA GALDEI)",259,"GALDA DE JOS",4366,1,PART,PRCNCT,PRSD,PRSD_SV,"2025-05-18 21:22:29",118,100,61,39,0,98,2,200,100,62,36
1,ALBA,"PRIMĂRIA COMUNEI GÂRBOVA",260,GÂRBOVA,4482,1,PART,PRCNCT,PRSD,PRSD_SV,"2025-05-18 22:08:49",1209,577,502,55,20,574,3,1300,723,322,252
1,ALBA,"ȘCOALA PRIMARĂ CĂRPINIȘ",261,GÂRBOVA,4482,1,PART,PRCNCT,PRSD,PRSD_SV,"2025-05-18 21:15:37",195,121,76,44,1,119,2,300,179,64,55
1,ALBA,"ȘCOALA PRIMARĂ RECIU",262,GÂRBOVA,4482,1,PART,PRCNCT,PRSD,PRSD_SV,"2025-05-18 21:32:46",253,130,104,26,0,128,2,300,170,85,43
1,ALBA,"ŞCOALA GIMNAZIALĂ ”EMIL RACOVIŢĂ” GÎRDA DE SUS",263,"GÂRDA DE SUS",4525,1,PART,PRCNCT,PRSD,PRSD_SV,"2025-05-18 22:09:21",741,442,376,59,7,441,1,800,358,258,183
1,ALBA,"ŞCOALA PRIMARĂ BIHARIA",264,"GÂRDA DE SUS",4525,1,PART,PRCNCT,PRSD,PRSD_SV,"2025-05-18 21:27:17",102,55,41,14,0,55,0,200,145,29,26
1,ALBA,"ŞCOALA GIMNAZIALĂ GHEŢARI",265,"GÂRDA DE SUS",4525,1,PART,PRCNCT,PRSD,PRSD_SV,"2025-05-18 21:42:01",370,166,147,16,3,165,1,400,234,111,54
1,ALBA,"CĂMIN CULTURAL HOPÎRTA",266,HOPÂRTA,4703,1,PART,PRCNCT,PRSD,PRSD_SV,"2025-05-18 21:20:28",203,126,87,39,0,126,0,300,174,70,56
1,ALBA,"CĂMIN CULTURAL SILIVAŞ",267,HOPÂRTA,4703,1,PART,PRCNCT,PRSD,PRSD_SV,"2025-05-18 21:13:48",244,134,115,19,0,128,6,300,166,83,45
1,ALBA,"CĂMIN CULTURAL ŞPĂLNACA",268,HOPÂRTA,4703,1,PART,PRCNCT,PRSD,PRSD_SV,"2025-05-18 21:12:37",130,106,57,49,0,104,2,200,94,41,63
1,ALBA,"CĂMIN CULTURAL TURDAŞ",269,HOPÂRTA,4703,1,PART,PRCNCT,PRSD,PRSD_SV,"2025-05-18 21:13:44",140,84,56,28,0,84,0,200,116,49,35
1,ALBA,"CĂMIN CULTURAL VAMA SEACĂ",270,HOPÂRTA,4703,1,PART,PRCNCT,PRSD,PRSD_SV,"2025-05-18 21:08:40",144,111,79,32,0,111,0,200,89,61,50
1,ALBA,"ȘCOALA GIMNAZIALĂ HOREA",271,HOREA,4767,1,PART,PRCNCT,PRSD,PRSD_SV,"2025-05-18 21:33:53",587,295,256,38,1,290,5,700,405,189,101
1,ALBA,"ȘCOALA PRIMARĂ TRIFEȘTI",272,HOREA,4767,1,PART,PRCNCT,PRSD,PRSD_SV,"2025-05-18 21:33:33",368,203,188,14,1,203,0,400,197,159,44
1,ALBA,"ȘCOALA PRIMARĂ GIURGIUȚ",273,HOREA,4767,1,PART,PRCNCT,PRSD,PRSD_SV,"2025-05-18 21:23:17",103,82,63,19,0,82,0,200,118,59,23
1,ALBA,"CĂMIN CULTURAL MĂTIȘEȘTI",274,HOREA,4767,1,PART,PRCNCT,PRSD,PRSD_SV,"2025-05-18 21:32:14",329,192,174,18,0,191,1,400,208,124,67
1,ALBA,"ȘCOALA PRIMARĂ PĂTRUȘEȘTI",275,HOREA,4767,1,PART,PRCNCT,PRSD,PRSD_SV,"2025-05-18 21:21:51",114,75,65,10,0,74,1,200,125,62,12
1,ALBA,"ȘCOALA PRIMARĂ PRELUCA",276,HOREA,4767,1,PART,PRCNCT,PRSD,PRSD_SV,"2025-05-18 21:21:55",62,39,31,8,0,39,0,100,61,25,14
1,ALBA,"PRIMĂRIA COMUNEI IGHIU",277,IGHIU,4927,1,PART,PRCNCT,PRSD,PRSD_SV,"2025-05-18 21:39:04",1254,819,659,159,1,812,7,1300,481,415,397
1,ALBA,"ȘCOALA PRIMARĂ BUCERDEA VINOASĂ",278,IGHIU,4927,1,PART,PRCNCT,PRSD,PRSD_SV,"2025-05-18 21:31:21",773,561,484,77,0,554,7,800,239,248,306
1,ALBA,"ȘCOALA GIMNAZIALĂ IGHIEL",279,IGHIU,4927,1,PART,PRCNCT,PRSD,PRSD_SV,"2025-05-18 21:48:13",835,494,449,45,0,485,9,900,406,336,149
1,ALBA,"ŞCOALA GIMNAZIALĂ ŞARD",280,IGHIU,4927,1,PART,PRCNCT,PRSD,PRSD_SV,"2025-05-18 22:07:20",953,559,481,78,0,550,9,1000,441,334,216
1,ALBA,"ŞCOALA GIMNAZIALĂ ŞARD",281,IGHIU,4927,1,PART,PRCNCT,PRSD,PRSD_SV,"2025-05-18 21:25:21",1194,625,589,36,0,619,6,1300,675,365,254
1,ALBA,"ȘCOALĂ GIMNAZIALĂ ȚELNA",282,IGHIU,4927,1,PART,PRCNCT,PRSD,PRSD_SV,"2025-05-18 21:44:02",875,451,409,40,2,449,2,900,449,253,196
1,ALBA,"ȘCOALA GIMNAZIALĂ ÎNTREGALDE",283,ÎNTREGALDE,4981,1,PART,PRCNCT,PRSD,PRSD_SV,"2025-05-18 21:43:11",211,105,81,24,0,104,1,300,195,61,43
1,ALBA,"ȘCOALA CU CLASELE I-IV DEALU GEOAGIULUI",284,ÎNTREGALDE,4981,1,PART,PRCNCT,PRSD,PRSD_SV,"2025-05-18 21:20:59",84,56,29,27,0,55,1,100,44,45,10
1,ALBA,"ȘCOALA CU CLASELE I-IV GHIONCANI",285,ÎNTREGALDE,4981,1,PART,PRCNCT,PRSD,PRSD_SV,"2025-05-18 21:19:19",50,39,13,26,0,39,0,100,61,23,16
1,ALBA,"CĂMINUL CULTURAL NECRILEȘTI",286,ÎNTREGALDE,4981,1,PART,PRCNCT,PRSD,PRSD_SV,"2025-05-18 21:29:11",139,75,58,17,0,74,1,200,125,49,25
1,ALBA,"LICEUL TEHNOLOGIC JIDVEI",287,JIDVEI,5103,1,PART,PRCNCT,PRSD,PRSD_SV,"2025-05-18 21:40:05",1107,529,493,33,3,520,9,1200,671,299,221
1,ALBA,"ȘCOALA GENERALĂ BĂLCACIU",288,JIDVEI,5103,1,PART,PRCNCT,PRSD,PRSD_SV,"2025-05-18 21:34:37",1105,418,384,29,5,415,3,1200,782,287,128
1,ALBA,"GRĂDINIȚA CU PROGRAM NORMAL CĂPÂLNA DE JOS",289,JIDVEI,5103,1,PART,PRCNCT,PRSD,PRSD_SV,"2025-05-18 21:40:43",633,348,309,35,4,343,5,700,352,216,127
1,ALBA,"SCOALA GENERALĂ FEISA",290,JIDVEI,5103,1,PART,PRCNCT,PRSD,PRSD_SV,"2025-05-18 21:43:52",595,325,305,19,1,322,3,600,275,179,143
1,ALBA,"ȘCOALA GENERALĂ VESEUȘ",291,JIDVEI,5103,1,PART,PRCNCT,PRSD,PRSD_SV,"2025-05-18 21:47:43",720,339,324,14,1,336,3,800,461,180,156
1,ALBA,"ȘCOALA GIMNAZIALĂ LIVEZILE",292,LIVEZILE,5167,1,PART,PRCNCT,PRSD,PRSD_SV,"2025-05-18 21:36:12",533,416,322,78,16,414,2,600,184,201,213
1,ALBA,"CĂMIN CULTURAL IZVOARELE",293,LIVEZILE,5167,1,PART,PRCNCT,PRSD,PRSD_SV,"2025-05-18 21:38:07",78,63,29,33,1,63,0,200,137,30,33
1,ALBA,"CĂMIN CULTURAL POIANA AIUDULUI",294,LIVEZILE,5167,1,PART,PRCNCT,PRSD,PRSD_SV,"2025-05-18 21:35:59",262,171,112,53,6,170,1,300,129,85,85
1,ALBA,"CĂMIN CULTURAL VĂLIȘOARA",295,LIVEZILE,5167,1,PART,PRCNCT,PRSD,PRSD_SV,"2025-05-18 21:21:35",123,127,58,56,13,125,2,200,73,64,61
1,ALBA,"PRIMĂRIA LOPADEA NOUĂ",296,"LOPADEA NOUĂ",5210,1,PART,PRCNCT,PRSD,PRSD_SV,"2025-05-18 21:34:04",798,535,500,35,0,530,5,900,365,28,502
1,ALBA,"CĂMIN CULTURAL ASINIP",297,"LOPADEA NOUĂ",5210,1,PART,PRCNCT,PRSD,PRSD_SV,"2025-05-18 21:18:46",65,78,30,48,0,77,1,100,22,36,41
1,ALBA,"CLĂDIRE ANEXĂ PRIMĂRIA LOPADEA NOUĂ",298,"LOPADEA NOUĂ",5210,1,PART,PRCNCT,PRSD,PRSD_SV,"2025-05-18 21:45:37",396,259,226,33,0,257,2,500,241,114,143
1,ALBA,"CĂMINUL CULTURAL BEȚA",299,"LOPADEA NOUĂ",5210,1,PART,PRCNCT,PRSD,PRSD_SV,"2025-05-18 21:17:54",292,167,152,15,0,165,2,400,233,22,143
1,ALBA,"CLĂDIRE ANEXĂ PRIMĂRIA LOPADEA NOUĂ",300,"LOPADEA NOUĂ",5210,1,PART,PRCNCT,PRSD,PRSD_SV,"2025-05-18 21:46:15",520,337,296,40,1,333,4,600,263,223,110
1,ALBA,"CLĂDIRE ANEXĂ PRIMĂRIA LOPADEA NOUĂ",301,"LOPADEA NOUĂ",5210,1,PART,PRCNCT,PRSD,PRSD_SV,"2025-05-18 21:19:47",43,34,15,19,0,33,1,100,66,12,21
1,ALBA,"ŞCOALA GIMNAZIALĂ ”SIMION LAZĂR” LUNCA MUREŞULUI, STRADA GĂRII NR. 241 A",302,"LUNCA MUREŞULUI",5309,1,PART,PRCNCT,PRSD,PRSD_SV,"2025-05-18 21:54:10",753,392,328,62,2,391,1,800,408,235,156
1,ALBA,"ŞCOALA GIMNAZIALĂ ”SIMION LAZĂR” LUNCA MUREȘULUI, STRADA GĂRII NR. 241 A",303,"LUNCA MUREŞULUI",5309,1,PART,PRCNCT,PRSD,PRSD_SV,"2025-05-18 22:08:55",899,467,429,35,3,461,6,900,433,232,229
1,ALBA,"ŞCOALA PRIMARĂ GURA ARIEŞULUI, STRADA MICĂ NR. 84",304,"LUNCA MUREŞULUI",5309,1,PART,PRCNCT,PRSD,PRSD_SV,"2025-05-18 21:53:31",339,195,155,40,0,193,2,400,205,120,73
1,ALBA,"CĂMINUL CULTURAL LUPȘA",305,LUPŞA,5336,1,PART,PRCNCT,PRSD,PRSD_SV,"2025-05-18 21:41:58",615,406,344,62,0,404,2,700,294,261,143
1,ALBA,"ŞCOALA PRIMARĂ HĂDĂRĂU",306,LUPŞA,5336,1,PART,PRCNCT,PRSD,PRSD_SV,"2025-05-18 21:29:33",283,165,139,26,0,164,1,400,235,110,54
1,ALBA,"ŞCOALA GIMNAZIALĂ MUŞCA",307,LUPŞA,5336,1,PART,PRCNCT,PRSD,PRSD_SV,"2025-05-18 21:51:36",844,442,399,42,1,438,4,900,458,279,159
1,ALBA,"ŞCOALA PRIMARĂ VALEA LUPȘII",308,LUPŞA,5336,1,PART,PRCNCT,PRSD,PRSD_SV,"2025-05-18 21:58:05",658,377,346,31,0,377,0,700,323,293,84
1,ALBA,"ŞCOALA GIMNAZIALĂ METEŞ",309,METEŞ,5577,1,PART,PRCNCT,PRSD,PRSD_SV,"2025-05-18 21:33:09",461,237,195,41,1,235,2,500,263,167,68
1,ALBA,"ŞCOALA GIMNAZIALĂ AMPOIŢA",310,METEŞ,5577,1,PART,PRCNCT,PRSD,PRSD_SV,"2025-05-18 22:10:40",617,377,321,53,3,374,3,700,323,209,165
1,ALBA,"CĂMINUL CULTURAL LUNCA AMPOIȚEI",311,METEŞ,5577,1,PART,PRCNCT,PRSD,PRSD_SV,"2025-05-18 21:33:52",196,120,105,15,0,116,4,300,180,79,37
1,ALBA,"CĂMINUL CULTURAL POIANA AMPOIULUI",312,METEŞ,5577,1,PART,PRCNCT,PRSD,PRSD_SV,"2025-05-18 21:22:50",207,109,83,26,0,107,2,300,191,54,53
1,ALBA,"CĂMINUL CULTURAL PRESACA AMPOIULUI",313,METEŞ,5577,1,PART,PRCNCT,PRSD,PRSD_SV,"2025-05-18 21:29:38",284,186,162,24,0,183,3,300,114,116,67
1,ALBA,"ŞCOALA PRIMARĂ ”DIONISIU POPOVICIU” TĂUŢI",314,METEŞ,5577,1,PART,PRCNCT,PRSD,PRSD_SV,"2025-05-18 21:30:05",517,303,253,47,3,300,3,600,297,149,151
1,ALBA,"ŞCOALA GIMNAZIALĂ ”ION BREAZU” MIHALŢ",315,MIHALŢ,5700,1,PART,PRCNCT,PRSD,PRSD_SV,"2025-05-18 21:48:34",975,593,510,65,18,591,2,1000,407,336,255
1,ALBA,"ŞCOALA GIMNAZIALĂ ”ION BREAZU” MIHALŢ",316,MIHALŢ,5700,1,PART,PRCNCT,PRSD,PRSD_SV,"2025-05-18 21:51:05",795,483,444,29,10,480,3,900,417,263,217
1,ALBA,"CĂMIN CULTURAL CISTEI",317,MIHALŢ,5700,1,PART,PRCNCT,PRSD,PRSD_SV,"2025-05-18 21:49:05",466,317,270,37,10,315,2,500,183,159,156
1,ALBA,"CĂMIN CULTURAL OBREJA",318,MIHALŢ,5700,1,PART,PRCNCT,PRSD,PRSD_SV,"2025-05-18 21:25:37",414,261,228,30,3,258,3,500,239,151,107
1,ALBA,"GRĂDINIŢA CU PROGRAM NORMAL - MIRĂSLĂU",319,MIRĂSLĂU,5755,1,PART,PRCNCT,PRSD,PRSD_SV,"2025-05-18 21:28:47",691,366,336,30,0,364,2,800,434,166,198
1,ALBA,"ŞCOALA PRIMARĂ - CICĂU",320,MIRĂSLĂU,5755,1,PART,PRCNCT,PRSD,PRSD_SV,"2025-05-18 21:19:26",69,54,25,29,0,54,0,100,46,23,31
1,ALBA,"ŞCOALA PRIMARĂ - DECEA",321,MIRĂSLĂU,5755,1,PART,PRCNCT,PRSD,PRSD_SV,"2025-05-18 21:35:11",586,294,259,33,2,289,5,700,406,115,174
1,ALBA,"ŞCOALA PRIMARĂ - LOPADEA VECHE",322,MIRĂSLĂU,5755,1,PART,PRCNCT,PRSD,PRSD_SV,"2025-05-18 21:28:03",208,181,121,60,0,179,2,300,119,70,109
1,ALBA,"ŞCOALA PRIMARĂ - ORMENIŞ",323,MIRĂSLĂU,5755,1,PART,PRCNCT,PRSD,PRSD_SV,"2025-05-18 21:27:25",61,53,27,26,0,53,0,100,47,21,32
1,ALBA,"CĂMINUL CULTURAL",324,MOGOŞ,5826,1,PART,PRCNCT,PRSD,PRSD_SV,"2025-05-18 21:29:37",483,296,202,93,1,295,1,500,204,148,147
1,ALBA,"ŞCOALA CU CLASELE I-IV, SAT BUTEŞTI",325,MOGOŞ,5826,1,PART,PRCNCT,PRSD,PRSD_SV,"2025-05-18 21:19:52",40,24,11,13,0,24,0,100,76,15,9
1,ALBA,"REFUGIU TURISTIC VALEA BARNII",326,MOGOŞ,5826,1,PART,PRCNCT,PRSD,PRSD_SV,"2025-05-18 21:21:57",112,61,32,29,0,60,1,200,139,37,23
1,ALBA,"PRIMĂRIA COMUNEI NOȘLAC",327,NOŞLAC,6048,1,PART,PRCNCT,PRSD,PRSD_SV,"2025-05-18 21:49:39",953,476,397,78,1,472,4,1000,524,276,196
1,ALBA,"CĂMINUL CULTURAL GĂBUD",328,NOŞLAC,6048,1,PART,PRCNCT,PRSD,PRSD_SV,"2025-05-18 21:23:31",236,133,93,40,0,132,1,300,167,76,56
1,ALBA,"CĂMINUL CULTURAL STÂNA DE MUREȘ",329,NOŞLAC,6048,1,PART,PRCNCT,PRSD,PRSD_SV,"2025-05-18 21:23:57",280,181,127,52,2,179,2,300,119,72,107
1,ALBA,"INTERNAT ŞCOLAR - OCOLIŞ",330,OCOLIŞ,6119,1,PART,PRCNCT,PRSD,PRSD_SV,"2025-05-18 21:28:33",237,225,153,65,7,221,4,300,75,93,128
1,ALBA,"TABĂRA DE CREAȚIE SI ODIHNĂ ”AVRAM IANCU”",331,OCOLIŞ,6119,1,PART,PRCNCT,PRSD,PRSD_SV,"2025-05-18 21:22:12",43,45,22,23,0,44,1,100,55,16,28
1,ALBA,"ȘCOALA PRIMARĂ - RUNC",332,OCOLIŞ,6119,1,PART,PRCNCT,PRSD,PRSD_SV,"2025-05-18 21:25:14",100,80,58,20,2,80,0,200,120,44,36
1,ALBA,"ȘCOALA PRIMARĂ - VIDOLM",333,OCOLIŞ,6119,1,PART,PRCNCT,PRSD,PRSD_SV,"2025-05-18 21:25:26",52,66,25,40,1,66,0,200,134,27,39
1,ALBA,"ȘCOALA GIMNAZIALĂ OHABA",334,OHABA,6164,1,PART,PRCNCT,PRSD,PRSD_SV,"2025-05-18 21:34:20",310,192,144,35,13,189,3,400,208,92,97
1,ALBA,"CLĂDIRE ADMINISTRATIVĂ COLIBI (FOSTA ŞCOALĂ GENERALĂ)",335,OHABA,6164,1,PART,PRCNCT,PRSD,PRSD_SV,"2025-05-18 21:23:14",21,36,11,25,0,36,0,100,64,20,16
1,ALBA,"FOSTUL SEDIU C.A.P.",336,OHABA,6164,1,PART,PRCNCT,PRSD,PRSD_SV,"2025-05-18 21:34:21",138,113,65,43,5,113,0,200,87,60,53
1,ALBA,"ŞCOALA GIMNAZIALĂ PIANU DE SUS",337,PIANU,6217,1,PART,PRCNCT,PRSD,PRSD_SV,"2025-05-18 22:06:33",1359,830,736,92,2,818,12,1400,570,463,355
1,ALBA,"ŞCOALA GIMNAZIALĂ ”AUGUSTIN BENA” PIANU DE JOS",338,PIANU,6217,1,PART,PRCNCT,PRSD,PRSD_SV,"2025-05-18 22:24:05",1129,658,532,113,13,651,7,1200,542,415,236
1,ALBA,"CLĂDIRE ADMINISTRATIVĂ (FOSTA ŞCOALĂ GENERALĂ CU CLASELE I-IV) PLAIURI",339,PIANU,6217,1,PART,PRCNCT,PRSD,PRSD_SV,"2025-05-18 21:15:54",26,30,12,18,0,30,0,100,70,22,8
1,ALBA,"ŞCOALA PRIMARĂ ”GHEORGHE PAVELESCU” PURCĂREŢI",340,PIANU,6217,1,PART,PRCNCT,PRSD,PRSD_SV,"2025-05-18 21:38:07",217,92,77,15,0,92,0,300,208,55,37
1,ALBA,"ŞCOALA GIMNAZIALĂ STRUNGARI",341,PIANU,6217,1,PART,PRCNCT,PRSD,PRSD_SV,"2025-05-18 21:28:22",215,161,115,46,0,161,0,300,139,92,69
1,ALBA,"PRIMĂRIA COMUNEI POIANA VADULUI",342,"POIANA VADULUI",6271,1,PART,PRCNCT,PRSD,PRSD_SV,"2025-05-18 21:55:15",836,368,337,31,0,362,6,900,532,279,83
1,ALBA,"PRIMARIA COMUNEI PONOR",343,PONOR,6397,1,PART,PRCNCT,PRSD,PRSD_SV,"2025-05-18 21:50:19",334,206,150,49,7,206,0,400,194,124,82
1,ALBA,"CAMINUL CULTURAL GEOGEL",344,PONOR,6397,1,PART,PRCNCT,PRSD,PRSD_SV,"2025-05-18 21:21:56",177,96,65,26,5,95,1,200,104,42,53
1,ALBA,"CĂMINUL CULTURAL",345,POŞAGA,6468,1,PART,PRCNCT,PRSD,PRSD_SV,"2025-05-18 21:40:23",333,204,165,38,1,202,2,400,196,76,126
1,ALBA,"ȘCOALA CU CLASELE I-IV - LUNCA",346,POŞAGA,6468,1,PART,PRCNCT,PRSD,PRSD_SV,"2025-05-18 21:22:53",104,83,40,40,3,82,1,200,117,30,52
1,ALBA,"ȘCOALA CU CLASELE I-IV - ORĂȘTI",347,POŞAGA,6468,1,PART,PRCNCT,PRSD,PRSD_SV,"2025-05-18 21:18:21",89,59,46,13,0,57,2,100,41,40,17
1,ALBA,"ŞCOALA PRIMARĂ - POȘAGA DE SUS",348,POŞAGA,6468,1,PART,PRCNCT,PRSD,PRSD_SV,"2025-05-18 21:27:31",122,50,43,7,0,50,0,200,150,22,28
1,ALBA,"ȘCOALA PRIMARĂ - SAGAGEA",349,POŞAGA,6468,1,PART,PRCNCT,PRSD,PRSD_SV,"2025-05-18 21:35:49",135,82,63,18,1,81,1,200,118,53,28
1,ALBA,"ȘCOALA GIMNAZIALĂ ”DEMETRIU RADU” RĂDEȘTI",350,RĂDEŞTI,6547,1,PART,PRCNCT,PRSD,PRSD_SV,"2025-05-18 21:36:45",555,372,301,61,10,371,1,600,228,169,202
1,ALBA,"CĂMIN CULTURAL LEORINȚ",351,RĂDEŞTI,6547,1,PART,PRCNCT,PRSD,PRSD_SV,"2025-05-18 22:01:09",253,190,151,34,5,189,1,300,110,62,127
1,ALBA,"ŞCOALA PRIMARĂ MEŞCREAC",352,RĂDEŞTI,6547,1,PART,PRCNCT,PRSD,PRSD_SV,"2025-05-18 21:36:44",244,159,122,34,3,157,2,300,141,76,81
1,ALBA,"PRIMĂRIA COMUNEI RÎMEŢ",353,RÂMEŢ,6627,1,PART,PRCNCT,PRSD,PRSD_SV,"2025-05-18 21:33:49",171,107,52,55,0,106,1,200,93,54,52
1,ALBA,"FOSTA ŞCOALĂ CU CLASELE I-IV BRĂDEȘTI",354,RÂMEŢ,6627,1,PART,PRCNCT,PRSD,PRSD_SV,"2025-05-18 21:22:50",90,49,22,27,0,49,0,150,101,19,30
1,ALBA,"FOSTA ŞCOALĂ CU CLASELE I-IV VALEA INZELULUI",355,RÂMEŢ,6627,1,PART,PRCNCT,PRSD,PRSD_SV,"2025-05-18 21:15:39",71,46,24,22,0,46,0,100,54,25,21
1,ALBA,"FOSTA ŞCOALĂ CU CLASELE I-IV VALEA MĂNĂSTIRII",356,RÂMEŢ,6627,1,PART,PRCNCT,PRSD,PRSD_SV,"2025-05-18 21:39:47",128,129,66,63,0,129,0,250,121,81,48
1,ALBA,"GRĂDINIȚA COPII RIMETEA",357,RIMETEA,6592,1,PART,PRCNCT,PRSD,PRSD_SV,"2025-05-18 21:44:49",440,408,201,207,0,404,4,500,92,38,366
1,ALBA,"ŞCOALA PRIMARA COLŢEŞTI",358,RIMETEA,6592,1,PART,PRCNCT,PRSD,PRSD_SV,"2025-05-18 21:39:53",412,240,184,56,0,240,0,500,260,19,221
1,ALBA,"PRIMĂRIA ROŞIA DE SECAŞ",359,"ROŞIA DE SECAŞ",6930,1,PART,PRCNCT,PRSD,PRSD_SV,"2025-05-18 21:40:11",565,297,256,41,0,292,5,600,303,188,104
1,ALBA,"FOSTUL SEDIU CAP",360,"ROŞIA DE SECAŞ",6930,1,PART,PRCNCT,PRSD,PRSD_SV,"2025-05-18 21:33:06",338,168,127,41,0,168,0,400,232,90,78
1,ALBA,"ȘCOALA PRIMARĂ UNGUREI",361,"ROŞIA DE SECAŞ",6930,1,PART,PRCNCT,PRSD,PRSD_SV,"2025-05-18 21:23:01",302,109,93,16,0,107,2,400,291,74,33
1,ALBA,"PRIMARIA COMUNEI ROȘIA MONTANĂ",362,"ROŞIA MONTANĂ",6761,1,PART,PRCNCT,PRSD,PRSD_SV,"2025-05-18 21:58:36",599,324,277,46,1,314,10,700,376,176,138
1,ALBA,"ŞCOALA CU CLASELE I-IV - GURA ROȘIEI",363,"ROŞIA MONTANĂ",6761,1,PART,PRCNCT,PRSD,PRSD_SV,"2025-05-18 21:37:41",615,379,319,60,0,373,6,700,321,250,123
1,ALBA,"LOCUINȚE SOCIALE - CĂRPINIȘ",364,"ROŞIA MONTANĂ",6761,1,PART,PRCNCT,PRSD,PRSD_SV,"2025-05-18 21:41:58",659,377,336,40,1,373,4,700,323,229,144
1,ALBA,"ȘCOALA CU CLASELE I-IV - CORNA",365,"ROŞIA MONTANĂ",6761,1,PART,PRCNCT,PRSD,PRSD_SV,"2025-05-18 21:58:46",105,78,63,15,0,75,3,200,122,56,19
1,ALBA,"ŞCOALA CU CLASELE I-IV - VÎRTOP",366,"ROŞIA MONTANĂ",6761,1,PART,PRCNCT,PRSD,PRSD_SV,"2025-05-18 21:28:54",170,110,93,17,0,108,2,200,90,84,24
1,ALBA,"ŞCOALA PRIMARĂ SĂLCIUA DE JOS",367,SĂLCIUA,6976,1,PART,PRCNCT,PRSD,PRSD_SV,"2025-05-18 22:08:04",668,380,321,56,3,378,2,700,320,225,153
1,ALBA,"ŞCOALA GIMNAZIALĂ ”SIMION PANTEA” SĂLCIUA",368,SĂLCIUA,6976,1,PART,PRCNCT,PRSD,PRSD_SV,"2025-05-18 21:59:39",519,273,236,33,4,272,1,600,327,164,108
1,ALBA,"ȘCOALA GIMNAZIALĂ ”DAVID PRODAN” SĂLIȘTEA",369,SĂLIŞTEA,7044,1,PART,PRCNCT,PRSD,PRSD_SV,"2025-05-18 21:27:13",1057,644,579,64,1,640,4,1100,456,384,256
1,ALBA,"ŞCOALA PRIMARĂ MĂRGINENI",370,SĂLIŞTEA,7044,1,PART,PRCNCT,PRSD,PRSD_SV,"2025-05-18 21:13:04",47,41,21,20,0,41,0,100,59,26,15
1,ALBA,"ŞCOALA PRIMARĂ SĂLIŞTEA-DEAL",371,SĂLIŞTEA,7044,1,PART,PRCNCT,PRSD,PRSD_SV,"2025-05-18 21:33:50",230,115,101,14,0,115,0,300,185,100,15
1,ALBA,"ŞCOALA PRIMARĂ TĂRTĂRIA",372,SĂLIŞTEA,7044,1,PART,PRCNCT,PRSD,PRSD_SV,"2025-05-18 21:26:20",577,405,327,65,13,404,1,600,195,173,231
1,ALBA,"ȘCOALA GIMNAZIALĂ SĂSCIORI",373,SĂSCIORI,7099,1,PART,PRCNCT,PRSD,PRSD_SV,"2025-05-18 21:58:46",1326,768,699,69,0,766,2,1400,632,379,387
1,ALBA,"ȘCOALA PRIMARĂ CĂPÎLNA",374,SĂSCIORI,7099,1,PART,PRCNCT,PRSD,PRSD_SV,"2025-05-18 21:34:15",667,334,289,45,0,329,5,700,366,182,147
1,ALBA,"ȘCOALA PRIMARĂ LAZ",375,SĂSCIORI,7099,1,PART,PRCNCT,PRSD,PRSD_SV,"2025-05-18 21:37:30",322,219,178,41,0,217,2,400,181,94,123
1,ALBA,"ȘCOALA GIMNAZIALĂ LOMAN",376,SĂSCIORI,7099,1,PART,PRCNCT,PRSD,PRSD_SV,"2025-05-18 21:26:26",701,354,311,43,0,350,4,800,446,235,115
1,ALBA,"ȘCOALA GIMNAZIALĂ RĂCHITA",377,SĂSCIORI,7099,1,PART,PRCNCT,PRSD,PRSD_SV,"2025-05-18 21:27:37",787,365,347,18,0,362,3,800,435,301,61
1,ALBA,"ȘCOALA PRIMARĂ SEBEȘEL",378,SĂSCIORI,7099,1,PART,PRCNCT,PRSD,PRSD_SV,"2025-05-18 21:56:36",1155,626,579,47,0,614,12,1200,574,342,272
1,ALBA,"SCOALA GIMNAZIALA ”ION POP RETEGANUL” SANCEL",379,SÂNCEL,7348,1,PART,PRCNCT,PRSD,PRSD_SV,"2025-05-18 21:59:55",1313,700,630,63,7,691,9,1400,700,381,310
1,ALBA,"GRADINIŢA DE COPII CU PROGRAM NORMAL ICLOD",380,SÂNCEL,7348,1,PART,PRCNCT,PRSD,PRSD_SV,"2025-05-18 21:26:37",289,138,98,40,0,134,4,400,262,90,44
1,ALBA,"ŞCOALA PRIMARĂ PĂNADE",381,SÂNCEL,7348,1,PART,PRCNCT,PRSD,PRSD_SV,"2025-05-18 21:37:01",494,340,280,46,14,337,3,600,260,160,177
1,ALBA,"PRIMĂRIA COMUNEI SÂNTIMBRU",382,SÂNTIMBRU,7384,1,PART,PRCNCT,PRSD,PRSD_SV,"2025-05-18 21:35:23",755,472,419,49,4,468,4,800,328,240,228
1,ALBA,"CĂMINUL CULTURAL SÂNTIMBRU",383,SÂNTIMBRU,7384,1,PART,PRCNCT,PRSD,PRSD_SV,"2025-05-18 21:41:01",450,233,201,31,1,231,2,500,267,193,38
1,ALBA,"GRĂDINIȚA CU PROGRAM NORMAL COȘLARIU",384,SÂNTIMBRU,7384,2,PART,PRCNCT,PRSD,PRSD_SV,"2025-05-18 22:29:56",356,220,176,41,3,216,4,400,180,102,114
1,ALBA,"CENTRU DE ZI PERSOANE VĂRSTNICE",385,SÂNTIMBRU,7384,1,PART,PRCNCT,PRSD,PRSD_SV,"2025-05-18 21:11:19",73,70,34,36,0,69,1,100,30,29,40
1,ALBA,"CĂMINUL CULTURAL ”EUGEN CURTA” GALTIU",386,SÂNTIMBRU,7384,1,PART,PRCNCT,PRSD,PRSD_SV,"2025-05-18 21:55:47",398,272,227,42,3,269,3,500,228,152,117
1,ALBA,"CĂMINUL CULTURAL TOTOI",387,SÂNTIMBRU,7384,1,PART,PRCNCT,PRSD,PRSD_SV,"2025-05-18 21:33:20",465,319,243,73,3,317,2,500,181,165,152
1,ALBA,"CĂMINUL CULTURAL SCĂRIȘOARA",388,SCĂRIŞOARA,7197,1,PART,PRCNCT,PRSD,PRSD_SV,"2025-05-18 21:56:54",523,351,278,47,26,347,4,600,249,174,173
1,ALBA,"ŞCOALA GIMNAZIALĂ LĂZEȘTI",389,SCĂRIŞOARA,7197,1,PART,PRCNCT,PRSD,PRSD_SV,"2025-05-18 21:39:42",187,136,84,37,15,136,0,200,64,63,73
1,ALBA,"ŞCOALA PRIMARĂ NEGEȘTI",390,SCĂRIŞOARA,7197,1,PART,PRCNCT,PRSD,PRSD_SV,"2025-05-18 21:31:14",135,95,76,12,7,95,0,200,105,58,37
1,ALBA,"ŞCOALA PRIMARĂ RUNC",391,SCĂRIŞOARA,7197,1,PART,PRCNCT,PRSD,PRSD_SV,"2025-05-18 21:22:36",125,80,52,11,17,80,0,200,120,42,38
1,ALBA,"ŞCOALA PRIMARĂ SFOARTEA",392,SCĂRIŞOARA,7197,1,PART,PRCNCT,PRSD,PRSD_SV,"2025-05-18 21:32:43",62,42,27,11,4,42,0,100,58,10,32
1,ALBA,"ŞCOALA PRIMARĂ ȘTIULEȚI",393,SCĂRIŞOARA,7197,1,PART,PRCNCT,PRSD,PRSD_SV,"2025-05-18 21:26:54",108,93,69,16,8,91,2,200,107,50,41
1,ALBA,"CĂMINUL CULTURAL SOHODOL",394,SOHODOL,7446,1,PART,PRCNCT,PRSD,PRSD_SV,"2025-05-18 22:02:33",744,370,324,46,0,366,4,800,430,229,137
1,ALBA,"IMOBIL PROPRIETATE PARTICULARĂ",395,SOHODOL,7446,1,PART,PRCNCT,PRSD,PRSD_SV,"2025-05-18 21:32:40",188,124,107,17,0,123,1,200,76,66,57
1,ALBA,"ȘCOALA PRIMARĂ PELEŞ",396,SOHODOL,7446,1,PART,PRCNCT,PRSD,PRSD_SV,"2025-05-18 21:28:13",310,127,113,14,0,127,0,400,273,71,56
1,ALBA,"ŞCOALA PRIMARĂ POIANA",397,SOHODOL,7446,1,PART,PRCNCT,PRSD,PRSD_SV,"2025-05-18 21:17:12",118,63,41,22,0,61,2,200,137,30,31
1,ALBA,"ȘCOALA GIMNAZIALĂ „TIMOTEI OVIDIU TARNU” STREMȚ",398,STREMŢ,7767,1,PART,PRCNCT,PRSD,PRSD_SV,"2025-05-18 22:12:09",1148,752,634,111,7,747,5,1200,448,361,386
1,ALBA,"ȘCOALA GIMNAZIALĂ „VASILE BOLOGA” GEOAGIU DE SUS",399,STREMŢ,7767,1,PART,PRCNCT,PRSD,PRSD_SV,"2025-05-18 22:06:13",621,437,341,92,4,434,3,700,263,209,225
1,ALBA,"CĂMINUL CULTURAL GEOMAL",400,STREMŢ,7767,1,PART,PRCNCT,PRSD,PRSD_SV,"2025-05-18 21:51:19",226,162,123,39,0,160,2,300,138,88,72
1,ALBA,"CĂMIN CULTURAL ȘIBOT",401,ŞIBOT,7810,1,PART,PRCNCT,PRSD,PRSD_SV,"2025-05-18 22:11:25",1145,677,587,90,0,667,10,1200,523,318,349
1,ALBA,"CĂMINUL CULTURAL BALOMIR",402,ŞIBOT,7810,1,PART,PRCNCT,PRSD,PRSD_SV,"2025-05-18 21:40:39",488,325,250,74,1,318,7,600,275,190,128
1,ALBA,"ŞCOALA PRIMARĂ BĂCĂINŢI",403,ŞIBOT,7810,1,PART,PRCNCT,PRSD,PRSD_SV,"2025-05-18 21:50:06",211,141,98,43,0,141,0,300,159,75,66
1,ALBA,"CLĂDIRE ADMINISTRATIVĂ SĂRĂCSĂU (FOSTA ŞCOALĂ GENERALĂ)",404,ŞIBOT,7810,1,PART,PRCNCT,PRSD,PRSD_SV,"2025-05-18 21:19:05",137,90,51,39,0,89,1,200,110,54,35
1,ALBA,"ŞCOALA GIMNAZIALĂ ŞONA",405,ŞONA,7865,1,PART,PRCNCT,PRSD,PRSD_SV,"2025-05-18 21:54:47",1079,534,491,39,4,520,14,1100,566,307,213
1,ALBA,"CĂMINUL CULTURAL ALECUŞ",406,ŞONA,7865,1,PART,PRCNCT,PRSD,PRSD_SV,"2025-05-18 21:16:18",71,40,23,17,0,40,0,100,60,16,24
1,ALBA,"SALA MULTIFUNCȚIONALĂ BIIA",407,ŞONA,7865,1,PART,PRCNCT,PRSD,PRSD_SV,"2025-05-18 22:18:01",976,612,502,47,63,609,3,1000,388,301,308
1,ALBA,"CĂMIN CULTURAL LUNCA TÂRNAVEI",408,ŞONA,7865,1,PART,PRCNCT,PRSD,PRSD_SV,"2025-05-18 21:27:58",318,200,183,15,2,198,2,400,200,104,94
1,ALBA,"ȘCOALA GIMNAZIALĂ SÎNMICLĂUŞ",409,ŞONA,7865,1,PART,PRCNCT,PRSD,PRSD_SV,"2025-05-18 21:48:55",1133,490,462,28,0,486,4,1200,710,253,233
1,ALBA,"ȘCOALA GIMNAZIALĂ ȘPRING",410,ŞPRING,7945,1,PART,PRCNCT,PRSD,PRSD_SV,"2025-05-18 21:31:19",570,343,289,44,10,341,2,600,257,171,170
1,ALBA,"ŞCOALA GENERALĂ CUNŢA",411,ŞPRING,7945,1,PART,PRCNCT,PRSD,PRSD_SV,"2025-05-18 21:34:30",460,302,237,64,1,298,4,500,198,166,132
1,ALBA,"ŞCOALA PRIMARĂ DRAŞOV",412,ŞPRING,7945,1,PART,PRCNCT,PRSD,PRSD_SV,"2025-05-18 21:34:11",447,256,197,48,11,252,4,500,244,136,116
1,ALBA,"SEDIU ADMINISTRATIV VINGARD - COMUNA ŞPRING",413,ŞPRING,7945,1,PART,PRCNCT,PRSD,PRSD_SV,"2025-05-18 21:34:57",551,243,209,34,0,239,4,600,357,143,96
1,ALBA,"PRIMĂRIA COMUNEI ŞUGAG",414,ŞUGAG,8014,1,PART,PRCNCT,PRSD,PRSD_SV,"2025-05-18 22:43:46",1362,988,863,122,3,980,8,1400,412,500,480
1,ALBA,"CLĂDIRE ADMINISTRATIVĂ (FOSTĂ ŞCOALA GENERALĂ DOBRA)",415,ŞUGAG,8014,1,PART,PRCNCT,PRSD,PRSD_SV,"2025-05-18 21:54:47",431,295,263,32,0,288,7,500,205,155,133
1,ALBA,"ŞCOALA PRIMARĂ MĂRTINIE",416,ŞUGAG,8014,1,PART,PRCNCT,PRSD,PRSD_SV,"2025-05-18 21:50:48",456,354,311,43,0,352,2,500,146,190,162
1,ALBA,"ŞCOALA GIMNAZIALĂ ”AVRAM IANCU” UNIREA",417,UNIREA,8158,1,PART,PRCNCT,PRSD,PRSD_SV,"2025-05-18 21:57:48",894,378,307,54,17,375,3,900,522,186,189
1,ALBA,"ŞCOALA GIMNAZIALĂ ”AVRAM IANCU” UNIREA",418,UNIREA,8158,1,PART,PRCNCT,PRSD,PRSD_SV,"2025-05-18 21:59:39",782,396,340,44,12,392,4,791,395,195,197
1,ALBA,"ŞCOALA GIMNAZIALĂ ”GHEORGHE MAIER” UNIREA",419,UNIREA,8158,1,PART,PRCNCT,PRSD,PRSD_SV,"2025-05-18 22:38:36",1162,598,536,48,14,587,11,1200,602,294,293
1,ALBA,"CĂMINUL CULTURAL CIUGUDU DE JOS",420,UNIREA,8158,1,PART,PRCNCT,PRSD,PRSD_SV,"2025-05-18 21:43:31",259,147,109,36,2,147,0,300,153,93,54
1,ALBA,"ŞCOALA PRIMARĂ CIUGUDU DE SUS",421,UNIREA,8158,1,PART,PRCNCT,PRSD,PRSD_SV,"2025-05-18 21:30:18",96,63,33,30,0,63,0,200,137,35,28
1,ALBA,"ŞCOALA PRIMARĂ DUMBRAVA",422,UNIREA,8158,1,PART,PRCNCT,PRSD,PRSD_SV,"2025-05-18 22:06:18",259,172,87,61,24,167,5,300,128,88,79
1,ALBA,"CĂMINUL CULTURAL INOC",423,UNIREA,8158,1,PART,PRCNCT,PRSD,PRSD_SV,"2025-05-18 21:29:10",152,98,68,30,0,97,1,185,87,58,39
1,ALBA,"CĂMINUL CULTURAL MĂHĂCENI",424,UNIREA,8158,1,PART,PRCNCT,PRSD,PRSD_SV,"2025-05-18 21:39:41",199,158,86,69,3,157,1,300,142,89,68
1,ALBA,"CĂMINUL CULTURAL VADU MOȚILOR",425,"VADU MOŢILOR",8229,1,PART,PRCNCT,PRSD,PRSD_SV,"2025-05-18 22:32:20",1028,608,546,52,10,602,6,1100,492,434,168
1,ALBA,"PRIMĂRIA VALEA LUNGĂ",426,"VALEA LUNGĂ",8354,1,PART,PRCNCT,PRSD,PRSD_SV,"2025-05-18 22:11:05",1565,836,749,74,13,833,3,1600,764,569,264
1,ALBA,"ŞCOALA PRIMARĂ GLOGOVEŢ",427,"VALEA LUNGĂ",8354,1,PART,PRCNCT,PRSD,PRSD_SV,"2025-05-18 21:26:13",127,101,64,37,0,100,1,200,99,65,35
1,ALBA,"CASĂ PARTICULARĂ",428,"VALEA LUNGĂ",8354,1,PART,PRCNCT,PRSD,PRSD_SV,"2025-05-18 21:35:31",153,99,73,25,1,99,0,200,101,65,34
1,ALBA,"ȘCOALA PRIMARĂ LUNCA",429,"VALEA LUNGĂ",8354,1,PART,PRCNCT,PRSD,PRSD_SV,"2025-05-18 21:51:00",407,216,175,41,0,212,4,500,284,108,104
1,ALBA,"CĂMIN CULTURAL TĂUNI",430,"VALEA LUNGĂ",8354,1,PART,PRCNCT,PRSD,PRSD_SV,"2025-05-18 21:39:30",227,137,84,49,4,135,2,300,163,86,49
1,ALBA,"PRIMĂRIA COMUNEI VIDRA",431,VIDRA,8425,1,PART,PRCNCT,PRSD,PRSD_SV,"2025-05-18 21:37:45",293,178,138,40,0,175,3,400,222,90,85
1,ALBA,"ŞCOALA PRIMARĂ GOIEŞTI",432,VIDRA,8425,1,PART,PRCNCT,PRSD,PRSD_SV,"2025-05-18 21:29:29",283,145,126,19,0,144,1,300,155,108,36
1,ALBA,"FOSTUL SEDIU AL PRIMĂRIEI PONOREL",433,VIDRA,8425,1,PART,PRCNCT,PRSD,PRSD_SV,"2025-05-18 21:36:08",666,353,331,22,0,349,4,700,347,220,129
1,ALBA,"CĂMINUL CULTURAL VINŢU DE JOS",434,"VINŢU DE JOS",8826,1,PART,PRCNCT,PRSD,PRSD_SV,"2025-05-18 21:42:45",1071,714,608,106,0,708,6,1100,386,366,342
1,ALBA,"ŞCOALA GIMNAZIALĂ ”IULIU MANIU” VINŢU DE JOS",435,"VINŢU DE JOS",8826,3,PART,PRCNCT,PRSD,PRSD_SV,"2025-05-19 00:57:05",1357,783,691,92,0,779,4,1400,617,496,283
1,ALBA,"GRĂDINIȚA CU PROGRAM NORMAL SIBIȘENI",436,"VINŢU DE JOS",8826,1,PART,PRCNCT,PRSD,PRSD_SV,"2025-05-18 21:43:45",584,365,315,49,1,362,3,700,335,175,187
1,ALBA,"CĂMINUL CULTURAL INURI",437,"VINŢU DE JOS",8826,1,PART,PRCNCT,PRSD,PRSD_SV,"2025-05-18 21:22:37",139,61,47,14,0,60,1,170,109,37,23
1,ALBA,"CĂMINUL CULTURAL MERETEU",438,"VINŢU DE JOS",8826,1,PART,PRCNCT,PRSD,PRSD_SV,"2025-05-18 21:35:42",180,119,100,18,1,119,0,200,81,56,63
1,ALBA,"ŞCOALA PRIMARĂ VALEA VINŢULUI",439,"VINŢU DE JOS",8826,1,PART,PRCNCT,PRSD,PRSD_SV,"2025-05-18 21:17:48",292,164,142,22,0,163,1,400,236,120,43
1,ALBA,"ȘCOALA PRIMARĂ VURPĂR",440,"VINŢU DE JOS",8826,1,PART,PRCNCT,PRSD,PRSD_SV,"2025-05-18 22:03:08",863,518,447,61,10,515,3,900,382,310,205
2,ARAD,"COLEGIUL ECONOMIC ARAD - (SALA DE CLASĂ B22)",1,"MUNICIPIUL ARAD",9262,2,PART,PRCNCT,PRSD,PRSD_SV,"2025-05-18 22:59:53",1491,670,406,263,1,665,5,1628,958,233,432
2,ARAD,"POLICLINICA MUNICIPALĂ (CABINET PLANNING FAMILIAL)",2,"MUNICIPIUL ARAD",9262,1,PART,PRCNCT,PRSD,PRSD_SV,"2025-05-18 22:40:38",1012,779,511,229,39,768,11,1160,381,235,533
2,ARAD,"SPITALUL CLINIC JUDEȚEAN ARAD – SECȚIA CLINICĂ ORL (SALA DE ȘEDINȚE)",3,"MUNICIPIUL ARAD",9262,1,PART,PRCNCT,PRSD,PRSD_SV,"2025-05-18 21:52:42",1048,694,538,119,37,689,5,1200,506,230,459
2,ARAD,"COLEGIUL NAŢIONAL „VASILE GOLDIŞ” ARAD (FOSTA ŞCOALĂ GENERALĂ NR. 4)",4,"MUNICIPIUL ARAD",9262,1,PART,PRCNCT,PRSD,PRSD_SV,"2025-05-18 21:46:26",1152,691,580,83,28,678,13,1310,619,259,419
2,ARAD,"COLEGIUL NAŢIONAL „VASILE GOLDIŞ” ARAD (FOSTA ŞCOALĂ GENERALĂ NR. 4)",5,"MUNICIPIUL ARAD",9262,1,PART,PRCNCT,PRSD,PRSD_SV,"2025-05-18 22:18:12",1092,685,565,80,40,672,13,1250,565,216,456
2,ARAD,"COLEGIUL NAŢIONAL „VASILE GOLDIŞ” ARAD (FOSTA ŞCOALĂ GENERALĂ NR. 4)",6,"MUNICIPIUL ARAD",9262,2,PART,PRCNCT,PRSD,PRSD_SV,"2025-05-19 03:05:21",818,527,407,83,37,512,14,950,423,193,319
2,ARAD,"COLEGIUL NAŢIONAL „VASILE GOLDIŞ” ARAD (FOSTA ŞCOALĂ GENERALĂ NR. 4)",7,"MUNICIPIUL ARAD",9262,1,PART,PRCNCT,PRSD,PRSD_SV,"2025-05-18 21:38:04",814,521,427,80,14,516,5,940,419,156,360
2,ARAD,"COLEGIUL NAŢIONAL „VASILE GOLDIŞ” ARAD",8,"MUNICIPIUL ARAD",9262,1,PART,PRCNCT,PRSD,PRSD_SV,"2025-05-18 22:33:27",1866,1251,985,249,17,1236,15,2100,849,430,806
2,ARAD,"COLEGIUL DE ARTE „SABIN DRĂGOI” ARAD",9,"MUNICIPIUL ARAD",9262,1,PART,PRCNCT,PRSD,PRSD_SV,"2025-05-18 21:37:34",884,606,461,143,2,596,10,960,354,195,401
2,ARAD,"COLEGIUL DE ARTE „SABIN DRĂGOI” ARAD",10,"MUNICIPIUL ARAD",9262,1,PART,PRCNCT,PRSD,PRSD_SV,"2025-05-18 21:35:08",1097,652,558,93,1,642,10,1410,758,196,446
2,ARAD,"LICEUL TEHNOLOGIC DE ELECTRONICĂ ŞI AUTOMATIZĂRI „CAIUS IACOB” ARAD",11,"MUNICIPIUL ARAD",9262,1,PART,PRCNCT,PRSD,PRSD_SV,"2025-05-18 21:42:41",1206,695,615,79,1,680,15,1300,605,229,451
2,ARAD,"LICEUL TEOLOGIC BAPTIST „ALEXA POPOVICI” ARAD",12,"MUNICIPIUL ARAD",9262,1,PART,PRCNCT,PRSD,PRSD_SV,"2025-05-18 21:25:35",756,453,393,60,0,448,5,820,367,115,333
2,ARAD,"LICEUL TEOLOGIC BAPTIST „ALEXA POPOVICI” ARAD",13,"MUNICIPIUL ARAD",9262,1,PART,PRCNCT,PRSD,PRSD_SV,"2025-05-18 21:35:24",867,471,436,34,1,466,5,940,469,112,354
2,ARAD,"LICEUL NAȚIONAL DE INFORMATICĂ ARAD",14,"MUNICIPIUL ARAD",9262,1,PART,PRCNCT,PRSD,PRSD_SV,"2025-05-18 21:41:45",1189,790,601,189,0,779,11,1290,500,260,519
2,ARAD,"SALA SPORTURILOR",15,"MUNICIPIUL ARAD",9262,1,PART,PRCNCT,PRSD,PRSD_SV,"2025-05-18 21:29:34",894,567,488,77,2,557,10,970,403,146,411
2,ARAD,"SALA SPORTURILOR",16,"MUNICIPIUL ARAD",9262,1,PART,PRCNCT,PRSD,PRSD_SV,"2025-05-18 21:21:36",830,554,475,78,1,545,9,892,338,158,387
2,ARAD,"UNIVERSITATEA „AUREL VLAICU” DIN ARAD",17,"MUNICIPIUL ARAD",9262,2,PART,PRCNCT,PRSD,PRSD_SV,"2025-05-18 22:25:34",1499,875,786,88,1,864,11,1630,755,298,566
2,ARAD,"UNIVERSITATEA „AUREL VLAICU” DIN ARAD",18,"MUNICIPIUL ARAD",9262,1,PART,PRCNCT,PRSD,PRSD_SV,"2025-05-18 21:39:49",1235,712,682,30,0,700,12,1340,628,213,487
2,ARAD,"UNIVERSITATEA „AUREL VLAICU” DIN ARAD",19,"MUNICIPIUL ARAD",9262,1,PART,PRCNCT,PRSD,PRSD_SV,"2025-05-18 21:35:23",1097,679,613,65,1,665,14,1190,511,258,407
2,ARAD,"UNIVERSITATEA „AUREL VLAICU” DIN ARAD",20,"MUNICIPIUL ARAD",9262,1,PART,PRCNCT,PRSD,PRSD_SV,"2025-05-18 21:53:48",1228,753,622,131,0,744,9,1330,577,273,471
2,ARAD,"GRĂDINIȚA CU PROGRAM PRELUNGIT „CĂSUȚA PITICILOR” ARAD (GRĂDINIȚA CU PROGRAM PRELUNGIT „PRICHINDEL”)",21,"MUNICIPIUL ARAD",9262,1,PART,PRCNCT,PRSD,PRSD_SV,"2025-05-18 21:41:37",1494,919,839,80,0,903,16,1620,701,324,579
2,ARAD,"GRĂDINIȚA CU PROGRAM PRELUNGIT „CĂSUȚA PITICILOR” ARAD (GRĂDINIȚA CU PROGRAM PRELUNGIT „PRICHINDEL”)",22,"MUNICIPIUL ARAD",9262,1,PART,PRCNCT,PRSD,PRSD_SV,"2025-05-18 21:39:40",1421,868,828,39,1,856,12,1540,672,320,536
2,ARAD,"ŞCOALA GIMNAZIALĂ „REGINA MARIA” ARAD (FOSTA ŞCOALĂ GENERALĂ NR. 12)",23,"MUNICIPIUL ARAD",9262,1,PART,PRCNCT,PRSD,PRSD_SV,"2025-05-18 21:36:16",1320,852,708,144,0,842,10,1430,578,299,543
2,ARAD,"ŞCOALA GIMNAZIALĂ „REGINA MARIA” ARAD (FOSTA ŞCOALĂ GENERALĂ NR. 12)",24,"MUNICIPIUL ARAD",9262,1,PART,PRCNCT,PRSD,PRSD_SV,"2025-05-18 21:34:48",1129,640,564,74,2,633,7,1220,580,246,387
2,ARAD,"ŞCOALA GIMNAZIALĂ „REGINA MARIA” ARAD (FOSTA ŞCOALĂ GENERALĂ NR. 12)",25,"MUNICIPIUL ARAD",9262,1,PART,PRCNCT,PRSD,PRSD_SV,"2025-05-18 21:28:36",1258,702,650,52,0,687,15,1360,658,244,443
2,ARAD,"ȘCOALA GIMNAZIALĂ „CAIUS IACOB” ARAD (FOSTA ŞCOALĂ GENERALĂ NR. 22)",26,"MUNICIPIUL ARAD",9262,1,PART,PRCNCT,PRSD,PRSD_SV,"2025-05-18 22:05:41",1252,770,639,131,0,750,19,1350,580,339,411
2,ARAD,"ȘCOALA GIMNAZIALĂ „CAIUS IACOB” ARAD (FOSTA ŞCOALĂ GENERALĂ NR. 22)",27,"MUNICIPIUL ARAD",9262,1,PART,PRCNCT,PRSD,PRSD_SV,"2025-05-18 22:03:00",1147,612,531,81,0,605,7,1240,628,255,350
2,ARAD,"ȘCOALA GIMNAZIALĂ „CAIUS IACOB” ARAD (FOSTA ŞCOALĂ GENERALĂ NR. 22)",28,"MUNICIPIUL ARAD",9262,1,PART,PRCNCT,PRSD,PRSD_SV,"2025-05-18 21:59:38",1282,773,711,61,1,768,5,1380,607,327,441
2,ARAD,"ȘCOALA GIMNAZIALĂ „CAIUS IACOB” ARAD (FOSTA ŞCOALĂ GENERALĂ NR. 22)",29,"MUNICIPIUL ARAD",9262,1,PART,PRCNCT,PRSD,PRSD_SV,"2025-05-18 21:35:11",1324,695,663,32,0,677,18,1430,735,273,404
2,ARAD,"ȘCOALA GIMNAZIALĂ „CAIUS IACOB” ARAD (FOSTA ŞCOALĂ GENERALĂ NR. 22)",30,"MUNICIPIUL ARAD",9262,1,PART,PRCNCT,PRSD,PRSD_SV,"2025-05-18 21:31:10",1100,631,584,46,1,623,8,1200,569,246,377
2,ARAD,"ȘCOALA GIMNAZIALĂ „CAIUS IACOB” ARAD (FOSTA ŞCOALĂ GENERALĂ NR. 22)",31,"MUNICIPIUL ARAD",9262,1,PART,PRCNCT,PRSD,PRSD_SV,"2025-05-18 21:44:17",1395,821,768,52,1,809,12,1510,689,319,490
2,ARAD,"DIRECŢIA DE ASISTENŢĂ SOCIALĂ ARAD",32,"MUNICIPIUL ARAD",9262,1,PART,PRCNCT,PRSD,PRSD_SV,"2025-05-18 21:56:37",1535,1091,935,153,3,1083,8,1660,569,456,627
2,ARAD,"GRĂDINIȚA CU PROGRAM PRELUNGIT ”CĂSUȚA PITICILOR” ARAD (GRĂDINIȚA CU PROGRAM PRELUNGIT NR. 7)",33,"MUNICIPIUL ARAD",9262,1,PART,PRCNCT,PRSD,PRSD_SV,"2025-05-18 22:11:55",1395,821,759,62,0,805,16,1510,689,276,529
2,ARAD,"GRĂDINIȚA CU PROGRAM PRELUNGIT ”CĂSUȚA PITICILOR” ARAD (GRĂDINIȚA CU PROGRAM PRELUNGIT NR. 7)",34,"MUNICIPIUL ARAD",9262,1,PART,PRCNCT,PRSD,PRSD_SV,"2025-05-18 21:44:13",1335,708,639,69,0,700,8,1450,742,285,415
2,ARAD,"ŞCOALA GIMNAZIALĂ „ARON COTRUŞ”ARAD (FOSTA ŞCOALĂ GENERALĂ NR. 13)",35,"MUNICIPIUL ARAD",9262,1,PART,PRCNCT,PRSD,PRSD_SV,"2025-05-18 21:55:19",1200,730,672,58,0,721,9,1300,570,282,439
2,ARAD,"ŞCOALA GIMNAZIALĂ „ARON COTRUŞ”ARAD (FOSTA ŞCOALĂ GENERALĂ NR. 13)",36,"MUNICIPIUL ARAD",9262,1,PART,PRCNCT,PRSD,PRSD_SV,"2025-05-18 22:08:24",1490,831,781,50,0,818,13,1620,789,332,486
2,ARAD,"ŞCOALA GIMNAZIALĂ „ARON COTRUŞ”ARAD (FOSTA ŞCOALĂ GENERALĂ NR. 13)",37,"MUNICIPIUL ARAD",9262,1,PART,PRCNCT,PRSD,PRSD_SV,"2025-05-18 21:48:50",813,489,415,74,0,481,8,880,391,200,281
2,ARAD,"ŞCOALA GIMNAZIALĂ „ARON COTRUŞ”ARAD (FOSTA ŞCOALĂ GENERALĂ NR. 13)",38,"MUNICIPIUL ARAD",9262,1,PART,PRCNCT,PRSD,PRSD_SV,"2025-05-18 21:58:29",1622,963,914,49,0,948,15,1760,797,323,625
2,ARAD,"ŞCOALA GIMNAZIALĂ „ARON COTRUŞ”ARAD (FOSTA ŞCOALĂ GENERALĂ NR. 13)",39,"MUNICIPIUL ARAD",9262,2,PART,PRCNCT,PRSD,PRSD_SV,"2025-05-18 22:59:53",1167,737,682,55,0,729,8,1260,523,311,418
2,ARAD,"ŞCOALA GIMNAZIALĂ „ARON COTRUŞ”ARAD (FOSTA ŞCOALĂ GENERALĂ NR. 13)",40,"MUNICIPIUL ARAD",9262,1,PART,PRCNCT,PRSD,PRSD_SV,"2025-05-18 21:48:35",1186,807,711,83,13,788,19,1350,543,282,506
2,ARAD,"ŞCOALA GIMNAZIALĂ „ARON COTRUŞ”ARAD (FOSTA ŞCOALĂ GENERALĂ NR. 13)",41,"MUNICIPIUL ARAD",9262,1,PART,PRCNCT,PRSD,PRSD_SV,"2025-05-18 22:05:24",1379,869,774,73,22,860,9,1570,701,310,550
2,ARAD,"GRĂDINIȚA CU PROGRAM PRELUNGIT NR. 11 ARAD",42,"MUNICIPIUL ARAD",9262,1,PART,PRCNCT,PRSD,PRSD_SV,"2025-05-18 21:42:34",1307,824,758,65,1,815,9,1410,586,301,514
2,ARAD,"GRĂDINIŢA CU PROGRAM PRELUNGIT „PALATUL FERMECAT” ARAD ( GRĂDINIȚA CU PROGRAM NORMAL NR. 9 - ACTIVITATE SUSPENDATĂ)",43,"MUNICIPIUL ARAD",9262,1,PART,PRCNCT,PRSD,PRSD_SV,"2025-05-18 22:12:08",699,556,421,50,85,550,6,820,264,284,266
2,ARAD,"GRĂDINIŢA CU PROGRAM PRELUNGIT „PALATUL FERMECAT” ARAD (GRĂDINIŢA CU PROGRAM PRELUNGIT NR. 24)",44,"MUNICIPIUL ARAD",9262,2,PART,PRCNCT,PRSD,PRSD_SV,"2025-05-18 23:14:34",1039,642,476,78,88,623,19,1190,548,312,311
2,ARAD,"ŞCOALA GIMNAZIALĂ „AUREL VLAICU”ARAD (FOSTA ŞCOALĂ GENERALĂ NR. 21)",45,"MUNICIPIUL ARAD",9262,1,PART,PRCNCT,PRSD,PRSD_SV,"2025-05-18 22:15:16",1191,842,648,115,79,818,24,1360,518,345,473
2,ARAD,"ŞCOALA GIMNAZIALĂ „AUREL VLAICU”ARAD (FOSTA ŞCOALĂ GENERALĂ NR. 21)",46,"MUNICIPIUL ARAD",9262,1,PART,PRCNCT,PRSD,PRSD_SV,"2025-05-18 22:11:18",949,756,558,114,84,744,12,1090,334,310,434
2,ARAD,"ŞCOALA GIMNAZIALĂ „AUREL VLAICU”ARAD (FOSTA ŞCOALĂ GENERALĂ NR. 21)",47,"MUNICIPIUL ARAD",9262,1,PART,PRCNCT,PRSD,PRSD_SV,"2025-05-18 21:58:10",1135,780,625,73,82,767,13,1300,520,297,470
2,ARAD,"ȘCOALA GIMNAZIALĂ „NICOLAE BĂLCESCU” ARAD (FOSTA ŞCOALĂ GENERALĂ NR.11)",48,"MUNICIPIUL ARAD",9262,1,PART,PRCNCT,PRSD,PRSD_SV,"2025-05-18 21:41:55",1571,858,778,80,0,840,18,1700,842,311,529
2,ARAD,"ȘCOALA GIMNAZIALĂ „NICOLAE BĂLCESCU” ARAD (FOSTA ŞCOALĂ GENERALĂ NR.11)",49,"MUNICIPIUL ARAD",9262,1,PART,PRCNCT,PRSD,PRSD_SV,"2025-05-18 22:44:06",1473,753,662,91,0,739,13,1600,847,330,409
2,ARAD,"ȘCOALA GIMNAZIALĂ „NICOLAE BĂLCESCU” ARAD (FOSTA ŞCOALĂ GENERALĂ NR.11)",50,"MUNICIPIUL ARAD",9262,1,PART,PRCNCT,PRSD,PRSD_SV,"2025-05-18 21:47:30",1136,600,547,53,0,592,8,1230,630,295,297
2,ARAD,"GRĂDINIȚA CU PROGRAM PRELUNGIT „PALATUL FERMECAT” ARAD",51,"MUNICIPIUL ARAD",9262,2,PART,PRCNCT,PRSD,PRSD_SV,"2025-05-19 00:13:51",1492,820,752,66,2,804,13,1620,800,279,525
2,ARAD,"GRĂDINIȚA CU PROGRAM PRELUNGIT „PALATUL FERMECAT” ARAD",52,"MUNICIPIUL ARAD",9262,1,PART,PRCNCT,PRSD,PRSD_SV,"2025-05-18 21:59:46",1498,761,670,91,0,745,16,1620,859,317,428
2,ARAD,"ȘCOALA GIMNAZIALĂ ”AUREL VLAICU” ARAD (GRĂDINIȚA CU PROGRAM PRELUNGIT NR. 8)",53,"MUNICIPIUL ARAD",9262,1,PART,PRCNCT,PRSD,PRSD_SV,"2025-05-18 22:08:21",1808,1060,1006,54,0,1039,21,1960,900,494,545
2,ARAD,"GRĂDINIȚA CU PROGRAM PRELUNGIT „PALATUL FERMECAT” ARAD (GRĂDINIȚA CU PROGRAM NORMAL NR. 8)",54,"MUNICIPIUL ARAD",9262,1,PART,PRCNCT,PRSD,PRSD_SV,"2025-05-18 22:19:05",1997,1255,1172,83,0,1239,16,2170,915,493,746
2,ARAD,"ȘCOALA GIMNAZIALĂ ”AUREL VLAICU” ARAD (ȘCOALA GIMNAZIALĂ „FRAȚII NEUMANN” ARAD - FOSTA ȘCOALA GENERALĂ NR. 10)",55,"MUNICIPIUL ARAD",9262,1,PART,PRCNCT,PRSD,PRSD_SV,"2025-05-18 21:41:22",1408,687,623,64,0,674,13,1480,793,283,391
2,ARAD,"ȘCOALA GIMNAZIALĂ „AUREL VLAICU” ARAD (ȘCOALA GIMNAZIALĂ „FRAȚII NEUMAN” ARAD - FOSTA ȘCOALĂ GENERALĂ NR. 10)",56,"MUNICIPIUL ARAD",9262,1,PART,PRCNCT,PRSD,PRSD_SV,"2025-05-18 21:58:30",1071,649,582,66,1,642,6,1150,501,271,371
2,ARAD,"ȘCOALA GIMNAZIALĂ „AUREL VLAICU” ARAD (ȘCOALA GIMNAZIALĂ „FRAȚII NEUMAN” ARAD - FOSTA ŞCOALĂ GENERALĂ NR. 10)",57,"MUNICIPIUL ARAD",9262,1,PART,PRCNCT,PRSD,PRSD_SV,"2025-05-18 21:47:50",1406,806,770,36,0,791,15,1520,714,353,438
2,ARAD,"LICEUL CU PROGRAM SPORTIV ARAD (FOSTA ŞCOALĂ GENERALĂ NR. 9)",58,"MUNICIPIUL ARAD",9262,1,PART,PRCNCT,PRSD,PRSD_SV,"2025-05-18 21:49:08",1535,870,834,36,0,855,15,1660,790,443,412
2,ARAD,"LICEUL CU PROGRAM SPORTIV ARAD (FOSTA ŞCOALĂ GENERALĂ NR. 9)",59,"MUNICIPIUL ARAD",9262,1,PART,PRCNCT,PRSD,PRSD_SV,"2025-05-18 21:36:59",1287,682,653,29,0,669,13,1400,718,385,284
2,ARAD,"LICEUL CU PROGRAM SPORTIV ARAD (FOSTA ŞCOALĂ GENERALĂ NR. 9)",60,"MUNICIPIUL ARAD",9262,1,PART,PRCNCT,PRSD,PRSD_SV,"2025-05-18 21:56:19",1691,917,862,55,0,894,23,1830,913,481,413
2,ARAD,"LICEUL CU PROGRAM SPORTIV ARAD (FOSTA ŞCOALĂ GENERALĂ NR. 9)",61,"MUNICIPIUL ARAD",9262,1,PART,PRCNCT,PRSD,PRSD_SV,"2025-05-18 21:54:48",1231,674,627,47,0,665,9,1330,656,321,344
2,ARAD,"LICEUL CU PROGRAM SPORTIV ARAD (FOSTA ŞCOALĂ GENERALĂ NR. 9)",62,"MUNICIPIUL ARAD",9262,1,PART,PRCNCT,PRSD,PRSD_SV,"2025-05-18 21:31:56",1404,763,734,29,0,752,11,1520,757,411,341
2,ARAD,"GRĂDINIŢA CU PROGRAM PRELUNGIT „GRĂDINIŢA PRIETENIEI” ARAD",63,"MUNICIPIUL ARAD",9262,1,PART,PRCNCT,PRSD,PRSD_SV,"2025-05-18 22:13:28",1556,844,742,102,0,834,10,1690,846,402,432
2,ARAD,"GRĂDINIŢA CU PROGRAM PRELUNGIT „GRĂDINIŢA PRIETENIEI” ARAD",64,"MUNICIPIUL ARAD",9262,1,PART,PRCNCT,PRSD,PRSD_SV,"2025-05-18 21:59:35",1356,731,633,98,0,724,7,1470,739,352,372
2,ARAD,"LICEUL TEHNOLOGIC DE CONSTRUCȚII ȘI PROTECȚIA MEDIULUI ARAD (FOSTA ŞCOALĂ GENERALĂ NR. 6)",65,"MUNICIPIUL ARAD",9262,1,PART,PRCNCT,PRSD,PRSD_SV,"2025-05-18 21:46:12",1416,764,689,74,1,752,12,1540,776,307,445
2,ARAD,"LICEUL TEHNOLOGIC DE CONSTRUCȚII ȘI PROTECȚIA MEDIULUI ARAD (FOSTA ŞCOALĂ GENERALĂ NR. 6)",66,"MUNICIPIUL ARAD",9262,1,PART,PRCNCT,PRSD,PRSD_SV,"2025-05-18 21:40:49",1489,812,727,85,0,791,21,1610,798,347,444
2,ARAD,"GRĂDINIŢA CU PROGRAM PRELUNGIT „FURNICUŢA” ARAD",67,"MUNICIPIUL ARAD",9262,1,PART,PRCNCT,PRSD,PRSD_SV,"2025-05-18 21:57:35",1522,760,688,72,0,746,14,1650,890,296,450
2,ARAD,"GRĂDINIŢA CU PROGRAM PRELUNGIT „FURNICUŢA” ARAD",68,"MUNICIPIUL ARAD",9262,1,PART,PRCNCT,PRSD,PRSD_SV,"2025-05-18 21:57:38",1314,763,675,88,0,753,10,1420,657,290,463
2,ARAD,"ŞCOALA GIMNAZIALĂ „AVRAM IANCU” ARAD (FOSTA ŞCOALĂ GENERALĂ NR. 18)",69,"MUNICIPIUL ARAD",9262,1,PART,PRCNCT,PRSD,PRSD_SV,"2025-05-18 21:36:55",1099,696,552,66,78,678,18,1260,564,298,380
2,ARAD,"ŞCOALA GIMNAZIALĂ „AVRAM IANCU” ARAD (FOSTA ŞCOALĂ GENERALĂ NR. 18)",70,"MUNICIPIUL ARAD",9262,1,PART,PRCNCT,PRSD,PRSD_SV,"2025-05-18 21:50:47",1315,805,640,83,82,784,21,1490,685,306,478
2,ARAD,"LICEUL TEHNOLOGIC DE CONSTRUCȚII ȘI PROTECȚIA MEDIULUI ARAD",71,"MUNICIPIUL ARAD",9262,1,PART,PRCNCT,PRSD,PRSD_SV,"2025-05-18 21:46:52",1361,855,668,114,73,835,20,1540,685,389,446
2,ARAD,"LICEUL TEHNOLOGIC DE CONSTRUCȚII ȘI PROTECȚIA MEDIULUI ARAD",72,"MUNICIPIUL ARAD",9262,2,PART,PRCNCT,PRSD,PRSD_SV,"2025-05-18 22:35:55",1492,812,675,55,82,804,8,1690,878,401,403
2,ARAD,"ŞCOALA GIMNAZIALĂ „ILARION FELEA” ARAD (FOSTA ŞCOALĂ GENERALĂ NR. 8)",73,"MUNICIPIUL ARAD",9262,1,PART,PRCNCT,PRSD,PRSD_SV,"2025-05-18 21:51:03",1383,654,510,64,80,643,11,1570,916,512,131
2,ARAD,"AGENȚIA NAȚIONALĂ DE ADMINISTRARE FISCALĂ, FOSTA DIRECȚIE VAMALĂ",74,"MUNICIPIUL ARAD",9262,1,PART,PRCNCT,PRSD,PRSD_SV,"2025-05-18 22:07:42",1024,732,507,150,75,716,16,1170,438,326,390
2,ARAD,"AGENȚIA NAȚIONALĂ DE ADMINISTRARE FISCALĂ, FOSTA DIRECȚIE VAMALĂ",75,"MUNICIPIUL ARAD",9262,2,PART,PRCNCT,PRSD,PRSD_SV,"2025-05-18 23:17:23",1228,816,606,142,68,800,16,1400,584,345,455
2,ARAD,"GRĂDINIȚA CU PROGRAM PRELUNGIT „PITICOT” ARAD (GRĂDINIȚA CU PROGRAM NORMAL NR. 12)",76,"MUNICIPIUL ARAD",9262,1,PART,PRCNCT,PRSD,PRSD_SV,"2025-05-18 21:45:21",1567,771,688,81,2,760,11,1700,929,412,348
2,ARAD,"GRĂDINIȚA CU PROGRAM PRELUNGIT „PITICOT” ARAD (GRĂDINIȚA CU PROGRAM NORMAL NR. 12)",77,"MUNICIPIUL ARAD",9262,1,PART,PRCNCT,PRSD,PRSD_SV,"2025-05-18 21:24:50",1028,510,473,36,1,502,8,1130,620,247,255
2,ARAD,"CENTRU PENTRU ACORDAREA AJUTOARELOR BĂNEŞTI PENTRU ÎNCĂLZIREA LOCUINŢELOR",78,"MUNICIPIUL ARAD",9262,1,PART,PRCNCT,PRSD,PRSD_SV,"2025-05-18 22:13:45",1420,791,615,105,71,772,19,1610,819,406,366
2,ARAD,"ŞCOALA GIMNAZIALĂ „IOSIF MOLDOVAN” ARAD (FOSTA ŞCOALĂ GENERALĂ NR. 3)",79,"MUNICIPIUL ARAD",9262,1,PART,PRCNCT,PRSD,PRSD_SV,"2025-05-18 21:48:27",1529,836,762,54,20,829,7,1730,894,318,511
2,ARAD,"ŞCOALA GIMNAZIALĂ „IOSIF MOLDOVAN” ARAD (FOSTA ŞCOALĂ GENERALĂ NR. 3)",80,"MUNICIPIUL ARAD",9262,1,PART,PRCNCT,PRSD,PRSD_SV,"2025-05-18 21:47:17",1137,690,576,114,0,674,16,1230,540,309,365
2,ARAD,"ŞCOALA GIMNAZIALĂ „IOSIF MOLDOVAN” ARAD (FOSTA ŞCOALĂ GENERALĂ NR. 3)",81,"MUNICIPIUL ARAD",9262,2,PART,PRCNCT,PRSD,PRSD_SV,"2025-05-18 22:52:41",1085,620,568,51,1,606,14,1170,550,263,343
2,ARAD,"ŞCOALA GIMNAZIALĂ „IOSIF MOLDOVAN” ARAD (FOSTA ŞCOALĂ GENERALĂ NR. 3)",82,"MUNICIPIUL ARAD",9262,1,PART,PRCNCT,PRSD,PRSD_SV,"2025-05-18 21:45:45",1391,734,694,19,21,724,10,1580,846,329,395
2,ARAD,"ŞCOALA GIMNAZIALĂ „IOSIF MOLDOVAN” ARAD (FOSTA ŞCOALĂ GENERALĂ NR. 3)",83,"MUNICIPIUL ARAD",9262,1,PART,PRCNCT,PRSD,PRSD_SV,"2025-05-18 21:39:10",1232,641,616,24,1,630,11,1330,689,275,355
2,ARAD,"ŞCOALA GIMNAZIALĂ „IOSIF MOLDOVAN” ARAD (FOSTA ŞCOALĂ GENERALĂ NR. 3)",84,"MUNICIPIUL ARAD",9262,1,PART,PRCNCT,PRSD,PRSD_SV,"2025-05-18 21:44:32",1468,774,628,75,71,758,16,1660,886,380,378
2,ARAD,"ŞCOALA GIMNAZIALĂ ”IOSIF MOLDOVAN” ARAD (FOSTA ŞCOALA GENERALĂ NR. 3)",85,"MUNICIPIUL ARAD",9262,1,PART,PRCNCT,PRSD,PRSD_SV,"2025-05-18 21:48:11",1807,935,875,59,1,925,10,1960,1025,370,555
2,ARAD,"GRĂDINIȚA CU PROGRAM PRELUNGIT „ELEFĂNŢELUL ALFA” ARAD",86,"MUNICIPIUL ARAD",9262,1,PART,PRCNCT,PRSD,PRSD_SV,"2025-05-18 21:35:12",1135,531,475,56,0,525,6,1220,689,237,288
2,ARAD,"GRĂDINIȚA CU PROGRAM PRELUNGIT „ELEFĂNŢELUL ALFA” ARAD",87,"MUNICIPIUL ARAD",9262,1,PART,PRCNCT,PRSD,PRSD_SV,"2025-05-18 21:54:11",1308,663,627,36,0,650,13,1410,747,296,354
2,ARAD,"STAȚIUNEA DE CERCETARE - DEZVOLTARE PENTRU CREȘTEREA BOVINELOR ARAD",88,"MUNICIPIUL ARAD",9262,1,PART,PRCNCT,PRSD,PRSD_SV,"2025-05-18 21:23:53",324,168,120,28,20,166,2,410,242,102,64
2,ARAD,"LICEUL TEHNOLOGIC DE TRANSPORTURI AUTO „HENRI COANDĂ” ARAD",89,"MUNICIPIUL ARAD",9262,1,PART,PRCNCT,PRSD,PRSD_SV,"2025-05-18 21:47:15",922,542,471,51,20,535,7,1060,518,202,333
2,ARAD,"ŞCOALA GIMNAZIALĂ „MIHAI EMINESCU” ARAD (FOSTA ŞCOALĂ GENERALĂ NR. 1)",90,"MUNICIPIUL ARAD",9262,1,PART,PRCNCT,PRSD,PRSD_SV,"2025-05-18 21:53:58",1318,733,634,78,21,724,9,1500,767,294,430
2,ARAD,"LICEUL TEHNOLOGIC DE INDUSTRIE ALIMENTARĂ ARAD",91,"MUNICIPIUL ARAD",9262,1,PART,PRCNCT,PRSD,PRSD_SV,"2025-05-18 21:28:55",1422,752,687,49,16,743,9,1620,868,262,481
2,ARAD,"LICEUL TEHNOLOGIC DE INDUSTRIE ALIMENTARĂ ARAD",92,"MUNICIPIUL ARAD",9262,1,PART,PRCNCT,PRSD,PRSD_SV,"2025-05-18 21:22:21",824,456,374,76,6,452,4,960,504,185,267
2,ARAD,"COLEGIUL „CSIKY GERGELY” ARAD",93,"MUNICIPIUL ARAD",9262,1,PART,PRCNCT,PRSD,PRSD_SV,"2025-05-18 22:02:27",1050,594,470,96,28,586,8,1210,616,242,344
2,ARAD,"LICEUL TEHNOLOGIC „FRANCISC NEUMAN” ARAD",94,"MUNICIPIUL ARAD",9262,1,PART,PRCNCT,PRSD,PRSD_SV,"2025-05-18 22:00:29",1209,404,357,47,0,397,7,1310,906,205,192
2,ARAD,"LICEUL TEHNOLOGIC „FRANCISC NEUMAN” ARAD",95,"MUNICIPIUL ARAD",9262,1,PART,PRCNCT,PRSD,PRSD_SV,"2025-05-18 21:59:27",1397,610,572,37,1,600,10,1510,900,258,342
2,ARAD,"LICEUL TEHNOLOGIC „FRANCISC NEUMAN” ARAD",96,"MUNICIPIUL ARAD",9262,1,PART,PRCNCT,PRSD,PRSD_SV,"2025-05-18 21:37:54",1132,479,440,38,1,464,15,1220,741,196,268
2,ARAD,"LICEUL TEHNOLOGIC „FRANCISC NEUMAN” ARAD",97,"MUNICIPIUL ARAD",9262,1,PART,PRCNCT,PRSD,PRSD_SV,"2025-05-18 21:42:56",925,542,490,51,1,538,4,1000,458,162,376
2,ARAD,"PRIMĂRIA MUNICIPIULUI ARAD, DIRECȚIA VENITURI",98,"MUNICIPIUL ARAD",9262,1,PART,PRCNCT,PRSD,PRSD_SV,"2025-05-18 21:49:16",1391,716,636,78,2,709,7,1500,784,309,400
2,ARAD,"COLEGIUL NAȚIONAL „PREPARANDIA-DIMITRIE ȚICHINDEAL” ARAD",99,"MUNICIPIUL ARAD",9262,1,PART,PRCNCT,PRSD,PRSD_SV,"2025-05-18 21:42:59",922,590,501,88,1,579,11,1000,410,194,385
2,ARAD,"GRĂDINIȚA CU PROGRAM PRELUNGIT NR. 14 ARAD",100,"MUNICIPIUL ARAD",9262,1,PART,PRCNCT,PRSD,PRSD_SV,"2025-05-18 21:34:03",1214,662,571,91,0,653,9,1320,658,227,426
2,ARAD,"GRĂDINIȚA CU PROGRAM PRELUNGIT NR. 14 ARAD (GRĂDINIȚA CU PROGRAM NORMAL NR. 26)",101,"MUNICIPIUL ARAD",9262,1,PART,PRCNCT,PRSD,PRSD_SV,"2025-05-18 21:21:21",456,269,247,22,0,265,4,500,231,104,161
2,ARAD,"PATINOARUL MUNICIPAL ARAD",102,"MUNICIPIUL ARAD",9262,1,PART,PRCNCT,PRSD,PRSD_SV,"2025-05-18 21:31:00",833,565,523,42,0,558,7,900,335,173,385
2,ARAD,"LICEUL TEORETIC „ADAM MULLER GUTTENBRUNN” ARAD (FOSTA ȘCOALĂ GENERALĂ NR. 20)",103,"MUNICIPIUL ARAD",9262,1,PART,PRCNCT,PRSD,PRSD_SV,"2025-05-18 22:20:14",1433,811,766,44,1,799,12,1550,739,262,537
2,ARAD,"LICEUL TEORETIC ”ADAM MULLER GUTTENBRUNN” ARAD (SALA DE SPORT)",104,"MUNICIPIUL ARAD",9262,1,PART,PRCNCT,PRSD,PRSD_SV,"2025-05-18 21:53:53",1052,694,659,34,1,685,9,1140,446,238,447
2,ARAD,"LICEUL TEORETIC „ADAM MULLER GUTTENBRUNN” ARAD",105,"MUNICIPIUL ARAD",9262,1,PART,PRCNCT,PRSD,PRSD_SV,"2025-05-18 21:47:50",1099,592,533,59,0,586,6,1190,598,241,345
2,ARAD,"LICEUL TEORETIC „ADAM MULLER GUTTENBRUNN” ARAD",106,"MUNICIPIUL ARAD",9262,1,PART,PRCNCT,PRSD,PRSD_SV,"2025-05-18 21:30:30",992,513,480,33,0,505,8,1070,557,226,279
2,ARAD,"LICEUL TEORETIC ”ADAM MULLER GUTTENBRUNN” ARAD (CORP P+1E - CLASA PREGĂTITOARE C)",107,"MUNICIPIUL ARAD",9262,1,PART,PRCNCT,PRSD,PRSD_SV,"2025-05-18 21:45:34",892,482,447,35,0,473,9,970,488,189,284
2,ARAD,"LICEUL TEORETIC ”ADAM MULLER GUTTENBRUNN” ARAD (CORP P+1E - SALA DE RELIGIE)",108,"MUNICIPIUL ARAD",9262,1,PART,PRCNCT,PRSD,PRSD_SV,"2025-05-18 21:57:53",822,455,373,82,0,448,7,886,431,223,225
2,ARAD,"GRĂDINIȚA CU PROGRAM PRELUNGIT NR. 14 ARAD (GRĂDINIȚA CU PROGRAM PRELUNGIT NR. 3)",109,"MUNICIPIUL ARAD",9262,1,PART,PRCNCT,PRSD,PRSD_SV,"2025-05-18 21:39:49",1607,985,901,84,0,973,12,1740,755,428,545
2,ARAD,"LICEUL TEHNOLOGIC „FRANCISC NEUMAN” ARAD (LICEUL TEHNOLOGIC „IULIU MOLDOVAN” ARAD - FOST GRUP ŞCOLAR FORESTIER)",110,"MUNICIPIUL ARAD",9262,1,PART,PRCNCT,PRSD,PRSD_SV,"2025-05-18 22:07:58",1490,780,694,86,0,773,7,1618,838,382,391
2,ARAD,"ŞCOALA GIMNAZIALĂ „ADAM NICOLAE” ARAD (FOSTA ŞCOALĂ GENERALĂ NR. 7)",111,"MUNICIPIUL ARAD",9262,1,PART,PRCNCT,PRSD,PRSD_SV,"2025-05-18 22:02:05",1608,766,703,52,11,743,23,1740,974,462,281
2,ARAD,"ŞCOALA GIMNAZIALĂ „ADAM NICOLAE” ARAD (FOSTA ŞCOALĂ GENERALĂ NR. 7)",112,"MUNICIPIUL ARAD",9262,1,PART,PRCNCT,PRSD,PRSD_SV,"2025-05-18 22:00:43",1271,718,679,39,0,709,9,1370,652,367,342
2,ARAD,"ŞCOALA GIMNAZIALĂ „ADAM NICOLAE” ARAD (FOSTA ŞCOALĂ GENERALĂ NR. 7)",113,"MUNICIPIUL ARAD",9262,1,PART,PRCNCT,PRSD,PRSD_SV,"2025-05-18 22:00:37",1419,801,730,70,1,792,9,1540,739,380,412
2,ARAD,"CÂMPUL DUMBRAVA ROŞIE",114,"MUNICIPIUL ARAD",9262,1,PART,PRCNCT,PRSD,PRSD_SV,"2025-05-18 21:31:11",86,141,42,99,0,139,2,165,24,112,27
2,ARAD,"CÂMPUL ALBINELOR",115,"MUNICIPIUL ARAD",9262,1,PART,PRCNCT,PRSD,PRSD_SV,"2025-05-18 21:24:42",165,123,89,34,0,123,0,190,67,102,21
2,ARAD,"LICEUL TEORETIC „MIHAI VELICIU”",116,"ORAŞ CHIŞINEU-CRIŞ",9459,1,PART,PRCNCT,PRSD,PRSD_SV,"2025-05-18 21:49:43",1229,683,601,82,0,678,5,1340,657,297,381
2,ARAD,"LICEUL TEORETIC „MIHAI VELICIU”",117,"ORAŞ CHIŞINEU-CRIŞ",9459,1,PART,PRCNCT,PRSD,PRSD_SV,"2025-05-18 22:13:48",805,422,378,44,0,420,2,880,458,162,258
2,ARAD,"ȘCOALA GENERALĂ CHIȘINEU-CRIȘ",118,"ORAŞ CHIŞINEU-CRIŞ",9459,1,PART,PRCNCT,PRSD,PRSD_SV,"2025-05-18 21:49:24",1525,939,826,111,2,924,15,1660,721,388,536
2,ARAD,"ȘCOALA GIMNAZIALĂ PĂDURENI",119,"ORAŞ CHIŞINEU-CRIŞ",9459,1,PART,PRCNCT,PRSD,PRSD_SV,"2025-05-18 21:50:59",1548,824,762,61,1,815,9,1680,856,404,411
2,ARAD,"ŞCOALA GIMNAZIALĂ NĂDAB",120,"ORAŞ CHIŞINEU-CRIŞ",9459,1,PART,PRCNCT,PRSD,PRSD_SV,"2025-05-18 21:46:04",1476,724,666,57,1,717,7,1600,876,473,244
2,ARAD,"LICEUL TEHNOLOGIC „ION CREANGĂ”",121,"ORAŞ CURTICI",9495,1,PART,PRCNCT,PRSD,PRSD_SV,"2025-05-18 21:39:10",1380,680,629,51,0,668,12,1500,820,359,309
2,ARAD,"LICEUL TEHNOLOGIC „ION CREANGĂ”",122,"ORAŞ CURTICI",9495,1,PART,PRCNCT,PRSD,PRSD_SV,"2025-05-18 22:00:41",1421,656,550,105,1,652,4,1550,894,358,294
2,ARAD,"LICEUL TEHNOLOGIC „ION CREANGĂ”",123,"ORAŞ CURTICI",9495,1,PART,PRCNCT,PRSD,PRSD_SV,"2025-05-18 21:38:21",1563,515,484,30,1,510,5,1700,1185,355,155
2,ARAD,"LICEUL TEHNOLOGIC „ION CREANGĂ”",124,"ORAŞ CURTICI",9495,1,PART,PRCNCT,PRSD,PRSD_SV,"2025-05-18 21:41:03",1347,605,574,31,0,599,6,1460,855,346,253
2,ARAD,"GRĂDINIŢA CU PROGRAM PRELUNGIT „GRĂDINIŢA VESELIEI”",125,"ORAŞ CURTICI",9495,1,PART,PRCNCT,PRSD,PRSD_SV,"2025-05-18 21:58:00",1352,716,659,57,0,706,10,1470,754,392,314
2,ARAD,"ȘCOALA GIMNAZIALĂ INEU",126,"ORAŞ INEU",9538,1,PART,PRCNCT,PRSD,PRSD_SV,"2025-05-18 21:49:26",1364,783,688,74,21,777,6,1550,767,380,397
2,ARAD,"GRĂDINIȚA CU PROGRAM NORMAL CU 4 (PATRU) SĂLI DE GRUPĂ",127,"ORAŞ INEU",9538,1,PART,PRCNCT,PRSD,PRSD_SV,"2025-05-18 22:07:10",1484,783,726,57,0,770,13,1690,907,510,260
2,ARAD,"COLEGIUL ”MIHAI VITEAZUL” INEU",128,"ORAŞ INEU",9538,1,PART,PRCNCT,PRSD,PRSD_SV,"2025-05-18 21:42:19",1538,891,811,71,9,878,13,1670,779,461,417
2,ARAD,"CĂMINUL CULTURAL DIN CARTIERUL TRAIAN",129,"ORAŞ INEU",9538,1,PART,PRCNCT,PRSD,PRSD_SV,"2025-05-18 21:42:05",1320,764,706,57,1,761,3,1440,676,489,272
2,ARAD,"SALA DE SPORT",130,"ORAŞ INEU",9538,1,PART,PRCNCT,PRSD,PRSD_SV,"2025-05-18 21:26:17",1258,745,666,79,0,732,13,1370,625,381,351
2,ARAD,"ŞCOALA GIMNAZIALĂ MOCREA",131,"ORAŞ INEU",9538,1,PART,PRCNCT,PRSD,PRSD_SV,"2025-05-18 21:19:18",594,238,207,31,0,233,5,650,412,162,71
2,ARAD,"LICEUL ATANASIE MARIENESCU",132,"ORAŞ LIPOVA",9574,1,PART,PRCNCT,PRSD,PRSD_SV,"2025-05-18 21:34:02",809,397,348,49,0,391,6,880,483,235,156
2,ARAD,"SEDIUL ASOCIAŢIA CARITAS BANAT SANCTUS GERHARDUS LIPOVA",133,"ORAŞ LIPOVA",9574,1,PART,PRCNCT,PRSD,PRSD_SV,"2025-05-18 21:36:51",1115,566,520,46,0,558,8,1210,644,309,249
2,ARAD,"CLĂDIRE PAROHIA ROMANO-CATOLICĂ LIPOVA",134,"ORAŞ LIPOVA",9574,1,PART,PRCNCT,PRSD,PRSD_SV,"2025-05-18 21:55:52",1048,581,480,80,21,571,10,1200,619,310,261
2,ARAD,"CLĂDIRE PAROHIA ORTODOXĂ LIPOVA",135,"ORAŞ LIPOVA",9574,1,PART,PRCNCT,PRSD,PRSD_SV,"2025-05-18 21:52:10",995,484,445,39,0,477,7,1080,596,338,139
2,ARAD,"CENTRUL RECREATIV LIPOVA",136,"ORAŞ LIPOVA",9574,1,PART,PRCNCT,PRSD,PRSD_SV,"2025-05-18 21:36:30",1233,615,547,67,1,601,14,1340,725,325,276
2,ARAD,"LICEUL SEVER BOCU (GRĂDINIŢA P.P. LIPOVA)",137,"ORAŞ LIPOVA",9574,1,PART,PRCNCT,PRSD,PRSD_SV,"2025-05-18 21:39:06",1165,570,527,43,0,559,11,1270,700,310,249
2,ARAD,"SEDIU AGENȚIA DE PLĂȚI ȘI INTERVENȚIE PENTRU AGRICULTURĂ RADNA",138,"ORAŞ LIPOVA",9574,1,PART,PRCNCT,PRSD,PRSD_SV,"2025-05-18 21:42:56",998,486,428,43,15,481,5,1150,664,284,197
2,ARAD,"LICEUL ATANASIE MARIENESCU",139,"ORAŞ LIPOVA",9574,1,PART,PRCNCT,PRSD,PRSD_SV,"2025-05-18 21:35:58",922,461,402,59,0,455,6,1000,539,256,199
2,ARAD,"CLĂDIRE PAROHIA ORTODOXĂ ȘOIMOȘ",140,"ORAŞ LIPOVA",9574,1,PART,PRCNCT,PRSD,PRSD_SV,"2025-05-18 21:45:20",696,390,351,39,0,385,5,750,360,274,111
2,ARAD,"LICEUL TEORETIC „JOZEF GREGOR TAJOVSKY” NĂDLAC",141,"ORAŞ NĂDLAC",9627,1,PART,PRCNCT,PRSD,PRSD_SV,"2025-05-18 22:06:33",1517,966,735,230,1,954,12,1870,904,446,508
2,ARAD,"LICEUL TEORETIC „JOZEF GREGOR TAJOVSKY” NĂDLAC",142,"ORAŞ NĂDLAC",9627,1,PART,PRCNCT,PRSD,PRSD_SV,"2025-05-18 21:44:13",1657,831,756,75,0,815,16,2020,1189,477,338
2,ARAD,"CASA DE CULTURĂ NĂDLAC",143,"ORAŞ NĂDLAC",9627,1,PART,PRCNCT,PRSD,PRSD_SV,"2025-05-18 22:00:22",1565,841,698,139,4,830,11,1920,1079,430,400
2,ARAD,"LICEUL TEORETIC „JOZEF GREGOR TAJOVSKY” NĂDLAC, ORAȘUL NĂDLAC - GRĂDINIȚA CU PROGRAM PRELUNGIT NR.2",144,"ORAŞ NĂDLAC",9627,1,PART,PRCNCT,PRSD,PRSD_SV,"2025-05-18 21:30:30",1608,882,809,68,5,876,6,1970,1088,408,468
2,ARAD,"CLĂDIRE „BUCURIA COPIILOR”",145,"ORAŞ PÂNCOTA",9654,1,PART,PRCNCT,PRSD,PRSD_SV,"2025-05-18 22:00:13",1071,543,469,59,15,528,15,1160,617,312,216
2,ARAD,"LICEUL TEORETIC PÂNCOTA",146,"ORAŞ PÂNCOTA",9654,1,PART,PRCNCT,PRSD,PRSD_SV,"2025-05-18 22:04:00",1297,660,588,63,9,656,4,1410,750,396,260
2,ARAD,"LICEUL TEORETIC PÂNCOTA",147,"ORAŞ PÂNCOTA",9654,1,PART,PRCNCT,PRSD,PRSD_SV,"2025-05-18 21:44:50",1393,644,610,30,4,636,8,1510,866,376,260
2,ARAD,"GRĂDINIŢA PN PÂNCOTA",148,"ORAŞ PÂNCOTA",9654,1,PART,PRCNCT,PRSD,PRSD_SV,"2025-05-18 22:09:25",1337,577,519,50,8,569,8,1460,883,425,144
2,ARAD,"CĂMIN CULTURAL MĂDERAT",149,"ORAŞ PÂNCOTA",9654,1,PART,PRCNCT,PRSD,PRSD_SV,"2025-05-18 21:35:38",1291,606,524,74,8,599,7,1400,794,388,211
2,ARAD,"CASA DE CULTURĂ „DORU IOAN PETESCU”",150,"ORAŞ PECICA",11584,1,PART,PRCNCT,PRSD,PRSD_SV,"2025-05-18 21:39:20",1150,679,614,63,2,676,3,1250,571,375,301
2,ARAD,"LICEUL TEORETIC „GHEORGHE LAZĂR”",151,"ORAŞ PECICA",11584,1,PART,PRCNCT,PRSD,PRSD_SV,"2025-05-18 21:45:30",1682,1041,831,207,3,1029,12,1830,789,644,385
2,ARAD,"GRĂDINIȚA CU PROGRAM PRELUNGIT",152,"ORAŞ PECICA",11584,1,PART,PRCNCT,PRSD,PRSD_SV,"2025-05-18 21:47:56",1347,678,602,75,1,667,11,1470,792,376,291
2,ARAD,"PRIMĂRIA ORAȘULUI PECICA",153,"ORAŞ PECICA",11584,1,PART,PRCNCT,PRSD,PRSD_SV,"2025-05-18 21:57:41",1269,748,624,89,35,729,19,1380,632,292,437
2,ARAD,"ŞCOALA PRIMARĂ 2 PECICA",154,"ORAŞ PECICA",11584,1,PART,PRCNCT,PRSD,PRSD_SV,"2025-05-18 21:55:20",1361,718,673,45,0,711,7,1480,762,308,403
2,ARAD,"ŞCOALA PRIMARĂ 3 PECICA",155,"ORAŞ PECICA",11584,1,PART,PRCNCT,PRSD,PRSD_SV,"2025-05-18 21:44:13",1645,631,576,55,0,621,10,1790,1159,416,205
2,ARAD,"ŞCOALA PRIMARĂ 1 PECICA",156,"ORAŞ PECICA",11584,1,PART,PRCNCT,PRSD,PRSD_SV,"2025-05-18 21:59:26",1695,913,866,46,1,903,10,1850,937,659,244
2,ARAD,"ŞCOALA PRIMARĂ SEDERHAT",157,"ORAŞ PECICA",11584,1,PART,PRCNCT,PRSD,PRSD_SV,"2025-05-18 21:24:56",266,178,126,52,0,176,2,300,122,107,69
2,ARAD,"ȘCOALA PRIMARĂ TURNU",158,"ORAŞ PECICA",11584,1,PART,PRCNCT,PRSD,PRSD_SV,"2025-05-18 21:46:12",1070,772,509,262,1,767,5,1160,388,421,346
2,ARAD,"GRĂDINIȚA CU PROGRAM PRELUNGIT NR. 1 SÂNTANA (CU 8 SĂLI DE GRUPĂ) - SALĂ MULTIFUNCȚIONALĂ",159,"ORAŞ SÂNTANA",12091,1,PART,PRCNCT,PRSD,PRSD_SV,"2025-05-18 21:46:25",1289,496,437,59,0,493,3,1400,904,336,157
2,ARAD,"LICEUL TEHNOLOGIC STEFAN HELL SÂNTANA",160,"ORAŞ SÂNTANA",12091,2,PART,PRCNCT,PRSD,PRSD_SV,"2025-05-18 23:53:58",1679,672,624,48,0,663,9,1830,1158,391,272
2,ARAD,"ȘCOALA GIMNAZIALĂ ”SFÂNTA ANA” SÂNTANA",161,"ORAŞ SÂNTANA",12091,1,PART,PRCNCT,PRSD,PRSD_SV,"2025-05-18 21:28:37",1026,375,340,35,0,370,5,1110,735,207,163
2,ARAD,"ȘCOALA GIMNAZIALĂ SÂNTANA",162,"ORAŞ SÂNTANA",12091,1,PART,PRCNCT,PRSD,PRSD_SV,"2025-05-18 21:41:43",1474,579,545,33,1,571,8,1600,1021,334,237
2,ARAD,"GRĂDINIȚA PP NR. 2 SÂNTANA",163,"ORAŞ SÂNTANA",12091,1,PART,PRCNCT,PRSD,PRSD_SV,"2025-05-18 21:43:28",1317,520,480,40,0,514,6,1430,910,319,195
2,ARAD,"GRĂDINIȚA PP NR. 2 SÂNTANA",164,"ORAŞ SÂNTANA",12091,1,PART,PRCNCT,PRSD,PRSD_SV,"2025-05-18 21:34:28",1648,392,360,31,1,388,4,1800,1408,303,85
2,ARAD,"BIBLIOTECA ORAȘULUI SÂNTANA",165,"ORAŞ SÂNTANA",12091,1,PART,PRCNCT,PRSD,PRSD_SV,"2025-05-18 21:34:45",1024,286,255,31,0,277,9,1110,824,188,89
2,ARAD,"CĂMIN CULTURAL SATU NOU",166,"ORAŞ SÂNTANA",12091,1,PART,PRCNCT,PRSD,PRSD_SV,"2025-05-18 21:36:07",1063,617,565,49,3,610,7,1150,533,345,265
2,ARAD,"GRĂDINIȚA PP NR. 1 SÂNTANA",167,"ORAŞ SÂNTANA",12091,1,PART,PRCNCT,PRSD,PRSD_SV,"2025-05-18 21:37:50",906,498,466,31,1,492,6,990,492,280,212
2,ARAD,"CĂMINUL CULTURAL CAPORAL ALEXA",168,"ORAŞ SÂNTANA",12091,2,PART,PRCNCT,PRSD,PRSD_SV,"2025-05-19 00:28:11",1191,612,552,60,0,608,4,1300,688,495,113
2,ARAD,"CASA DE CULTURĂ SEBIȘ",169,"ORAŞ SEBIŞ",9690,1,PART,PRCNCT,PRSD,PRSD_SV,"2025-05-18 22:34:04",1523,778,692,72,14,762,16,1660,882,366,396
2,ARAD,"LICEUL ORAŞULUI SEBIŞ",170,"ORAŞ SEBIŞ",9690,1,PART,PRCNCT,PRSD,PRSD_SV,"2025-05-18 22:07:43",1484,746,670,71,5,735,11,1620,874,369,366
2,ARAD,"LICEUL ORAȘULUI SEBIȘ",171,"ORAŞ SEBIŞ",9690,1,PART,PRCNCT,PRSD,PRSD_SV,"2025-05-18 21:52:02",1175,535,482,52,1,527,8,1340,805,265,262
2,ARAD,"ŞCOALA PRIMARĂ PRĂJEŞTI",172,"ORAŞ SEBIŞ",9690,1,PART,PRCNCT,PRSD,PRSD_SV,"2025-05-18 21:42:41",201,125,92,33,0,123,2,270,145,46,77
2,ARAD,"ŞCOALA PRIMARĂ DONCENI",173,"ORAŞ SEBIŞ",9690,1,PART,PRCNCT,PRSD,PRSD_SV,"2025-05-18 22:07:16",116,81,56,25,0,80,1,130,49,47,33
2,ARAD,"ŞCOALA PRIMARĂ PRUNIŞOR",174,"ORAŞ SEBIŞ",9690,1,PART,PRCNCT,PRSD,PRSD_SV,"2025-05-18 21:25:45",457,230,199,28,3,230,0,500,270,151,79
2,ARAD,"CĂMINUL CULTURAL SĂLĂJENI",175,"ORAŞ SEBIŞ",9690,1,PART,PRCNCT,PRSD,PRSD_SV,"2025-05-18 21:25:56",134,86,68,18,0,84,2,150,64,51,33
2,ARAD,"CĂMINUL CULTURAL ALMAŞ",176,ALMAŞ,9743,1,PART,PRCNCT,PRSD,PRSD_SV,"2025-05-18 21:55:21",1076,524,469,49,6,515,9,1170,646,337,178
2,ARAD,"CĂMINUL CULTURAL CIL",177,ALMAŞ,9743,1,PART,PRCNCT,PRSD,PRSD_SV,"2025-05-18 21:39:40",436,238,205,32,1,231,7,480,242,145,86
2,ARAD,"CĂMINUL CULTURAL JOIA MARE",178,ALMAŞ,9743,1,PART,PRCNCT,PRSD,PRSD_SV,"2025-05-18 21:25:19",143,102,73,29,0,102,0,160,58,73,29
2,ARAD,"CĂMINUL CULTURAL RĂDEŞTI",179,ALMAŞ,9743,1,PART,PRCNCT,PRSD,PRSD_SV,"2025-05-18 21:44:02",337,209,182,27,0,205,4,370,161,144,61
2,ARAD,"ȘCOALA GIMNAZIALĂ ”GHEORGHE POPOVICI” APATEU,",180,APATEU,9798,1,PART,PRCNCT,PRSD,PRSD_SV,"2025-05-18 21:44:45",926,453,424,24,5,453,0,1010,557,215,238
2,ARAD,"ȘCOALA GIMNAZIALĂ ”GHEORGHE POPOVICI” APATEU,",181,APATEU,9798,1,PART,PRCNCT,PRSD,PRSD_SV,"2025-05-18 21:53:10",928,426,392,31,3,424,2,1010,584,273,151
2,ARAD,"ŞCOALA PRIMARĂ BERECHIU",182,APATEU,9798,1,PART,PRCNCT,PRSD,PRSD_SV,"2025-05-18 21:44:56",671,310,265,44,1,308,2,730,420,200,108
2,ARAD,"ŞCOALA GENERALĂ MOŢIORI",183,APATEU,9798,1,PART,PRCNCT,PRSD,PRSD_SV,"2025-05-18 21:22:52",218,122,105,17,0,119,3,240,118,73,46
2,ARAD,"PRIMĂRIA COMUNEI ARCHIŞ",184,ARCHIŞ,9832,1,PART,PRCNCT,PRSD,PRSD_SV,"2025-05-18 21:29:13",279,178,154,24,0,177,1,310,132,74,103
2,ARAD,"GRĂDINIŢA CU PROGRAM NORMAL BÂRZEŞTI",185,ARCHIŞ,9832,1,PART,PRCNCT,PRSD,PRSD_SV,"2025-05-18 21:23:13",126,81,60,21,0,79,2,140,59,49,30
2,ARAD,"GRĂDINIȚA CU PROGRAM NORMAL GROȘENI",186,ARCHIŞ,9832,1,PART,PRCNCT,PRSD,PRSD_SV,"2025-05-18 21:37:47",623,306,284,22,0,301,5,680,374,177,124
2,ARAD,"GRĂDINIŢA CU PROGRAM NORMAL NERMIȘ",187,ARCHIŞ,9832,1,PART,PRCNCT,PRSD,PRSD_SV,"2025-05-18 21:22:15",150,108,85,23,0,106,2,170,62,69,37
2,ARAD,"PRIMĂRIA COMUNEI BATA",188,BATA,9887,1,PART,PRCNCT,PRSD,PRSD_SV,"2025-05-18 21:27:57",357,201,175,26,0,199,2,390,189,140,59
2,ARAD,"CĂMINUL CULTURAL BACĂUL DE MIJLOC",189,BATA,9887,1,PART,PRCNCT,PRSD,PRSD_SV,"2025-05-18 21:21:10",147,82,65,17,0,79,3,170,88,61,18
2,ARAD,"CĂMINUL CULTURAL BULCI",190,BATA,9887,1,PART,PRCNCT,PRSD,PRSD_SV,"2025-05-18 21:18:28",73,48,24,24,0,48,0,80,32,22,26
2,ARAD,"CAMIN CULTURAL ȚELA",191,BATA,9887,1,PART,PRCNCT,PRSD,PRSD_SV,"2025-05-18 21:19:34",263,141,101,40,0,140,1,290,149,106,34
2,ARAD,"GRĂDINIŢA PN BÂRSA",192,BÂRSA,10051,1,PART,PRCNCT,PRSD,PRSD_SV,"2025-05-18 21:56:39",742,422,377,44,1,417,5,810,388,237,180
2,ARAD,"CĂMIN CULTURAL ALDEŞTI",193,BÂRSA,10051,1,PART,PRCNCT,PRSD,PRSD_SV,"2025-05-18 21:40:27",416,258,202,45,11,255,3,460,202,125,130
2,ARAD,"CLĂDIREA COMUNEI BÂRSA (FOSTA ŞCOALĂ CU CLASELE I-IV HODIŞ)",194,BÂRSA,10051,1,PART,PRCNCT,PRSD,PRSD_SV,"2025-05-18 21:27:33",137,97,70,27,0,97,0,160,63,55,42
2,ARAD,"CLĂDIREA COMUNEI BÂRSA (FOSTA ŞCOALĂ CU CLASELE I-IV VOIVODENI)",195,BÂRSA,10051,1,PART,PRCNCT,PRSD,PRSD_SV,"2025-05-18 21:19:50",146,95,74,21,0,94,1,160,65,57,37
2,ARAD,"CĂMINUL CULTURAL BÂRZAVA",196,BÂRZAVA,10104,1,PART,PRCNCT,PRSD,PRSD_SV,"2025-05-18 21:41:46",736,491,384,107,0,489,2,800,309,335,154
2,ARAD,"ŞCOALA GENERALĂ BĂTUŢA",197,BÂRZAVA,10104,1,PART,PRCNCT,PRSD,PRSD_SV,"2025-05-18 21:13:31",48,32,12,20,0,31,1,60,28,18,13
2,ARAD,"CENTRU LOCAL DE INFORMARE ȘI PROMOVARE TURISTICĂ CĂPRUȚA",198,BÂRZAVA,10104,1,PART,PRCNCT,PRSD,PRSD_SV,"2025-05-18 21:30:13",183,101,85,16,0,99,2,200,99,60,39
2,ARAD,"CĂMINUL CULTURAL DUMBRĂVIŢA",199,BÂRZAVA,10104,1,PART,PRCNCT,PRSD,PRSD_SV,"2025-05-18 21:15:17",207,134,103,31,0,132,2,230,96,89,43
2,ARAD,"ŞCOALA GIMNAZIALĂ GROŞII NOI",200,BÂRZAVA,10104,1,PART,PRCNCT,PRSD,PRSD_SV,"2025-05-18 21:17:15",148,101,73,28,0,98,3,170,69,56,42
2,ARAD,"ŞCOALA GENERALĂ LALAŞINŢ",201,BÂRZAVA,10104,1,PART,PRCNCT,PRSD,PRSD_SV,"2025-05-18 21:31:30",239,144,97,47,0,143,1,260,116,109,34
2,ARAD,"ŞCOALA GENERALĂ MONOROŞTIA",202,BÂRZAVA,10104,1,PART,PRCNCT,PRSD,PRSD_SV,"2025-05-18 21:20:36",241,132,114,17,1,130,2,270,138,103,27
2,ARAD,"CĂMIN CULTURAL SLATINA DE MUREŞ",203,BÂRZAVA,10104,1,PART,PRCNCT,PRSD,PRSD_SV,"2025-05-18 21:16:57",119,66,54,12,0,63,3,130,64,47,16
2,ARAD,"PRIMĂRIA COMUNEI BELIU",204,BELIU,9930,1,PART,PRCNCT,PRSD,PRSD_SV,"2025-05-18 22:04:43",1417,839,716,100,23,825,14,1540,701,409,416
2,ARAD,"CĂMINUL CULTURAL BENEŞTI",205,BELIU,9930,1,PART,PRCNCT,PRSD,PRSD_SV,"2025-05-18 21:29:32",95,64,51,13,0,64,0,110,46,47,17
2,ARAD,"CĂMINUL CULTURAL BOCHIA",206,BELIU,9930,1,PART,PRCNCT,PRSD,PRSD_SV,"2025-05-18 21:31:17",38,35,19,16,0,35,0,50,15,24,11
2,ARAD,"CĂMINUL CULTURAL SECACI",207,BELIU,9930,1,PART,PRCNCT,PRSD,PRSD_SV,"2025-05-18 21:32:49",119,77,56,21,0,77,0,130,53,37,40
2,ARAD,"CĂMINUL CULTURAL TĂGĂDĂU",208,BELIU,9930,1,PART,PRCNCT,PRSD,PRSD_SV,"2025-05-18 21:30:01",398,161,140,21,0,160,1,440,279,97,63
2,ARAD,"ȘCOALA PRIMARĂ VASILE GOLDIŞ",209,BELIU,9930,1,PART,PRCNCT,PRSD,PRSD_SV,"2025-05-18 21:37:35",405,194,155,31,8,193,1,450,256,144,49
2,ARAD,"CĂMINUL CULTURAL BIRCHIŞ",210,BIRCHIŞ,10006,1,PART,PRCNCT,PRSD,PRSD_SV,"2025-05-18 21:58:33",516,280,228,52,0,278,2,560,280,170,108
2,ARAD,"ŞCOALA GIMNAZIALĂ CĂPĂLNAŞ",211,BIRCHIŞ,10006,1,PART,PRCNCT,PRSD,PRSD_SV,"2025-05-18 21:34:39",712,371,283,47,41,365,6,830,459,209,156
2,ARAD,"CĂMINUL CULTURAL OSTROV",212,BIRCHIŞ,10006,1,PART,PRCNCT,PRSD,PRSD_SV,"2025-05-18 21:36:51",207,136,102,34,0,135,1,230,94,89,46
2,ARAD,"CĂMINUL CULTURAL BOCSIG",213,BOCSIG,10195,1,PART,PRCNCT,PRSD,PRSD_SV,"2025-05-18 22:01:58",1489,781,710,66,5,778,3,1620,839,498,280
2,ARAD,"ȘCOALA PRIMARĂ BOCSIG CARTIER",214,BOCSIG,10195,1,PART,PRCNCT,PRSD,PRSD_SV,"2025-05-18 21:30:47",308,170,145,25,0,169,1,340,170,100,69
2,ARAD,"CĂMINUL CULTURAL MÂNERĂU",215,BOCSIG,10195,1,PART,PRCNCT,PRSD,PRSD_SV,"2025-05-18 21:41:05",272,178,137,41,0,177,1,300,122,106,71
2,ARAD,"ŞCOALA PRIMARĂ RĂPSIG",216,BOCSIG,10195,1,PART,PRCNCT,PRSD,PRSD_SV,"2025-05-18 21:38:56",568,305,271,32,2,303,2,620,315,197,106
2,ARAD,"PRIMĂRIA COMUNEI BRAZII",217,BRAZII,10239,1,PART,PRCNCT,PRSD,PRSD_SV,"2025-05-18 21:37:24",60,51,26,24,1,50,1,70,19,34,16
2,ARAD,"CĂMINUL CULTURAL BUCEAVA",218,BRAZII,10239,1,PART,PRCNCT,PRSD,PRSD_SV,"2025-05-18 21:20:58",66,29,23,6,0,29,0,80,51,21,8
2,ARAD,"CĂMINUL CULTURAL ŞOIMUŞ",219,BRAZII,10239,1,PART,PRCNCT,PRSD,PRSD_SV,"2025-05-18 21:21:45",71,44,26,18,0,44,0,80,36,30,14
2,ARAD,"CĂMINUL CULTURAL IACOBINI",220,BRAZII,10239,1,PART,PRCNCT,PRSD,PRSD_SV,"2025-05-18 21:31:55",163,123,91,30,2,121,2,180,57,77,44
2,ARAD,"CĂMINUL CULTURAL MĂDRIGEŞTI",221,BRAZII,10239,1,PART,PRCNCT,PRSD,PRSD_SV,"2025-05-18 21:26:34",205,127,98,29,0,123,4,230,103,91,32
2,ARAD,"CĂMINUL CULTURAL SECAŞ",222,BRAZII,10239,1,PART,PRCNCT,PRSD,PRSD_SV,"2025-05-18 22:21:27",387,251,216,25,10,248,3,420,169,188,60
2,ARAD,"PRIMĂRIA COMUNEI BUTENI",223,BUTENI,10293,1,PART,PRCNCT,PRSD,PRSD_SV,"2025-05-18 21:41:14",753,488,409,59,20,482,6,820,332,208,274
2,ARAD,"ȘCOALA GIMNAZIALĂ ”GABRIEL BROLA” BUTENI",224,BUTENI,10293,1,PART,PRCNCT,PRSD,PRSD_SV,"2025-05-18 22:25:12",950,548,462,61,25,543,5,1030,482,353,190
2,ARAD,"CĂMINUL CULTURAL BERINDIA",225,BUTENI,10293,1,PART,PRCNCT,PRSD,PRSD_SV,"2025-05-18 21:21:45",174,117,100,17,0,116,1,190,73,76,40
2,ARAD,"ȘCOALA PRIMARĂ CUIED",226,BUTENI,10293,1,PART,PRCNCT,PRSD,PRSD_SV,"2025-05-18 21:28:12",523,307,256,41,10,303,4,570,263,196,107
2,ARAD,"GRĂDINIȚA CU PROGRAM NORMAL PĂULIAN",227,BUTENI,10293,1,PART,PRCNCT,PRSD,PRSD_SV,"2025-05-18 21:17:47",247,135,110,25,0,132,3,270,135,87,45
2,ARAD,"CĂMINUL CULTURAL CĂRAND",228,CĂRAND,10346,1,PART,PRCNCT,PRSD,PRSD_SV,"2025-05-18 21:47:54",475,269,231,34,4,268,1,520,251,186,82
2,ARAD,"CĂMINUL CULTURAL SELIŞTEA",229,CĂRAND,10346,1,PART,PRCNCT,PRSD,PRSD_SV,"2025-05-18 21:51:28",407,200,177,22,1,199,1,440,240,110,89
2,ARAD,"PRIMĂRIA COMUNEI CERMEI",230,CERMEI,10373,1,PART,PRCNCT,PRSD,PRSD_SV,"2025-05-18 21:49:38",1487,783,659,95,29,774,9,1620,837,407,367
2,ARAD,"PUNCT DE LUCRU AL PRIMĂRIEI",231,CERMEI,10373,1,PART,PRCNCT,PRSD,PRSD_SV,"2025-05-18 21:34:30",699,339,275,56,8,332,7,760,421,212,120
2,ARAD,"PRIMĂRIA COMUNEI CHISINDIA",232,CHISINDIA,10417,1,PART,PRCNCT,PRSD,PRSD_SV,"2025-05-18 21:36:37",693,385,341,40,4,380,5,760,375,209,171
2,ARAD,"CĂMIN CULTURAL PĂIUŞENI",233,CHISINDIA,10417,1,PART,PRCNCT,PRSD,PRSD_SV,"2025-05-18 21:32:11",280,178,149,29,0,177,1,310,132,117,60
2,ARAD,"CĂMIN CULTURAL VĂSOAIA",234,CHISINDIA,10417,1,PART,PRCNCT,PRSD,PRSD_SV,"2025-05-18 21:15:07",36,37,16,21,0,37,0,60,23,19,18
2,ARAD,"ŞCOALA GIMNAZIALĂ CONOP",235,CONOP,10453,1,PART,PRCNCT,PRSD,PRSD_SV,"2025-05-18 21:18:25",436,251,211,39,1,250,1,480,229,170,80
2,ARAD,"ŞCOALA PRIMARĂ BELOTINŢ",236,CONOP,10453,1,PART,PRCNCT,PRSD,PRSD_SV,"2025-05-18 21:14:18",231,118,93,25,0,118,0,260,142,86,32
2,ARAD,"ȘCOALA PRIMARĂ CHELMAC",237,CONOP,10453,1,PART,PRCNCT,PRSD,PRSD_SV,"2025-05-18 21:11:50",228,152,110,42,0,150,2,260,108,100,50
2,ARAD,"ŞCOALA PRIMARĂ MILOVA",238,CONOP,10453,1,PART,PRCNCT,PRSD,PRSD_SV,"2025-05-18 21:16:26",448,252,211,40,1,251,1,490,238,199,52
2,ARAD,"ŞCOALA PRIMARĂ ODVOŞ",239,CONOP,10453,1,PART,PRCNCT,PRSD,PRSD_SV,"2025-05-18 21:27:25",351,202,158,44,0,202,0,390,188,146,56
2,ARAD,"CĂMIN CULTURAL COVĂSINȚ",240,COVĂSINŢ,10514,1,PART,PRCNCT,PRSD,PRSD_SV,"2025-05-18 21:43:31",990,350,290,53,7,347,3,1070,720,196,151
2,ARAD,"CĂMINUL CULTURAL COVĂSINŢ",241,COVĂSINŢ,10514,1,PART,PRCNCT,PRSD,PRSD_SV,"2025-05-18 21:54:41",1061,494,454,36,4,490,4,1150,656,283,207
2,ARAD,"PRIMĂRIA COMUNEI CRAIVA",242,CRAIVA,10532,1,PART,PRCNCT,PRSD,PRSD_SV,"2025-05-18 21:28:53",493,206,179,23,4,201,5,540,334,129,72
2,ARAD,"ŞCOALA PRIMARĂ CHIŞLACA",243,CRAIVA,10532,1,PART,PRCNCT,PRSD,PRSD_SV,"2025-05-18 21:23:58",598,268,233,30,5,266,2,660,392,171,95
2,ARAD,"ŞCOALA PRIMARĂ CIUNTEŞTI",244,CRAIVA,10532,1,PART,PRCNCT,PRSD,PRSD_SV,"2025-05-18 21:15:17",100,60,49,11,0,60,0,110,50,52,8
2,ARAD,"CĂMINUL CULTURAL COROI",245,CRAIVA,10532,1,PART,PRCNCT,PRSD,PRSD_SV,"2025-05-18 21:16:53",127,81,56,25,0,80,1,140,59,52,28
2,ARAD,"ŞCOALA PRIMARĂ MĂRĂUŞ",246,CRAIVA,10532,1,PART,PRCNCT,PRSD,PRSD_SV,"2025-05-18 21:24:57",220,126,106,12,8,125,1,240,114,82,43
2,ARAD,"ŞCOALA PRIMARĂ ROGOZ DE BELIU",247,CRAIVA,10532,1,PART,PRCNCT,PRSD,PRSD_SV,"2025-05-18 21:19:09",88,81,48,29,4,81,0,100,19,49,32
2,ARAD,"ŞCOALA PRIMARĂ STOINEŞTI",248,CRAIVA,10532,1,PART,PRCNCT,PRSD,PRSD_SV,"2025-05-18 21:22:55",118,93,71,20,2,93,0,130,37,77,16
2,ARAD,"ŞCOALA PRIMARĂ SUSAG",249,CRAIVA,10532,1,PART,PRCNCT,PRSD,PRSD_SV,"2025-05-18 21:19:11",271,143,115,28,0,143,0,300,157,105,38
2,ARAD,"ŞCOALA PRIMARĂ ŞIAD",250,CRAIVA,10532,1,PART,PRCNCT,PRSD,PRSD_SV,"2025-05-18 21:29:26",184,105,73,32,0,103,2,200,95,70,33
2,ARAD,"CĂMINUL CULTURAL DEZNA",251,DEZNA,10649,1,PART,PRCNCT,PRSD,PRSD_SV,"2025-05-18 21:57:34",613,390,310,33,47,386,4,670,280,191,195
2,ARAD,"CĂMINUL CULTURAL BUHANI",252,DEZNA,10649,1,PART,PRCNCT,PRSD,PRSD_SV,"2025-05-18 21:31:51",145,101,81,19,1,100,1,160,59,67,33
2,ARAD,"CĂMINUL CULTURAL LAZ",253,DEZNA,10649,1,PART,PRCNCT,PRSD,PRSD_SV,"2025-05-18 21:17:52",24,25,9,16,0,25,0,40,15,13,12
2,ARAD,"CĂMINUL CULTURAL NEAGRA",254,DEZNA,10649,1,PART,PRCNCT,PRSD,PRSD_SV,"2025-05-18 21:23:18",86,46,30,16,0,46,0,100,54,27,19
2,ARAD,"CĂMINUL CULTURAL SLATINA DE CRIȘ",255,DEZNA,10649,1,PART,PRCNCT,PRSD,PRSD_SV,"2025-05-18 21:27:27",96,69,40,28,1,67,2,110,41,41,26
2,ARAD,"CĂMINUL CULTURAL DIECI",256,DIECI,10701,1,PART,PRCNCT,PRSD,PRSD_SV,"2025-05-18 21:34:12",580,344,294,33,17,341,3,630,286,231,110
2,ARAD,"CĂMINUL CULTURAL CROCNA",257,DIECI,10701,1,PART,PRCNCT,PRSD,PRSD_SV,"2025-05-18 21:33:56",287,152,125,25,2,151,1,300,148,110,41
2,ARAD,"CĂMINUL CULTURAL REVETIŞ",258,DIECI,10701,1,PART,PRCNCT,PRSD,PRSD_SV,"2025-05-18 22:04:06",275,152,120,27,5,150,2,300,148,105,45
2,ARAD,"CĂMINUL CULTURAL ROŞIA",259,DIECI,10701,1,PART,PRCNCT,PRSD,PRSD_SV,"2025-05-18 21:21:14",35,37,16,21,0,36,1,60,23,23,13
2,ARAD,"CĂMIN CULTURAL DOROBANŢI",260,DOROBANŢI,12912,1,PART,PRCNCT,PRSD,PRSD_SV,"2025-05-18 22:07:45",1355,762,677,77,8,754,8,1470,708,159,595
2,ARAD,"PRIMĂRIA COMUNEI FÂNTÂNELE",261,FÂNTÂNELE,9280,1,PART,PRCNCT,PRSD,PRSD_SV,"2025-05-18 21:49:14",1084,535,466,68,1,527,8,1180,645,252,275
2,ARAD,"GRĂDINIȚA CU PROGRAM PRELUNGIT FÂNTÂNELE",262,FÂNTÂNELE,9280,1,PART,PRCNCT,PRSD,PRSD_SV,"2025-05-18 21:32:06",1251,652,595,55,2,643,9,1360,708,306,337
2,ARAD,"CĂMINUL CULTURAL TISA NOUĂ",263,FÂNTÂNELE,9280,1,PART,PRCNCT,PRSD,PRSD_SV,"2025-05-18 21:41:32",868,462,416,46,0,455,7,950,488,298,157
2,ARAD,"ȘCOALA GIMNAZIALĂ „AUREL SEBEȘAN” FELNAC",264,FELNAC,10827,1,PART,PRCNCT,PRSD,PRSD_SV,"2025-05-18 22:03:52",1006,506,441,59,6,499,7,1090,584,279,220
2,ARAD,"ȘCOALA GIMNAZIALĂ „AUREL SEBEȘAN” FELNAC - SALA DE SPORT",265,FELNAC,10827,1,PART,PRCNCT,PRSD,PRSD_SV,"2025-05-18 22:17:50",1314,685,623,51,11,674,11,1430,745,442,232
2,ARAD,"FOSTA ŞCOALA PRIMARĂ CĂLUGĂRENI",266,FELNAC,10827,2,PART,PRCNCT,PRSD,PRSD_SV,"2025-05-18 23:22:13",274,180,149,31,0,179,1,300,120,97,82
2,ARAD,"ŞCOALA GIMNAZIALĂ FRUMUŞENI",267,FRUMUŞENI,12920,1,PART,PRCNCT,PRSD,PRSD_SV,"2025-05-18 22:05:24",1489,770,691,79,0,761,9,1620,850,463,298
2,ARAD,"GRĂDINIŢA CU PROGRAM NORMAL ALUNIŞ",268,FRUMUŞENI,12920,1,PART,PRCNCT,PRSD,PRSD_SV,"2025-05-18 21:41:53",881,514,466,48,0,509,5,960,446,338,171
2,ARAD,"LICEUL TEHNOLOGIC VASILE JUNCU MINIȘ-CORP B",269,GHIOROC,10872,2,PART,PRCNCT,PRSD,PRSD_SV,"2025-05-19 00:23:12",1556,809,706,100,3,801,8,1700,891,383,418
2,ARAD,"CĂMINUL CULTURAL CUVIN",270,GHIOROC,10872,1,PART,PRCNCT,PRSD,PRSD_SV,"2025-05-18 22:04:17",1365,747,653,91,3,738,9,1490,743,382,356
2,ARAD,"CĂMINUL CULTURAL MINIŞ",271,GHIOROC,10872,1,PART,PRCNCT,PRSD,PRSD_SV,"2025-05-18 21:36:06",571,376,275,100,1,370,6,630,254,175,195
2,ARAD,"PRIMĂRIA COMUNEI GRĂNICERI",272,GRĂNICERI,10916,1,PART,PRCNCT,PRSD,PRSD_SV,"2025-05-18 21:49:13",1061,450,413,34,3,449,1,1150,700,280,169
2,ARAD,"ŞCOALA GIMNAZIALĂ ŞICLĂU",273,GRĂNICERI,10916,1,PART,PRCNCT,PRSD,PRSD_SV,"2025-05-18 21:49:51",952,375,328,44,3,372,3,1030,655,317,55
2,ARAD,"LICEUL ”IOAN BUTEANU” GURAHONȚ",274,GURAHONŢ,10943,1,PART,PRCNCT,PRSD,PRSD_SV,"2025-05-18 21:45:30",711,360,316,41,3,354,6,780,420,243,111
2,ARAD,"LICEUL ”IOAN BUTEANU” GURAHONŢ",275,GURAHONŢ,10943,1,PART,PRCNCT,PRSD,PRSD_SV,"2025-05-18 21:38:00",673,388,350,38,0,386,2,730,342,233,153
2,ARAD,"CĂMIN CULTURAL",276,GURAHONŢ,10943,1,PART,PRCNCT,PRSD,PRSD_SV,"2025-05-18 21:33:40",513,275,241,29,5,273,2,560,285,208,65
2,ARAD,"CĂMIN CULTURAL",277,GURAHONŢ,10943,1,PART,PRCNCT,PRSD,PRSD_SV,"2025-05-18 21:17:47",57,49,35,14,0,49,0,70,21,33,16
2,ARAD,"CĂMINUL CULTURAL FENIŞ",278,GURAHONŢ,10943,1,PART,PRCNCT,PRSD,PRSD_SV,"2025-05-18 21:21:05",80,43,33,10,0,42,1,90,47,24,18
2,ARAD,"CĂMINUL CULTURAL HONŢIŞOR",279,GURAHONŢ,10943,1,PART,PRCNCT,PRSD,PRSD_SV,"2025-05-18 21:32:51",260,181,156,23,2,180,1,290,109,140,40
2,ARAD,"CĂMINUL CULTURAL IOSAŞ",280,GURAHONŢ,10943,1,PART,PRCNCT,PRSD,PRSD_SV,"2025-05-18 21:29:21",176,114,98,16,0,113,1,200,86,78,35
2,ARAD,"CĂMINUL CULTURAL PESCARI",281,GURAHONŢ,10943,1,PART,PRCNCT,PRSD,PRSD_SV,"2025-05-18 21:29:25",229,122,97,25,0,121,1,260,138,73,48
2,ARAD,"CĂMINUL CULTURAL ZIMBRU",282,GURAHONŢ,10943,1,PART,PRCNCT,PRSD,PRSD_SV,"2025-05-18 21:41:18",290,151,137,14,0,151,0,320,169,101,50
2,ARAD,"PRIMĂRIA COMUNEI HĂLMAGIU",283,HĂLMAGIU,11058,1,PART,PRCNCT,PRSD,PRSD_SV,"2025-05-18 21:46:12",882,523,418,88,17,519,4,960,437,342,177
2,ARAD,"CĂMINUL CULTURAL BĂNEȘTI",284,HĂLMAGIU,11058,1,PART,PRCNCT,PRSD,PRSD_SV,"2025-05-18 21:42:31",208,149,128,21,0,146,3,230,81,102,44
2,ARAD,"ŞCOALA GENERALĂ",285,HĂLMAGIU,11058,1,PART,PRCNCT,PRSD,PRSD_SV,"2025-05-18 21:34:46",247,144,118,26,0,144,0,270,126,80,64
2,ARAD,"CĂMINUL CULTURAL LEASA",286,HĂLMAGIU,11058,1,PART,PRCNCT,PRSD,PRSD_SV,"2025-05-18 21:19:09",144,121,78,27,16,119,2,160,39,57,62
2,ARAD,"CĂMINUL CULTURAL POIENARI",287,HĂLMAGIU,11058,1,PART,PRCNCT,PRSD,PRSD_SV,"2025-05-18 21:24:19",129,101,88,13,0,101,0,150,49,66,35
2,ARAD,"CĂMINUL CULTURAL TISA",288,HĂLMAGIU,11058,1,PART,PRCNCT,PRSD,PRSD_SV,"2025-05-18 21:27:06",133,112,79,33,0,112,0,150,38,57,55
2,ARAD,"CĂMIN CULTURAL ŢĂRMURE",289,HĂLMAGIU,11058,1,PART,PRCNCT,PRSD,PRSD_SV,"2025-05-18 21:31:38",247,181,144,34,3,177,4,270,89,112,65
2,ARAD,"PRIMĂRIA COMUNEI HĂLMĂGEL",290,HĂLMĂGEL,11174,1,PART,PRCNCT,PRSD,PRSD_SV,"2025-05-18 21:46:25",439,238,199,38,1,237,1,480,242,149,88
2,ARAD,"ŞCOALA PRIMARĂ LUNCŞOARA",291,HĂLMĂGEL,11174,1,PART,PRCNCT,PRSD,PRSD_SV,"2025-05-18 21:41:28",260,129,103,26,0,127,2,290,161,93,34
2,ARAD,"CĂMINUL CULTURAL SÂRBI",292,HĂLMĂGEL,11174,1,PART,PRCNCT,PRSD,PRSD_SV,"2025-05-18 21:17:18",70,52,32,20,0,52,0,80,28,23,29
2,ARAD,"ŞCOALA PRIMARĂ TÂRNĂVIŢA",293,HĂLMĂGEL,11174,1,PART,PRCNCT,PRSD,PRSD_SV,"2025-05-18 21:16:56",96,75,47,28,0,74,1,110,35,48,26
2,ARAD,"ȘCOALA GENERALĂ I-VIII HĂȘMAȘ",294,HĂŞMAŞ,11236,1,PART,PRCNCT,PRSD,PRSD_SV,"2025-05-18 21:21:18",321,219,173,41,5,219,0,350,131,104,115
2,ARAD,"CĂMINUL CULTURAL AGRIŞU MIC",295,HĂŞMAŞ,11236,1,PART,PRCNCT,PRSD,PRSD_SV,"2025-05-18 21:23:20",159,110,80,30,0,108,2,180,70,74,34
2,ARAD,"CENTRU DE ZI PENTRU PREVENIREA SEPARARII COPILULUI DE FAMILIA SA",296,HĂŞMAŞ,11236,1,PART,PRCNCT,PRSD,PRSD_SV,"2025-05-18 21:23:36",186,125,96,26,3,122,3,210,85,68,54
2,ARAD,"CĂMINUL CULTURAL CLIT",297,HĂŞMAŞ,11236,1,PART,PRCNCT,PRSD,PRSD_SV,"2025-05-18 21:17:20",56,45,31,14,0,45,0,70,25,18,27
2,ARAD,"CĂMINUL CULTURAL COMĂNEŞTI",298,HĂŞMAŞ,11236,1,PART,PRCNCT,PRSD,PRSD_SV,"2025-05-18 21:21:29",83,71,44,18,9,70,1,90,19,32,38
2,ARAD,"CĂMINUL CULTURAL URVIŞU DE BELIU",299,HĂŞMAŞ,11236,1,PART,PRCNCT,PRSD,PRSD_SV,"2025-05-18 21:18:11",174,126,106,19,1,125,1,190,64,86,39
2,ARAD,"CĂMINUL CULTURAL IGNEŞTI",300,IGNEŞTI,11307,1,PART,PRCNCT,PRSD,PRSD_SV,"2025-05-18 21:27:56",217,140,114,26,0,134,6,240,100,61,73
2,ARAD,"CLĂDIREA FOSTEI ȘCOLI PRIMARE MINEAD",301,IGNEŞTI,11307,1,PART,PRCNCT,PRSD,PRSD_SV,"2025-05-18 21:14:04",70,51,35,15,1,51,0,80,29,22,29
2,ARAD,"CĂMINUL CULTURAL NĂDĂLBEȘTI",302,IGNEŞTI,11307,1,PART,PRCNCT,PRSD,PRSD_SV,"2025-05-18 21:14:39",112,63,45,18,0,63,0,130,67,46,17
2,ARAD,"CĂMIN CULTURAL",303,IGNEŞTI,11307,1,PART,PRCNCT,PRSD,PRSD_SV,"2025-05-18 21:22:32",174,99,80,19,0,98,1,190,91,68,30
2,ARAD,"CONSILIUL LOCAL IRATOŞU",304,IRATOŞU,11352,1,PART,PRCNCT,PRSD,PRSD_SV,"2025-05-18 21:46:58",1626,799,699,100,0,792,7,1770,971,359,433
2,ARAD,"ŞCOALA GIMNAZIALĂ VARIAŞU MARE",305,IRATOŞU,11352,1,PART,PRCNCT,PRSD,PRSD_SV,"2025-05-18 21:33:17",421,243,179,43,21,242,1,510,267,109,133
2,ARAD,"ŞCOALA GIMNAZIALĂ VARIAŞU MIC",306,IRATOŞU,11352,1,PART,PRCNCT,PRSD,PRSD_SV,"2025-05-18 21:11:10",98,86,47,39,0,85,1,110,24,54,31
2,ARAD,"ŞCOALA GIMNAZIALĂ LIVADA",307,LIVADA,9333,1,PART,PRCNCT,PRSD,PRSD_SV,"2025-05-18 21:54:35",1356,831,728,102,1,823,8,1480,649,465,358
2,ARAD,"CAMINUL CULTURAL LIVADA",308,LIVADA,9333,1,PART,PRCNCT,PRSD,PRSD_SV,"2025-05-18 21:39:13",753,576,505,69,2,566,10,820,244,245,321
2,ARAD,"ŞCOALA GIMNAZIALĂ SÂNLEANI",309,LIVADA,9333,1,PART,PRCNCT,PRSD,PRSD_SV,"2025-05-18 21:26:02",1490,869,780,84,5,856,13,1620,751,420,436
2,ARAD,"ŞCOALA GIMNAZIALĂ PAVEL COVACI MACEA",310,MACEA,11398,1,PART,PRCNCT,PRSD,PRSD_SV,"2025-05-18 21:40:49",1867,938,842,94,2,930,8,2040,1102,530,400
2,ARAD,"ŞCOALA GIMNAZIALĂ PAVEL COVACI MACEA",311,MACEA,11398,1,PART,PRCNCT,PRSD,PRSD_SV,"2025-05-18 21:49:53",1885,853,774,73,6,849,4,2060,1207,539,310
2,ARAD,"ŞCOALA GIMNAZIALĂ PAVEL COVACI MACEA",312,MACEA,11398,1,PART,PRCNCT,PRSD,PRSD_SV,"2025-05-18 21:40:51",1130,368,322,46,0,368,0,1230,862,284,84
2,ARAD,"ŞCOALA GIMNAZIALĂ PAVEL COVACI MACEA",313,MACEA,11398,1,PART,PRCNCT,PRSD,PRSD_SV,"2025-05-18 21:33:42",1035,326,298,28,0,319,7,1130,804,258,61
2,ARAD,"CĂMINUL CULTURAL MIȘCA",314,MIŞCA,11423,1,PART,PRCNCT,PRSD,PRSD_SV,"2025-05-18 21:30:21",1003,443,387,56,0,439,4,1100,657,315,124
2,ARAD,"CLĂDIREA PRIMĂRIEI DIN SATUL SATU NOU",315,MIŞCA,11423,1,PART,PRCNCT,PRSD,PRSD_SV,"2025-05-18 21:34:40",703,352,313,28,11,349,3,770,418,87,262
2,ARAD,"CLĂDIREA PRIMĂRIEI DIN SATUL VÂNĂTORI",316,MIŞCA,11423,1,PART,PRCNCT,PRSD,PRSD_SV,"2025-05-18 21:57:04",1044,393,347,39,7,387,6,1130,737,240,147
2,ARAD,"ŞCOALA PRIMARĂ DIN SATUL ZERINDU MIC",317,MIŞCA,11423,1,PART,PRCNCT,PRSD,PRSD_SV,"2025-05-18 21:37:52",153,106,89,17,0,106,0,170,64,26,80
2,ARAD,"ȘCOALA GIMNAZIALĂ „GHEORGHE GROZA”",318,MONEASA,11478,1,PART,PRCNCT,PRSD,PRSD_SV,"2025-05-18 21:44:55",541,610,264,334,12,602,8,800,190,269,333
2,ARAD,"FOSTA ŞCOALĂ RĂNUŞA",319,MONEASA,11478,1,PART,PRCNCT,PRSD,PRSD_SV,"2025-05-18 21:37:29",199,124,98,24,2,123,1,220,96,60,63
2,ARAD,"PRIMĂRIA COMUNEI OLARI",320,OLARI,11502,1,PART,PRCNCT,PRSD,PRSD_SV,"2025-05-18 21:37:12",1255,572,503,54,15,569,3,1360,788,277,292
2,ARAD,"ŞCOALA PRIMARĂ SINTEA MICĂ",321,OLARI,11502,1,PART,PRCNCT,PRSD,PRSD_SV,"2025-05-18 21:12:39",320,177,142,34,1,176,1,350,173,115,61
2,ARAD,"CĂMIN CULTURAL PĂULIŞ",322,PĂULIŞ,11539,1,PART,PRCNCT,PRSD,PRSD_SV,"2025-05-18 22:00:51",1505,870,773,97,0,862,8,1640,770,535,327
2,ARAD,"CENTRUL LOCAL DE INFORMARE TURISTICĂ BARAŢCA",323,PĂULIŞ,11539,1,PART,PRCNCT,PRSD,PRSD_SV,"2025-05-18 21:24:37",211,129,97,32,0,127,2,230,101,73,54
2,ARAD,"CĂMINUL CULTURAL CLADOVA",324,PĂULIŞ,11539,1,PART,PRCNCT,PRSD,PRSD_SV,"2025-05-18 21:22:50",228,149,103,46,0,146,3,250,101,88,58
2,ARAD,"CĂMIN CULTURAL SÂMBĂTENI",325,PĂULIŞ,11539,1,PART,PRCNCT,PRSD,PRSD_SV,"2025-05-18 22:06:19",1689,887,794,92,1,877,9,1840,953,627,250
2,ARAD,"PRIMĂRIA COMUNEI PEREGU MARE",326,"PEREGU MARE",11637,1,PART,PRCNCT,PRSD,PRSD_SV,"2025-05-18 21:48:01",739,326,292,31,3,322,4,810,484,180,142
2,ARAD,"CLĂDIREA PRIMĂRIEI DIN SATUL PEREGU MIC",327,"PEREGU MARE",11637,1,PART,PRCNCT,PRSD,PRSD_SV,"2025-05-18 22:03:32",768,389,349,33,7,387,2,840,451,125,262
2,ARAD,"PRIMĂRIA PETRIŞ",328,PETRIŞ,11664,1,PART,PRCNCT,PRSD,PRSD_SV,"2025-05-18 21:36:53",387,235,179,53,3,230,5,420,185,130,100
2,ARAD,"CĂMINUL CULTURAL CORBEŞTI",329,PETRIŞ,11664,1,PART,PRCNCT,PRSD,PRSD_SV,"2025-05-18 21:30:09",145,103,72,30,1,103,0,160,57,65,38
2,ARAD,"CĂMINUL CULTURAL ILTEU",330,PETRIŞ,11664,1,PART,PRCNCT,PRSD,PRSD_SV,"2025-05-18 21:24:33",173,144,93,51,0,142,2,190,46,93,49
2,ARAD,"CĂMINUL CULTURAL OBÂRŞIA",331,PETRIŞ,11664,1,PART,PRCNCT,PRSD,PRSD_SV,"2025-05-18 21:31:46",77,69,42,27,0,67,2,90,21,28,39
2,ARAD,"CĂMINUL CULTURAL ROŞIA NOUĂ",332,PETRIŞ,11664,1,PART,PRCNCT,PRSD,PRSD_SV,"2025-05-18 21:23:18",205,122,100,22,0,121,1,230,108,68,53
2,ARAD,"CĂMINUL CULTURAL SELIŞTE",333,PETRIŞ,11664,1,PART,PRCNCT,PRSD,PRSD_SV,"2025-05-18 21:20:08",91,64,43,20,1,64,0,100,36,36,28
2,ARAD,"PRIMĂRIA COMUNEI PILU",334,PILU,11735,1,PART,PRCNCT,PRSD,PRSD_SV,"2025-05-18 21:46:22",895,394,356,37,1,392,2,980,586,256,136
2,ARAD,"ŞCOALA GIMNAZIALĂ VĂRȘAND",335,PILU,11735,1,PART,PRCNCT,PRSD,PRSD_SV,"2025-05-18 21:58:06",815,380,325,55,0,378,2,1100,720,233,145
2,ARAD,"PRIMĂRIA COMUNEI PLEŞCUŢA",336,PLEŞCUŢA,11762,1,PART,PRCNCT,PRSD,PRSD_SV,"2025-05-18 21:21:13",203,125,94,31,0,125,0,230,105,74,51
2,ARAD,"CĂMINUL CULTURAL ACIUŢA",337,PLEŞCUŢA,11762,1,PART,PRCNCT,PRSD,PRSD_SV,"2025-05-18 21:14:51",168,80,59,21,0,79,1,190,110,52,27
2,ARAD,"CĂMINUL CULTURAL GURA VĂII",338,PLEŞCUŢA,11762,1,PART,PRCNCT,PRSD,PRSD_SV,"2025-05-18 21:31:51",218,128,109,19,0,125,3,240,112,77,48
2,ARAD,"CĂMINUL CULTURAL TĂLAGIU",339,PLEŞCUŢA,11762,1,PART,PRCNCT,PRSD,PRSD_SV,"2025-05-18 21:18:14",286,135,107,28,0,134,1,320,185,96,38
2,ARAD,"CĂMINUL CULTURAL SĂVÂRȘIN",340,SĂVÂRŞIN,11842,1,PART,PRCNCT,PRSD,PRSD_SV,"2025-05-18 22:08:36",1267,740,619,111,10,731,9,1380,640,433,298
2,ARAD,"ŞCOALA PRIMARĂ CĂPRIOARA",341,SĂVÂRŞIN,11842,1,PART,PRCNCT,PRSD,PRSD_SV,"2025-05-18 21:38:15",220,164,100,49,15,164,0,240,76,105,59
2,ARAD,"ŞCOALA PRIMARĂ PÂRNEŞTI",342,SĂVÂRŞIN,11842,1,PART,PRCNCT,PRSD,PRSD_SV,"2025-05-18 21:26:20",129,98,82,16,0,97,1,150,52,73,24
2,ARAD,"CĂMINUL CULTURAL TEMEŞEŞTI",343,SĂVÂRŞIN,11842,1,PART,PRCNCT,PRSD,PRSD_SV,"2025-05-18 21:14:01",99,83,57,26,0,83,0,110,27,63,20
2,ARAD,"CĂMINUL CULTURAL TOC",344,SĂVÂRŞIN,11842,1,PART,PRCNCT,PRSD,PRSD_SV,"2025-05-18 21:47:55",335,198,160,36,2,195,3,370,172,87,108
2,ARAD,"CĂMINUL CULTURAL TROAȘ",345,SĂVÂRŞIN,11842,1,PART,PRCNCT,PRSD,PRSD_SV,"2025-05-18 21:33:01",132,84,61,23,0,83,1,150,66,62,21
2,ARAD,"CĂMIN CULTURAL VALEA MARE",346,SĂVÂRŞIN,11842,1,PART,PRCNCT,PRSD,PRSD_SV,"2025-05-18 21:47:57",171,107,75,26,6,104,3,190,83,73,31
2,ARAD,"PRIMĂRIA COMUNEI SECUSIGIU",347,SECUSIGIU,11940,1,PART,PRCNCT,PRSD,PRSD_SV,"2025-05-18 21:39:28",877,399,352,47,0,397,2,960,561,297,100
2,ARAD,"ȘCOALA GIMNAZIALĂ SECUSIGIU",348,SECUSIGIU,11940,1,PART,PRCNCT,PRSD,PRSD_SV,"2025-05-18 21:30:08",932,418,361,57,0,417,1,1010,592,335,82
2,ARAD,"CĂMINUL CULTURAL MUNAR",349,SECUSIGIU,11940,1,PART,PRCNCT,PRSD,PRSD_SV,"2025-05-18 21:29:18",421,262,224,38,0,261,1,460,198,155,106
2,ARAD,"CLĂDIREA PRIMĂRIEI DIN SATU MARE",350,SECUSIGIU,11940,1,PART,PRCNCT,PRSD,PRSD_SV,"2025-05-18 21:25:44",798,335,288,47,0,334,1,870,535,246,88
2,ARAD,"REMIZA P.S.I SÎNPETRU GERMAN",351,SECUSIGIU,11940,1,PART,PRCNCT,PRSD,PRSD_SV,"2025-05-18 21:34:41",837,309,284,25,0,307,2,910,601,205,102
2,ARAD,"ȘCOALA GIMNAZIALĂ SÎNPETRU GERMAN",352,SECUSIGIU,11940,1,PART,PRCNCT,PRSD,PRSD_SV,"2025-05-18 21:52:13",880,357,337,20,0,353,4,960,603,285,68
2,ARAD,"PRIMĂRIA COMUNEI SELEUŞ",353,SELEUŞ,11995,1,PART,PRCNCT,PRSD,PRSD_SV,"2025-05-18 21:43:44",1459,774,710,64,0,770,4,1590,816,507,263
2,ARAD,"ŞCOALA PRIMARĂ IERMATA",354,SELEUŞ,11995,1,PART,PRCNCT,PRSD,PRSD_SV,"2025-05-18 21:36:33",319,214,182,32,0,207,7,350,136,167,40
2,ARAD,"CĂMINUL CULTURAL MORODA",355,SELEUŞ,11995,1,PART,PRCNCT,PRSD,PRSD_SV,"2025-05-18 21:35:15",574,304,272,32,0,301,3,630,326,218,83
2,ARAD,"ȘCOALA GIMNAZIALĂ „DR. IOAN DANICICO”",356,SEMLAC,12037,1,PART,PRCNCT,PRSD,PRSD_SV,"2025-05-18 21:47:35",1742,807,743,64,0,798,9,1900,1093,527,271
2,ARAD,"ȘCOALA GIMNAZIALĂ ”DR. IOAN DANICICO”",357,SEMLAC,12037,1,PART,PRCNCT,PRSD,PRSD_SV,"2025-05-18 21:41:20",1632,709,648,61,0,702,7,1780,1071,441,261
2,ARAD,"CLUBUL TINERETULUI",358,"SINTEA MARE",12055,1,PART,PRCNCT,PRSD,PRSD_SV,"2025-05-18 21:33:39",1008,506,448,58,0,503,3,1100,594,328,175
2,ARAD,"CĂMINUL CULTURAL ADEA",359,"SINTEA MARE",12055,1,PART,PRCNCT,PRSD,PRSD_SV,"2025-05-18 21:31:26",830,368,332,36,0,363,5,910,542,185,178
2,ARAD,"CĂMINUL CULTURAL ŢIPAR I",360,"SINTEA MARE",12055,1,PART,PRCNCT,PRSD,PRSD_SV,"2025-05-18 21:50:34",1114,505,462,43,0,498,7,1210,705,331,167
2,ARAD,"PRIMĂRIA COMUNEI SOCODOR",361,SOCODOR,12126,1,PART,PRCNCT,PRSD,PRSD_SV,"2025-05-18 21:41:00",907,514,442,51,21,512,2,990,476,291,221
2,ARAD,"CĂMINUL CULTURAL SOCODOR",362,SOCODOR,12126,1,PART,PRCNCT,PRSD,PRSD_SV,"2025-05-18 21:53:03",941,480,426,41,13,473,7,1020,540,286,187
2,ARAD,"PRIMĂRIA COMUNEI ȘAGU",363,ŞAGU,12144,1,PART,PRCNCT,PRSD,PRSD_SV,"2025-05-18 21:45:37",1104,622,547,61,14,611,11,1200,578,335,276
2,ARAD,"PRIMĂRIA COMUNEI ȘAGU",364,ŞAGU,12144,1,PART,PRCNCT,PRSD,PRSD_SV,"2025-05-18 21:19:25",700,419,361,46,12,414,5,760,341,249,165
2,ARAD,"ŞCOALA GENERALĂ",365,ŞAGU,12144,1,PART,PRCNCT,PRSD,PRSD_SV,"2025-05-18 21:29:12",606,327,259,47,21,325,2,660,333,186,139
2,ARAD,"ŞCOALA GENERALĂ",366,ŞAGU,12144,1,PART,PRCNCT,PRSD,PRSD_SV,"2025-05-18 21:19:37",369,201,170,30,1,195,6,400,199,143,52
2,ARAD,"ŞCOALA GIMNAZIALĂ",367,ŞAGU,12144,1,PART,PRCNCT,PRSD,PRSD_SV,"2025-05-18 21:26:46",481,252,216,36,0,250,2,530,278,156,94
2,ARAD,"CĂMINUL CULTURAL HUNEDOARA TIMIȘANĂ",368,ŞAGU,12144,1,PART,PRCNCT,PRSD,PRSD_SV,"2025-05-18 21:21:01",166,127,92,35,0,125,2,190,63,88,37
2,ARAD,"PRIMĂRIA COMUNEI ȘEITIN",369,ŞEITIN,12206,1,PART,PRCNCT,PRSD,PRSD_SV,"2025-05-18 21:53:10",1200,592,527,62,3,589,3,1310,718,393,196
2,ARAD,"ȘCOALA GIMNAZIALĂ „ȘTEFAN BOZIAN” ȘEITIN",370,ŞEITIN,12206,1,PART,PRCNCT,PRSD,PRSD_SV,"2025-05-18 21:54:09",1259,586,531,54,1,578,8,1370,784,391,187
2,ARAD,"ŞCOALA GIMNAZIALĂ ”MIHAI VELICIU”",371,ŞEPREUŞ,12224,1,PART,PRCNCT,PRSD,PRSD_SV,"2025-05-18 21:33:28",1021,436,379,49,8,433,3,1110,674,285,148
2,ARAD,"ŞCOALA GIMNAZIALĂ ”MIHAI VELICIU”",372,ŞEPREUŞ,12224,1,PART,PRCNCT,PRSD,PRSD_SV,"2025-05-18 21:33:24",1177,427,390,33,4,426,1,1280,853,316,110
2,ARAD,"CĂMINUL CULTURAL ȘICULA",373,ŞICULA,12242,1,PART,PRCNCT,PRSD,PRSD_SV,"2025-05-18 21:27:18",878,472,418,54,0,466,6,960,488,324,142
2,ARAD,"ȘCOALA GIMNAZIALĂ ȘICULA",374,ŞICULA,12242,1,PART,PRCNCT,PRSD,PRSD_SV,"2025-05-18 21:35:01",867,441,411,30,0,437,4,950,509,302,135
2,ARAD,"CĂMINUL CULTURAL CHERELUȘ",375,ŞICULA,12242,1,PART,PRCNCT,PRSD,PRSD_SV,"2025-05-18 21:29:04",731,386,333,50,3,385,1,800,414,282,103
2,ARAD,"ŞCOALA GIMNAZIALĂ GURBA",376,ŞICULA,12242,1,PART,PRCNCT,PRSD,PRSD_SV,"2025-05-18 21:44:12",912,480,427,53,0,479,1,990,510,354,125
2,ARAD,"CĂMINUL CULTURAL ȘILINDIA",377,ŞILINDIA,12288,1,PART,PRCNCT,PRSD,PRSD_SV,"2025-05-18 21:38:16",659,381,272,87,22,376,5,720,339,215,161
2,ARAD,"ȘCOALA GIMNAZIALĂ ŞIMAND",378,ŞIMAND,12340,1,PART,PRCNCT,PRSD,PRSD_SV,"2025-05-18 21:51:27",1158,553,487,66,0,550,3,1260,707,373,177
2,ARAD,"ȘCOALA PRIMARĂ ŞIMAND",379,ŞIMAND,12340,1,PART,PRCNCT,PRSD,PRSD_SV,"2025-05-18 21:50:05",1216,674,617,57,0,665,9,1320,646,457,208
2,ARAD,"ȘCOALA GIMNAZIALĂ ȘIMAND - GRĂDINIȚA CU PROGRAM NORMAL NR.2",380,ŞIMAND,12340,1,PART,PRCNCT,PRSD,PRSD_SV,"2025-05-18 21:32:36",1048,469,434,35,0,469,0,1140,671,349,120
2,ARAD,"CĂMINUL CULTURAL ȘIRIA",381,ŞIRIA,12368,1,PART,PRCNCT,PRSD,PRSD_SV,"2025-05-18 22:04:11",1380,587,514,66,7,579,8,1500,913,300,279
2,ARAD,"CĂMINUL CULTURAL ȘIRIA",382,ŞIRIA,12368,1,PART,PRCNCT,PRSD,PRSD_SV,"2025-05-18 21:53:58",1345,524,488,34,2,518,6,1470,946,304,214
2,ARAD,"CENTRU SOCIAL COMUNITAR ”PROF. MARCEL IOAN PRIESCU”",383,ŞIRIA,12368,1,PART,PRCNCT,PRSD,PRSD_SV,"2025-05-18 21:29:25",1799,548,486,56,6,536,12,1960,1412,378,158
2,ARAD,"CĂMINUL CULTURAL GALȘA",384,ŞIRIA,12368,1,PART,PRCNCT,PRSD,PRSD_SV,"2025-05-18 21:40:30",1849,981,878,94,9,971,10,2020,1039,632,339
2,ARAD,"CĂMINUL CULTURAL MÂSCA",385,ŞIRIA,12368,1,PART,PRCNCT,PRSD,PRSD_SV,"2025-05-18 21:34:24",759,458,401,57,0,453,5,830,372,287,166
2,ARAD,"PRIMĂRIA COMUNEI ȘIȘTAROVĂȚ",386,ŞIŞTAROVĂŢ,12402,1,PART,PRCNCT,PRSD,PRSD_SV,"2025-05-18 21:45:54",339,179,141,38,0,177,2,370,191,116,61
2,ARAD,"CĂMINUL CULTURAL ŞOFRONEA",387,ŞOFRONEA,9360,1,PART,PRCNCT,PRSD,PRSD_SV,"2025-05-18 21:45:22",1881,1048,943,96,9,1033,15,2050,1002,537,496
2,ARAD,"CĂMINUL CULTURAL SÂNPAUL",388,ŞOFRONEA,9360,1,PART,PRCNCT,PRSD,PRSD_SV,"2025-05-18 21:25:38",697,515,400,102,13,510,5,760,245,177,333
2,ARAD,"CĂMINUL CULTURAL TAUŢ",389,TAUŢ,12457,1,PART,PRCNCT,PRSD,PRSD_SV,"2025-05-18 21:49:42",549,380,254,110,16,376,4,600,220,219,157
2,ARAD,"ŞCOALA PRIMARĂ MINIŞEL",390,TAUŢ,12457,1,PART,PRCNCT,PRSD,PRSD_SV,"2025-05-18 21:19:30",115,73,46,27,0,71,2,130,57,37,34
2,ARAD,"CĂMINUL CULTURAL MINIŞU DE SUS",391,TAUŢ,12457,1,PART,PRCNCT,PRSD,PRSD_SV,"2025-05-18 21:37:56",37,53,18,35,0,51,2,70,17,33,18
2,ARAD,"CĂMINUL CULTURAL NADĂŞ",392,TAUŢ,12457,1,PART,PRCNCT,PRSD,PRSD_SV,"2025-05-18 21:27:55",561,302,256,39,7,299,3,610,308,213,86
2,ARAD,"ȘCOALA GIMNAZIALĂ TÂRNOVA",393,TÂRNOVA,12509,1,PART,PRCNCT,PRSD,PRSD_SV,"2025-05-18 21:39:57",1439,705,628,69,8,700,5,1570,865,493,207
2,ARAD,"ȘCOALA GIMNAZIALĂ AGRIŞU MARE",394,TÂRNOVA,12509,1,PART,PRCNCT,PRSD,PRSD_SV,"2025-05-18 21:43:49",932,515,481,32,2,514,1,1010,495,454,60
2,ARAD,"CĂMINUL CULTURAL ARĂNEAG",395,TÂRNOVA,12509,1,PART,PRCNCT,PRSD,PRSD_SV,"2025-05-18 21:32:43",343,198,160,36,2,198,0,370,172,145,53
2,ARAD,"CĂMINUL CULTURAL CHIER",396,TÂRNOVA,12509,1,PART,PRCNCT,PRSD,PRSD_SV,"2025-05-18 21:39:51",950,424,371,53,0,417,7,1030,606,333,84
2,ARAD,"CĂMINUL CULTURAL DRAUŢ",397,TÂRNOVA,12509,1,PART,PRCNCT,PRSD,PRSD_SV,"2025-05-18 21:43:36",656,348,302,46,0,344,4,710,362,235,109
2,ARAD,"CĂMINUL CULTURAL DUD",398,TÂRNOVA,12509,1,PART,PRCNCT,PRSD,PRSD_SV,"2025-05-18 21:24:49",547,328,298,30,0,325,3,600,272,288,37
2,ARAD,"ŞCOALA GIMNAZIALĂ ”TEODOR PĂCĂŢIAN” USUSĂU",399,USUSĂU,10765,1,PART,PRCNCT,PRSD,PRSD_SV,"2025-05-18 21:37:29",524,288,254,29,5,286,2,570,282,219,67
2,ARAD,"GRĂDINIŢA CU PROGRAM NORMAL BRUZNIC",400,USUSĂU,10765,1,PART,PRCNCT,PRSD,PRSD_SV,"2025-05-18 21:10:28",76,56,40,16,0,56,0,90,34,47,9
2,ARAD,"GRĂDINIŢA CU PROGRAM NORMAL DORGOŞ",401,USUSĂU,10765,1,PART,PRCNCT,PRSD,PRSD_SV,"2025-05-18 21:26:31",257,147,119,28,0,145,2,280,133,119,26
2,ARAD,"ŞCOALA PRIMARĂ ZĂBALŢ",402,USUSĂU,10765,1,PART,PRCNCT,PRSD,PRSD_SV,"2025-05-18 21:31:03",219,140,121,19,0,139,1,240,100,107,32
2,ARAD,"PRIMĂRIA COMUNEI VĂRĂDIA DE MUREȘ",403,"VĂRĂDIA DE MUREŞ",12572,1,PART,PRCNCT,PRSD,PRSD_SV,"2025-05-18 21:30:35",469,208,172,31,5,201,7,510,302,138,63
2,ARAD,"CĂMINUL CULTURAL BAIA",404,"VĂRĂDIA DE MUREŞ",12572,1,PART,PRCNCT,PRSD,PRSD_SV,"2025-05-18 21:22:44",96,77,62,15,0,76,1,110,33,51,25
2,ARAD,"ŞCOALA PRIMARĂ JULIȚA",405,"VĂRĂDIA DE MUREŞ",12572,1,PART,PRCNCT,PRSD,PRSD_SV,"2025-05-18 21:19:23",279,184,137,47,0,183,1,310,126,103,80
2,ARAD,"CĂMINUL CULTURAL LUPEȘTI",406,"VĂRĂDIA DE MUREŞ",12572,1,PART,PRCNCT,PRSD,PRSD_SV,"2025-05-18 21:26:41",187,138,109,29,0,135,3,210,72,74,61
2,ARAD,"CĂMINUL CULTURAL NICOLAE BĂLCESCU",407,"VĂRĂDIA DE MUREŞ",12572,1,PART,PRCNCT,PRSD,PRSD_SV,"2025-05-18 21:36:52",198,145,104,40,1,143,2,220,75,94,49
2,ARAD,"CĂMINUL CULTURAL STEJAR",408,"VĂRĂDIA DE MUREŞ",12572,1,PART,PRCNCT,PRSD,PRSD_SV,"2025-05-18 21:19:07",108,66,52,14,0,66,0,120,54,44,22
2,ARAD,"CĂMINUL CULTURAL VÎRFURILE",409,VÂRFURILE,12689,1,PART,PRCNCT,PRSD,PRSD_SV,"2025-05-18 21:44:40",883,469,404,65,0,467,2,960,491,293,174
2,ARAD,"ŞCOALA GENERALĂ AVRAM IANCU",410,VÂRFURILE,12689,1,PART,PRCNCT,PRSD,PRSD_SV,"2025-05-18 21:59:50",593,310,278,32,0,306,4,650,340,195,111
2,ARAD,"CĂMIN CULTURAL LAZURI",411,VÂRFURILE,12689,1,PART,PRCNCT,PRSD,PRSD_SV,"2025-05-18 22:22:06",583,344,293,51,0,341,3,640,296,207,134
2,ARAD,"PRIMĂRIA COMUNEI VINGA",412,VINGA,12643,1,PART,PRCNCT,PRSD,PRSD_SV,"2025-05-18 21:50:32",907,515,410,102,3,511,4,990,475,218,293
2,ARAD,"ŞCOALA GIMNAZIALĂ NR. 2 VINGA",413,VINGA,12643,1,PART,PRCNCT,PRSD,PRSD_SV,"2025-05-18 21:34:23",1375,633,567,66,0,628,5,1500,867,395,233
2,ARAD,"GRĂDINIŢA PN VINGA",414,VINGA,12643,1,PART,PRCNCT,PRSD,PRSD_SV,"2025-05-18 22:08:17",1645,724,677,47,0,712,12,1800,1076,438,274
2,ARAD,"ŞCOALA GENERALĂ MAILAT",415,VINGA,12643,1,PART,PRCNCT,PRSD,PRSD_SV,"2025-05-18 21:36:36",823,429,305,118,6,426,3,900,471,116,310
2,ARAD,"ŞCOALA GENERALĂ MĂNĂŞTUR",416,VINGA,12643,1,PART,PRCNCT,PRSD,PRSD_SV,"2025-05-18 21:36:33",995,513,463,50,0,510,3,1080,567,373,137
2,ARAD,"CĂMINUL CULTURAL VLADIMIRESCU",417,VLADIMIRESCU,9397,1,PART,PRCNCT,PRSD,PRSD_SV,"2025-05-18 21:52:37",1701,858,759,99,0,852,6,1850,992,489,363
2,ARAD,"PRIMĂRIA COMUNEI VLADIMIRESCU",418,VLADIMIRESCU,9397,1,PART,PRCNCT,PRSD,PRSD_SV,"2025-05-18 21:42:58",1589,784,684,98,2,774,10,1730,946,375,399
2,ARAD,"CENTRU DE ZI VÂRSTNICI VLADIMIRESCU",419,VLADIMIRESCU,9397,1,PART,PRCNCT,PRSD,PRSD_SV,"2025-05-18 21:49:47",1702,806,744,62,0,792,14,1850,1044,415,377
2,ARAD,"ȘCOALA GIMNAZIALĂ VLADIMIRESCU",420,VLADIMIRESCU,9397,1,PART,PRCNCT,PRSD,PRSD_SV,"2025-05-18 21:38:20",1464,827,697,130,0,810,17,1590,763,487,323
2,ARAD,"CENTRUL DE CONSILIERE ȘI SPRIJIN PENTRU COPII ȘI ADULȚI",421,VLADIMIRESCU,9397,1,PART,PRCNCT,PRSD,PRSD_SV,"2025-05-18 21:55:12",1839,1359,1169,187,3,1346,13,2010,651,450,896
2,ARAD,"GRĂDINIȚA CU PROGRAM NORMAL CICIR",422,VLADIMIRESCU,9397,1,PART,PRCNCT,PRSD,PRSD_SV,"2025-05-18 21:51:19",882,542,491,51,0,536,6,960,418,292,244
2,ARAD,"ȘCOALA GIMNAZIALĂ HORIA",423,VLADIMIRESCU,9397,1,PART,PRCNCT,PRSD,PRSD_SV,"2025-05-18 21:55:02",1048,563,490,73,0,555,8,1140,577,329,226
2,ARAD,"CLĂDIRE TAXE ŞI IMPOZITE HORIA",424,VLADIMIRESCU,9397,2,PART,PRCNCT,PRSD,PRSD_SV,"2025-05-18 22:41:47",1177,632,573,59,0,628,4,1280,648,409,219
2,ARAD,"ŞCOALA PRIMARĂ MÂNDRULOC",425,VLADIMIRESCU,9397,1,PART,PRCNCT,PRSD,PRSD_SV,"2025-05-18 21:47:19",1254,780,667,113,0,772,8,1360,580,401,371
2,ARAD,"CĂMIN CULTURAL ZĂBRANI",426,ZĂBRANI,12778,1,PART,PRCNCT,PRSD,PRSD_SV,"2025-05-18 21:53:43",957,483,440,43,0,476,7,1040,557,307,169
2,ARAD,"GRĂDINIŢA CU PROGRAM NORMAL ZĂBRANI",427,ZĂBRANI,12778,1,PART,PRCNCT,PRSD,PRSD_SV,"2025-05-18 21:54:57",876,459,411,47,1,453,6,960,501,292,161
2,ARAD,"GRĂDINIŢA PROGRAM NORMAL CHESINŢ",428,ZĂBRANI,12778,1,PART,PRCNCT,PRSD,PRSD_SV,"2025-05-18 21:42:54",898,484,437,47,0,483,1,980,496,343,140
2,ARAD,"CĂMINUL CULTURAL NEUDORF",429,ZĂBRANI,12778,1,PART,PRCNCT,PRSD,PRSD_SV,"2025-05-18 21:36:34",837,394,356,37,1,391,3,910,516,260,131
2,ARAD,"SALA DE ŞEDINŢE A CONSILIULUI LOCAL ZĂDĂRENI",430,ZĂDĂRENI,12938,1,PART,PRCNCT,PRSD,PRSD_SV,"2025-05-18 21:39:07",1002,533,467,54,12,530,3,1092,559,337,193
2,ARAD,"SEDIU S.V.S.U. ZĂDĂRENI",431,ZĂDĂRENI,12938,1,PART,PRCNCT,PRSD,PRSD_SV,"2025-05-18 21:40:39",1219,695,581,82,32,686,9,1330,635,380,306
2,ARAD,"CĂMINUL CULTURAL BODROGU NOU",432,ZĂDĂRENI,12938,1,PART,PRCNCT,PRSD,PRSD_SV,"2025-05-18 21:23:42",234,224,132,92,0,221,3,260,36,121,100
2,ARAD,"PRIMĂRIA COMUNEI ZĂRAND",433,ZĂRAND,12812,1,PART,PRCNCT,PRSD,PRSD_SV,"2025-05-18 21:57:23",1205,524,470,54,0,521,3,1310,786,393,128
2,ARAD,"ŞCOALA GIMNAZIALĂ CINTEI",434,ZĂRAND,12812,1,PART,PRCNCT,PRSD,PRSD_SV,"2025-05-18 21:45:06",986,469,430,39,0,462,7,1070,601,351,111
2,ARAD,"PRIMĂRIA COMUNEI ZERIND",435,ZERIND,12849,1,PART,PRCNCT,PRSD,PRSD_SV,"2025-05-18 21:45:30",736,298,259,39,0,295,3,800,502,91,204
2,ARAD,"ŞCOALA PRIMARA IERMATA NEAGRA",436,ZERIND,12849,1,PART,PRCNCT,PRSD,PRSD_SV,"2025-05-18 21:22:15",461,205,184,21,0,204,1,510,305,61,143
2,ARAD,"CĂMINUL CULTURAL ZIMANDU NOU",437,"ZIMANDU NOU",12876,1,PART,PRCNCT,PRSD,PRSD_SV,"2025-05-18 21:50:51",1523,852,748,93,11,832,20,1660,808,340,492
2,ARAD,"CĂMINUL CULTURAL UTVINIȘ",438,"ZIMANDU NOU",12876,2,PART,PRCNCT,PRSD,PRSD_SV,"2025-05-19 00:04:44",186,123,101,22,0,120,3,210,87,57,63
2,ARAD,"CĂMINUL CULTURAL ANDREI ȘAGUNA",439,"ZIMANDU NOU",12876,1,PART,PRCNCT,PRSD,PRSD_SV,"2025-05-18 21:27:07",1177,720,632,75,13,708,12,1280,560,341,367
2,ARAD,"CĂMIN CULTURAL ZIMANDCUZ",440,"ZIMANDU NOU",12876,1,PART,PRCNCT,PRSD,PRSD_SV,"2025-05-18 21:37:29",1553,878,726,148,4,867,11,1690,812,381,486
3,ARGEŞ,"BIBLIOTECA JUDEŢEANĂ ARGEŞ ”DINICU GOLESCU”",1,"MUNICIPIUL PITEŞTI",13169,1,PART,PRCNCT,PRSD,PRSD_SV,"2025-05-18 22:00:33",1190,983,579,404,0,970,13,1300,317,384,586
3,ARGEŞ,"COLEGIUL ECONOMIC ”MARIA TEIULEANU”",2,"MUNICIPIUL PITEŞTI",13169,1,PART,PRCNCT,PRSD,PRSD_SV,"2025-05-18 21:46:22",1010,750,581,168,1,730,20,1100,350,262,468
3,ARGEŞ,"ŞCOALA GIMNAZIALĂ ”ION PILLAT” ( FOSTĂ ŞCOALĂ NR.3)",3,"MUNICIPIUL PITEŞTI",13169,1,PART,PRCNCT,PRSD,PRSD_SV,"2025-05-18 21:55:48",988,612,521,88,3,605,7,1100,488,173,432
3,ARGEŞ,"COLEGIUL ECONOMIC ”MARIA TEIULEANU” (FOST LICEUL TEHNOLOGIC „ION MINCU”)",4,"MUNICIPIUL PITEŞTI",13169,1,PART,PRCNCT,PRSD,PRSD_SV,"2025-05-18 22:14:40",1423,903,828,74,1,891,12,1600,697,349,542
3,ARGEŞ,"ŞCOALA GIMNAZIALĂ ” NEGRU VODĂ” ( FOSTĂ ŞCOALA NR. 12)",5,"MUNICIPIUL PITEŞTI",13169,1,PART,PRCNCT,PRSD,PRSD_SV,"2025-05-18 22:39:54",1595,974,834,140,0,956,18,1700,726,435,521
3,ARGEŞ,"ŞCOALA GIMNAZIALĂ ” NEGRU VODĂ” ( FOSTĂ ŞCOALA NR. 12)",6,"MUNICIPIUL PITEŞTI",13169,1,PART,PRCNCT,PRSD,PRSD_SV,"2025-05-18 21:32:51",1687,887,816,70,1,871,16,1800,913,422,449
3,ARGEŞ,"ŞCOALA GIMNAZIALĂ ” NEGRU VODĂ” ( FOSTĂ ŞCOALA NR. 12)",7,"MUNICIPIUL PITEŞTI",13169,1,PART,PRCNCT,PRSD,PRSD_SV,"2025-05-18 22:13:21",1574,847,789,58,0,837,10,1700,853,391,446
3,ARGEŞ,"ŞCOALA GIMNAZIALĂ ” NEGRU VODĂ” ( FOSTĂ ŞCOALA NR. 12)",8,"MUNICIPIUL PITEŞTI",13169,1,PART,PRCNCT,PRSD,PRSD_SV,"2025-05-18 21:34:52",1684,935,860,75,0,917,18,1800,865,519,398
3,ARGEŞ,"GRĂDINIŢA CU PROGRAM PRELUNGIT ” MICUL PRINŢ” (FOSTA GRĂDINIŢA CU PROGRAM PRELUNGIT NR. 13",9,"MUNICIPIUL PITEŞTI",13169,1,PART,PRCNCT,PRSD,PRSD_SV,"2025-05-18 22:23:44",2211,1433,1287,146,0,1409,24,2350,917,610,799
3,ARGEŞ,"ŞCOALA GIMNAZIALĂ ”MIRCEA CEL BĂTRAN” (FOSTĂ ŞCOALA NR. 13)",10,"MUNICIPIUL PITEŞTI",13169,1,PART,PRCNCT,PRSD,PRSD_SV,"2025-05-18 22:12:28",1701,986,917,68,1,974,12,1900,914,434,540
3,ARGEŞ,"ŞCOALA GIMNAZIALĂ ”MIRCEA CEL BĂTRAN” (FOSTĂ ŞCOALA NR. 13)",11,"MUNICIPIUL PITEŞTI",13169,2,PART,PRCNCT,PRSD,PRSD_SV,"2025-05-18 22:52:43",1685,984,887,97,0,965,19,1800,816,456,509
3,ARGEŞ,"ŞCOALA GIMNAZIALĂ ”MIRCEA CEL BĂTRAN” (FOSTĂ ŞCOALA NR. 13)",12,"MUNICIPIUL PITEŞTI",13169,1,PART,PRCNCT,PRSD,PRSD_SV,"2025-05-18 22:03:56",1822,1032,983,48,1,1019,13,2000,968,425,594
3,ARGEŞ,"ŞCOALA GIMNAZIALĂ ”MIRCEA CEL BĂTRAN” (FOSTĂ ŞCOALA NR. 13)",13,"MUNICIPIUL PITEŞTI",13169,1,PART,PRCNCT,PRSD,PRSD_SV,"2025-05-18 21:58:13",1692,1099,925,174,0,1078,21,1800,701,471,607
3,ARGEŞ,"GRĂDINIŢA CU PROGRAM PRELUNGIT ”LUMINIŞUL PĂDURII” (FOSTĂ GRĂDINIŢĂ NR. 6)",14,"MUNICIPIUL PITEŞTI",13169,1,PART,PRCNCT,PRSD,PRSD_SV,"2025-05-18 21:38:15",1274,742,681,60,1,724,18,1400,658,284,440
3,ARGEŞ,"GRĂDINIŢA CU PROGRAM PRELUNGIT ”LUMINIŞUL PĂDURII” (FOSTĂ GRĂDINIŢĂ NR. 6)",15,"MUNICIPIUL PITEŞTI",13169,1,PART,PRCNCT,PRSD,PRSD_SV,"2025-05-18 22:50:47",1536,938,874,64,0,922,16,1700,762,368,554
3,ARGEŞ,"LICEUL TEHNOLOGIC ”DACIA” (FOST GRUP ŞCOLAR INDUSTRIAL CONSTRUCŢII MAŞINI)",16,"MUNICIPIUL PITEŞTI",13169,1,PART,PRCNCT,PRSD,PRSD_SV,"2025-05-18 22:22:45",1402,935,829,106,0,920,15,1500,565,274,646
3,ARGEŞ,"COLEGIUL NAŢIONAL ”ION C. BRĂTIANU”",17,"MUNICIPIUL PITEŞTI",13169,1,PART,PRCNCT,PRSD,PRSD_SV,"2025-05-18 21:50:23",832,663,467,195,1,651,12,900,237,212,439
3,ARGEŞ,"ŞCOALA NR.1 - STRUCTURĂ A ŞCOLII GIMNAZIALE „NICOLAE BĂLCESCU” (FOSTA ŞCOALA GIMNAZIALĂ NR.9)",18,"MUNICIPIUL PITEŞTI",13169,1,PART,PRCNCT,PRSD,PRSD_SV,"2025-05-18 22:12:58",1585,1000,890,78,32,977,23,1700,700,304,673
3,ARGEŞ,"ŞCOALA NR.1 - STRUCTURĂ A ŞCOLII GIMNAZIALE „NICOLAE BĂLCESCU” (FOSTA ŞCOALA GIMNAZIALĂ NR.9)",19,"MUNICIPIUL PITEŞTI",13169,1,PART,PRCNCT,PRSD,PRSD_SV,"2025-05-18 22:09:14",1527,910,835,55,20,903,7,1700,790,318,585
3,ARGEŞ,"UNIVERSITATEA „CONSTANTIN BRÂNCOVEANU” (INTRAREA C)",20,"MUNICIPIUL PITEŞTI",13169,2,PART,PRCNCT,PRSD,PRSD_SV,"2025-05-18 23:27:45",1500,877,759,118,0,858,19,1600,723,409,449
3,ARGEŞ,"ŞCOALA GIMNAZIALĂ „ALEXANDRU DAVILA” (INTRAREA B) (FOSTA ŞCOALĂ NR.14)",21,"MUNICIPIUL PITEŞTI",13169,1,PART,PRCNCT,PRSD,PRSD_SV,"2025-05-18 21:58:05",1065,622,514,105,3,602,20,1200,578,253,349
3,ARGEŞ,"ŞCOALA GIMNAZIALĂ ”NICOLAE BĂLCESCU” ( FOSTA ŞCOALĂ NR.6)",22,"MUNICIPIUL PITEŞTI",13169,1,PART,PRCNCT,PRSD,PRSD_SV,"2025-05-18 21:48:46",1677,930,898,32,0,919,11,1800,870,410,509
3,ARGEŞ,"ŞCOALA GIMNAZIALĂ ”NICOLAE BĂLCESCU” ( FOSTA ŞCOALĂ NR.6)",23,"MUNICIPIUL PITEŞTI",13169,1,PART,PRCNCT,PRSD,PRSD_SV,"2025-05-18 21:44:18",1490,762,706,55,1,749,13,1600,838,378,371
3,ARGEŞ,"ŞCOALA GIMNAZIALĂ ”NICOLAE BĂLCESCU” ( FOSTA ŞCOALĂ NR.6)",24,"MUNICIPIUL PITEŞTI",13169,2,PART,PRCNCT,PRSD,PRSD_SV,"2025-05-19 00:26:38",1610,942,868,73,1,926,16,1800,858,400,526
3,ARGEŞ,"ŞCOALA GIMNAZIALĂ ”NICOLAE BĂLCESCU” ( FOSTA ŞCOALĂ NR.6)",25,"MUNICIPIUL PITEŞTI",13169,2,PART,PRCNCT,PRSD,PRSD_SV,"2025-05-18 23:54:28",1761,1103,951,152,0,1085,18,1900,797,463,622
3,ARGEŞ,"GRĂDINIŢA CU PROGRAM PRELUNGIT ”ALBĂ CA ZĂPADA” ( FOSTA GRĂDINIŢĂ NR. 10)",26,"MUNICIPIUL PITEŞTI",13169,1,PART,PRCNCT,PRSD,PRSD_SV,"2025-05-18 22:03:45",1625,919,834,85,0,902,17,1761,842,488,414
3,ARGEŞ,"ŞCOALA GIMNAZIALĂ ”ADRIAN PĂUNESCU” (FOSTĂ ŞCOALA NR. 15 )",27,"MUNICIPIUL PITEŞTI",13169,1,PART,PRCNCT,PRSD,PRSD_SV,"2025-05-18 22:06:39",1623,984,850,134,0,970,14,1800,816,461,509
3,ARGEŞ,"ŞCOALA GIMNAZIALĂ ”ADRIAN PĂUNESCU” (FOSTĂ ŞCOALA NR. 15 )",28,"MUNICIPIUL PITEŞTI",13169,1,PART,PRCNCT,PRSD,PRSD_SV,"2025-05-18 22:10:56",1668,1020,878,142,0,1000,20,1799,779,458,542
3,ARGEŞ,"SC APĂ CANAL 2000 SA",29,"MUNICIPIUL PITEŞTI",13169,1,PART,PRCNCT,PRSD,PRSD_SV,"2025-05-18 21:56:09",1817,1112,1011,101,0,1092,20,1950,838,473,619
3,ARGEŞ,"SC APĂ CANAL 2000 SA",30,"MUNICIPIUL PITEŞTI",13169,1,PART,PRCNCT,PRSD,PRSD_SV,"2025-05-18 23:37:38",2052,1244,1140,104,0,1220,24,2200,956,641,579
3,ARGEŞ,"S.C. LISA DRAXLMAIER S.A.",31,"MUNICIPIUL PITEŞTI",13169,1,PART,PRCNCT,PRSD,PRSD_SV,"2025-05-18 21:59:54",1685,1016,947,69,0,997,19,1800,784,439,558
3,ARGEŞ,"LICEUL TEORETIC ”ION CANTACUZINIO”",32,"MUNICIPIUL PITEŞTI",13169,1,PART,PRCNCT,PRSD,PRSD_SV,"2025-05-18 22:49:52",1731,1017,865,152,0,1001,16,1900,883,414,587
3,ARGEŞ,"LICEUL TEORETIC ”ION CANTACUZINIO”",33,"MUNICIPIUL PITEŞTI",13169,1,PART,PRCNCT,PRSD,PRSD_SV,"2025-05-18 21:46:38",1844,1162,1071,90,1,1135,27,2000,838,490,645
3,ARGEŞ,"LICEUL TEORETIC ” ION CANTACUZINO”",34,"MUNICIPIUL PITEŞTI",13169,1,PART,PRCNCT,PRSD,PRSD_SV,"2025-05-18 22:29:31",1624,886,810,76,0,862,24,1800,914,418,444
3,ARGEŞ,"LICEUL TEORETIC ”ION CANTACUZINO” (INTRAREA D)",35,"MUNICIPIUL PITEŞTI",13169,2,PART,PRCNCT,PRSD,PRSD_SV,"2025-05-19 01:01:10",1533,1070,841,62,167,1051,19,1700,630,449,602
3,ARGEŞ,"ŞCOALA GIMNAZIALĂ ”MATEI BASARAB” ( FOSTA ŞCOALA NR. 19)",36,"MUNICIPIUL PITEŞTI",13169,1,PART,PRCNCT,PRSD,PRSD_SV,"2025-05-18 22:24:13",1893,1209,1073,134,2,1193,16,2000,791,475,718
3,ARGEŞ,"ŞCOALA GIMNAZIALĂ ”MATEI BASARAB” ( FOSTA ŞCOALA NR. 19)",37,"MUNICIPIUL PITEŞTI",13169,1,PART,PRCNCT,PRSD,PRSD_SV,"2025-05-18 22:38:58",2198,1468,1354,114,0,1442,26,2350,882,506,936
3,ARGEŞ,"ŞCOALA GIMNAZIALĂ „MATEI BASARAB” (FOSTA ŞCOALĂ NR.19)",38,"MUNICIPIUL PITEŞTI",13169,1,PART,PRCNCT,PRSD,PRSD_SV,"2025-05-18 21:44:27",1797,1067,1001,66,0,1053,14,2000,933,419,634
3,ARGEŞ,"UNIVERSITATEA ”CONSTANTIN BRÂNCOVEANU”",39,"MUNICIPIUL PITEŞTI",13169,1,PART,PRCNCT,PRSD,PRSD_SV,"2025-05-18 21:50:41",1427,828,741,86,1,819,9,1600,772,333,486
3,ARGEŞ,"UNIVERSITATEA ”CONSTANTIN BRÂNCOVEANU”",40,"MUNICIPIUL PITEŞTI",13169,1,PART,PRCNCT,PRSD,PRSD_SV,"2025-05-18 22:03:31",1503,910,834,76,0,898,12,1600,690,396,502
3,ARGEŞ,"ŞCOALA GIMNAZIALĂ ”ALEXANDRU DAVILA” (FOSTĂ ŞCOALĂ NR.14)",41,"MUNICIPIUL PITEŞTI",13169,1,PART,PRCNCT,PRSD,PRSD_SV,"2025-05-18 22:17:52",1702,1036,954,82,0,1015,21,1850,814,390,625
3,ARGEŞ,"ŞCOALA GIMNAZIALĂ ”MARIN PREDA” (FOSTA ŞCOALĂ NR.10)",42,"MUNICIPIUL PITEŞTI",13169,1,PART,PRCNCT,PRSD,PRSD_SV,"2025-05-18 22:13:57",1646,1011,886,125,0,989,22,1801,790,400,589
3,ARGEŞ,"ŞCOALA GIMNAZIALĂ ”MARIN PREDA” (FOSTA ŞCOALĂ NR.10)",43,"MUNICIPIUL PITEŞTI",13169,1,PART,PRCNCT,PRSD,PRSD_SV,"2025-05-18 22:04:17",1307,830,744,86,0,812,18,1401,571,269,543
3,ARGEŞ,"ŞCOALA GIMNAZIALĂ ”MARIN PREDA” (FOSTA ŞCOALĂ NR.10)",44,"MUNICIPIUL PITEŞTI",13169,1,PART,PRCNCT,PRSD,PRSD_SV,"2025-05-18 22:13:18",1503,923,819,103,1,909,14,1650,727,294,615
3,ARGEŞ,"COLEGIUL TEHNIC ” ARMAND CĂLINESCU”",45,"MUNICIPIUL PITEŞTI",13169,1,PART,PRCNCT,PRSD,PRSD_SV,"2025-05-18 21:23:51",656,524,380,83,61,517,7,700,176,178,339
3,ARGEŞ,"COLEGIUL TEHNIC ” ARMAND CĂLINESCU”",46,"MUNICIPIUL PITEŞTI",13169,1,PART,PRCNCT,PRSD,PRSD_SV,"2025-05-18 21:41:41",1241,750,682,68,0,737,13,1400,650,246,491
3,ARGEŞ,"ŞCOALA GIMNAZIALĂ ”NICOLAE SIMONIDE” (FOSTĂ ŞCOALĂ NR.1)",47,"MUNICIPIUL PITEŞTI",13169,1,PART,PRCNCT,PRSD,PRSD_SV,"2025-05-18 21:42:41",987,651,560,89,2,645,6,1096,445,206,439
3,ARGEŞ,"ŞCOALA GIMNAZIALĂ ”NICOLAE SIMONIDE” (FOSTĂ ŞCOALĂ NR.1)",48,"MUNICIPIUL PITEŞTI",13169,1,PART,PRCNCT,PRSD,PRSD_SV,"2025-05-18 22:03:21",1442,859,788,71,0,848,11,1600,741,275,573
3,ARGEŞ,"ŞCOALA GIMNAZIALĂ ”NICOLAE SIMONIDE” (FOSTĂ ŞCOALĂ NR.1)",49,"MUNICIPIUL PITEŞTI",13169,1,PART,PRCNCT,PRSD,PRSD_SV,"2025-05-18 21:50:22",837,560,486,72,2,550,10,900,340,191,359
3,ARGEŞ,"DIRECŢIA APELOR ARGEŞ-VEDEA",50,"MUNICIPIUL PITEŞTI",13169,1,PART,PRCNCT,PRSD,PRSD_SV,"2025-05-18 21:48:17",1177,765,677,88,0,758,7,1300,535,358,400
3,ARGEŞ,"ŞCOALA GIMNAZIALĂ „NICOLAE SIMONIDE”, (FOSTA ŞCOALĂ NR.1), (INTRAREA D)",51,"MUNICIPIUL PITEŞTI",13169,1,PART,PRCNCT,PRSD,PRSD_SV,"2025-05-18 21:51:38",1554,852,816,36,0,834,18,1700,848,294,540
3,ARGEŞ,"ŞCOALA GIMNAZIALĂ ”NICOLAE IORGA”(FOSTĂ ŞCOALĂ NR.5)",52,"MUNICIPIUL PITEŞTI",13169,1,PART,PRCNCT,PRSD,PRSD_SV,"2025-05-18 21:53:37",1288,759,709,50,0,747,12,1400,641,243,504
3,ARGEŞ,"ŞCOALA GIMNAZIALĂ ”NICOLAE IORGA”(FOSTĂ ŞCOALĂ NR.5)",53,"MUNICIPIUL PITEŞTI",13169,2,PART,PRCNCT,PRSD,PRSD_SV,"2025-05-18 23:16:26",972,660,543,116,1,650,10,1100,440,210,440
3,ARGEŞ,"ŞCOALA GIMNAZIALĂ ”TUDOR VLADIMIRESCU” ( FOSTĂ ŞCOALĂ NR.20)",54,"MUNICIPIUL PITEŞTI",13169,1,PART,PRCNCT,PRSD,PRSD_SV,"2025-05-18 22:17:33",1604,984,897,86,1,965,19,1800,816,432,533
3,ARGEŞ,"ŞCOALA GIMNAZIALĂ ”TUDOR VLADIMIRESCU” ( FOSTĂ ŞCOALĂ NR.20)",55,"MUNICIPIUL PITEŞTI",13169,1,PART,PRCNCT,PRSD,PRSD_SV,"2025-05-18 21:39:41",1492,906,840,66,0,887,19,1600,694,410,477
3,ARGEŞ,"ŞCOALA GIMNAZIALĂ ” TUDOR VLADIMIRESCU” ( FOSTĂ ŞCOALĂ NR.20)",56,"MUNICIPIUL PITEŞTI",13169,1,PART,PRCNCT,PRSD,PRSD_SV,"2025-05-18 21:44:44",1577,945,877,68,0,929,16,1700,755,344,585
3,ARGEŞ,"ŞCOALA GIMNAZIALĂ ” MIRCEA ELIADE” ( FOSTĂ ŞCOALĂ NR.18)",57,"MUNICIPIUL PITEŞTI",13169,1,PART,PRCNCT,PRSD,PRSD_SV,"2025-05-18 21:53:17",1574,870,813,56,1,854,16,1700,830,332,522
3,ARGEŞ,"ŞCOALA GIMNAZIALĂ ” MIRCEA ELIADE” ( FOSTĂ ŞCOALĂ NR.18)",58,"MUNICIPIUL PITEŞTI",13169,1,PART,PRCNCT,PRSD,PRSD_SV,"2025-05-18 21:54:17",1521,855,789,66,0,842,13,1700,845,384,458
3,ARGEŞ,"ŞCOALA GIMNAZIALĂ ” TUDOR ARGHEZI” ( FOSTĂ ŞCOALĂ NR.7)",59,"MUNICIPIUL PITEŞTI",13169,1,PART,PRCNCT,PRSD,PRSD_SV,"2025-05-18 21:58:08",1600,916,784,132,0,900,16,1800,884,448,452
3,ARGEŞ,"ŞCOALA GIMNAZIALĂ ” TUDOR ARGHEZI” ( FOSTĂ ŞCOALĂ NR.7)",60,"MUNICIPIUL PITEŞTI",13169,1,PART,PRCNCT,PRSD,PRSD_SV,"2025-05-18 21:53:07",1739,1006,911,95,0,992,14,1900,894,378,614
3,ARGEŞ,"ŞCOALA GIMNAZIALĂ ” TUDOR ARGHEZI” ( FOSTĂ ŞCOALĂ NR.7)",61,"MUNICIPIUL PITEŞTI",13169,1,PART,PRCNCT,PRSD,PRSD_SV,"2025-05-18 22:36:23",2099,1274,1216,57,1,1257,17,2307,1033,449,808
3,ARGEŞ,"ŞCOALA GIMNAZIALĂ ” TUDOR ARGHEZI” ( FOSTĂ ŞCOALĂ NR.7)",62,"MUNICIPIUL PITEŞTI",13169,1,PART,PRCNCT,PRSD,PRSD_SV,"2025-05-18 21:59:28",1625,920,826,94,0,906,14,1800,880,395,511
3,ARGEŞ,"COLEGIUL TEHNIC ”COSTIN D. NENIŢESCU”",63,"MUNICIPIUL PITEŞTI",13169,1,PART,PRCNCT,PRSD,PRSD_SV,"2025-05-18 21:55:48",1467,792,632,159,1,778,14,1600,808,439,339
3,ARGEŞ,"COLEGIUL TEHNIC ”COSTIN D. NENIŢESCU”",64,"MUNICIPIUL PITEŞTI",13169,1,PART,PRCNCT,PRSD,PRSD_SV,"2025-05-18 21:42:48",1751,1113,1036,77,0,1098,15,1900,787,524,574
3,ARGEŞ,"COLEGIUL TEHNIC ”COSTIN D. NENIŢESCU”",65,"MUNICIPIUL PITEŞTI",13169,1,PART,PRCNCT,PRSD,PRSD_SV,"2025-05-18 22:12:10",1508,860,796,64,0,849,11,1600,740,374,475
3,ARGEŞ,"ŞCOALA NR.2 - STRUCTURĂ A ŞCOLII GIMNAZIALE „TUDOR VLADIMIRESCU” (FOSTA ȘCOALĂ NR.8)",66,"MUNICIPIUL PITEŞTI",13169,1,PART,PRCNCT,PRSD,PRSD_SV,"2025-05-18 22:39:56",1587,1164,951,213,0,1150,14,1700,536,464,686
3,ARGEŞ,"DIRECȚIA DE ASISTENȚĂ SOCIALĂ A MUNICIPIULUI PITEȘTI",67,"MUNICIPIUL PITEŞTI",13169,1,PART,PRCNCT,PRSD,PRSD_SV,"2025-05-18 22:40:04",1924,1109,1027,80,2,1084,25,2100,991,374,710
3,ARGEŞ,"ŞCOALA GIMNAZIALĂ ”MIHAI EMINESCU” (FOSTA ŞCOALA NR.11)",68,"MUNICIPIUL PITEŞTI",13169,1,PART,PRCNCT,PRSD,PRSD_SV,"2025-05-18 22:16:15",1429,955,801,154,0,933,22,1600,645,354,579
3,ARGEŞ,"ŞCOALA GIMNAZIALĂ ”MIHAI EMINESCU” (FOSTA ŞCOALA NR.11)",69,"MUNICIPIUL PITEŞTI",13169,1,PART,PRCNCT,PRSD,PRSD_SV,"2025-05-18 22:27:33",1312,903,704,199,0,890,13,1400,497,381,509
3,ARGEŞ,"GRĂDINIŢA CU PROGRAM PRELUNGIT ” FLOARE DE COLŢ” ( FOSTA GRĂDINIŢĂ NR.5)",70,"MUNICIPIUL PITEŞTI",13169,1,PART,PRCNCT,PRSD,PRSD_SV,"2025-05-18 22:07:54",1152,766,687,78,1,754,12,1300,534,267,487
3,ARGEŞ,"UNIVERSITATEA PITEŞTI",71,"MUNICIPIUL PITEŞTI",13169,1,PART,PRCNCT,PRSD,PRSD_SV,"2025-05-18 22:49:34",1597,1029,868,160,1,1014,15,1800,771,357,657
3,ARGEŞ,"COLEGIUL NAŢIONAL ”ALEXANDRU ODOBESCU”",72,"MUNICIPIUL PITEŞTI",13169,1,PART,PRCNCT,PRSD,PRSD_SV,"2025-05-18 22:00:39",2209,1362,1273,89,0,1340,22,2400,1038,526,814
3,ARGEŞ,"COLEGIUL NAŢIONAL ”ALEXANDRU ODOBESCU”",73,"MUNICIPIUL PITEŞTI",13169,1,PART,PRCNCT,PRSD,PRSD_SV,"2025-05-18 22:27:33",1514,832,745,87,0,824,8,1700,868,435,389
3,ARGEŞ,"GRĂDINIŢA CU PROGRAM PRELUNGIT ” ARMONIA” ( FOSTA GRĂDINIŢĂ NR.8)",74,"MUNICIPIUL PITEŞTI",13169,1,PART,PRCNCT,PRSD,PRSD_SV,"2025-05-18 21:34:16",1673,939,829,110,0,931,8,1800,861,538,393
3,ARGEŞ,"ŞCOALA GIMNAZIALĂ ”ION MINULESCU” (FOSTA ŞCOALĂ NR.2)",75,"MUNICIPIUL PITEŞTI",13169,1,PART,PRCNCT,PRSD,PRSD_SV,"2025-05-18 21:56:24",1280,835,650,184,1,819,16,1400,565,388,431
3,ARGEŞ,"ŞCOALA GIMNAZIALĂ ”ION MINULESCU” (FOSTA ŞCOALĂ NR.2)",76,"MUNICIPIUL PITEŞTI",13169,1,PART,PRCNCT,PRSD,PRSD_SV,"2025-05-18 21:42:21",1518,985,852,133,0,973,12,1700,715,393,580
3,ARGEŞ,"COLEGIUL TEHNIC ”DIMITRIE DIMA”",77,"MUNICIPIUL PITEŞTI",13169,1,PART,PRCNCT,PRSD,PRSD_SV,"2025-05-18 22:11:30",1434,854,747,106,1,839,15,1600,746,431,408
3,ARGEŞ,"COLEGIUL TEHNIC ”DIMITRIE DIMA”",78,"MUNICIPIUL PITEŞTI",13169,1,PART,PRCNCT,PRSD,PRSD_SV,"2025-05-18 22:02:27",1896,1029,956,73,0,1011,18,2100,1071,680,331
3,ARGEŞ,"ŞCOALA GIMNAZIALĂ ” TUDOR MUŞATESCU” (FOSTA ŞCOALA NR. 17) (INTRAREA A)",79,"MUNICIPIUL PITEŞTI",13169,1,PART,PRCNCT,PRSD,PRSD_SV,"2025-05-18 22:11:49",1203,652,583,69,0,635,17,1300,648,289,346
3,ARGEŞ,"ŞCOALA GIMNAZIALĂ „TUDOR MUŞATESCU” (FOSTĂ ŞCOALĂ NR.17) (INTRAREA B)",80,"MUNICIPIUL PITEŞTI",13169,1,PART,PRCNCT,PRSD,PRSD_SV,"2025-05-18 21:50:53",1200,634,570,64,0,623,11,1300,666,350,273
3,ARGEŞ,"LICEUL TEHNOLOGIC ” CONSTANTIN BRÂNCUŞI” ( FOST LICEU TEHNOLOGIC DE INDUSTRIALIZAREA LEMNULUI)",81,"MUNICIPIUL PITEŞTI",13169,1,PART,PRCNCT,PRSD,PRSD_SV,"2025-05-18 21:34:24",1509,895,855,39,1,889,6,1700,805,267,622
3,ARGEŞ,"LICEUL TEHNOLOGIC ” CONSTANTIN BRÂNCUŞI” ( FOST LICEU TEHNOLOGIC DE INDUSTRIALIZAREA LEMNULUI)",82,"MUNICIPIUL PITEŞTI",13169,1,PART,PRCNCT,PRSD,PRSD_SV,"2025-05-18 22:06:49",1522,958,866,91,1,933,25,1700,742,298,635
3,ARGEŞ,"GRĂDINIŢA CU PROGRAM NORMAL ”ISTEŢEL” ( FOSTA GRĂDINIŢĂ NR.4)",83,"MUNICIPIUL PITEŞTI",13169,1,PART,PRCNCT,PRSD,PRSD_SV,"2025-05-18 22:29:18",1724,1052,939,112,1,1033,19,1900,848,442,591
3,ARGEŞ,"GRĂDINIŢA CU PROGRAM PRELUNGIT ” ARIPI DESCHISE” ( FOSTA GRĂDINIŢĂ NR.14)",84,"MUNICIPIUL PITEŞTI",13169,1,PART,PRCNCT,PRSD,PRSD_SV,"2025-05-18 22:16:47",1616,950,893,56,1,932,18,1802,852,348,584
3,ARGEŞ,"ŞCOALA GIMNAZIALĂ ”I. L. CARAGIALE” (FOSTĂ ŞCOALĂ NR.16)",85,"MUNICIPIUL PITEŞTI",13169,1,PART,PRCNCT,PRSD,PRSD_SV,"2025-05-18 21:53:54",1440,850,743,107,0,835,15,1600,750,371,464
3,ARGEŞ,"ŞCOALA GIMNAZIALĂ ”I. L. CARAGIALE” (FOSTĂ ŞCOALĂ NR.16)",86,"MUNICIPIUL PITEŞTI",13169,1,PART,PRCNCT,PRSD,PRSD_SV,"2025-05-18 21:57:11",1620,865,804,60,1,857,8,1800,935,359,498
3,ARGEŞ,"ŞCOALA GIMNAZIALĂ ”I. L. CARAGIALE” (FOSTĂ ŞCOALĂ NR.16)",87,"MUNICIPIUL PITEŞTI",13169,1,PART,PRCNCT,PRSD,PRSD_SV,"2025-05-18 22:26:51",1490,873,831,41,1,861,12,1600,727,293,568
3,ARGEŞ,"ŞCOALA GIMNAZIALĂ ” TRAIAN” ( FOSTĂ ŞCOALĂ NR.4)",88,"MUNICIPIUL PITEŞTI",13169,1,PART,PRCNCT,PRSD,PRSD_SV,"2025-05-18 21:48:59",1279,805,747,58,0,791,14,1400,595,288,503
3,ARGEŞ,"ŞCOALA GIMNAZIALĂ ” TRAIAN” ( FOSTĂ ŞCOALĂ NR.4)",89,"MUNICIPIUL PITEŞTI",13169,1,PART,PRCNCT,PRSD,PRSD_SV,"2025-05-18 23:07:29",1581,1012,893,119,0,998,14,1700,688,399,599
3,ARGEŞ,"ŞCOALA GIMNAZIALĂ ”OPREA IORGULESCU” - I",90,"MUNICIPIUL CÂMPULUNG",13490,1,PART,PRCNCT,PRSD,PRSD_SV,"2025-05-18 21:55:07",694,496,359,136,1,486,10,750,254,177,309
3,ARGEŞ,"ŞCOALA GIMNAZIALĂ ”OPREA IORGULESCU” - II",91,"MUNICIPIUL CÂMPULUNG",13490,1,PART,PRCNCT,PRSD,PRSD_SV,"2025-05-18 22:03:04",756,452,386,66,0,439,13,850,398,147,292
3,ARGEŞ,"ŞCOALA GIMNAZIALĂ NANU MUSCEL",92,"MUNICIPIUL CÂMPULUNG",13490,1,PART,PRCNCT,PRSD,PRSD_SV,"2025-05-18 22:14:41",1084,741,588,130,23,728,13,1200,459,265,463
3,ARGEŞ,"GRĂDINIȚA CU PROGRAM NORMAL NR. 9",93,"MUNICIPIUL CÂMPULUNG",13490,1,PART,PRCNCT,PRSD,PRSD_SV,"2025-05-18 22:03:05",1560,813,781,31,1,795,18,1700,887,367,428
3,ARGEŞ,"GRĂDINIȚA CU PROGRAM NORMAL NR. 9 - II",94,"MUNICIPIUL CÂMPULUNG",13490,1,PART,PRCNCT,PRSD,PRSD_SV,"2025-05-18 21:36:15",1461,755,693,62,0,744,11,1600,845,305,439
3,ARGEŞ,"GRĂDINIȚA CU PROGRAM NORMAL NR. 9 - III",95,"MUNICIPIUL CÂMPULUNG",13490,1,PART,PRCNCT,PRSD,PRSD_SV,"2025-05-18 21:48:15",1327,688,650,38,0,672,16,1400,712,312,360
3,ARGEŞ,"BIBLIOTECA MUNICIPALA ION BARBU - FILIALA GRUI",96,"MUNICIPIUL CÂMPULUNG",13490,1,PART,PRCNCT,PRSD,PRSD_SV,"2025-05-18 21:41:25",1383,809,716,93,0,796,13,1500,691,332,464
3,ARGEŞ,"ŞCOALA GENERALĂ NR. 5",97,"MUNICIPIUL CÂMPULUNG",13490,1,PART,PRCNCT,PRSD,PRSD_SV,"2025-05-18 21:51:37",1096,629,557,72,0,618,11,1200,571,257,361
3,ARGEŞ,"S.C. HIDROELECTRICA S.A.",98,"MUNICIPIUL CÂMPULUNG",13490,1,PART,PRCNCT,PRSD,PRSD_SV,"2025-05-18 21:36:53",946,591,550,39,2,585,6,1000,409,250,335
3,ARGEŞ,"ŞCOALA GIMNAZIALĂ ”THEODOR AMAN” - I",99,"MUNICIPIUL CÂMPULUNG",13490,1,PART,PRCNCT,PRSD,PRSD_SV,"2025-05-18 21:46:03",1304,713,660,53,0,698,15,1400,687,298,400
3,ARGEŞ,"ŞCOALA GIMNAZIALĂ ”THEODOR AMAN” - II",100,"MUNICIPIUL CÂMPULUNG",13490,1,PART,PRCNCT,PRSD,PRSD_SV,"2025-05-18 21:38:20",1022,487,437,49,1,482,5,1100,613,237,245
3,ARGEŞ,"ŞCOALA GIMNAZIALĂ ”THEODOR AMAN” - III",101,"MUNICIPIUL CÂMPULUNG",13490,1,PART,PRCNCT,PRSD,PRSD_SV,"2025-05-18 21:42:21",1226,540,513,27,0,530,10,1400,860,277,253
3,ARGEŞ,"GRĂDINIŢA CU PROGRAM PRELUNGIT ”SFÂNTA MARINA” - I",102,"MUNICIPIUL CÂMPULUNG",13490,1,PART,PRCNCT,PRSD,PRSD_SV,"2025-05-18 21:49:34",1251,612,573,39,0,603,9,1400,788,258,345
3,ARGEŞ,"GRĂDINIŢA CU PROGRAM PRELUNGIT ”SFÂNTA MARINA” - II",103,"MUNICIPIUL CÂMPULUNG",13490,1,PART,PRCNCT,PRSD,PRSD_SV,"2025-05-18 21:33:54",1191,516,495,21,0,508,8,1300,784,263,245
3,ARGEŞ,"GRĂDINIŢA CU PROGRAM PRELUNGIT ”SFÂNTA MARINA” - III",104,"MUNICIPIUL CÂMPULUNG",13490,1,PART,PRCNCT,PRSD,PRSD_SV,"2025-05-18 21:51:04",1468,611,583,27,1,602,9,1600,989,360,242
3,ARGEŞ,"LICEUL TEORETIC DAN BARBILIAN I",105,"MUNICIPIUL CÂMPULUNG",13490,1,PART,PRCNCT,PRSD,PRSD_SV,"2025-05-18 21:50:34",957,542,497,45,0,537,5,1050,508,228,309
3,ARGEŞ,"LICEUL TEORETIC DAN BARBILIAN II",106,"MUNICIPIUL CÂMPULUNG",13490,1,PART,PRCNCT,PRSD,PRSD_SV,"2025-05-18 21:38:32",1436,590,546,44,0,582,8,1600,1010,292,290
3,ARGEŞ,"LICEUL TEORETIC DAN BARBILIAN III",107,"MUNICIPIUL CÂMPULUNG",13490,1,PART,PRCNCT,PRSD,PRSD_SV,"2025-05-18 21:58:35",1360,638,597,41,0,630,8,1500,862,243,387
3,ARGEŞ,"GRĂDINIŢA VALEA ROMÂNEŞTILOR",108,"MUNICIPIUL CÂMPULUNG",13490,1,PART,PRCNCT,PRSD,PRSD_SV,"2025-05-18 21:38:05",392,213,189,24,0,213,0,450,237,131,82
3,ARGEŞ,"COLEGIUL NAŢIONAL PEDAGOGIC ”CAROL I”",109,"MUNICIPIUL CÂMPULUNG",13490,1,PART,PRCNCT,PRSD,PRSD_SV,"2025-05-18 21:51:33",746,438,377,60,1,432,6,800,362,169,263
3,ARGEŞ,"GRĂDINIȚA NR. 6",110,"MUNICIPIUL CÂMPULUNG",13490,1,PART,PRCNCT,PRSD,PRSD_SV,"2025-05-18 21:58:44",909,487,429,58,0,482,5,1000,513,223,259
3,ARGEŞ,"LICEUL TEHNOLOGIC AUTO",111,"MUNICIPIUL CÂMPULUNG",13490,1,PART,PRCNCT,PRSD,PRSD_SV,"2025-05-18 22:06:36",1091,514,472,41,1,501,13,1200,686,255,246
3,ARGEŞ,"ŞCOALA GENERALĂ NR.4 ”APA SĂRATĂ”",112,"MUNICIPIUL CÂMPULUNG",13490,1,PART,PRCNCT,PRSD,PRSD_SV,"2025-05-18 21:52:56",710,361,311,50,0,353,8,800,439,149,204
3,ARGEŞ,"AȘEZĂMÂNTUL SOCIAL DE LA PAROHIA MĂRCUȘ",113,"MUNICIPIUL CÂMPULUNG",13490,1,PART,PRCNCT,PRSD,PRSD_SV,"2025-05-18 21:46:53",475,295,262,33,0,291,4,550,255,93,198
3,ARGEŞ,"COLEGIUL NAŢIONAL ”DINICU GOLESCU”",114,"MUNICIPIUL CÂMPULUNG",13490,1,PART,PRCNCT,PRSD,PRSD_SV,"2025-05-18 22:06:49",1166,743,596,145,2,735,8,1300,557,257,478
3,ARGEŞ,"ŞCOALA GIMNAZIALĂ ”C.D. ARICESCU”",115,"MUNICIPIUL CÂMPULUNG",13490,1,PART,PRCNCT,PRSD,PRSD_SV,"2025-05-18 22:04:08",804,597,448,96,53,581,14,900,303,226,355
3,ARGEŞ,"ȘCOALA GIMNAZIALĂ NR.2 ”REGINA MARIA” ( I )",116,"MUNICIPIUL CURTEA DE ARGEŞ",13622,1,PART,PRCNCT,PRSD,PRSD_SV,"2025-05-18 21:39:52",1429,799,722,76,1,792,7,1550,751,378,414
3,ARGEŞ,"ȘCOALA GIMNAZIALĂ NR.2 ”REGINA MARIA” ( II )",117,"MUNICIPIUL CURTEA DE ARGEŞ",13622,1,PART,PRCNCT,PRSD,PRSD_SV,"2025-05-18 21:55:44",1144,650,546,104,0,639,11,1250,600,306,333
3,ARGEŞ,"ȘCOALA GIMNAZIALĂ NR.2 ”REGINA MARIA” ( III )",118,"MUNICIPIUL CURTEA DE ARGEŞ",13622,1,PART,PRCNCT,PRSD,PRSD_SV,"2025-05-18 22:47:38",1581,1065,870,155,40,1050,15,1700,635,473,577
3,ARGEŞ,"GRUP ȘCOLAR ”FERDINAND I”",119,"MUNICIPIUL CURTEA DE ARGEŞ",13622,1,PART,PRCNCT,PRSD,PRSD_SV,"2025-05-18 22:27:40",1573,901,790,109,2,885,16,1700,799,429,456
3,ARGEŞ,"GRUP ȘCOLAR AGRICOL ”CONSTANTIN DOBRESCU ARGEȘ” ( I )",120,"MUNICIPIUL CURTEA DE ARGEŞ",13622,1,PART,PRCNCT,PRSD,PRSD_SV,"2025-05-18 21:46:12",1276,716,581,134,1,703,13,1400,684,361,342
3,ARGEŞ,"GRUP ȘCOLAR AGRICOL ”CONSTANTIN DOBRESCU ARGEȘ” ( II )",121,"MUNICIPIUL CURTEA DE ARGEŞ",13622,1,PART,PRCNCT,PRSD,PRSD_SV,"2025-05-18 21:41:26",1557,750,663,87,0,743,7,1700,950,382,361
3,ARGEŞ,"ȘCOALA GIMNAZIALĂ NR.6 ”BASARAB I”",122,"MUNICIPIUL CURTEA DE ARGEŞ",13622,1,PART,PRCNCT,PRSD,PRSD_SV,"2025-05-18 21:28:56",1304,735,630,105,0,726,9,1400,665,355,371
3,ARGEŞ,"GRUP ȘCOLAR FORESTIER CURTEA DE ARGEȘ ( I )",123,"MUNICIPIUL CURTEA DE ARGEŞ",13622,1,PART,PRCNCT,PRSD,PRSD_SV,"2025-05-18 21:47:44",1265,648,607,40,1,636,12,1400,752,258,378
3,ARGEŞ,"GRUP ȘCOLAR FORESTIER CURTEA DE ARGEȘ ( II )",124,"MUNICIPIUL CURTEA DE ARGEŞ",13622,1,PART,PRCNCT,PRSD,PRSD_SV,"2025-05-18 23:05:55",1390,654,611,43,0,644,10,1500,846,318,326
3,ARGEŞ,"CENTRUL DE CULTURĂ ȘI ARTE ” GEORGE TOPÎRCEANU” ( I )",125,"MUNICIPIUL CURTEA DE ARGEŞ",13622,1,PART,PRCNCT,PRSD,PRSD_SV,"2025-05-18 22:33:22",1355,794,693,99,2,774,20,1500,706,320,454
3,ARGEŞ,"ȘCOALA GIMNAZIALĂ NR.4 ” MIRCEA CEL BATRÂN”",126,"MUNICIPIUL CURTEA DE ARGEŞ",13622,1,PART,PRCNCT,PRSD,PRSD_SV,"2025-05-18 21:53:55",1212,752,617,135,0,742,10,1300,548,294,448
3,ARGEŞ,"ȘCOALA GIMNAZIALĂ NR.1 ”CAROL I”",127,"MUNICIPIUL CURTEA DE ARGEŞ",13622,1,PART,PRCNCT,PRSD,PRSD_SV,"2025-05-18 21:31:51",1197,730,657,72,1,712,18,1300,570,365,347
3,ARGEŞ,"ȘCOALA GIMNAZIALĂ NR.1 ”CAROL I”",128,"MUNICIPIUL CURTEA DE ARGEŞ",13622,1,PART,PRCNCT,PRSD,PRSD_SV,"2025-05-18 21:36:27",1456,830,736,93,1,815,15,1600,770,377,438
3,ARGEŞ,"ȘCOALA GENERALĂ NR.5 ”ARMAND CĂLINESCU” (I)",129,"MUNICIPIUL CURTEA DE ARGEŞ",13622,1,PART,PRCNCT,PRSD,PRSD_SV,"2025-05-18 21:56:30",1266,666,602,64,0,651,15,1400,734,347,304
3,ARGEŞ,"ȘCOALA GENERALĂ NR 5 ”ARMAND CĂLINESCU” (II)",130,"MUNICIPIUL CURTEA DE ARGEŞ",13622,1,PART,PRCNCT,PRSD,PRSD_SV,"2025-05-18 22:33:22",980,474,420,52,2,469,5,1100,626,228,241
3,ARGEŞ,"ȘCOALA GENERALĂ VALEA SASULUI",131,"MUNICIPIUL CURTEA DE ARGEŞ",13622,1,PART,PRCNCT,PRSD,PRSD_SV,"2025-05-18 21:56:29",862,545,490,52,3,539,6,950,405,254,285
3,ARGEŞ,"GRUP ȘCOLAR AUTO CURTEA DE ARGEȘ",132,"MUNICIPIUL CURTEA DE ARGEŞ",13622,1,PART,PRCNCT,PRSD,PRSD_SV,"2025-05-18 22:22:31",1912,1045,973,72,0,1034,11,2050,1005,527,507
3,ARGEŞ,"CENTRUL DE CULTURĂ ȘI ARTE ”GEORGE TOPÎRCEANU” (II)",133,"MUNICIPIUL CURTEA DE ARGEŞ",13622,1,PART,PRCNCT,PRSD,PRSD_SV,"2025-05-18 22:14:29",1352,752,668,84,0,732,20,1450,698,302,430
3,ARGEŞ,"ȘCOALA GENERALĂ NR.3 ”SFÂNTUL APOSTOL ANDREI”",134,"MUNICIPIUL CURTEA DE ARGEŞ",13622,1,PART,PRCNCT,PRSD,PRSD_SV,"2025-05-18 21:59:00",1354,739,670,69,0,729,10,1450,711,422,307
3,ARGEŞ,"ȘCOALA GENERALĂ NOAPTEȘ",135,"MUNICIPIUL CURTEA DE ARGEŞ",13622,1,PART,PRCNCT,PRSD,PRSD_SV,"2025-05-18 21:34:58",771,452,413,39,0,446,6,850,398,283,163
3,ARGEŞ,"PRIMĂRIA ORAŞULUI COSTEŞTI",136,"ORAŞ COSTEŞTI",13668,1,PART,PRCNCT,PRSD,PRSD_SV,"2025-05-18 21:51:55",1671,962,864,98,0,953,9,1800,838,606,347
3,ARGEŞ,"CASA DE CULTURĂ COSTEŞTI",137,"ORAŞ COSTEŞTI",13668,1,PART,PRCNCT,PRSD,PRSD_SV,"2025-05-18 22:04:09",1535,891,769,122,0,876,15,1650,759,420,456
3,ARGEŞ,"LICEUL TEORETIC COSTEŞTI",138,"ORAŞ COSTEŞTI",13668,1,PART,PRCNCT,PRSD,PRSD_SV,"2025-05-18 22:04:41",1554,928,808,90,30,913,15,1650,722,551,362
3,ARGEŞ,"ŞCOALA TELEŞTI",139,"ORAŞ COSTEŞTI",13668,1,PART,PRCNCT,PRSD,PRSD_SV,"2025-05-18 21:35:22",741,435,394,41,0,431,4,800,365,252,179
3,ARGEŞ,"ŞCOALA GENERALĂ ZORILE",140,"ORAŞ COSTEŞTI",13668,2,PART,PRCNCT,PRSD,PRSD_SV,"2025-05-19 00:19:50",806,481,431,50,0,473,8,900,419,298,175
3,ARGEŞ,"ŞCOALA GENERALĂ BROŞTENI",141,"ORAŞ COSTEŞTI",13668,1,PART,PRCNCT,PRSD,PRSD_SV,"2025-05-18 21:48:14",659,376,322,54,0,372,4,750,374,227,145
3,ARGEŞ,"ŞCOALA GENERALĂ PÎRVU ROŞU",142,"ORAŞ COSTEŞTI",13668,1,PART,PRCNCT,PRSD,PRSD_SV,"2025-05-18 21:50:26",470,323,235,88,0,321,2,550,227,201,120
3,ARGEŞ,"ŞCOALA GENERALĂ PODU BROŞTENI",143,"ORAŞ COSTEŞTI",13668,1,PART,PRCNCT,PRSD,PRSD_SV,"2025-05-18 21:36:25",516,335,254,81,0,331,4,550,215,176,155
3,ARGEŞ,"ŞCOALA GENERALĂ STÎRCI",144,"ORAŞ COSTEŞTI",13668,1,PART,PRCNCT,PRSD,PRSD_SV,"2025-05-18 21:29:53",176,102,83,19,0,102,0,199,97,79,23
3,ARGEŞ,"GRĂDINIŢA ”FLORILE SOARELUI”-INTRARE 1",145,"ORAŞ MIOVENI",13301,1,PART,PRCNCT,PRSD,PRSD_SV,"2025-05-18 22:10:43",1437,903,841,62,0,888,15,1399,496,521,367
3,ARGEŞ,"LICEUL TEORETIC ”IULIA ZAMFIRESCU” - INTRARE C",146,"ORAŞ MIOVENI",13301,1,PART,PRCNCT,PRSD,PRSD_SV,"2025-05-18 22:11:11",1277,793,732,61,0,774,19,1400,607,424,350
3,ARGEŞ,"FOSTUL SEDIU AL GRĂDINIȚEI DIN BLOCUL M6",147,"ORAŞ MIOVENI",13301,1,PART,PRCNCT,PRSD,PRSD_SV,"2025-05-18 21:30:46",1577,915,853,62,0,897,18,1600,685,506,391
3,ARGEŞ,"GRĂDINIŢA ”FLORILE SOARELUI” - INTRARE 2",148,"ORAŞ MIOVENI",13301,1,PART,PRCNCT,PRSD,PRSD_SV,"2025-05-18 21:43:42",1314,815,788,27,0,811,4,1400,585,423,388
3,ARGEŞ,"DISPENSAR UMAN",149,"ORAŞ MIOVENI",13301,1,PART,PRCNCT,PRSD,PRSD_SV,"2025-05-18 22:11:19",1375,827,754,73,0,811,16,1500,673,426,385
3,ARGEŞ,"SALA DE SPORT - ŞCOALA GIMNAZIALĂ ”LIVIU REBREANU”",150,"ORAŞ MIOVENI",13301,1,PART,PRCNCT,PRSD,PRSD_SV,"2025-05-18 21:32:00",1781,987,945,42,0,973,14,1900,913,578,395
3,ARGEŞ,"LICEUL TEORETIC ”IULIA ZAMFIRESCU” - INTRARE B",151,"ORAŞ MIOVENI",13301,1,PART,PRCNCT,PRSD,PRSD_SV,"2025-05-18 22:22:18",1302,831,738,93,0,819,12,1397,566,454,365
3,ARGEŞ,"ȘCOALA GIMNAZIALĂ LIVIU REBREANU” - INTRARE ELEVI",152,"ORAŞ MIOVENI",13301,1,PART,PRCNCT,PRSD,PRSD_SV,"2025-05-18 21:28:47",902,577,516,61,0,566,11,1003,426,328,238
3,ARGEŞ,"ȘCOALA GIMNAZIALĂ ”LIVIU REBREANU” - INTRARE PROFESORI",153,"ORAŞ MIOVENI",13301,1,PART,PRCNCT,PRSD,PRSD_SV,"2025-05-18 21:30:36",1051,648,592,56,0,636,12,1150,502,352,284
3,ARGEŞ,"GRĂDINIŢA CU PROGRAM PRELUNGIT ”TIC-PITIC”",154,"ORAŞ MIOVENI",13301,1,PART,PRCNCT,PRSD,PRSD_SV,"2025-05-18 21:27:48",1027,630,573,57,0,619,11,1100,470,319,300
3,ARGEŞ,"GRĂDINIŢA CU PROGRAM PRELUNGIT ”TIC-PITIC”,",155,"ORAŞ MIOVENI",13301,1,PART,PRCNCT,PRSD,PRSD_SV,"2025-05-18 21:50:53",1077,614,566,48,0,611,3,1200,586,288,323
3,ARGEŞ,"SC SERVICII GENERALE MIOVENI S.R.L",156,"ORAŞ MIOVENI",13301,1,PART,PRCNCT,PRSD,PRSD_SV,"2025-05-18 21:58:13",1224,747,669,78,0,737,10,1200,453,414,323
3,ARGEŞ,"CASA DE CULTURĂ A SINDICATELOR DACIA",157,"ORAŞ MIOVENI",13301,1,PART,PRCNCT,PRSD,PRSD_SV,"2025-05-18 21:51:58",1205,777,685,92,0,755,22,1300,523,368,387
3,ARGEŞ,"FOSTUL SEDIU AL GRĂDINIȚEI DIN BLOCUL T6",158,"ORAŞ MIOVENI",13301,1,PART,PRCNCT,PRSD,PRSD_SV,"2025-05-18 21:35:51",1434,851,807,44,0,838,13,1600,749,428,410
3,ARGEŞ,"FOSTUL SEDIU AL GRĂDINIȚEI ”CAMPIONII” DIN BLOCUL T2A",159,"ORAŞ MIOVENI",13301,1,PART,PRCNCT,PRSD,PRSD_SV,"2025-05-18 22:05:28",1210,696,660,36,0,683,13,1300,604,333,350
3,ARGEŞ,"GRĂDINIȚA ”CAMPIONII”",160,"ORAŞ MIOVENI",13301,1,PART,PRCNCT,PRSD,PRSD_SV,"2025-05-18 22:16:24",1541,904,828,76,0,886,18,1500,596,421,465
3,ARGEŞ,"ȘCOALA GIMNAZIALĂ ”GEORGE TOPÂRCEANU”",161,"ORAŞ MIOVENI",13301,1,PART,PRCNCT,PRSD,PRSD_SV,"2025-05-18 21:46:34",1142,798,671,125,2,787,11,1250,452,386,401
3,ARGEŞ,"FOSTUL SEDIU AL ȘCOLII CLUCEREASA",162,"ORAŞ MIOVENI",13301,1,PART,PRCNCT,PRSD,PRSD_SV,"2025-05-18 21:36:08",335,529,199,25,305,518,11,658,129,393,125
3,ARGEŞ,"ȘCOALA GIMNAZIALĂ NR.1 MIOVENI (COLIBAȘI)",163,"ORAŞ MIOVENI",13301,1,PART,PRCNCT,PRSD,PRSD_SV,"2025-05-18 21:50:43",1336,964,876,87,1,950,14,1490,526,483,467
3,ARGEŞ,"CLĂDIREA MULTIFUNCȚIONALĂ COLIBAȘI",164,"ORAŞ MIOVENI",13301,1,PART,PRCNCT,PRSD,PRSD_SV,"2025-05-18 21:54:31",658,532,423,36,73,525,7,850,318,301,224
3,ARGEŞ,"CLĂDIREA MULTIFUNCȚIONALĂ FĂGETU",165,"ORAŞ MIOVENI",13301,1,PART,PRCNCT,PRSD,PRSD_SV,"2025-05-18 21:55:00",736,475,438,37,0,466,9,800,325,379,87
3,ARGEŞ,"CĂMINUL CULTURAL FĂGETU",166,"ORAŞ MIOVENI",13301,1,PART,PRCNCT,PRSD,PRSD_SV,"2025-05-18 22:02:28",219,494,141,25,328,487,7,550,56,415,72
3,ARGEŞ,"ȘCOALA GIMNAZIALĂ ”MARIN SORESCU” RACOVIȚA",167,"ORAŞ MIOVENI",13301,1,PART,PRCNCT,PRSD,PRSD_SV,"2025-05-18 21:34:45",1231,922,782,79,61,902,20,1300,378,461,441
3,ARGEŞ,"FOSTUL SEDIU AL ȘCOLII RACOVIȚA DE SUS",168,"ORAŞ MIOVENI",13301,1,PART,PRCNCT,PRSD,PRSD_SV,"2025-05-18 21:48:32",675,440,407,33,0,437,3,750,310,253,184
3,ARGEŞ,"CASA DE CULTURĂ ŞTEFĂNEŞTI",169,"ORAŞ ŞTEFĂNEŞTI",13392,1,PART,PRCNCT,PRSD,PRSD_SV,"2025-05-18 22:11:11",1091,734,605,128,1,729,5,1200,466,352,377
3,ARGEŞ,"ŞCOALA PRIMARĂ ŞTEFĂNEŞTI",170,"ORAŞ ŞTEFĂNEŞTI",13392,1,PART,PRCNCT,PRSD,PRSD_SV,"2025-05-18 22:37:49",1416,933,842,91,0,921,12,1500,567,585,336
3,ARGEŞ,"ŞCOALA PRIMARĂ ENCULEŞTI",171,"ORAŞ ŞTEFĂNEŞTI",13392,1,PART,PRCNCT,PRSD,PRSD_SV,"2025-05-18 21:47:18",461,264,233,31,0,260,4,500,236,197,63
3,ARGEŞ,"ŞCOALA ”RADU GOLESCU” GOLEȘTI",172,"ORAŞ ŞTEFĂNEŞTI",13392,1,PART,PRCNCT,PRSD,PRSD_SV,"2025-05-18 21:57:30",1017,585,521,64,0,576,9,1100,515,399,177
3,ARGEŞ,"ŞCOALA GENERALĂ NR.1 ŞTEFĂNEŞTI, CORP C (GRĂDINIŢĂ)",173,"ORAŞ ŞTEFĂNEŞTI",13392,1,PART,PRCNCT,PRSD,PRSD_SV,"2025-05-18 23:56:45",973,693,606,87,0,683,10,1000,307,338,345
3,ARGEŞ,"LICEUL TEHNOLOGIC ”DINU BRĂTIANU”",174,"ORAŞ ŞTEFĂNEŞTI",13392,1,PART,PRCNCT,PRSD,PRSD_SV,"2025-05-18 22:36:19",1970,1424,1153,244,27,1405,19,2100,676,616,789
3,ARGEŞ,"LICEUL TEHNOLOGIC ”DINU BRĂTIANU”",175,"ORAŞ ŞTEFĂNEŞTI",13392,1,PART,PRCNCT,PRSD,PRSD_SV,"2025-05-18 22:03:18",1253,649,579,70,0,641,8,1350,701,365,276
3,ARGEŞ,"ȘCOALA GENERALĂ ”CONSTANTIN BRÂNCOVEANU”",176,"ORAŞ ŞTEFĂNEŞTI",13392,1,PART,PRCNCT,PRSD,PRSD_SV,"2025-05-18 21:42:13",1376,944,767,177,0,938,6,1500,556,517,421
3,ARGEŞ,"ŞCOALA GENERALĂ ”CONSTANTIN BRÂNCOVEANU” VALEA MARE",177,"ORAŞ ŞTEFĂNEŞTI",13392,1,PART,PRCNCT,PRSD,PRSD_SV,"2025-05-18 22:13:42",1856,1268,1159,106,3,1258,10,1900,632,527,731
3,ARGEŞ,"NIDEC MOTOR CORPORATION ROMANIA S.A.",178,"ORAŞ ŞTEFĂNEŞTI",13392,1,PART,PRCNCT,PRSD,PRSD_SV,"2025-05-18 23:31:19",2178,1569,1347,222,0,1537,32,2350,781,612,925
3,ARGEŞ,"ŞCOALA PRIMARĂ GOLEŞTII-BADII",179,"ORAŞ TOPOLOVENI",13757,1,PART,PRCNCT,PRSD,PRSD_SV,"2025-05-18 21:38:37",824,517,467,50,0,512,5,900,383,288,224
3,ARGEŞ,"LICEUL TEORETIC ”ION MIHALACHE’’ TOPOLOVENI",180,"ORAŞ TOPOLOVENI",13757,1,PART,PRCNCT,PRSD,PRSD_SV,"2025-05-18 21:51:51",880,578,482,96,0,568,10,999,421,272,296
3,ARGEŞ,"LICEUL TEORETIC ”ION MIHALACHE’’ TOPOLOVENI",181,"ORAŞ TOPOLOVENI",13757,2,PART,PRCNCT,PRSD,PRSD_SV,"2025-05-18 23:05:48",864,550,500,50,0,543,7,950,400,277,266
3,ARGEŞ,"MUZEU ORĂȘENESC",182,"ORAŞ TOPOLOVENI",13757,1,PART,PRCNCT,PRSD,PRSD_SV,"2025-05-18 21:38:06",627,421,365,56,0,415,6,700,279,210,205
3,ARGEŞ,"ŞCOALA GIMNAZIALĂ ”NICOLAE CRISTESCU” TOPOLOVENI",183,"ORAŞ TOPOLOVENI",13757,1,PART,PRCNCT,PRSD,PRSD_SV,"2025-05-18 22:17:20",865,617,485,132,0,611,6,950,333,328,283
3,ARGEŞ,"ŞCOALA GIMNAZIALĂ ”NICOLAE CRISTESCU” TOPOLOVENI",184,"ORAŞ TOPOLOVENI",13757,1,PART,PRCNCT,PRSD,PRSD_SV,"2025-05-18 21:46:55",894,560,498,62,0,551,9,1000,440,294,257
3,ARGEŞ,"ŞCOALA GIMNAZIALĂ ” NICOLAE CRISTESCU” SALA DE SPORT",185,"ORAŞ TOPOLOVENI",13757,1,PART,PRCNCT,PRSD,PRSD_SV,"2025-05-18 21:34:58",1101,707,642,64,1,701,6,1200,493,341,360
3,ARGEŞ,"ŞCOALA PRIMARĂ INURI",186,"ORAŞ TOPOLOVENI",13757,1,PART,PRCNCT,PRSD,PRSD_SV,"2025-05-18 21:36:04",255,204,162,42,0,202,2,300,96,134,68
3,ARGEŞ,"ŞCOALA PRIMARĂ ŢIGĂNEŞTI- LINIE",187,"ORAŞ TOPOLOVENI",13757,1,PART,PRCNCT,PRSD,PRSD_SV,"2025-05-18 21:28:07",611,410,379,31,0,400,10,700,290,210,190
3,ARGEŞ,"ŞCOALA GENERALĂ ŢIGĂNEŞTI - CENTRU",188,"ORAŞ TOPOLOVENI",13757,1,PART,PRCNCT,PRSD,PRSD_SV,"2025-05-18 21:40:23",663,442,388,54,0,436,6,700,258,257,179
3,ARGEŞ,"CASA DE CULTURĂ ALBEŞTII DE ARGEŞ",189,"ALBEŞTII DE ARGEŞ",13819,3,PART,PRCNCT,PRSD,PRSD_SV,"2025-05-19 01:40:09",1600,1003,894,107,2,995,8,1750,747,620,375
3,ARGEŞ,"ŞCOALA PRIMARĂ ALBEŞTII -UNGURENI",190,"ALBEŞTII DE ARGEŞ",13819,1,PART,PRCNCT,PRSD,PRSD_SV,"2025-05-18 21:49:09",991,548,498,50,0,542,6,1100,552,341,201
3,ARGEŞ,"ŞCOALA PRIMARĂ ALBEŞTII-UNGURENI",191,"ALBEŞTII DE ARGEŞ",13819,1,PART,PRCNCT,PRSD,PRSD_SV,"2025-05-18 21:54:12",1000,550,514,36,0,543,7,1100,550,324,219
3,ARGEŞ,"ŞCOALA PRIMARĂ BRĂTEŞTI",192,"ALBEŞTII DE ARGEŞ",13819,1,PART,PRCNCT,PRSD,PRSD_SV,"2025-05-18 21:42:20",567,333,299,34,0,333,0,650,317,191,142
3,ARGEŞ,"SCOALA PRIMARĂ DOBROŢU",193,"ALBEŞTII DE ARGEŞ",13819,1,PART,PRCNCT,PRSD,PRSD_SV,"2025-05-18 21:47:29",755,465,412,53,0,460,5,850,385,245,215
3,ARGEŞ,"ŞCOALA GIMNAZIALĂ NR.1 ALBEȘTII DE MUSCEL, STRADA MAGISTRAT SORIN MOISESCU NR.360",194,"ALBEŞTII DE MUSCEL",13891,1,PART,PRCNCT,PRSD,PRSD_SV,"2025-05-18 22:08:20",856,559,474,66,19,556,3,950,391,289,267
3,ARGEŞ,"ŞCOALA GENERALĂ I-IV CÂNDEȘTI, STRADA MAGISTRAT SORIN MOISESCU, NR.182",195,"ALBEŞTII DE MUSCEL",13891,1,PART,PRCNCT,PRSD,PRSD_SV,"2025-05-18 21:35:58",345,253,209,32,12,252,1,400,147,130,122
3,ARGEŞ,"CĂMIN CULTURAL ALBOTA",196,ALBOTA,13935,1,PART,PRCNCT,PRSD,PRSD_SV,"2025-05-18 22:11:50",2061,1421,1197,224,0,1411,10,2200,779,790,621
3,ARGEŞ,"ŞCOALA PRIMARĂ CERBU",197,ALBOTA,13935,1,PART,PRCNCT,PRSD,PRSD_SV,"2025-05-18 21:36:41",684,463,388,75,0,452,11,750,287,258,194
3,ARGEŞ,"ŞCOALA GIMNAZIALĂ MAREŞ",198,ALBOTA,13935,1,PART,PRCNCT,PRSD,PRSD_SV,"2025-05-18 21:29:19",862,588,502,86,0,578,10,950,362,347,231
3,ARGEŞ,"ŞCOALA GIMNAZIALĂ BROŞTENI - ANINOASA, CORP B",199,ANINOASA,13999,1,PART,PRCNCT,PRSD,PRSD_SV,"2025-05-18 21:48:15",1185,705,591,113,1,696,9,1300,595,449,247
3,ARGEŞ,"ŞCOALA GIMNAZIALĂ SLĂNIC",200,ANINOASA,13999,1,PART,PRCNCT,PRSD,PRSD_SV,"2025-05-18 21:50:04",905,531,475,56,0,523,8,1000,469,341,182
3,ARGEŞ,"CĂMIN CULTURAL VALEA SILIŞTII",201,ANINOASA,13999,1,PART,PRCNCT,PRSD,PRSD_SV,"2025-05-18 21:43:07",492,314,251,63,0,306,8,550,236,188,118
3,ARGEŞ,"ŞCOALA GIMNAZIALĂ GEORGE STEPHĂNESCU",202,AREFU,14049,1,PART,PRCNCT,PRSD,PRSD_SV,"2025-05-18 21:48:49",853,602,450,152,0,592,10,950,348,317,275
3,ARGEŞ,"CĂMINUL CULTURAL AREFU",203,AREFU,14049,1,PART,PRCNCT,PRSD,PRSD_SV,"2025-05-18 21:38:01",965,599,473,126,0,591,8,1100,501,354,237
3,ARGEŞ,"GRĂDINIȚA NR. 1 BASCOV",204,BASCOV,13187,1,PART,PRCNCT,PRSD,PRSD_SV,"2025-05-18 21:54:36",1268,879,693,186,0,861,18,1400,521,408,453
3,ARGEŞ,"ŞCOALA GENERALĂ BASCOV, CLĂDIREA VECHE",205,BASCOV,13187,1,PART,PRCNCT,PRSD,PRSD_SV,"2025-05-18 22:16:34",1991,1383,1186,197,0,1365,18,2200,817,611,754
3,ARGEŞ,"ŞCOALA GENERALĂ BASCOV, CLĂDIREA NOUĂ",206,BASCOV,13187,1,PART,PRCNCT,PRSD,PRSD_SV,"2025-05-18 21:43:21",1608,1188,1028,160,0,1168,20,1800,612,552,616
3,ARGEŞ,"ŞCOALA GENERALĂ GLÎMBOCU",207,BASCOV,13187,1,PART,PRCNCT,PRSD,PRSD_SV,"2025-05-18 22:08:29",821,598,517,81,0,592,6,900,302,332,260
3,ARGEŞ,"ŞCOALA GENERALĂ MICA",208,BASCOV,13187,1,PART,PRCNCT,PRSD,PRSD_SV,"2025-05-18 21:31:49",477,384,333,51,0,373,11,557,173,215,158
3,ARGEŞ,"ŞCOALA GENERALĂ SCHIAU",209,BASCOV,13187,1,PART,PRCNCT,PRSD,PRSD_SV,"2025-05-18 22:56:57",1566,1028,903,124,1,1011,17,1700,672,482,529
3,ARGEŞ,"ŞCOALA GENERALĂ VALEA URSULUI",210,BASCOV,13187,1,PART,PRCNCT,PRSD,PRSD_SV,"2025-05-18 21:43:12",1601,1150,916,234,0,1132,18,1750,600,632,500
3,ARGEŞ,"ŞCOALA BĂBANA",211,BĂBANA,14085,1,PART,PRCNCT,PRSD,PRSD_SV,"2025-05-18 21:20:44",753,482,423,58,1,478,4,850,368,362,116
3,ARGEŞ,"SALA DE FESTIVITĂȚII A CONSILIULUI LOCAL BĂBANA",212,BĂBANA,14085,1,PART,PRCNCT,PRSD,PRSD_SV,"2025-05-18 21:18:51",603,485,368,110,7,480,5,650,165,308,172
3,ARGEŞ,"ŞCOALA GROŞI",213,BĂBANA,14085,1,PART,PRCNCT,PRSD,PRSD_SV,"2025-05-18 21:17:41",390,315,225,90,0,312,3,450,135,208,104
3,ARGEŞ,"ŞCOALA SLĂTIOARELE",214,BĂBANA,14085,1,PART,PRCNCT,PRSD,PRSD_SV,"2025-05-18 21:18:03",663,473,372,101,0,468,5,750,277,268,200
3,ARGEŞ,"PRIMĂRIA BĂICULEŞTI",215,BĂICULEŞTI,14165,1,PART,PRCNCT,PRSD,PRSD_SV,"2025-05-18 21:35:28",1388,769,685,84,0,762,7,1500,731,483,279
3,ARGEŞ,"ŞCOALA MĂNICEŞTI",216,BĂICULEŞTI,14165,1,PART,PRCNCT,PRSD,PRSD_SV,"2025-05-18 21:28:45",621,328,274,53,1,319,9,700,372,207,112
3,ARGEŞ,"SEDIUL ADMINISTRATIV TUTANA",217,BĂICULEŞTI,14165,1,PART,PRCNCT,PRSD,PRSD_SV,"2025-05-18 21:57:31",1412,812,717,95,0,805,7,1551,739,522,283
3,ARGEŞ,"CĂMINUL CULTURAL",218,BĂICULEŞTI,14165,1,PART,PRCNCT,PRSD,PRSD_SV,"2025-05-18 21:25:20",668,398,344,54,0,390,8,750,352,229,161
3,ARGEŞ,"CĂMINUL CULTURAL",219,BĂICULEŞTI,14165,1,PART,PRCNCT,PRSD,PRSD_SV,"2025-05-18 21:19:35",813,561,455,106,0,549,12,900,339,267,282
3,ARGEŞ,"CĂMIN CULTURAL BĂLILEŞTI",220,BĂLILEŞTI,14272,1,PART,PRCNCT,PRSD,PRSD_SV,"2025-05-18 22:00:55",883,591,488,103,0,583,8,1000,409,337,246
3,ARGEŞ,"CĂMIN CULTURAL BĂJEŞTI",221,BĂLILEŞTI,14272,1,PART,PRCNCT,PRSD,PRSD_SV,"2025-05-18 22:10:52",819,575,481,94,0,569,6,900,325,294,275
3,ARGEŞ,"CĂMIN CULTURAL POIENIŢA",222,BĂLILEŞTI,14272,1,PART,PRCNCT,PRSD,PRSD_SV,"2025-05-18 21:55:25",943,569,513,56,0,560,9,1000,431,331,229
3,ARGEŞ,"ŞCOALA CU CLASELE I-IV GOLEŞTI-PRIBOAIA",223,BĂLILEŞTI,14272,1,PART,PRCNCT,PRSD,PRSD_SV,"2025-05-18 21:34:18",562,348,298,50,0,343,5,650,302,223,120
3,ARGEŞ,"ŞCOALA CU CLASELE I-VIII BÂRLA",224,BÂRLA,14450,1,PART,PRCNCT,PRSD,PRSD_SV,"2025-05-18 21:38:06",765,453,342,111,0,448,5,850,397,306,142
3,ARGEŞ,"ŞCOALA BĂDEŞTI",225,BÂRLA,14450,1,PART,PRCNCT,PRSD,PRSD_SV,"2025-05-18 21:30:50",252,173,132,41,0,172,1,300,127,118,54
3,ARGEŞ,"ŞCOALA MÎNDRA",226,BÂRLA,14450,1,PART,PRCNCT,PRSD,PRSD_SV,"2025-05-18 21:31:00",587,335,252,83,0,331,4,650,315,217,114
3,ARGEŞ,"CENTRUL AFTER SCHOOL MOZĂCENII VALE",227,BÂRLA,14450,1,PART,PRCNCT,PRSD,PRSD_SV,"2025-05-18 21:28:12",843,450,370,80,0,445,5,900,450,279,166
3,ARGEŞ,"ŞCOALA URLUIENI",228,BÂRLA,14450,1,PART,PRCNCT,PRSD,PRSD_SV,"2025-05-18 21:38:57",920,514,363,151,0,512,2,1000,486,351,161
3,ARGEŞ,"CĂMIN CULTURAL BELEŢI",229,BELEŢI-NEGREŞTI,14352,1,PART,PRCNCT,PRSD,PRSD_SV,"2025-05-18 22:00:13",517,347,294,53,0,345,2,600,253,215,130
3,ARGEŞ,"CĂMIN CULTURAL NEGREŞTI",230,BELEŢI-NEGREŞTI,14352,1,PART,PRCNCT,PRSD,PRSD_SV,"2025-05-18 21:38:03",913,594,520,74,0,589,5,1000,406,348,241
3,ARGEŞ,"CĂMIN CULTURAL BEREVOEŞTI-PĂMÎNTENI",231,BEREVOEŞTI,14405,1,PART,PRCNCT,PRSD,PRSD_SV,"2025-05-18 21:43:18",1628,936,819,117,0,932,4,1750,814,624,308
3,ARGEŞ,"ŞCOALA BRATIA",232,BEREVOEŞTI,14405,1,PART,PRCNCT,PRSD,PRSD_SV,"2025-05-18 21:19:30",121,101,76,25,0,99,2,150,49,63,36
3,ARGEŞ,"ŞCOALA GĂMĂCEŞTI",233,BEREVOEŞTI,14405,1,PART,PRCNCT,PRSD,PRSD_SV,"2025-05-18 21:24:57",902,382,360,22,0,377,5,1000,618,297,80
3,ARGEŞ,"ŞCOALA BOGAŢI",234,BOGAŢI,14584,1,PART,PRCNCT,PRSD,PRSD_SV,"2025-05-18 21:47:18",1257,683,596,87,0,681,2,1350,667,415,266
3,ARGEŞ,"GRĂDINIŢA BUJOI",235,BOGAŢI,14584,1,PART,PRCNCT,PRSD,PRSD_SV,"2025-05-18 21:40:16",503,320,270,50,0,318,2,550,230,203,115
3,ARGEŞ,"ŞCOALA CHIŢEŞTI",236,BOGAŢI,14584,1,PART,PRCNCT,PRSD,PRSD_SV,"2025-05-18 21:25:42",207,160,100,59,1,160,0,250,90,91,69
3,ARGEŞ,"ŞCOALA GLÎMBOCEL",237,BOGAŢI,14584,1,PART,PRCNCT,PRSD,PRSD_SV,"2025-05-18 21:19:34",151,103,72,31,0,103,0,200,97,71,32
3,ARGEŞ,"ŞCOALA GLÎMBOCELU",238,BOGAŢI,14584,1,PART,PRCNCT,PRSD,PRSD_SV,"2025-05-18 21:34:32",585,352,295,57,0,346,6,650,298,222,124
3,ARGEŞ,"ŞCOALA SUSENI",239,BOGAŢI,14584,1,PART,PRCNCT,PRSD,PRSD_SV,"2025-05-18 21:37:19",740,399,359,38,2,398,1,800,401,295,103
3,ARGEŞ,"CĂMIN CULTURAL BOTENI",240,BOTENI,14673,1,PART,PRCNCT,PRSD,PRSD_SV,"2025-05-18 21:47:20",1357,860,736,120,4,852,8,1450,590,524,328
3,ARGEŞ,"ŞCOALA PRIMARĂ LUNCA",241,BOTENI,14673,1,PART,PRCNCT,PRSD,PRSD_SV,"2025-05-18 21:13:33",476,279,254,25,0,276,3,550,271,188,88
3,ARGEŞ,"CĂMINUL CULTURAL BOȚEȘTI",242,BOŢEŞTI,14726,1,PART,PRCNCT,PRSD,PRSD_SV,"2025-05-18 22:07:49",638,444,349,94,1,434,10,700,256,227,207
3,ARGEŞ,"ŞCOALA PRIMARĂ MOŞTENI-GRECI",243,BOŢEŞTI,14726,1,PART,PRCNCT,PRSD,PRSD_SV,"2025-05-18 21:30:12",242,205,137,68,0,205,0,300,95,142,63
3,ARGEŞ,"CĂMINUL CULTURAL BRADU",244,BRADU,13276,1,PART,PRCNCT,PRSD,PRSD_SV,"2025-05-18 21:55:56",1242,930,781,149,0,918,12,1300,370,473,445
3,ARGEŞ,"ȘCOALA PRIMARĂ ” MIHAI EMINESCU”",245,BRADU,13276,1,PART,PRCNCT,PRSD,PRSD_SV,"2025-05-18 21:44:56",855,556,479,77,0,550,6,950,394,355,195
3,ARGEŞ,"GRĂDINIȚA ” SCUFIȚA ROȘIE ”",246,BRADU,13276,1,PART,PRCNCT,PRSD,PRSD_SV,"2025-05-18 22:06:07",1850,1158,1009,148,1,1144,14,2000,842,739,405
3,ARGEŞ,"GRĂDINIȚA AFTER SCHOOL - GEAMĂNA",247,BRADU,13276,1,PART,PRCNCT,PRSD,PRSD_SV,"2025-05-18 22:43:22",1689,1222,1024,198,0,1202,20,1850,628,507,695
3,ARGEŞ,"GRĂDINIȚA SCHOOL GEAMĂNA",248,BRADU,13276,2,PART,PRCNCT,PRSD,PRSD_SV,"2025-05-19 01:57:57",1768,1186,1031,155,0,1174,12,1900,714,553,621
3,ARGEŞ,"CLĂDIRE ADMINISTRATIVĂ C18",249,BRADU,13276,1,PART,PRCNCT,PRSD,PRSD_SV,"2025-05-18 22:01:42",647,512,406,106,0,504,8,700,188,207,297
3,ARGEŞ,"CĂMIN CULTURAL BRĂDULEŢ",250,BRĂDULEŢ,14753,1,PART,PRCNCT,PRSD,PRSD_SV,"2025-05-18 21:41:58",421,276,208,68,0,270,6,500,224,149,121
3,ARGEŞ,"CĂMIN CULTURAL BRĂDETU",251,BRĂDULEŢ,14753,1,PART,PRCNCT,PRSD,PRSD_SV,"2025-05-18 21:36:36",272,212,144,68,0,208,4,350,138,109,99
3,ARGEŞ,"CĂMINUL CULTURAL GALEŞU",252,BRĂDULEŢ,14753,1,PART,PRCNCT,PRSD,PRSD_SV,"2025-05-18 22:00:23",657,504,340,78,86,494,10,750,246,278,216
3,ARGEŞ,"ŞCOALA GENERALĂ BUDEASA MARE",253,BUDEASA,14851,1,PART,PRCNCT,PRSD,PRSD_SV,"2025-05-18 21:40:18",1128,764,611,153,0,755,9,1200,436,391,364
3,ARGEŞ,"ŞCOALA GENERALĂ BUDEASA MICĂ",254,BUDEASA,14851,1,PART,PRCNCT,PRSD,PRSD_SV,"2025-05-18 21:41:52",759,536,426,110,0,525,11,850,314,290,235
3,ARGEŞ,"ŞCOALA GENERALĂ CALOTEŞTI",255,BUDEASA,14851,1,PART,PRCNCT,PRSD,PRSD_SV,"2025-05-18 21:39:26",816,515,431,84,0,510,5,900,385,289,221
3,ARGEŞ,"ŞCOALA GENERALĂ GĂLĂŞEŞTI",256,BUDEASA,14851,1,PART,PRCNCT,PRSD,PRSD_SV,"2025-05-18 21:38:52",848,557,488,69,0,550,7,950,393,326,224
3,ARGEŞ,"SCOALA GIMNAZIALA BUGHEA DE JOS",257,"BUGHEA DE JOS",14922,1,PART,PRCNCT,PRSD,PRSD_SV,"2025-05-18 21:56:01",1366,812,726,86,0,808,4,1500,688,476,332
3,ARGEŞ,"SCOALA PRIMARA MLACI",258,"BUGHEA DE JOS",14922,1,PART,PRCNCT,PRSD,PRSD_SV,"2025-05-18 21:31:53",615,366,335,31,0,357,9,700,334,167,190
3,ARGEŞ,"SCOALA PRIMARA HULUBESTI",259,"BUGHEA DE JOS",14922,1,PART,PRCNCT,PRSD,PRSD_SV,"2025-05-18 21:28:58",420,237,209,28,0,237,0,500,263,112,125
3,ARGEŞ,"ŞCOALA GIMNAZIALĂ NR. 1 BUGHEA DE SUS",260,"BUGHEA DE SUS",20063,1,PART,PRCNCT,PRSD,PRSD_SV,"2025-05-18 21:49:32",1702,928,797,104,27,911,17,1850,922,443,468
3,ARGEŞ,"GRĂDINIŢA GRUI",261,"BUGHEA DE SUS",20063,1,PART,PRCNCT,PRSD,PRSD_SV,"2025-05-18 21:30:06",693,499,427,63,9,490,9,750,251,233,257
3,ARGEŞ,"ŞCOALA GIMNAZIALĂ VULPEŞTI",262,BUZOEŞTI,14940,1,PART,PRCNCT,PRSD,PRSD_SV,"2025-05-18 21:54:10",773,422,360,62,0,419,3,850,428,289,130
3,ARGEŞ,"CĂMIN CULTURAL BUZOEŞTI",263,BUZOEŞTI,14940,1,PART,PRCNCT,PRSD,PRSD_SV,"2025-05-18 21:44:21",828,490,371,119,0,484,6,900,410,300,184
3,ARGEŞ,"ŞCOALA GIMNAZIALĂ CORNĂŢEL",264,BUZOEŞTI,14940,1,PART,PRCNCT,PRSD,PRSD_SV,"2025-05-18 21:29:11",707,388,322,66,0,383,5,800,412,244,139
3,ARGEŞ,"GRĂDINIŢA CU PROGRAM NORMAL IONEŞTI",265,BUZOEŞTI,14940,1,PART,PRCNCT,PRSD,PRSD_SV,"2025-05-18 21:45:41",565,348,270,53,25,347,1,650,302,197,150
3,ARGEŞ,"ȘCOALA GIMNAZIALĂ ŞERBOENI",266,BUZOEŞTI,14940,1,PART,PRCNCT,PRSD,PRSD_SV,"2025-05-18 23:14:53",1195,715,630,84,1,709,6,1300,585,412,297
3,ARGEŞ,"ŞCOALA GIMNAZIALĂ TOMŞANCA",267,BUZOEŞTI,14940,1,PART,PRCNCT,PRSD,PRSD_SV,"2025-05-18 21:31:40",276,160,119,41,0,158,2,300,140,93,65
3,ARGEŞ,"ŞCOALA GIM.”PROF.UNIV.DR.ION STOIA” CĂLDĂRARU",268,CĂLDĂRARU,15064,1,PART,PRCNCT,PRSD,PRSD_SV,"2025-05-18 21:34:44",660,358,278,78,2,356,2,700,342,235,121
3,ARGEŞ,"ŞCOALA PRIMARĂ ”ÎNV.CONSTANTIN MIHALCEA” BURDEA",269,CĂLDĂRARU,15064,1,PART,PRCNCT,PRSD,PRSD_SV,"2025-05-18 21:35:50",430,256,188,68,0,254,2,500,244,166,88
3,ARGEŞ,"ŞCOALAGEN CU CLS. I-VIII STRÎMBENI",270,CĂLDĂRARU,15064,1,PART,PRCNCT,PRSD,PRSD_SV,"2025-05-18 21:43:53",582,337,236,101,0,335,2,650,313,198,137
3,ARGEŞ,"SCOALA GENERALA VRANESTI",271,CĂLINEŞTI,15108,1,PART,PRCNCT,PRSD,PRSD_SV,"2025-05-18 21:40:14",1029,685,589,96,0,680,5,1100,415,370,310
3,ARGEŞ,"SCOALA CALINESTI",272,CĂLINEŞTI,15108,1,PART,PRCNCT,PRSD,PRSD_SV,"2025-05-18 21:37:51",1659,1013,829,143,41,1001,12,1800,787,579,422
3,ARGEŞ,"SCOALA CIRSTIENI",273,CĂLINEŞTI,15108,1,PART,PRCNCT,PRSD,PRSD_SV,"2025-05-18 21:31:51",646,329,307,22,0,327,2,700,371,238,89
3,ARGEŞ,"SCOALA CIOCANESTI",274,CĂLINEŞTI,15108,1,PART,PRCNCT,PRSD,PRSD_SV,"2025-05-18 21:38:58",756,580,480,100,0,573,7,850,270,360,213
3,ARGEŞ,"SCOALA GLODU",275,CĂLINEŞTI,15108,1,PART,PRCNCT,PRSD,PRSD_SV,"2025-05-18 21:46:26",566,350,307,43,0,345,5,650,300,202,143
3,ARGEŞ,"GRĂDINIŢA DRĂGHICEŞTI",276,CĂLINEŞTI,15108,1,PART,PRCNCT,PRSD,PRSD_SV,"2025-05-18 21:24:07",856,577,486,90,1,569,8,900,323,313,256
3,ARGEŞ,"SCOALA RADU NEGRU",277,CĂLINEŞTI,15108,1,PART,PRCNCT,PRSD,PRSD_SV,"2025-05-18 21:29:40",524,343,297,46,0,340,3,600,257,244,96
3,ARGEŞ,"GRĂDINIȚA UDENI",278,CĂLINEŞTI,15108,1,PART,PRCNCT,PRSD,PRSD_SV,"2025-05-18 21:20:08",569,372,338,34,0,368,4,600,228,242,126
3,ARGEŞ,"SCOALA RINCACIOV",279,CĂLINEŞTI,15108,1,PART,PRCNCT,PRSD,PRSD_SV,"2025-05-18 21:23:38",510,304,265,39,0,302,2,600,296,225,77
3,ARGEŞ,"ȘCOALA GENERALĂ VALEA CORBULUI",280,CĂLINEŞTI,15108,1,PART,PRCNCT,PRSD,PRSD_SV,"2025-05-18 21:28:06",988,482,457,25,0,472,10,1100,618,429,43
3,ARGEŞ,"SCOALA VALENI",281,CĂLINEŞTI,15108,1,PART,PRCNCT,PRSD,PRSD_SV,"2025-05-18 21:48:12",881,537,459,78,0,532,5,1000,463,309,223
3,ARGEŞ,"CĂMINUL CULTURAL CĂTEASCA",282,CĂTEASCA,15233,1,PART,PRCNCT,PRSD,PRSD_SV,"2025-05-18 21:50:41",672,505,377,128,0,500,5,750,245,256,244
3,ARGEŞ,"CĂMINUL CULTURAL CĂTANELE",283,CĂTEASCA,15233,1,PART,PRCNCT,PRSD,PRSD_SV,"2025-05-18 22:13:25",850,659,484,175,0,652,7,950,291,428,224
3,ARGEŞ,"CĂMIN CULTURAL CIREŞU",284,CĂTEASCA,15233,1,PART,PRCNCT,PRSD,PRSD_SV,"2025-05-18 21:49:53",579,393,322,70,1,391,2,648,255,233,158
3,ARGEŞ,"CĂMINUL CULTURAL GRUIU",285,CĂTEASCA,15233,1,PART,PRCNCT,PRSD,PRSD_SV,"2025-05-18 21:42:20",521,382,300,82,0,374,8,604,222,230,144
3,ARGEŞ,"CĂMINUL CULTURAL SILIŞTEA",286,CĂTEASCA,15233,1,PART,PRCNCT,PRSD,PRSD_SV,"2025-05-18 21:30:08",404,285,223,62,0,282,3,450,165,175,107
3,ARGEŞ,"CĂMINUL CULTURAL CEPARI",287,CEPARI,15313,1,PART,PRCNCT,PRSD,PRSD_SV,"2025-05-18 21:20:03",656,385,315,69,1,379,6,700,315,227,152
3,ARGEŞ,"ŞCOALA CĂRPENIŞ",288,CEPARI,15313,1,PART,PRCNCT,PRSD,PRSD_SV,"2025-05-18 21:32:00",556,334,287,47,0,333,1,600,266,211,122
3,ARGEŞ,"ŞCOALA CEPARI - UNGURENI",289,CEPARI,15313,1,PART,PRCNCT,PRSD,PRSD_SV,"2025-05-18 21:27:25",260,158,121,37,0,158,0,300,142,100,58
3,ARGEŞ,"CĂMIN CULTURAL URLUIEȘTI",290,CEPARI,15313,1,PART,PRCNCT,PRSD,PRSD_SV,"2025-05-18 21:38:15",194,149,106,43,0,148,1,250,101,106,42
3,ARGEŞ,"CĂMIN CULTURAL CETĂŢENI",291,CETĂŢENI,15402,1,PART,PRCNCT,PRSD,PRSD_SV,"2025-05-18 21:30:05",807,474,405,69,0,468,6,900,426,229,239
3,ARGEŞ,"GRĂDINIŢA LĂICĂI",292,CETĂŢENI,15402,1,PART,PRCNCT,PRSD,PRSD_SV,"2025-05-18 21:32:55",606,416,347,67,2,415,1,700,284,217,198
3,ARGEŞ,"ŞCOALA I-IV VALEA CETĂŢUIA",293,CETĂŢENI,15402,1,PART,PRCNCT,PRSD,PRSD_SV,"2025-05-18 21:34:29",767,335,318,17,0,333,2,850,515,201,132
3,ARGEŞ,"ŞCOALA GIMNAZIALĂ CICĂNEŞTI",294,CICĂNEŞTI,15448,1,PART,PRCNCT,PRSD,PRSD_SV,"2025-05-18 22:34:07",1657,1054,963,74,17,1043,11,1800,746,669,374
3,ARGEŞ,"CĂMIN CULTURAL CIOFRÎNGENI",295,CIOFRÂNGENI,15493,1,PART,PRCNCT,PRSD,PRSD_SV,"2025-05-18 21:49:22",1014,619,523,96,0,610,9,1091,472,331,279
3,ARGEŞ,"CĂMIN CULTURAL BURLUŞI",296,CIOFRÂNGENI,15493,1,PART,PRCNCT,PRSD,PRSD_SV,"2025-05-18 21:32:35",338,235,161,74,0,232,3,400,165,107,125
3,ARGEŞ,"CĂMINUL CULTURAL LACURILE",297,CIOFRÂNGENI,15493,1,PART,PRCNCT,PRSD,PRSD_SV,"2025-05-18 21:32:36",501,322,260,62,0,318,4,550,228,179,139
3,ARGEŞ,"ȘCOALA GIMNAZIALĂ BRĂTIA",298,CIOMĂGEŞTI,15554,2,PART,PRCNCT,PRSD,PRSD_SV,"2025-05-19 01:35:40",322,195,132,63,0,191,4,350,155,99,92
3,ARGEŞ,"SCOALA CIOMĂGEȘTI",299,CIOMĂGEŞTI,15554,1,PART,PRCNCT,PRSD,PRSD_SV,"2025-05-18 21:32:39",316,179,146,33,0,178,1,350,171,106,72
3,ARGEŞ,"GRĂDINIȚA DOGARI",300,CIOMĂGEŞTI,15554,1,PART,PRCNCT,PRSD,PRSD_SV,"2025-05-18 21:29:41",203,125,82,43,0,123,2,250,125,92,31
3,ARGEŞ,"PRIMARIA COMUNEI COCU",301,COCU,15652,1,PART,PRCNCT,PRSD,PRSD_SV,"2025-05-18 21:13:30",273,168,124,44,0,167,1,300,132,101,66
3,ARGEŞ,"ŞCOALĂ PRIMARĂ BĂRBĂTEŞTI",302,COCU,15652,1,PART,PRCNCT,PRSD,PRSD_SV,"2025-05-18 21:40:16",450,228,174,54,0,225,3,500,272,155,70
3,ARGEŞ,"ŞCOALĂ GIMNAZIALĂ NR.1 COCU",303,COCU,15652,1,PART,PRCNCT,PRSD,PRSD_SV,"2025-05-18 21:30:12",475,331,225,106,0,328,3,500,169,196,132
3,ARGEŞ,"ŞCOALĂ PRIMARĂ CRUCIŞOARA",304,COCU,15652,1,PART,PRCNCT,PRSD,PRSD_SV,"2025-05-18 21:12:22",241,151,98,53,0,150,1,300,149,103,47
3,ARGEŞ,"ŞCOALĂ PRIMARĂ RICHIŢELE DE SUS",305,COCU,15652,1,PART,PRCNCT,PRSD,PRSD_SV,"2025-05-18 21:31:10",290,161,120,41,0,159,2,350,189,102,57
3,ARGEŞ,"GRĂDINIŢA NR. 1 CORBENI",306,CORBENI,15741,1,PART,PRCNCT,PRSD,PRSD_SV,"2025-05-18 21:44:27",675,352,305,47,0,346,6,750,398,289,57
3,ARGEŞ,"ŞCOALA GIMNAZIALĂ NR. 1 CORBENI",307,CORBENI,15741,1,PART,PRCNCT,PRSD,PRSD_SV,"2025-05-18 22:01:49",1208,737,635,101,1,729,8,1300,563,441,288
3,ARGEŞ,"ŞCOALA PRIMARĂ BERINDEŞTI",308,CORBENI,15741,1,PART,PRCNCT,PRSD,PRSD_SV,"2025-05-18 21:30:05",566,376,336,40,0,372,4,650,274,246,126
3,ARGEŞ,"ŞCOALA GIMNAZIALĂ PROF. DR. VASILE VASILESCU",309,CORBENI,15741,1,PART,PRCNCT,PRSD,PRSD_SV,"2025-05-18 21:48:55",807,513,437,76,0,509,4,900,387,300,209
3,ARGEŞ,"ŞCOALA GIMNAZIALĂ PROF. DR. VASILE VASILESCU",310,CORBENI,15741,1,PART,PRCNCT,PRSD,PRSD_SV,"2025-05-18 22:07:44",1226,734,78,656,0,727,7,1350,616,516,211
3,ARGEŞ,"CĂMIN CULTURAL CORBI",311,CORBI,15830,1,PART,PRCNCT,PRSD,PRSD_SV,"2025-05-18 22:02:54",1605,876,761,113,2,867,9,1750,874,551,316
3,ARGEŞ,"CĂMIN CULTURAL CORBŞORI",312,CORBI,15830,1,PART,PRCNCT,PRSD,PRSD_SV,"2025-05-18 21:57:32",760,450,344,106,0,444,6,850,400,251,193
3,ARGEŞ,"CĂMIN CULTURAL STĂNEŞTI",313,CORBI,15830,1,PART,PRCNCT,PRSD,PRSD_SV,"2025-05-18 21:39:56",861,508,426,82,0,504,4,950,442,291,213
3,ARGEŞ,"CĂMIN CULTURAL COŞEŞTI",314,COŞEŞTI,15901,1,PART,PRCNCT,PRSD,PRSD_SV,"2025-05-18 21:32:28",821,501,441,60,0,496,5,900,399,325,171
3,ARGEŞ,"CĂMIN CULTURAL JUPÎNEŞTI",315,COŞEŞTI,15901,2,PART,PRCNCT,PRSD,PRSD_SV,"2025-05-19 00:59:05",932,431,392,39,0,427,4,1000,569,319,108
3,ARGEŞ,"CĂMINUL CULTURAL LĂPUŞANI",316,COŞEŞTI,15901,1,PART,PRCNCT,PRSD,PRSD_SV,"2025-05-18 21:19:30",311,197,172,25,0,195,2,350,153,164,31
3,ARGEŞ,"CĂMIN CULTURAL LEICEŞTI",317,COŞEŞTI,15901,1,PART,PRCNCT,PRSD,PRSD_SV,"2025-05-18 22:15:42",1516,891,797,93,1,884,7,1650,759,580,304
3,ARGEŞ,"ŞCOALA PETREŞTI",318,COŞEŞTI,15901,1,PART,PRCNCT,PRSD,PRSD_SV,"2025-05-18 21:36:48",682,460,371,89,0,458,2,750,290,275,183
3,ARGEŞ,"CĂMIN CULTURAL COTMEANA",319,COTMEANA,15983,1,PART,PRCNCT,PRSD,PRSD_SV,"2025-05-18 21:28:31",760,419,329,90,0,418,1,850,431,248,170
3,ARGEŞ,"ŞCOALA LINTEŞTI",320,COTMEANA,15983,1,PART,PRCNCT,PRSD,PRSD_SV,"2025-05-18 21:27:37",311,201,117,75,9,199,2,350,149,129,70
3,ARGEŞ,"CENTRUL INGRIJIRE COPII",321,COTMEANA,15983,1,PART,PRCNCT,PRSD,PRSD_SV,"2025-05-18 21:20:58",408,299,189,95,15,298,1,450,151,177,121
3,ARGEŞ,"ŞCOALA GIMNAZIALĂ ”MIRCEA GHIŢULESCU” CUCA",322,CUCA,16132,1,PART,PRCNCT,PRSD,PRSD_SV,"2025-05-18 21:41:49",359,253,169,84,0,253,0,400,147,140,113
3,ARGEŞ,"ŞCOALA PRIMARĂ CÎRCEŞTI",323,CUCA,16132,1,PART,PRCNCT,PRSD,PRSD_SV,"2025-05-18 21:28:55",224,153,107,46,0,151,2,250,97,84,67
3,ARGEŞ,"ŞCOALA PRIMARĂ MĂCĂI",324,CUCA,16132,1,PART,PRCNCT,PRSD,PRSD_SV,"2025-05-18 21:54:27",479,410,290,120,0,401,9,551,141,276,125
3,ARGEŞ,"ŞCOALA PRIMARĂ LĂUNELE",325,CUCA,16132,1,PART,PRCNCT,PRSD,PRSD_SV,"2025-05-18 21:47:58",470,295,215,80,0,294,1,497,202,196,98
3,ARGEŞ,"ŞCOALA DAVIDEŞTI",326,DAVIDEŞTI,16285,1,PART,PRCNCT,PRSD,PRSD_SV,"2025-05-18 21:33:08",506,344,290,54,0,338,6,550,206,216,122
3,ARGEŞ,"ŞCOALA CONŢEŞTI NR.1",327,DAVIDEŞTI,16285,1,PART,PRCNCT,PRSD,PRSD_SV,"2025-05-18 21:33:55",654,376,331,45,0,373,3,700,324,239,134
3,ARGEŞ,"ŞCOALA OLTEANCA",328,DAVIDEŞTI,16285,2,PART,PRCNCT,PRSD,PRSD_SV,"2025-05-19 00:15:59",807,345,321,24,0,340,5,900,555,250,90
3,ARGEŞ,"ŞCOALA VOROVENI",329,DAVIDEŞTI,16285,1,PART,PRCNCT,PRSD,PRSD_SV,"2025-05-18 21:30:23",500,324,287,37,0,322,2,550,226,210,112
3,ARGEŞ,"CLĂDIRE MULTIFUNCȚIONALĂ DÎMBOVICIOARA",330,DÂMBOVICIOARA,16329,1,PART,PRCNCT,PRSD,PRSD_SV,"2025-05-18 21:39:11",231,172,106,66,0,168,4,300,128,94,74
3,ARGEŞ,"ŞCOALA CIOCANU",331,DÂMBOVICIOARA,16329,1,PART,PRCNCT,PRSD,PRSD_SV,"2025-05-18 21:20:36",57,86,23,62,1,86,0,150,64,42,44
3,ARGEŞ,"CĂMINUL CULTURAL PODU DÎMBOVIŢEI",332,DÂMBOVICIOARA,16329,1,PART,PRCNCT,PRSD,PRSD_SV,"2025-05-18 21:30:09",482,376,268,106,2,372,4,550,174,192,180
3,ARGEŞ,"ŞCOALA DÎRMĂNEŞTI",333,DÂRMĂNEŞTI,16365,1,PART,PRCNCT,PRSD,PRSD_SV,"2025-05-18 21:28:56",976,545,468,77,0,542,3,1100,555,310,232
3,ARGEŞ,"CAMINUL CULTURAL NEGRENI",334,DÂRMĂNEŞTI,16365,1,PART,PRCNCT,PRSD,PRSD_SV,"2025-05-18 21:45:37",537,373,306,66,1,365,8,600,227,224,141
3,ARGEŞ,"ŞCOALA PISCANI",335,DÂRMĂNEŞTI,16365,1,PART,PRCNCT,PRSD,PRSD_SV,"2025-05-18 21:35:38",766,496,445,51,0,494,2,850,354,322,172
3,ARGEŞ,"ŞCOALA VALEA NANDRII",336,DÂRMĂNEŞTI,16365,1,PART,PRCNCT,PRSD,PRSD_SV,"2025-05-18 21:29:46",553,374,301,73,0,372,2,600,226,226,146
3,ARGEŞ,"CĂMIN CULTURAL DOBREŞTI",337,DOBREŞTI,16427,2,PART,PRCNCT,PRSD,PRSD_SV,"2025-05-19 00:23:06",697,509,360,149,0,503,6,800,291,296,207
3,ARGEŞ,"ŞCOALA GEN. I-IV FUREŞTI",338,DOBREŞTI,16427,1,PART,PRCNCT,PRSD,PRSD_SV,"2025-05-18 21:34:03",698,382,334,48,0,374,8,800,418,271,103
3,ARGEŞ,"CAMINUL CULTURAL ”PETRE IONESCU MUSCEL”",339,DOMNEŞTI,16454,1,PART,PRCNCT,PRSD,PRSD_SV,"2025-05-18 21:41:15",1216,905,735,114,56,898,7,1350,445,500,398
3,ARGEŞ,"CAMINUL CULTURAL ”PETRE IONESCU MUSCEL” -",340,DOMNEŞTI,16454,1,PART,PRCNCT,PRSD,PRSD_SV,"2025-05-18 21:41:54",1292,958,770,164,24,952,6,1400,442,506,446
3,ARGEŞ,"ŞCOALA GIMNAZIALĂ IOSIF CATRINESCU CLS. V-VIII",341,DRAGOSLAVELE,16472,1,PART,PRCNCT,PRSD,PRSD_SV,"2025-05-18 21:37:07",626,370,325,45,0,362,8,700,330,183,179
3,ARGEŞ,"CĂMIN CULTURAL DRAGOSLAVELE",342,DRAGOSLAVELE,16472,1,PART,PRCNCT,PRSD,PRSD_SV,"2025-05-18 21:53:10",855,536,447,89,0,529,7,949,413,291,238
3,ARGEŞ,"ŞCOALA VALEA HOTARULUI",343,DRAGOSLAVELE,16472,1,PART,PRCNCT,PRSD,PRSD_SV,"2025-05-18 21:37:57",542,318,299,19,0,308,10,600,282,262,46
3,ARGEŞ,"CĂMIN CULTURAL DRĂGANU",344,DRĂGANU,16506,1,PART,PRCNCT,PRSD,PRSD_SV,"2025-05-18 21:47:29",737,518,376,142,0,513,5,800,282,306,207
3,ARGEŞ,"ȘCOALA CU PROGRAM NORMAL",345,DRĂGANU,16506,1,PART,PRCNCT,PRSD,PRSD_SV,"2025-05-18 21:48:24",402,229,187,42,0,228,1,450,221,133,95
3,ARGEŞ,"ŞCOALA PRISLOP",346,DRĂGANU,16506,1,PART,PRCNCT,PRSD,PRSD_SV,"2025-05-18 21:53:58",530,335,288,47,0,327,8,600,265,198,129
3,ARGEŞ,"ȘCOALA GODENI, NR.26",347,GODENI,16551,1,PART,PRCNCT,PRSD,PRSD_SV,"2025-05-18 21:42:08",950,574,523,50,1,565,9,1100,526,254,311
3,ARGEŞ,"ŞCOALA GIMNAZIALĂ COTEȘTI-GODENI, NR.198",348,GODENI,16551,1,PART,PRCNCT,PRSD,PRSD_SV,"2025-05-18 21:44:39",1382,743,679,64,0,734,9,1500,757,441,293
3,ARGEŞ,"CĂMINUL CULTURAL HÂRSEŞTI",349,HÂRSEȘTI,16613,1,PART,PRCNCT,PRSD,PRSD_SV,"2025-05-18 21:45:26",1175,684,470,200,14,678,6,1300,616,424,254
3,ARGEŞ,"ŞCOALA MARTALOGI",350,HÂRSEȘTI,16613,1,PART,PRCNCT,PRSD,PRSD_SV,"2025-05-18 21:33:41",534,319,242,68,9,316,3,600,281,167,149
3,ARGEŞ,"CĂMIN CULTURAL HÎRTIEŞTI",351,HÂRTIEŞTI,16659,1,PART,PRCNCT,PRSD,PRSD_SV,"2025-05-18 21:48:38",740,472,428,44,0,462,10,800,328,247,215
3,ARGEŞ,"PRIMĂRIA VECHE HÎRTIEŞTI",352,HÂRTIEŞTI,16659,1,PART,PRCNCT,PRSD,PRSD_SV,"2025-05-18 21:39:34",292,188,157,31,0,185,3,350,162,110,75
3,ARGEŞ,"CENTRUL DE ZI LESPEZI",353,HÂRTIEŞTI,16659,1,PART,PRCNCT,PRSD,PRSD_SV,"2025-05-18 21:44:07",445,294,279,15,0,286,8,500,206,271,15
3,ARGEŞ,"ŞCOALA LUCIENI",354,HÂRTIEŞTI,16659,1,PART,PRCNCT,PRSD,PRSD_SV,"2025-05-18 21:23:42",283,186,157,29,0,185,1,350,164,120,65
3,ARGEŞ,"ŞCOALA GIMNAZIALĂ ELENA DAVILA PERTICARI",355,IZVORU,16739,1,PART,PRCNCT,PRSD,PRSD_SV,"2025-05-18 21:39:31",863,408,329,79,0,401,7,950,542,249,152
3,ARGEŞ,"ŞCOALA GIMNAZIALĂ ELENA DAVILA PERTICARI",356,IZVORU,16739,1,PART,PRCNCT,PRSD,PRSD_SV,"2025-05-18 21:29:05",851,381,312,69,0,379,2,900,519,261,118
3,ARGEŞ,PRIMĂRIE,357,LEORDENI,16757,1,PART,PRCNCT,PRSD,PRSD_SV,"2025-05-18 22:13:36",1360,928,718,182,28,917,11,1500,572,519,398
3,ARGEŞ,"CENTRUL CULTURAL MULTIFUNCȚIONAL BUDIŞTENI",358,LEORDENI,16757,1,PART,PRCNCT,PRSD,PRSD_SV,"2025-05-18 21:46:11",950,560,471,82,7,558,2,999,439,378,180
3,ARGEŞ,"ŞCOALA CIULNIŢA",359,LEORDENI,16757,1,PART,PRCNCT,PRSD,PRSD_SV,"2025-05-18 21:39:06",870,537,447,89,1,534,3,1000,463,341,193
3,ARGEŞ,"GRĂDINIŢA CU PROGRAM NORMAL COTU MALULUI",360,LEORDENI,16757,1,PART,PRCNCT,PRSD,PRSD_SV,"2025-05-18 21:21:49",335,201,170,31,0,201,0,400,199,150,51
3,ARGEŞ,"CLĂDIREA MULTIFUNCŢIONALĂ GLÂMBOCATA-DEAL",361,LEORDENI,16757,1,PART,PRCNCT,PRSD,PRSD_SV,"2025-05-18 21:43:18",832,514,423,91,0,511,3,900,386,330,181
3,ARGEŞ,"ȘCOALA GIMNAZIALĂ NR.1 LEREȘTI, SAT LEREȘTI",362,LEREŞTI,16908,1,PART,PRCNCT,PRSD,PRSD_SV,"2025-05-18 22:01:25",1303,815,734,73,8,798,17,1400,585,309,489
3,ARGEŞ,"CĂMIN CULTURAL LEREȘTI",363,LEREŞTI,16908,1,PART,PRCNCT,PRSD,PRSD_SV,"2025-05-18 21:41:45",1061,682,596,84,2,676,6,1200,518,314,362
3,ARGEŞ,"ȘCOALA GIMNAZIALĂ NR.1 LEREȘTI, SAT VOINEȘTI",364,LEREŞTI,16908,1,PART,PRCNCT,PRSD,PRSD_SV,"2025-05-18 21:53:55",1242,865,723,137,5,852,13,1400,535,308,544
3,ARGEŞ,"ŞCOALA GIMNAZIALĂ ”GENERAL CONSTANTIN CRISTESCU” LUNCA CORBULUI",365,"LUNCA CORBULUI",16944,1,PART,PRCNCT,PRSD,PRSD_SV,"2025-05-18 21:35:26",777,515,140,375,0,507,8,900,385,304,203
3,ARGEŞ,"ŞCOALA SILIŞTENI",366,"LUNCA CORBULUI",16944,1,PART,PRCNCT,PRSD,PRSD_SV,"2025-05-18 21:32:21",234,164,112,52,0,163,1,300,136,77,86
3,ARGEŞ,"ŞCOALA PĂDUREŢI",367,"LUNCA CORBULUI",16944,1,PART,PRCNCT,PRSD,PRSD_SV,"2025-05-18 21:44:06",753,433,277,156,0,431,2,850,417,266,165
3,ARGEŞ,"ŞCOALA MÎRGHIA DE SUS",368,"LUNCA CORBULUI",16944,1,PART,PRCNCT,PRSD,PRSD_SV,"2025-05-18 21:27:59",321,248,140,108,0,247,1,350,102,137,110
3,ARGEŞ,"ŞCOALA MĂLURENI",369,MĂLURENI,17049,1,PART,PRCNCT,PRSD,PRSD_SV,"2025-05-18 21:36:11",467,281,211,70,0,276,5,500,219,176,100
3,ARGEŞ,"CĂMIN CULTURAL BĂDICENI",370,MĂLURENI,17049,1,PART,PRCNCT,PRSD,PRSD_SV,"2025-05-18 21:37:00",399,269,197,72,0,266,3,400,131,151,115
3,ARGEŞ,"ŞCOALA BUNEŞTI",371,MĂLURENI,17049,1,PART,PRCNCT,PRSD,PRSD_SV,"2025-05-18 21:36:19",548,323,231,92,0,322,1,600,277,209,113
3,ARGEŞ,"TABĂRA PĂULEASCA",372,MĂLURENI,17049,1,PART,PRCNCT,PRSD,PRSD_SV,"2025-05-18 21:40:13",727,167,160,7,0,164,3,800,633,137,27
3,ARGEŞ,"ŞCOALA BOHARI",373,MĂLURENI,17049,1,PART,PRCNCT,PRSD,PRSD_SV,"2025-05-18 21:33:07",289,184,130,54,0,183,1,300,116,126,57
3,ARGEŞ,"ŞCOALA TOPLIŢA",374,MĂLURENI,17049,1,PART,PRCNCT,PRSD,PRSD_SV,"2025-05-18 21:12:55",251,132,92,40,0,132,0,300,168,58,74
3,ARGEŞ,"ŞCOALA ZĂRNEŞTI",375,MĂLURENI,17049,1,PART,PRCNCT,PRSD,PRSD_SV,"2025-05-18 21:29:57",754,477,384,93,0,475,2,850,373,308,167
3,ARGEŞ,"ŞCOALA GENERALĂ NR.1",376,MĂRĂCINENI,13365,1,PART,PRCNCT,PRSD,PRSD_SV,"2025-05-18 22:00:56",1249,827,706,121,0,814,13,1400,573,456,358
3,ARGEŞ,"ŞCOALA GENERALĂ NR.1",377,MĂRĂCINENI,13365,1,PART,PRCNCT,PRSD,PRSD_SV,"2025-05-18 21:52:10",1497,984,907,77,0,971,13,1600,616,489,482
3,ARGEŞ,"ŞCOALA GENERALĂ ARGEŞELU",378,MĂRĂCINENI,13365,1,PART,PRCNCT,PRSD,PRSD_SV,"2025-05-18 22:10:28",1863,1203,1068,134,1,1188,15,2048,845,604,584
3,ARGEŞ,"CĂMINUL CULTURAL MERIŞANI",379,MERIŞANI,17101,1,PART,PRCNCT,PRSD,PRSD_SV,"2025-05-18 21:27:29",675,438,356,80,2,436,2,750,312,239,197
3,ARGEŞ,"ȘCOALA GENERALĂ BORLEȘTI",380,MERIŞANI,17101,1,PART,PRCNCT,PRSD,PRSD_SV,"2025-05-18 21:39:33",468,273,244,29,0,272,1,500,227,179,93
3,ARGEŞ,"ŞCOALA PRIMARĂ DOBROGOSTEA",381,MERIŞANI,17101,1,PART,PRCNCT,PRSD,PRSD_SV,"2025-05-18 21:45:50",1069,583,507,75,1,575,8,1200,617,349,226
3,ARGEŞ,"ŞCOALA PRIMARĂ MALU VÂNĂT",382,MERIŞANI,17101,1,PART,PRCNCT,PRSD,PRSD_SV,"2025-05-18 21:33:56",731,368,321,47,0,365,3,800,432,314,51
3,ARGEŞ,"CĂMINUL CULTURAL VÎLCELELE",383,MERIŞANI,17101,1,PART,PRCNCT,PRSD,PRSD_SV,"2025-05-18 21:39:40",735,459,364,95,0,455,4,800,341,263,192
3,ARGEŞ,"ŞCOALA GIMNAZIALA NR.1 MICEȘTI",384,MICEŞTI,17209,1,PART,PRCNCT,PRSD,PRSD_SV,"2025-05-18 22:17:10",1551,941,850,91,0,918,23,1700,759,623,295
3,ARGEŞ,"ŞCOALA PRIMARA NR.2 PĂULEASCA",385,MICEŞTI,17209,1,PART,PRCNCT,PRSD,PRSD_SV,"2025-05-18 21:44:42",891,541,478,63,0,534,7,1000,459,396,138
3,ARGEŞ,"GRĂDINIȚA CU PROGRAM NORMAL PURCĂRENI",386,MICEŞTI,17209,1,PART,PRCNCT,PRSD,PRSD_SV,"2025-05-18 22:04:49",1404,840,764,75,1,829,11,1550,710,483,346
3,ARGEŞ,"CĂMINUL CULTURAL MIHĂEȘTI",387,MIHĂEŞTI,17254,1,PART,PRCNCT,PRSD,PRSD_SV,"2025-05-18 21:46:40",1147,474,406,68,0,465,9,1250,776,318,147
3,ARGEŞ,"GRADINITA CU PROGRAM NORMAL MIHAESTI",388,MIHĂEŞTI,17254,1,PART,PRCNCT,PRSD,PRSD_SV,"2025-05-18 21:38:43",909,442,385,57,0,437,5,950,508,315,122
3,ARGEŞ,"CĂMIN CULTURAL DRĂGHICI",389,MIHĂEŞTI,17254,1,PART,PRCNCT,PRSD,PRSD_SV,"2025-05-18 21:43:29",825,434,380,54,0,430,4,900,466,260,170
3,ARGEŞ,"CAMINUL CULTURAL FURNICOSI",390,MIHĂEŞTI,17254,1,PART,PRCNCT,PRSD,PRSD_SV,"2025-05-18 21:59:58",742,441,384,57,0,434,7,800,359,296,138
3,ARGEŞ,"CĂMIN CULTURAL VALEA-POPII",391,MIHĂEŞTI,17254,1,PART,PRCNCT,PRSD,PRSD_SV,"2025-05-18 21:39:37",739,474,400,73,1,473,1,850,376,283,190
3,ARGEŞ,"ȘCOALA CU CLASELE I-IV ȘI GRĂDINIȚA CU PROGRAM NORMAL VĂCAREA",392,MIHĂEŞTI,17254,1,PART,PRCNCT,PRSD,PRSD_SV,"2025-05-18 21:39:15",416,263,226,37,0,263,0,450,187,155,108
3,ARGEŞ,"CĂMIN CULTURAL MĂŢĂU",393,MIOARELE,17334,1,PART,PRCNCT,PRSD,PRSD_SV,"2025-05-18 21:52:06",954,526,490,35,1,518,8,1047,521,309,209
3,ARGEŞ,"ŞCOALA PRIMARĂ I-IV SUSLĂNEŞTI",394,MIOARELE,17334,1,PART,PRCNCT,PRSD,PRSD_SV,"2025-05-18 21:44:32",312,190,151,39,0,187,3,350,160,93,94
3,ARGEŞ,"CĂMIN CULTURAL MIROŞI",395,MIROŞI,17398,1,PART,PRCNCT,PRSD,PRSD_SV,"2025-05-18 21:41:14",1099,560,456,102,2,554,6,1200,640,303,251
3,ARGEŞ,"ŞCOALA SURDULEŞTI",396,MIROŞI,17398,1,PART,PRCNCT,PRSD,PRSD_SV,"2025-05-18 21:34:57",641,328,251,77,0,323,5,700,372,176,147
3,ARGEŞ,"ŞCOALA GENERALĂ CU CLASELE I-VIII MORĂREŞTI",397,MORĂREŞTI,17423,1,PART,PRCNCT,PRSD,PRSD_SV,"2025-05-18 21:49:39",807,617,446,171,0,607,10,900,283,410,197
3,ARGEŞ,"CAMINUL CULTURAL DEDULESTI",398,MORĂREŞTI,17423,1,PART,PRCNCT,PRSD,PRSD_SV,"2025-05-18 22:01:56",547,428,280,134,14,424,4,600,172,277,147
3,ARGEŞ,"CĂMIN CULTURAL MOŞOAIA",399,MOŞOAIA,17496,2,PART,PRCNCT,PRSD,PRSD_SV,"2025-05-19 00:00:55",1478,930,805,124,1,923,7,1600,670,550,373
3,ARGEŞ,"ŞCOALA CU CLASELE I-IV CIOCĂNĂI",400,MOŞOAIA,17496,1,PART,PRCNCT,PRSD,PRSD_SV,"2025-05-18 22:07:26",575,379,326,53,0,374,5,652,273,258,116
3,ARGEŞ,"ŞCOALA CU CLASELE I-VIII HINŢEŞTI",401,MOŞOAIA,17496,1,PART,PRCNCT,PRSD,PRSD_SV,"2025-05-18 21:47:38",1131,760,615,145,0,747,13,1250,490,386,361
3,ARGEŞ,"ŞCOALA CU CLASELE I-IV SMEURA",402,MOŞOAIA,17496,1,PART,PRCNCT,PRSD,PRSD_SV,"2025-05-18 22:23:59",1705,1153,977,176,0,1139,14,1850,697,567,572
3,ARGEŞ,"RESTAURANT CASTEL",403,MOŞOAIA,17496,1,PART,PRCNCT,PRSD,PRSD_SV,"2025-05-18 22:08:31",1671,1344,1074,269,1,1313,31,1800,456,458,855
3,ARGEŞ,"LICEUL TEHNOLOGIC LIVIU REBREANU",404,MOZĂCENI,17575,1,PART,PRCNCT,PRSD,PRSD_SV,"2025-05-18 21:49:28",1085,650,511,126,13,644,6,1200,550,395,249
3,ARGEŞ,"ŞCOALA GENERALĂ MIŞEI",405,MOZĂCENI,17575,1,PART,PRCNCT,PRSD,PRSD_SV,"2025-05-18 21:45:23",453,282,185,97,0,280,2,500,218,182,98
3,ARGEŞ,"SEDIUL PRIMĂRIEI VECHI - VILSĂNEȘTI",406,MUŞĂTEŞTI,17619,1,PART,PRCNCT,PRSD,PRSD_SV,"2025-05-18 21:25:15",445,242,172,70,0,237,5,501,259,136,101
3,ARGEŞ,"ŞCOALA GENERALĂ COSTEŞTI - VÎLSAN",407,MUŞĂTEŞTI,17619,1,PART,PRCNCT,PRSD,PRSD_SV,"2025-05-18 21:31:17",516,333,254,74,5,331,2,600,267,184,147
3,ARGEŞ,"ȘCOALA GIMNAZIALĂ CU CLASELE I-VIII",408,MUŞĂTEŞTI,17619,1,PART,PRCNCT,PRSD,PRSD_SV,"2025-05-18 22:13:29",1126,734,605,127,2,721,13,1200,466,393,328
3,ARGEŞ,"ŞCOALA GENERALĂ STROEŞTI",409,MUŞĂTEŞTI,17619,1,PART,PRCNCT,PRSD,PRSD_SV,"2025-05-18 21:30:50",821,500,423,77,0,493,7,900,400,311,182
3,ARGEŞ,"ŞCOALA NEGRAŞI",410,NEGRAŞI,17726,1,PART,PRCNCT,PRSD,PRSD_SV,"2025-05-18 21:34:02",542,313,222,91,0,312,1,600,287,190,122
3,ARGEŞ,"GRĂDINIŢA BÎRLOGU",411,NEGRAŞI,17726,1,PART,PRCNCT,PRSD,PRSD_SV,"2025-05-18 21:47:49",603,366,269,97,0,363,3,700,334,220,143
3,ARGEŞ,"ŞCOALA BUTA",412,NEGRAŞI,17726,1,PART,PRCNCT,PRSD,PRSD_SV,"2025-05-18 21:15:58",137,109,68,41,0,105,4,200,91,58,47
3,ARGEŞ,"ŞCOALA MOZACU",413,NEGRAŞI,17726,2,PART,PRCNCT,PRSD,PRSD_SV,"2025-05-18 23:13:24",215,139,94,45,0,138,1,250,111,67,71
3,ARGEŞ,"CAMINUL CULTURAL NUCSOARA",414,NUCŞOARA,17771,1,PART,PRCNCT,PRSD,PRSD_SV,"2025-05-18 21:33:54",327,269,182,79,8,264,5,400,131,153,111
3,ARGEŞ,"CĂMIN CULTURAL SBOGHIŢEŞTI",415,NUCŞOARA,17771,1,PART,PRCNCT,PRSD,PRSD_SV,"2025-05-18 21:39:43",311,230,178,46,6,230,0,350,120,154,76
3,ARGEŞ,"CĂMIN CULTURAL SLATINA",416,NUCŞOARA,17771,1,PART,PRCNCT,PRSD,PRSD_SV,"2025-05-18 21:42:39",432,305,247,52,6,304,1,500,195,218,86
3,ARGEŞ,"ȘCOALA GIMNAZIALĂ ”D. RĂDULESCU” OARJA",417,OARJA,17824,1,PART,PRCNCT,PRSD,PRSD_SV,"2025-05-18 22:00:05",1414,970,783,187,0,958,12,1550,580,636,322
3,ARGEŞ,"ŞCOALA PRIMARĂ OARJA SAT",418,OARJA,17824,1,PART,PRCNCT,PRSD,PRSD_SV,"2025-05-18 21:34:39",822,498,431,67,0,493,5,900,402,330,163
3,ARGEŞ,"SALA DE SPORT PIETROŞANI",419,PIETROŞANI,17851,1,PART,PRCNCT,PRSD,PRSD_SV,"2025-05-18 22:01:36",1353,802,710,91,1,798,4,1500,698,453,345
3,ARGEŞ,"PRIMĂRIE VECHE",420,PIETROŞANI,17851,1,PART,PRCNCT,PRSD,PRSD_SV,"2025-05-18 21:38:48",1238,742,662,79,1,728,14,1350,608,525,203
3,ARGEŞ,"ŞCOALAGENERALĂ CU CLASELE I-IV GĂNEŞTI",421,PIETROŞANI,17851,1,PART,PRCNCT,PRSD,PRSD_SV,"2025-05-18 21:30:36",491,299,260,39,0,294,5,550,251,205,89
3,ARGEŞ,"CĂMIN CULTURAL RETEVOIEŞTI",422,PIETROŞANI,17851,1,PART,PRCNCT,PRSD,PRSD_SV,"2025-05-18 21:41:41",1299,747,668,79,0,743,4,1400,653,473,270
3,ARGEŞ,"ŞCOALA CU CLASELE I-VIII POIANA LACULUI",423,"POIANA LACULUI",18028,1,PART,PRCNCT,PRSD,PRSD_SV,"2025-05-18 21:53:55",1341,902,747,153,2,897,5,1500,598,546,351
3,ARGEŞ,"ŞCOALA CU CLASELE I-IV CĂTUNAŞI",424,"POIANA LACULUI",18028,1,PART,PRCNCT,PRSD,PRSD_SV,"2025-05-18 21:22:09",428,357,263,94,0,355,2,500,143,227,128
3,ARGEŞ,"ŞCOALA CU CLASELE I-IV DEALUL VIILOR",425,"POIANA LACULUI",18028,1,PART,PRCNCT,PRSD,PRSD_SV,"2025-05-18 21:32:09",314,213,181,32,0,212,1,350,137,137,75
3,ARGEŞ,"ŞCOALA CU CLASELE I-IV DINCULEŞTI",426,"POIANA LACULUI",18028,1,PART,PRCNCT,PRSD,PRSD_SV,"2025-05-18 21:23:51",290,169,153,16,0,167,2,350,181,105,62
3,ARGEŞ,"ŞCOALA CU CLASELE I-IV GĂRDINEŞTI",427,"POIANA LACULUI",18028,1,PART,PRCNCT,PRSD,PRSD_SV,"2025-05-18 21:54:05",388,305,233,72,0,304,1,450,145,197,107
3,ARGEŞ,"ŞCOALA CU CLASELE I-IV METOFU",428,"POIANA LACULUI",18028,1,PART,PRCNCT,PRSD,PRSD_SV,"2025-05-18 21:27:58",291,170,144,26,0,168,2,350,180,141,27
3,ARGEŞ,"GRĂDINIŢA PĂDUROIU DIN DEAL",429,"POIANA LACULUI",18028,1,PART,PRCNCT,PRSD,PRSD_SV,"2025-05-18 21:41:29",761,488,433,55,0,482,6,850,362,350,132
3,ARGEŞ,"GRĂDINIŢA PĂDUROIU DIN VALE",430,"POIANA LACULUI",18028,1,PART,PRCNCT,PRSD,PRSD_SV,"2025-05-18 21:32:15",653,390,318,72,0,389,1,750,360,270,119
3,ARGEŞ,"ŞCOALA CU CLASELE I-VIII SĂMARA",431,"POIANA LACULUI",18028,2,PART,PRCNCT,PRSD,PRSD_SV,"2025-05-18 23:57:09",747,447,390,57,0,440,7,800,353,319,121
3,ARGEŞ,"CĂMIN CULTURAL POIENARI",432,"POIENARII DE ARGEŞ",17913,1,PART,PRCNCT,PRSD,PRSD_SV,"2025-05-18 21:35:45",568,410,331,77,2,404,6,650,240,161,243
3,ARGEŞ,"ŞCOALA GENERALĂ I-IV IOANICEŞTI",433,"POIENARII DE ARGEŞ",17913,1,PART,PRCNCT,PRSD,PRSD_SV,"2025-05-18 21:24:53",191,139,102,37,0,137,2,250,111,80,57
3,ARGEŞ,"ŞCOALA GIMNAZIALA NR.1 POIENARII DE MUSCEL",434,"POIENARII DE MUSCEL",17968,1,PART,PRCNCT,PRSD,PRSD_SV,"2025-05-18 21:47:04",1083,600,518,81,1,595,5,1200,600,340,255
3,ARGEŞ,"GRĂDINIŢA CU PROGRAM NORMAL NR.2 GROŞANI",435,"POIENARII DE MUSCEL",17968,1,PART,PRCNCT,PRSD,PRSD_SV,"2025-05-18 21:44:27",598,309,266,43,0,303,6,650,341,202,101
3,ARGEŞ,"ŞCOALA PRIMARĂ NR.1 JUGUR",436,"POIENARII DE MUSCEL",17968,1,PART,PRCNCT,PRSD,PRSD_SV,"2025-05-18 21:37:15",863,452,393,58,1,449,3,950,498,246,203
3,ARGEŞ,"ŞCOALA POPEŞTI",437,POPEŞTI,18162,2,PART,PRCNCT,PRSD,PRSD_SV,"2025-05-19 01:08:36",407,250,148,102,0,249,1,450,200,146,103
3,ARGEŞ,"ŞCOALA PURCĂRENI",438,POPEŞTI,18162,2,PART,PRCNCT,PRSD,PRSD_SV,"2025-05-19 01:13:15",531,279,233,46,0,279,0,600,321,190,89
3,ARGEŞ,"ŞCOALA SLOBOZIA",439,POPEŞTI,18162,1,PART,PRCNCT,PRSD,PRSD_SV,"2025-05-18 21:42:44",485,254,174,79,1,251,3,550,296,149,102
3,ARGEŞ,"CLUBUL TINERETULUI PRIBOIENI",440,PRIBOIENI,18242,1,PART,PRCNCT,PRSD,PRSD_SV,"2025-05-18 21:51:27",1465,1011,911,100,0,999,12,1600,589,585,414
3,ARGEŞ,"SALA DE SPORT",441,PRIBOIENI,18242,1,PART,PRCNCT,PRSD,PRSD_SV,"2025-05-18 21:43:48",1390,866,786,78,2,856,10,1500,634,533,323
3,ARGEŞ,"ŞCOALA CU CLASELE I-IV FURDUEŞTI",442,RĂTEŞTI,18331,1,PART,PRCNCT,PRSD,PRSD_SV,"2025-05-18 22:09:24",400,238,197,41,0,235,3,450,212,137,98
3,ARGEŞ,"ŞCOALA CU CLASELE I-IV MAVRODOLU",443,RĂTEŞTI,18331,1,PART,PRCNCT,PRSD,PRSD_SV,"2025-05-18 21:28:52",124,100,56,44,0,100,0,150,50,64,36
3,ARGEŞ,"ŞCOALA CU CLASELE I-IV NEJLOVELU",444,RĂTEŞTI,18331,1,PART,PRCNCT,PRSD,PRSD_SV,"2025-05-18 21:41:20",377,252,169,83,0,246,6,400,148,173,73
3,ARGEŞ,"ŞCOALA CU CLASELE I-IV PĂTULENI",445,RĂTEŞTI,18331,1,PART,PRCNCT,PRSD,PRSD_SV,"2025-05-18 21:34:54",765,450,399,51,0,447,3,850,400,313,134
3,ARGEŞ,"CĂMINUL CULTURAL TIGVENI",446,RĂTEŞTI,18331,1,PART,PRCNCT,PRSD,PRSD_SV,"2025-05-18 21:38:59",658,369,305,64,0,365,4,750,381,256,109
3,ARGEŞ,"CAMINUL CULTURAL RÂCA",447,RÂCA,20048,1,PART,PRCNCT,PRSD,PRSD_SV,"2025-05-18 21:33:28",767,489,348,141,0,486,3,850,361,195,291
3,ARGEŞ,"ŞCOALA GENERALA NR. 1 RECEA",448,RECEA,18411,1,PART,PRCNCT,PRSD,PRSD_SV,"2025-05-18 22:03:36",1349,743,568,174,1,732,11,1500,757,455,277
3,ARGEŞ,"ŞCOALA CU CLASELE I-VIII DEAGURILE",449,RECEA,18411,1,PART,PRCNCT,PRSD,PRSD_SV,"2025-05-18 21:48:52",693,399,302,95,2,396,3,750,351,253,143
3,ARGEŞ,"GRĂDINIŢA CU PROGRAM NORMAL ”MARIN ANGELESCU”, ROCIU",450,ROCIU,18475,1,PART,PRCNCT,PRSD,PRSD_SV,"2025-05-18 21:18:36",344,247,158,89,0,242,5,400,153,151,91
3,ARGEŞ,"GRĂDINIŢA CU PROGRAM NORMAL ”THEODOR ANGHEL”, GLIGANU DE JOS",451,ROCIU,18475,1,PART,PRCNCT,PRSD,PRSD_SV,"2025-05-18 21:34:37",335,261,158,102,1,258,3,380,119,153,105
3,ARGEŞ,"ŞCOALA PRIMARĂ ”ION BĂLTEANU”, GLIGANU DE SUS",452,ROCIU,18475,1,PART,PRCNCT,PRSD,PRSD_SV,"2025-05-18 21:34:57",515,370,272,98,0,367,3,570,200,213,154
3,ARGEŞ,"ŞCOALA GIMNAZIALĂ ”GHEORGHE MOCANU” PRIMAR, GIMNAZIAL, ŞERBĂNEŞTI",453,ROCIU,18475,1,PART,PRCNCT,PRSD,PRSD_SV,"2025-05-18 21:31:31",763,570,447,121,2,566,4,850,280,307,259
3,ARGEŞ,"LICEUL TEHNOLOGIC ” VICTOR SLĂVESCU” - SALA DE SPORT",454,RUCĂR,18527,1,PART,PRCNCT,PRSD,PRSD_SV,"2025-05-18 21:58:37",1183,741,670,70,1,737,4,1300,559,382,355
3,ARGEŞ,"ŞCOALA GENERALĂ NR.2 - CLASA NR. 1",455,RUCĂR,18527,1,PART,PRCNCT,PRSD,PRSD_SV,"2025-05-18 22:34:53",1001,729,561,145,23,727,2,1100,371,430,297
3,ARGEŞ,"ŞCOALA GIMNAZIALĂ ”NAE A GHICA” - SALA DE SPORT",456,RUCĂR,18527,1,PART,PRCNCT,PRSD,PRSD_SV,"2025-05-18 22:06:01",966,679,579,100,0,671,8,1100,421,361,310
3,ARGEŞ,"ȘCOALA GIMNAZIALĂ ”NAE A. GHICA” - SALA CLASĂ PREGĂTITOARE",457,RUCĂR,18527,1,PART,PRCNCT,PRSD,PRSD_SV,"2025-05-18 22:08:18",1332,892,786,103,3,880,12,1450,558,465,415
3,ARGEŞ,"ŞCOALA SĂTIC",458,RUCĂR,18527,1,PART,PRCNCT,PRSD,PRSD_SV,"2025-05-18 21:35:53",108,134,58,76,0,133,1,250,116,47,86
3,ARGEŞ,"CĂMINUL CULTURAL SĂLĂTRUCU CENTRU",459,SĂLĂTRUCU,18554,1,PART,PRCNCT,PRSD,PRSD_SV,"2025-05-18 21:30:18",1180,611,526,83,2,607,4,1300,689,387,220
3,ARGEŞ,"ŞCOALA CU CLASELE I-IV VĂLENI",460,SĂLĂTRUCU,18554,1,PART,PRCNCT,PRSD,PRSD_SV,"2025-05-18 21:28:16",520,306,261,45,0,300,6,600,294,224,76
3,ARGEŞ,CONTAINER,461,SĂPATA,18581,1,PART,PRCNCT,PRSD,PRSD_SV,"2025-05-18 21:24:23",205,161,106,55,0,160,1,250,89,97,63
3,ARGEŞ,"ŞCOALA GIMNAZIALĂ DUMITRU UDRESCU SĂPATA",462,SĂPATA,18581,1,PART,PRCNCT,PRSD,PRSD_SV,"2025-05-18 21:31:57",315,213,153,60,0,207,6,350,137,119,88
3,ARGEŞ,"ŞCOALA GENERALĂ DEALU BRADULUI",463,SĂPATA,18581,1,PART,PRCNCT,PRSD,PRSD_SV,"2025-05-18 21:17:38",133,106,65,41,0,105,1,150,44,73,32
3,ARGEŞ,"CĂMIN CULTURAL POPEŞTI",464,SĂPATA,18581,1,PART,PRCNCT,PRSD,PRSD_SV,"2025-05-18 21:37:29",649,456,346,108,2,451,5,700,244,296,155
3,ARGEŞ,"CLĂDIREA SOCIAL CULTURALĂ",465,"SCHITU GOLEŞTI",18670,1,PART,PRCNCT,PRSD,PRSD_SV,"2025-05-18 22:02:33",1529,856,782,72,2,846,10,1700,844,445,401
3,ARGEŞ,"CĂMIN CULTURAL LĂZĂREŞTI",466,"SCHITU GOLEŞTI",18670,1,PART,PRCNCT,PRSD,PRSD_SV,"2025-05-18 21:48:04",1755,832,759,73,0,821,11,1900,1068,557,264
3,ARGEŞ,"GRĂDINIȚA VALEA PECHII",467,"SCHITU GOLEŞTI",18670,1,PART,PRCNCT,PRSD,PRSD_SV,"2025-05-18 21:28:00",721,382,361,21,0,375,7,800,418,232,143
3,ARGEŞ,"ŞCOALA GEN.NR.2 CLASELE I-IV",468,SLOBOZIA,18741,1,PART,PRCNCT,PRSD,PRSD_SV,"2025-05-18 22:24:16",1800,830,747,83,0,823,7,1900,1070,619,204
3,ARGEŞ,"ȘCOALA GENERALĂ NR. 1, CLASELE I- IV",469,SLOBOZIA,18741,1,PART,PRCNCT,PRSD,PRSD_SV,"2025-05-18 21:34:19",234,170,87,83,0,169,1,250,80,109,60
3,ARGEŞ,"ȘOALA GENERALĂ DIN CENTRUL COMUNEI",470,SLOBOZIA,18741,1,PART,PRCNCT,PRSD,PRSD_SV,"2025-05-18 21:56:12",1562,820,754,66,0,815,5,1700,880,562,253
3,ARGEŞ,"GRĂDINIŢA CU PROGRAM PRELUNGIT STÎLPENI",471,STÂLPENI,18778,1,PART,PRCNCT,PRSD,PRSD_SV,"2025-05-18 22:09:41",1460,922,797,125,0,909,13,1600,678,558,351
3,ARGEŞ,"CĂMIN CULTURAL LIVEZENI",472,STÂLPENI,18778,1,PART,PRCNCT,PRSD,PRSD_SV,"2025-05-18 21:41:41",1206,769,666,103,0,758,11,1300,531,414,344
3,ARGEŞ,"CAMINUL CULTURAL RĂDEŞTI",473,STÂLPENI,18778,1,PART,PRCNCT,PRSD,PRSD_SV,"2025-05-18 22:02:26",1321,901,744,157,0,887,14,1450,549,478,409
3,ARGEŞ,"CĂMIN CULTURAL STOENEŞTI",474,STOENEŞTI,18858,1,PART,PRCNCT,PRSD,PRSD_SV,"2025-05-18 21:33:27",1022,630,512,118,0,625,5,1100,470,301,324
3,ARGEŞ,"CĂMIN CULTURAL BĂDENI",475,STOENEŞTI,18858,1,PART,PRCNCT,PRSD,PRSD_SV,"2025-05-18 21:51:26",1377,647,558,89,0,644,3,1500,853,347,297
3,ARGEŞ,"CĂMIN CULTURAL PIATRA",476,STOENEŞTI,18858,1,PART,PRCNCT,PRSD,PRSD_SV,"2025-05-18 21:41:34",392,224,193,31,0,224,0,450,226,126,98
3,ARGEŞ,"ŞCOALA GEN. VALEA BĂDENILOR",477,STOENEŞTI,18858,1,PART,PRCNCT,PRSD,PRSD_SV,"2025-05-18 21:40:10",595,280,256,24,0,278,2,650,370,188,90
3,ARGEŞ,"GRĂDINIȚA CU PROGRAM NORMAL STOLNICI",478,STOLNICI,18938,1,PART,PRCNCT,PRSD,PRSD_SV,"2025-05-18 22:00:47",1387,715,562,153,0,713,2,1500,785,483,230
3,ARGEŞ,"CĂMINUL CULTURAL FÎLFANI",479,STOLNICI,18938,1,PART,PRCNCT,PRSD,PRSD_SV,"2025-05-18 22:03:11",935,559,404,155,0,555,4,1000,441,327,228
3,ARGEŞ,"ŞCOALA GIMNAZIALĂ MARIN BRANIŞTE",480,SUSENI,19007,1,PART,PRCNCT,PRSD,PRSD_SV,"2025-05-18 21:42:29",864,575,452,122,1,570,5,950,375,348,222
3,ARGEŞ,"ŞCOALA PRIMARĂ IOAN RIZESCU",481,SUSENI,19007,1,PART,PRCNCT,PRSD,PRSD_SV,"2025-05-18 21:30:49",579,419,318,101,0,412,7,650,231,228,184
3,ARGEŞ,"ŞCOALA PRIMARĂ GHEOGHE TOMA",482,SUSENI,19007,1,PART,PRCNCT,PRSD,PRSD_SV,"2025-05-18 22:05:41",1021,675,538,137,0,661,14,1100,425,420,241
3,ARGEŞ,"ŞCOALA CU CLASELE I-VIII ŞTEFAN CEL MARE",483,"ŞTEFAN CEL MARE",19114,1,PART,PRCNCT,PRSD,PRSD_SV,"2025-05-18 21:37:04",651,323,268,55,0,320,3,700,377,228,92
3,ARGEŞ,"ŞCOALA CU CLASELE I-VIII ŞTEFAN CEL MARE",484,"ŞTEFAN CEL MARE",19114,1,PART,PRCNCT,PRSD,PRSD_SV,"2025-05-18 21:42:42",786,429,353,76,0,424,5,900,471,278,146
3,ARGEŞ,"ŞCOALA GLAVACIOC",485,"ŞTEFAN CEL MARE",19114,1,PART,PRCNCT,PRSD,PRSD_SV,"2025-05-18 21:23:05",325,182,133,49,0,181,1,400,218,120,61
3,ARGEŞ,"CĂMIN CULTURAL ŞUICI",486,ŞUICI,19141,1,PART,PRCNCT,PRSD,PRSD_SV,"2025-05-18 22:21:31",934,599,491,62,46,596,3,1000,401,327,269
3,ARGEŞ,"ŞCOALA IANCULEŞTI",487,ŞUICI,19141,1,PART,PRCNCT,PRSD,PRSD_SV,"2025-05-18 21:28:51",202,112,83,29,0,111,1,250,138,62,49
3,ARGEŞ,"ŞCOALA PRIMARĂ RUDENI",488,ŞUICI,19141,1,PART,PRCNCT,PRSD,PRSD_SV,"2025-05-18 21:33:52",626,403,349,54,0,399,4,700,297,199,200
3,ARGEŞ,"ŞCOALA PRIMARĂ VALEA CALULUI",489,ŞUICI,19141,1,PART,PRCNCT,PRSD,PRSD_SV,"2025-05-18 21:26:25",79,74,42,32,0,73,1,152,78,60,13
3,ARGEŞ,"CĂMIN CULTURAL TEIU",490,TEIU,19212,1,PART,PRCNCT,PRSD,PRSD_SV,"2025-05-18 21:29:56",860,570,408,161,1,565,5,950,380,360,205
3,ARGEŞ,"ŞCOALA GENERALĂ LEŞILE",491,TEIU,19212,1,PART,PRCNCT,PRSD,PRSD_SV,"2025-05-18 21:25:13",145,103,66,37,0,102,1,200,97,55,47
3,ARGEŞ,"PRIMĂRIA TIGVENI",492,TIGVENI,19249,1,PART,PRCNCT,PRSD,PRSD_SV,"2025-05-18 21:45:20",1523,825,734,91,0,792,33,1650,825,523,269
3,ARGEŞ,"ȘCOALA CU CLASELE I-IV BÎRSEȘTII DE JOS",493,TIGVENI,19249,1,PART,PRCNCT,PRSD,PRSD_SV,"2025-05-18 21:40:20",958,531,452,79,0,529,2,1050,519,330,199
3,ARGEŞ,"ŞCOALA CU CLASELE I-IV VLĂDEŞTI",494,TIGVENI,19249,1,PART,PRCNCT,PRSD,PRSD_SV,"2025-05-18 21:15:26",184,113,77,36,0,113,0,200,87,71,42
3,ARGEŞ,"SALA DE SPORT(ȘCOALA GENERALĂ NR. 1)",495,ŢIŢEŞTI,19338,1,PART,PRCNCT,PRSD,PRSD_SV,"2025-05-18 21:51:59",1299,741,673,68,0,730,11,1400,659,454,276
3,ARGEŞ,"ȘCOALA CU CLASELE I-IV ȚIȚEȘTI",496,ŢIŢEŞTI,19338,1,PART,PRCNCT,PRSD,PRSD_SV,"2025-05-18 21:31:06",1012,450,422,28,0,448,2,1100,650,294,154
3,ARGEŞ,"ȘCOALA CU CLASELE I-IV VALEA MĂNĂSTIRII",497,ŢIŢEŞTI,19338,1,PART,PRCNCT,PRSD,PRSD_SV,"2025-05-18 21:23:05",795,222,204,18,0,216,6,900,678,182,34
3,ARGEŞ,"ȘCOALA CU CLASELE I-IV VALEA STÂNII",498,ŢIŢEŞTI,19338,1,PART,PRCNCT,PRSD,PRSD_SV,"2025-05-18 21:28:45",846,547,486,61,0,539,8,950,403,265,274
3,ARGEŞ,"ŞCOALA I-VIII UDA",499,UDA,19392,1,PART,PRCNCT,PRSD,PRSD_SV,"2025-05-18 21:22:40",474,242,158,84,0,238,4,550,308,136,102
3,ARGEŞ,"ŞCOALA COTU",500,UDA,19392,1,PART,PRCNCT,PRSD,PRSD_SV,"2025-05-18 21:14:08",167,118,68,50,0,117,1,200,82,56,61
3,ARGEŞ,"CĂMIN CULTURAL GOVORA",501,UDA,19392,1,PART,PRCNCT,PRSD,PRSD_SV,"2025-05-18 21:16:17",366,199,138,61,0,197,2,400,201,127,70
3,ARGEŞ,"ŞCOALA I - IV SĂLIŞTEA",502,UDA,19392,1,PART,PRCNCT,PRSD,PRSD_SV,"2025-05-18 21:19:17",382,260,160,100,0,259,1,450,190,144,115
3,ARGEŞ,"CĂMIN CULTURAL",503,UNGHENI,19560,1,PART,PRCNCT,PRSD,PRSD_SV,"2025-05-18 21:38:16",521,342,235,103,4,338,4,600,253,215,123
3,ARGEŞ,"ŞCOALA COLŢU",504,UNGHENI,19560,1,PART,PRCNCT,PRSD,PRSD_SV,"2025-05-18 21:46:50",505,338,246,92,0,335,3,600,262,119,216
3,ARGEŞ,"SOCIETATEA AGRICOLA ALBINA",505,UNGHENI,19560,1,PART,PRCNCT,PRSD,PRSD_SV,"2025-05-18 22:10:45",983,609,456,153,0,603,6,1100,491,368,235
3,ARGEŞ,"CĂMINUL CULTURAL VALEA DANULUI",506,"VALEA DANULUI",19631,1,PART,PRCNCT,PRSD,PRSD_SV,"2025-05-18 21:45:00",1644,930,847,83,0,914,16,1750,820,547,367
3,ARGEŞ,"CĂMINUL CULTURAL VERNEŞTI",507,"VALEA DANULUI",19631,1,PART,PRCNCT,PRSD,PRSD_SV,"2025-05-18 21:40:26",855,515,484,31,0,510,5,950,435,342,168
3,ARGEŞ,"ŞCOALA GIMNAZIALĂ VALEA IAŞULUI",508,"VALEA IAŞULUI",19695,1,PART,PRCNCT,PRSD,PRSD_SV,"2025-05-18 21:42:52",818,537,410,63,64,531,6,900,363,282,249
3,ARGEŞ,"”LA REMUS POPESCU”",509,"VALEA IAŞULUI",19695,1,PART,PRCNCT,PRSD,PRSD_SV,"2025-05-18 21:21:26",178,115,92,23,0,115,0,200,85,72,43
3,ARGEŞ,"GRĂDINIŢA CERBURENI",510,"VALEA IAŞULUI",19695,1,PART,PRCNCT,PRSD,PRSD_SV,"2025-05-18 21:27:06",309,202,171,31,0,200,2,350,148,131,69
3,ARGEŞ,"ŞCOALA PRIMARĂ MUSTĂTEŞTI",511,"VALEA IAŞULUI",19695,1,PART,PRCNCT,PRSD,PRSD_SV,"2025-05-18 21:34:49",1068,654,593,61,0,646,8,1200,546,358,288
3,ARGEŞ,"CĂMIN CULTURAL VALEA MARE PRAVĂŢ",512,"VALEA MARE-PRAVĂŢ",13524,1,PART,PRCNCT,PRSD,PRSD_SV,"2025-05-18 21:29:46",1162,736,643,90,3,732,4,1300,564,308,424
3,ARGEŞ,"CĂMINUL CULTURAL BILCEŞTI",513,"VALEA MARE-PRAVĂŢ",13524,1,PART,PRCNCT,PRSD,PRSD_SV,"2025-05-18 21:44:55",661,383,344,39,0,380,3,750,367,191,189
3,ARGEŞ,"ŞCOALA GURA PRAVĂŢ",514,"VALEA MARE-PRAVĂŢ",13524,1,PART,PRCNCT,PRSD,PRSD_SV,"2025-05-18 21:29:59",1042,610,590,20,0,595,15,1150,540,449,146
3,ARGEŞ,"CĂMIN CULTURAL NĂMĂEŞTI",515,"VALEA MARE-PRAVĂŢ",13524,1,PART,PRCNCT,PRSD,PRSD_SV,"2025-05-18 21:30:52",452,367,274,92,1,363,4,500,133,191,172
3,ARGEŞ,"LICEUL TEHNOLOGIC VEDEA",516,VEDEA,19793,1,PART,PRCNCT,PRSD,PRSD_SV,"2025-05-18 21:58:20",722,591,327,202,62,584,7,800,209,297,287
3,ARGEŞ,"ŞCOALA FATA",517,VEDEA,19793,1,PART,PRCNCT,PRSD,PRSD_SV,"2025-05-18 21:19:30",393,262,180,82,0,261,1,450,188,140,121
3,ARGEŞ,"ŞCOALA FRĂTICI",518,VEDEA,19793,1,PART,PRCNCT,PRSD,PRSD_SV,"2025-05-18 21:26:53",316,196,139,57,0,194,2,350,154,126,68
3,ARGEŞ,"ŞCOALA IZVORU DE SUS",519,VEDEA,19793,1,PART,PRCNCT,PRSD,PRSD_SV,"2025-05-18 21:35:01",267,174,121,53,0,172,2,300,126,111,61
3,ARGEŞ,"ŞCOALA PRODANI-CONTAINER MODULAR",520,VEDEA,19793,1,PART,PRCNCT,PRSD,PRSD_SV,"2025-05-18 21:21:23",575,354,293,61,0,350,4,650,296,223,127
3,ARGEŞ,"ŞCOALA VAŢA",521,VEDEA,19793,1,PART,PRCNCT,PRSD,PRSD_SV,"2025-05-18 21:22:50",487,350,242,108,0,349,1,550,200,163,186
3,ARGEŞ,"CĂMINUL CULTURAL VLĂDEȘTI CENTRU",522,VLĂDEŞTI,19999,1,PART,PRCNCT,PRSD,PRSD_SV,"2025-05-18 22:14:07",1654,1039,937,102,0,1023,16,1800,761,703,320
3,ARGEŞ,"CĂMINUL CULTURAL VLĂDEȘTI DE SUS",523,VLĂDEŞTI,19999,1,PART,PRCNCT,PRSD,PRSD_SV,"2025-05-18 21:31:36",873,515,462,53,0,511,4,1000,485,394,117
3,ARGEŞ,"GRĂDINIȚA CU PROGRAM NORMAL MÂZGANA ” PICTOR ION MĂRGESCUˮ",524,VULTUREŞTI,20055,1,PART,PRCNCT,PRSD,PRSD_SV,"2025-05-18 21:34:45",751,302,269,33,0,294,8,850,548,218,76
3,ARGEŞ,"PRIMĂRIA VULTUREȘTI",525,VULTUREŞTI,20055,1,PART,PRCNCT,PRSD,PRSD_SV,"2025-05-18 21:31:27",801,476,414,62,0,471,5,800,324,298,173
3,ARGEŞ,"ȘCOALA PRIMARĂ BÂRZEȘTI",526,VULTUREŞTI,20055,1,PART,PRCNCT,PRSD,PRSD_SV,"2025-05-18 21:23:58",454,299,247,52,0,294,5,500,201,162,132
3,ARGEŞ,"ȘCOALA PRIMARĂ HULUBA",527,VULTUREŞTI,20055,1,PART,PRCNCT,PRSD,PRSD_SV,"2025-05-18 21:20:47",166,132,112,20,0,131,1,249,117,92,39
4,BACĂU,"ŞCOALA GIMNAZIALĂ NR. 9",1,"MUNICIPIUL BACĂU",20297,1,PART,PRCNCT,PRSD,PRSD_SV,"2025-05-18 21:51:36",1666,878,775,103,0,862,16,1806,928,338,524
4,BACĂU,"ŞCOALA GIMNAZIALĂ NR. 9",2,"MUNICIPIUL BACĂU",20297,1,PART,PRCNCT,PRSD,PRSD_SV,"2025-05-18 22:10:31",1239,742,632,99,11,731,11,1400,658,309,422
4,BACĂU,"ȘCOALA GIMNAZIALĂ ”GEORGETA MIRCEA CANCICOV”",3,"MUNICIPIUL BACĂU",20297,1,PART,PRCNCT,PRSD,PRSD_SV,"2025-05-18 21:32:57",1636,798,707,91,0,785,13,1800,1002,293,492
4,BACĂU,"ȘCOALA GIMNAZIALĂ ”GEORGETA MIRCEA CANCICOV”",4,"MUNICIPIUL BACĂU",20297,1,PART,PRCNCT,PRSD,PRSD_SV,"2025-05-18 21:29:25",1577,782,716,66,0,772,10,1700,918,282,490
4,BACĂU,"ȘCOALA GIMNAZIALĂ ”GEORGETA MIRCEA CANCICOV”",5,"MUNICIPIUL BACĂU",20297,1,PART,PRCNCT,PRSD,PRSD_SV,"2025-05-18 21:33:55",1407,722,670,40,12,713,9,1500,778,288,425
4,BACĂU,"ȘCOALA GIMNAZIALĂ ”GEORGETA MIRCEA CANCICOV”",6,"MUNICIPIUL BACĂU",20297,1,PART,PRCNCT,PRSD,PRSD_SV,"2025-05-18 21:45:02",1407,736,699,36,1,721,15,1500,764,266,455
4,BACĂU,"ȘCOALA GIMNAZIALĂ ”GEORGETA MIRCEA CANCICOV”",7,"MUNICIPIUL BACĂU",20297,1,PART,PRCNCT,PRSD,PRSD_SV,"2025-05-18 21:42:34",1203,562,507,55,0,547,15,1300,738,235,312
4,BACĂU,"ȘCOALA GIMNAZIALĂ ”GEORGETA MIRCEA CANCICOV”",8,"MUNICIPIUL BACĂU",20297,1,PART,PRCNCT,PRSD,PRSD_SV,"2025-05-18 21:42:48",1150,553,524,28,1,543,10,1300,747,187,356
4,BACĂU,"ȘCOALA GIMNAZIALĂ ”MIHAI DRĂGAN”",9,"MUNICIPIUL BACĂU",20297,1,PART,PRCNCT,PRSD,PRSD_SV,"2025-05-18 22:18:05",1311,628,587,41,0,617,11,1400,772,203,414
4,BACĂU,"ȘCOALA GIMNAZIALĂ ”MIHAI DRĂGAN”",10,"MUNICIPIUL BACĂU",20297,1,PART,PRCNCT,PRSD,PRSD_SV,"2025-05-18 21:32:42",1130,586,540,46,0,567,19,1300,714,201,366
4,BACĂU,"ȘCOALA GIMNAZIALĂ ”MIHAI DRĂGAN”",11,"MUNICIPIUL BACĂU",20297,2,PART,PRCNCT,PRSD,PRSD_SV,"2025-05-18 23:14:35",1156,613,549,64,0,602,11,1300,687,238,364
4,BACĂU,"ȘCOALA GIMNAZIALĂ ”MIHAI DRĂGAN”",12,"MUNICIPIUL BACĂU",20297,1,PART,PRCNCT,PRSD,PRSD_SV,"2025-05-18 21:20:50",1548,177,95,82,0,174,3,1700,1523,78,96
4,BACĂU,"ȘCOALA GIMNAZIALĂ ”MIHAI DRĂGAN”",13,"MUNICIPIUL BACĂU",20297,1,PART,PRCNCT,PRSD,PRSD_SV,"2025-05-18 21:56:30",1319,655,584,71,0,635,20,1500,845,257,378
4,BACĂU,"ȘCOALA GIMNAZIALĂ ”MIHAI DRĂGAN”",14,"MUNICIPIUL BACĂU",20297,1,PART,PRCNCT,PRSD,PRSD_SV,"2025-05-18 21:39:40",1338,638,599,39,0,633,5,1499,861,221,412
4,BACĂU,"GRĂDINIȚA CU PROGRAM PRELUNGIT ”CRAI NOU”",15,"MUNICIPIUL BACĂU",20297,1,PART,PRCNCT,PRSD,PRSD_SV,"2025-05-18 21:51:36",1040,502,423,79,0,501,1,1100,598,164,337
4,BACĂU,"GRĂDINIȚA CU PROGRAM PRELUNGIT ”CRAI NOU”",16,"MUNICIPIUL BACĂU",20297,1,PART,PRCNCT,PRSD,PRSD_SV,"2025-05-18 21:21:03",1020,487,420,67,0,482,5,1100,613,182,300
4,BACĂU,"ȘCOALA GIMNAZIALĂ ”MIHAIL SADOVEANU”",17,"MUNICIPIUL BACĂU",20297,1,PART,PRCNCT,PRSD,PRSD_SV,"2025-05-18 21:25:56",1288,645,548,97,0,636,9,1400,755,251,385
4,BACĂU,"ȘCOALA GIMNAZIALĂ ”MIHAIL SADOVEANU”",18,"MUNICIPIUL BACĂU",20297,1,PART,PRCNCT,PRSD,PRSD_SV,"2025-05-18 21:37:21",1851,792,734,58,0,777,15,2000,1208,310,467
4,BACĂU,"ȘCOALA GIMNAZIALĂ ”MIHAIL SADOVEANU”",19,"MUNICIPIUL BACĂU",20297,1,PART,PRCNCT,PRSD,PRSD_SV,"2025-05-18 21:53:00",1509,752,683,69,0,747,5,1700,948,302,445
4,BACĂU,"ȘCOALA GIMNAZIALĂ ”MIHAIL SADOVEANU”",20,"MUNICIPIUL BACĂU",20297,1,PART,PRCNCT,PRSD,PRSD_SV,"2025-05-18 22:12:01",1500,947,812,135,0,933,14,1600,653,361,572
4,BACĂU,"ADMINISTRAȚIA FINANȚELOR PUBLICE BACĂU",21,"MUNICIPIUL BACĂU",20297,1,PART,PRCNCT,PRSD,PRSD_SV,"2025-05-18 21:44:36",944,487,429,58,0,477,10,1000,513,180,297
4,BACĂU,"COLEGIUL NAŢIONAL ”GHEORGHE VRÂNCEANU”",22,"MUNICIPIUL BACĂU",20297,2,PART,PRCNCT,PRSD,PRSD_SV,"2025-05-19 00:50:02",1334,886,732,152,2,873,13,1500,614,251,622
4,BACĂU,"COLEGIUL NAŢIONAL ”GHEORGHE VRÂNCEANU”",23,"MUNICIPIUL BACĂU",20297,2,PART,PRCNCT,PRSD,PRSD_SV,"2025-05-18 23:31:06",1185,605,558,47,0,595,10,1300,695,203,392
4,BACĂU,"ŞCOALA GIMNAZIALĂ ”ALEXANDRU IOAN CUZA”",24,"MUNICIPIUL BACĂU",20297,1,PART,PRCNCT,PRSD,PRSD_SV,"2025-05-18 21:50:03",1169,725,569,155,1,713,12,1300,575,213,500
4,BACĂU,"COLEGIUL NAŢIONAL ”FERDINAND I”",25,"MUNICIPIUL BACĂU",20297,1,PART,PRCNCT,PRSD,PRSD_SV,"2025-05-18 21:47:00",1058,605,475,108,22,594,11,1200,595,235,359
4,BACĂU,"COLEGIUL NAŢIONAL ”FERDINAND I”",26,"MUNICIPIUL BACĂU",20297,1,PART,PRCNCT,PRSD,PRSD_SV,"2025-05-18 21:40:04",878,494,432,45,17,480,14,999,505,165,315
4,BACĂU,"COLEGIUL NAŢIONAL ”FERDINAND I”",27,"MUNICIPIUL BACĂU",20297,1,PART,PRCNCT,PRSD,PRSD_SV,"2025-05-18 21:27:52",1410,666,632,33,1,656,10,1600,934,202,454
4,BACĂU,"COLEGIUL NAȚIONAL ”FERDINAND I”",28,"MUNICIPIUL BACĂU",20297,1,PART,PRCNCT,PRSD,PRSD_SV,"2025-05-18 21:55:15",1492,774,735,39,0,764,10,1600,826,225,539
4,BACĂU,"COLEGIUL NAȚIONAL ”FERDINAND I”",29,"MUNICIPIUL BACĂU",20297,2,PART,PRCNCT,PRSD,PRSD_SV,"2025-05-19 00:43:58",1145,565,524,41,0,554,11,1311,746,215,339
4,BACĂU,"DIRECŢIA PENTRU AGRICULTURĂ BACĂU",30,"MUNICIPIUL BACĂU",20297,1,PART,PRCNCT,PRSD,PRSD_SV,"2025-05-18 21:47:57",1431,761,708,52,1,753,8,1600,839,250,503
4,BACĂU,"GRADINITA CU PROGRAM PRELUNGIT NR.29",31,"MUNICIPIUL BACĂU",20297,1,PART,PRCNCT,PRSD,PRSD_SV,"2025-05-18 21:23:51",1180,555,516,39,0,547,8,1300,745,218,329
4,BACĂU,"GRADINITA CU PROGRAM PRELUNGIT NR.29",32,"MUNICIPIUL BACĂU",20297,1,PART,PRCNCT,PRSD,PRSD_SV,"2025-05-18 21:34:27",1006,549,496,53,0,544,5,1100,551,168,376
4,BACĂU,"GRADINITA CU PROGRAM PRELUNGIT NR.29",33,"MUNICIPIUL BACĂU",20297,1,PART,PRCNCT,PRSD,PRSD_SV,"2025-05-18 21:39:52",1031,527,481,45,1,518,9,1100,573,169,349
4,BACĂU,"ȘCOALA GIMNAZIALĂ ”ION CREANGĂ”",34,"MUNICIPIUL BACĂU",20297,1,PART,PRCNCT,PRSD,PRSD_SV,"2025-05-18 21:33:02",1285,617,560,56,1,610,7,1400,783,243,367
4,BACĂU,"ȘCOALA GIMNAZIALĂ ”ION CREANGĂ”",35,"MUNICIPIUL BACĂU",20297,1,PART,PRCNCT,PRSD,PRSD_SV,"2025-05-18 21:35:15",1332,657,579,78,0,647,10,1500,843,278,369
4,BACĂU,"ȘCOALA GIMNAZIALĂ ”ION CREANGĂ”",36,"MUNICIPIUL BACĂU",20297,1,PART,PRCNCT,PRSD,PRSD_SV,"2025-05-18 21:50:15",1263,724,689,35,0,717,7,1400,676,248,469
4,BACĂU,"COLEGIUL ”N.VASILESCU-KARPEN”",37,"MUNICIPIUL BACĂU",20297,1,PART,PRCNCT,PRSD,PRSD_SV,"2025-05-18 21:42:13",1433,751,656,93,2,739,12,1600,849,254,485
4,BACĂU,"COLEGIUL ”N.VASILESCU-KARPEN”",38,"MUNICIPIUL BACĂU",20297,1,PART,PRCNCT,PRSD,PRSD_SV,"2025-05-18 22:12:32",1665,798,733,65,0,785,13,1800,1002,303,482
4,BACĂU,"COLEGIUL ”N.VASILESCU-KARPEN”",39,"MUNICIPIUL BACĂU",20297,1,PART,PRCNCT,PRSD,PRSD_SV,"2025-05-18 21:38:40",1235,316,241,75,0,312,4,1400,1084,110,202
4,BACĂU,"COLEGIUL ”N.VASILESCU-KARPEN”",40,"MUNICIPIUL BACĂU",20297,1,PART,PRCNCT,PRSD,PRSD_SV,"2025-05-18 21:50:39",1542,750,689,61,0,736,14,1700,950,302,434
4,BACĂU,"COLEGIUL TEHNOLOGIC ”ANGHEL SALIGNY” - CORPUL F",41,"MUNICIPIUL BACĂU",20297,1,PART,PRCNCT,PRSD,PRSD_SV,"2025-05-18 21:49:18",1623,901,707,69,125,882,19,1800,899,463,419
4,BACĂU,"COLEGIUL TEHNOLOGIC ”ANGHEL SALIGNY” - CORPUL F",42,"MUNICIPIUL BACĂU",20297,1,PART,PRCNCT,PRSD,PRSD_SV,"2025-05-18 22:04:56",1247,767,601,39,127,751,16,1400,633,370,381
4,BACĂU,"COLEGIUL ”MIHAI EMINESCU”",43,"MUNICIPIUL BACĂU",20297,1,PART,PRCNCT,PRSD,PRSD_SV,"2025-05-18 21:48:45",1023,740,494,124,122,719,21,1100,360,292,427
4,BACĂU,"COLEGIUL ”MIHAI EMINESCU”",44,"MUNICIPIUL BACĂU",20297,1,PART,PRCNCT,PRSD,PRSD_SV,"2025-05-18 22:07:53",1215,663,483,56,124,649,14,1300,637,325,324
4,BACĂU,"SCOALA GIMNAZIALĂ ”ALEXANDRU CEL BUN”",45,"MUNICIPIUL BACĂU",20297,1,PART,PRCNCT,PRSD,PRSD_SV,"2025-05-18 21:53:16",1184,667,610,56,1,658,9,1300,633,190,468
4,BACĂU,"GRĂDINIŢA CU PROGRAM PRELUNGIT NR.12",46,"MUNICIPIUL BACĂU",20297,1,PART,PRCNCT,PRSD,PRSD_SV,"2025-05-18 21:42:26",929,463,414,49,0,454,9,1000,537,160,294
4,BACĂU,"COLEGIUL NATIONAL ”VASILE ALECSANDRI”",47,"MUNICIPIUL BACĂU",20297,1,PART,PRCNCT,PRSD,PRSD_SV,"2025-05-18 22:11:40",805,444,378,65,1,441,3,900,456,154,287
4,BACĂU,"COLEGIUL NATIONAL ”VASILE ALECSANDRI”",48,"MUNICIPIUL BACĂU",20297,1,PART,PRCNCT,PRSD,PRSD_SV,"2025-05-18 21:43:05",790,428,381,46,1,424,4,900,472,143,281
4,BACĂU,"COLEGIUL NAȚIONAL DE ARTĂ ”GEORGE APOSTU”",49,"MUNICIPIUL BACĂU",20297,1,PART,PRCNCT,PRSD,PRSD_SV,"2025-05-18 21:34:40",684,460,342,117,1,453,7,792,332,131,322
4,BACĂU,"COLEGIUL NAȚIONAL PEDAGOGIC ”ŞTEFAN CEL MARE”",50,"MUNICIPIUL BACĂU",20297,2,PART,PRCNCT,PRSD,PRSD_SV,"2025-05-18 23:31:43",1236,796,597,75,124,791,5,1400,604,252,539
4,BACĂU,"COLEGIUL NAȚIONAL PEDAGOGIC ”ŞTEFAN CEL MARE”",51,"MUNICIPIUL BACĂU",20297,1,PART,PRCNCT,PRSD,PRSD_SV,"2025-05-18 21:50:10",1365,900,594,183,123,886,14,1500,600,345,541
4,BACĂU,"ŞCOALA GIMNAZIALĂ ”GEORGE BACOVIA”",52,"MUNICIPIUL BACĂU",20297,1,PART,PRCNCT,PRSD,PRSD_SV,"2025-05-18 21:27:41",1155,586,512,74,0,576,10,1300,714,229,347
4,BACĂU,"ŞCOALA GIMNAZIALĂ ”GEORGE BACOVIA”",53,"MUNICIPIUL BACĂU",20297,1,PART,PRCNCT,PRSD,PRSD_SV,"2025-05-18 21:38:49",1233,560,485,74,1,548,12,1400,840,225,323
4,BACĂU,"ȘCOALA GIMNAZIALĂ ”GEORGE BACOVIA”",54,"MUNICIPIUL BACĂU",20297,1,PART,PRCNCT,PRSD,PRSD_SV,"2025-05-18 21:46:25",958,502,447,52,3,494,8,1100,598,175,319
4,BACĂU,"ȘCOALA GIMNAZIALĂ ”GEORGE BACOVIA”",55,"MUNICIPIUL BACĂU",20297,1,PART,PRCNCT,PRSD,PRSD_SV,"2025-05-18 21:45:36",1124,521,463,58,0,516,5,1200,679,222,294
4,BACĂU,"ȘCOALA GIMNAZIALĂ ”GEORGE BACOVIA”",56,"MUNICIPIUL BACĂU",20297,1,PART,PRCNCT,PRSD,PRSD_SV,"2025-05-18 21:25:30",1155,508,478,30,0,499,9,1300,792,167,332
4,BACĂU,"ŞCOALA GIMNAZIALĂ ”DOMNIȚA MARIA”",57,"MUNICIPIUL BACĂU",20297,1,PART,PRCNCT,PRSD,PRSD_SV,"2025-05-18 22:05:38",1504,812,744,65,3,802,10,1700,888,432,370
4,BACĂU,"ŞCOALA GIMNAZIALĂ ”DOMNIȚA MARIA”",58,"MUNICIPIUL BACĂU",20297,1,PART,PRCNCT,PRSD,PRSD_SV,"2025-05-18 21:49:45",1247,607,565,42,0,593,14,1400,793,242,351
4,BACĂU,"ŞCOALA GIMNAZIALĂ ”DOMNIȚA MARIA”",59,"MUNICIPIUL BACĂU",20297,1,PART,PRCNCT,PRSD,PRSD_SV,"2025-05-18 21:42:37",1347,659,627,32,0,647,12,1500,841,242,405
4,BACĂU,"ŞCOALA GIMNAZIALĂ ”DOMNIȚA MARIA”",60,"MUNICIPIUL BACĂU",20297,1,PART,PRCNCT,PRSD,PRSD_SV,"2025-05-18 21:40:14",1285,652,592,60,0,641,11,1400,748,297,344
4,BACĂU,"ŞCOALA GIMNAZIALĂ ”DOMNIȚA MARIA”",61,"MUNICIPIUL BACĂU",20297,1,PART,PRCNCT,PRSD,PRSD_SV,"2025-05-18 21:45:30",1603,849,825,24,0,834,15,1800,951,335,499
4,BACĂU,"ȘCOALA GIMNAZIALĂ ”DR.ALEXANDRU ŞAFRAN”",62,"MUNICIPIUL BACĂU",20297,1,PART,PRCNCT,PRSD,PRSD_SV,"2025-05-18 22:22:39",1829,553,463,90,0,547,6,2000,1447,217,330
4,BACĂU,"ȘCOALA GIMNAZIALĂ ”DR.ALEXANDRU ŞAFRAN”",63,"MUNICIPIUL BACĂU",20297,1,PART,PRCNCT,PRSD,PRSD_SV,"2025-05-18 21:33:50",1554,630,580,50,0,623,7,1700,1070,260,363
4,BACĂU,"GRADINITA CU PROGRAM PRELUNGIT NR.24",64,"MUNICIPIUL BACĂU",20297,1,PART,PRCNCT,PRSD,PRSD_SV,"2025-05-18 21:41:45",1513,727,667,60,0,722,5,1700,973,298,424
4,BACĂU,"LICEUL TEHNOLOGIC ”DUMITRU MANGERON”",65,"MUNICIPIUL BACĂU",20297,1,PART,PRCNCT,PRSD,PRSD_SV,"2025-05-18 22:09:25",1258,614,576,37,1,604,10,1400,786,243,361
4,BACĂU,"LICEUL TEHNOLOGIC ”DUMITRU MANGERON”",66,"MUNICIPIUL BACĂU",20297,1,PART,PRCNCT,PRSD,PRSD_SV,"2025-05-18 21:35:49",1322,611,572,39,0,599,12,1500,889,272,327
4,BACĂU,"LICEUL TEHNOLOGIC ”DUMITRU MANGERON”",67,"MUNICIPIUL BACĂU",20297,1,PART,PRCNCT,PRSD,PRSD_SV,"2025-05-18 21:45:14",1504,678,537,140,1,666,12,1700,1022,290,376
4,BACĂU,"LICEUL TEHNOLOGIC ”DUMITRU MANGERON”",68,"MUNICIPIUL BACĂU",20297,1,PART,PRCNCT,PRSD,PRSD_SV,"2025-05-18 21:49:51",1600,587,537,50,0,578,9,1800,1213,214,364
4,BACĂU,"CLĂDIRE CĂMIN (CARE A APARȚINUT FOSTULUI COLEGIU TEHNIC ”LETEA”",69,"MUNICIPIUL BACĂU",20297,1,PART,PRCNCT,PRSD,PRSD_SV,"2025-05-18 21:47:40",1735,835,758,77,0,826,9,1900,1065,363,463
4,BACĂU,"CLĂDIRE CĂMIN (CARE A APARȚINUT FOSTULUI COLEGIU TEHNIC ”LETEA”",70,"MUNICIPIUL BACĂU",20297,1,PART,PRCNCT,PRSD,PRSD_SV,"2025-05-18 22:05:14",1489,670,630,40,0,663,7,1608,938,258,405
4,BACĂU,"CLĂDIRE CĂMIN (CARE A APARȚINUT FOSTULUI COLEGIU TEHNIC ”LETEA”",71,"MUNICIPIUL BACĂU",20297,1,PART,PRCNCT,PRSD,PRSD_SV,"2025-05-18 21:39:51",1578,671,639,32,0,664,7,1700,1029,285,379
4,BACĂU,"ŞCOALA GIMNAZIALĂ NR.10",72,"MUNICIPIUL BACĂU",20297,1,PART,PRCNCT,PRSD,PRSD_SV,"2025-05-18 21:39:55",1219,681,598,83,0,674,7,1300,619,231,443
4,BACĂU,"ȘCOALA GIMNAZIALĂ NR.10",73,"MUNICIPIUL BACĂU",20297,1,PART,PRCNCT,PRSD,PRSD_SV,"2025-05-18 21:59:50",1125,646,585,60,1,633,13,1200,554,218,415
4,BACĂU,"ȘCOALA GIMNAZIALĂ NR.10",74,"MUNICIPIUL BACĂU",20297,1,PART,PRCNCT,PRSD,PRSD_SV,"2025-05-18 21:20:42",750,385,365,20,0,383,2,800,415,115,268
4,BACĂU,"ŞCOALA PRIMARĂ NR.1",75,"MUNICIPIUL BACĂU",20297,1,PART,PRCNCT,PRSD,PRSD_SV,"2025-05-18 22:03:16",1731,515,490,25,0,510,5,1900,1385,271,239
4,BACĂU,"ŞCOALA PRIMARĂ NR.1",76,"MUNICIPIUL BACĂU",20297,1,PART,PRCNCT,PRSD,PRSD_SV,"2025-05-18 21:32:15",1534,479,440,39,0,470,9,1700,1221,253,217
4,BACĂU,"SCOALA GIMNAZIALĂ ”OCTAVIAN VOICU”",77,"MUNICIPIUL BACĂU",20297,1,PART,PRCNCT,PRSD,PRSD_SV,"2025-05-18 22:03:03",1053,486,415,71,0,483,3,1184,698,193,290
4,BACĂU,"SCOALA GIMNAZIALĂ ”OCTAVIAN VOICU”",78,"MUNICIPIUL BACĂU",20297,1,PART,PRCNCT,PRSD,PRSD_SV,"2025-05-18 21:42:06",962,452,426,26,0,447,5,1100,648,199,248
4,BACĂU,"SCOALA GIMNAZIALĂ ”OCTAVIAN VOICU”",79,"MUNICIPIUL BACĂU",20297,1,PART,PRCNCT,PRSD,PRSD_SV,"2025-05-18 21:37:20",1146,524,499,25,0,518,6,1300,776,230,288
4,BACĂU,"SCOALA GIMNAZIALĂ ”OCTAVIAN VOICU”",80,"MUNICIPIUL BACĂU",20297,1,PART,PRCNCT,PRSD,PRSD_SV,"2025-05-18 21:59:29",1090,459,437,22,0,454,5,1200,741,214,240
4,BACĂU,"GRĂDINIŢA CU PROGRAM PRELUNGIT ”DUMBRAVA MINUNATĂ”",81,"MUNICIPIUL BACĂU",20297,1,PART,PRCNCT,PRSD,PRSD_SV,"2025-05-18 21:39:41",1077,491,443,48,0,486,5,1200,709,177,309
4,BACĂU,"GRĂDINIŢA CU PROGRAM PRELUNGIT ”DUMBRAVA MINUNATĂ”",82,"MUNICIPIUL BACĂU",20297,1,PART,PRCNCT,PRSD,PRSD_SV,"2025-05-18 21:41:26",1048,487,441,44,2,481,6,1200,713,221,260
4,BACĂU,"GRĂDINIŢA CU PROGRAM PRELUNGIT NR.31",83,"MUNICIPIUL BACĂU",20297,1,PART,PRCNCT,PRSD,PRSD_SV,"2025-05-18 21:49:13",1032,490,421,69,0,481,9,1108,618,207,274
4,BACĂU,"ŞCOALA GIMNAZIALĂ ”NICOLAE IORGA”",84,"MUNICIPIUL BACĂU",20297,1,PART,PRCNCT,PRSD,PRSD_SV,"2025-05-18 22:03:35",1210,573,497,76,0,566,7,1300,727,221,345
4,BACĂU,"ŞCOALA GIMNAZIALĂ ”NICOLAE IORGA”",85,"MUNICIPIUL BACĂU",20297,1,PART,PRCNCT,PRSD,PRSD_SV,"2025-05-18 21:54:57",1083,472,435,36,1,468,4,1200,728,177,291
4,BACĂU,"ŞCOALA GIMNAZIALĂ ”NICOLAE IORGA”",86,"MUNICIPIUL BACĂU",20297,1,PART,PRCNCT,PRSD,PRSD_SV,"2025-05-18 21:48:29",1313,642,600,42,0,631,11,1400,758,251,380
4,BACĂU,"ŞCOALA GIMNAZIALĂ ”NICOLAE IORGA”",87,"MUNICIPIUL BACĂU",20297,1,PART,PRCNCT,PRSD,PRSD_SV,"2025-05-18 21:34:05",1334,614,588,25,1,606,8,1500,886,227,379
4,BACĂU,"GRĂDINIŢA CU PROGRAM PRELUNGIT NR.21 (CORPUL I)",88,"MUNICIPIUL BACĂU",20297,1,PART,PRCNCT,PRSD,PRSD_SV,"2025-05-18 21:33:56",811,445,394,51,0,438,7,900,455,108,330
4,BACĂU,"UNIVERSITATEA ”VASILE ALECSANDRI” - CORPUL A",89,"MUNICIPIUL BACĂU",20297,1,PART,PRCNCT,PRSD,PRSD_SV,"2025-05-18 21:54:55",950,642,450,192,0,627,15,1000,358,181,446
4,BACĂU,"UNIVERSITATEA ”VASILE ALECSANDRI” - CANTINĂ STUDENȚEASCĂ",90,"MUNICIPIUL BACĂU",20297,1,PART,PRCNCT,PRSD,PRSD_SV,"2025-05-18 21:37:39",815,426,352,73,1,417,9,874,448,146,271
4,BACĂU,"GRĂDNIŢA CU PROGRAM PRELUNGIT NR.30",91,"MUNICIPIUL BACĂU",20297,1,PART,PRCNCT,PRSD,PRSD_SV,"2025-05-18 21:35:46",979,454,405,49,0,445,9,1100,646,209,236
4,BACĂU,"GRĂDNIŢA CU PROGRAM PRELUNGIT NR.30",92,"MUNICIPIUL BACĂU",20297,1,PART,PRCNCT,PRSD,PRSD_SV,"2025-05-18 22:00:15",889,528,439,89,0,516,12,1000,472,235,281
4,BACĂU,"ŞCOALA GIMNAZIALĂ ”ION LUCA”",93,"MUNICIPIUL BACĂU",20297,1,PART,PRCNCT,PRSD,PRSD_SV,"2025-05-18 22:05:33",945,491,411,80,0,486,5,976,485,192,294
4,BACĂU,"ŞCOALA GIMNAZIALĂ ”ION LUCA”",94,"MUNICIPIUL BACĂU",20297,1,PART,PRCNCT,PRSD,PRSD_SV,"2025-05-18 21:32:35",1252,597,561,36,0,588,9,1400,803,238,350
4,BACĂU,"ŞCOALA GIMNAZIALĂ ”ION LUCA”",95,"MUNICIPIUL BACĂU",20297,1,PART,PRCNCT,PRSD,PRSD_SV,"2025-05-18 21:31:12",1200,504,475,29,0,496,8,1300,796,208,288
4,BACĂU,"ŞCOALA GIMNAZIALĂ ”ION LUCA”",96,"MUNICIPIUL BACĂU",20297,1,PART,PRCNCT,PRSD,PRSD_SV,"2025-05-18 21:29:04",1057,469,423,46,0,462,7,1200,731,200,262
4,BACĂU,"GRĂDINIŢA CU PROGRAM PRELUNGIT NR.27",97,"MUNICIPIUL BACĂU",20297,1,PART,PRCNCT,PRSD,PRSD_SV,"2025-05-18 21:34:56",1169,559,504,54,1,549,10,1300,741,211,338
4,BACĂU,"GRĂDINIŢA CU PROGRAM PRELUNGIT NR.27",98,"MUNICIPIUL BACĂU",20297,1,PART,PRCNCT,PRSD,PRSD_SV,"2025-05-18 21:42:43",1289,598,558,40,0,592,6,1400,802,252,340
4,BACĂU,"ŞCOALA GIMNAZIALĂ ”ALECU RUSSO”",99,"MUNICIPIUL BACĂU",20297,1,PART,PRCNCT,PRSD,PRSD_SV,"2025-05-18 21:33:25",1494,594,504,90,0,582,12,1700,1106,231,351
4,BACĂU,"ȘCOALA GIMNAZIALĂ ”ALECU RUSSO”",100,"MUNICIPIUL BACĂU",20297,1,PART,PRCNCT,PRSD,PRSD_SV,"2025-05-18 21:43:24",1464,606,558,48,0,600,6,1600,994,249,351
4,BACĂU,"ŞCOALA GIMNAZIALĂ ”ALECU RUSSO”",101,"MUNICIPIUL BACĂU",20297,1,PART,PRCNCT,PRSD,PRSD_SV,"2025-05-18 21:44:13",1721,728,691,37,0,723,5,1900,1172,281,442
4,BACĂU,"BAZINUL OLIMPIC BACĂU",102,"MUNICIPIUL BACĂU",20297,2,PART,PRCNCT,PRSD,PRSD_SV,"2025-05-19 00:02:20",1778,522,412,110,0,511,11,2000,1478,209,302
4,BACĂU,"BAZINUL OLIMPIC BACĂU",103,"MUNICIPIUL BACĂU",20297,1,PART,PRCNCT,PRSD,PRSD_SV,"2025-05-18 21:28:38",1334,362,238,124,0,359,3,1500,1138,157,202
4,BACĂU,"CASA NATIONALA DE ASIGURĂRI DE SĂNĂTATE BACĂU",104,"MUNICIPIUL BACĂU",20297,1,PART,PRCNCT,PRSD,PRSD_SV,"2025-05-18 21:49:02",1678,426,359,67,0,416,10,1800,1374,146,270
4,BACĂU,"CASA NATIONALĂ DE ASIGURĂRI DE SĂNĂTATE BACĂU",105,"MUNICIPIUL BACĂU",20297,1,PART,PRCNCT,PRSD,PRSD_SV,"2025-05-18 22:00:33",1205,370,300,69,1,368,2,1400,1030,119,249
4,BACĂU,"CENTRUL DE ZI ”CLUBUL PENSIONARILOR” BACĂU",106,"MUNICIPIUL BACĂU",20297,1,PART,PRCNCT,PRSD,PRSD_SV,"2025-05-18 21:48:19",1253,727,577,119,31,714,13,1400,673,204,510
4,BACĂU,"ŞCOALA GIMNAZIALĂ ”MIRON COSTIN”",107,"MUNICIPIUL BACĂU",20297,2,PART,PRCNCT,PRSD,PRSD_SV,"2025-05-19 00:24:23",1167,535,446,89,0,529,6,1300,765,260,269
4,BACĂU,"ŞCOALA GIMNAZIALĂ ”MIRON COSTIN”",108,"MUNICIPIUL BACĂU",20297,1,PART,PRCNCT,PRSD,PRSD_SV,"2025-05-18 21:58:52",1295,628,580,48,0,622,6,1400,772,229,393
4,BACĂU,"ŞCOALA GIMNAZIALĂ ”MIRON COSTIN”",109,"MUNICIPIUL BACĂU",20297,1,PART,PRCNCT,PRSD,PRSD_SV,"2025-05-18 21:45:51",1270,627,600,27,0,616,11,1400,773,210,406
4,BACĂU,"GRĂDINIŢA CU PROGRAM PRELUNGIT NR.23",110,"MUNICIPIUL BACĂU",20297,1,PART,PRCNCT,PRSD,PRSD_SV,"2025-05-18 22:24:16",1030,485,424,61,0,475,10,1101,616,189,286
4,BACĂU,"GRĂDINIŢA CU PROGRAM PRELUNGIT NR.23",111,"MUNICIPIUL BACĂU",20297,1,PART,PRCNCT,PRSD,PRSD_SV,"2025-05-18 22:10:08",1141,507,477,30,0,497,10,1310,803,180,317
4,BACĂU,"GRĂDINIŢA CU PROGRAM PRELUNGIT NR.33",112,"MUNICIPIUL BACĂU",20297,2,PART,PRCNCT,PRSD,PRSD_SV,"2025-05-18 23:28:47",1225,680,599,79,2,674,6,1300,620,216,458
4,BACĂU,"LICEUL CU PROGRAM SPORTIV",113,"MUNICIPIUL BACĂU",20297,1,PART,PRCNCT,PRSD,PRSD_SV,"2025-05-18 21:25:10",996,577,484,93,0,569,8,1100,523,188,381
4,BACĂU,"LICEUL CU PROGRAM SPORTIV",114,"MUNICIPIUL BACĂU",20297,1,PART,PRCNCT,PRSD,PRSD_SV,"2025-05-18 21:52:42",1107,705,571,134,0,694,11,1200,495,231,463
4,BACĂU,"LICEUL CU PROGRAM SPORTIV",115,"MUNICIPIUL BACĂU",20297,1,PART,PRCNCT,PRSD,PRSD_SV,"2025-05-18 21:35:15",1106,705,580,125,0,698,7,1200,495,179,519
4,BACĂU,"ŞCOALA GIMNAZIALĂ ”COSTANTIN PLATON”",116,"MUNICIPIUL BACĂU",20297,2,PART,PRCNCT,PRSD,PRSD_SV,"2025-05-19 00:42:45",1321,822,688,132,2,810,12,1500,678,244,566
4,BACĂU,"ŞCOALA GIMNAZIALĂ ”COSTANTIN PLATON”",117,"MUNICIPIUL BACĂU",20297,1,PART,PRCNCT,PRSD,PRSD_SV,"2025-05-18 22:02:56",1236,691,626,64,1,682,9,1400,709,211,471
4,BACĂU,"ŞCOALA GIMNAZIALĂ ”COSTANTIN PLATON”",118,"MUNICIPIUL BACĂU",20297,1,PART,PRCNCT,PRSD,PRSD_SV,"2025-05-18 21:52:10",1544,830,789,41,0,820,10,1700,870,240,580
4,BACĂU,"COLEGIUL ECONOMIC ”ION GHICA”",119,"MUNICIPIUL BACĂU",20297,1,PART,PRCNCT,PRSD,PRSD_SV,"2025-05-18 21:24:42",1281,744,663,81,0,737,7,1400,656,226,511
4,BACĂU,"COLEGIUL ECONOMIC ”ION GHICA”",120,"MUNICIPIUL BACĂU",20297,1,PART,PRCNCT,PRSD,PRSD_SV,"2025-05-18 21:39:29",988,566,338,228,0,556,10,1100,534,259,297
4,BACĂU,"LICEUL TEHNOLOGIC ”PETRU RAREȘ”",121,"MUNICIPIUL BACĂU",20297,1,PART,PRCNCT,PRSD,PRSD_SV,"2025-05-18 22:12:05",1528,811,732,79,0,797,14,1700,889,312,485
4,BACĂU,"LICEUL TEHNOLOGIC ”PETRU RAREȘ”",122,"MUNICIPIUL BACĂU",20297,1,PART,PRCNCT,PRSD,PRSD_SV,"2025-05-18 21:48:59",1278,616,580,36,0,611,5,1400,784,272,339
4,BACĂU,"ŞCOALA GIMNAZIALĂ ”NICU ENEA”",123,"MUNICIPIUL BACĂU",20297,1,PART,PRCNCT,PRSD,PRSD_SV,"2025-05-18 21:44:30",1362,743,683,60,0,738,5,1500,757,321,417
4,BACĂU,"ȘCOALA GIMNAZIALĂ ”NICU ENEA”",124,"MUNICIPIUL BACĂU",20297,1,PART,PRCNCT,PRSD,PRSD_SV,"2025-05-18 21:39:11",1309,703,645,58,0,698,5,1400,697,287,411
4,BACĂU,"ȘCOALA GIMNAZIALĂ ”NICU ENEA”",125,"MUNICIPIUL BACĂU",20297,1,PART,PRCNCT,PRSD,PRSD_SV,"2025-05-18 21:32:59",1579,868,813,54,1,857,11,1700,832,353,504
4,BACĂU,"LICEUL ”SPIRU HARET”",126,"MUNICIPIUL MOINEŞTI",20876,1,PART,PRCNCT,PRSD,PRSD_SV,"2025-05-18 21:44:27",836,374,333,41,0,367,7,900,526,158,209
4,BACĂU,"LICEUL ”SPIRU HARET”",127,"MUNICIPIUL MOINEŞTI",20876,1,PART,PRCNCT,PRSD,PRSD_SV,"2025-05-18 21:45:17",954,560,421,63,76,544,16,1000,440,264,280
4,BACĂU,"SALA DE SPORT A LICEULUI ”SPIRU HARET”",128,"MUNICIPIUL MOINEŞTI",20876,1,PART,PRCNCT,PRSD,PRSD_SV,"2025-05-18 21:56:01",1149,661,558,29,74,650,11,1300,639,253,397
4,BACĂU,"ŞCOALA ”ŞTEFAN LUCHIAN”",129,"MUNICIPIUL MOINEŞTI",20876,1,PART,PRCNCT,PRSD,PRSD_SV,"2025-05-18 21:41:50",1141,567,524,43,0,555,12,1300,733,248,307
4,BACĂU,"ŞCOALA „ŞTEFAN LUCHIAN”",130,"MUNICIPIUL MOINEŞTI",20876,1,PART,PRCNCT,PRSD,PRSD_SV,"2025-05-18 21:49:02",1131,581,540,41,0,570,11,1200,619,248,322
4,BACĂU,"BIBLIOTECA MUNICIPALĂ ” PROFESOR CONSTANTIN LOVIN”",131,"MUNICIPIUL MOINEŞTI",20876,1,PART,PRCNCT,PRSD,PRSD_SV,"2025-05-18 21:57:11",1121,586,544,42,0,577,9,1200,614,236,341
4,BACĂU,"ŞCOALA GEORGE ENESCU",132,"MUNICIPIUL MOINEŞTI",20876,1,PART,PRCNCT,PRSD,PRSD_SV,"2025-05-18 21:49:39",1569,686,614,71,1,664,22,1700,1014,367,297
4,BACĂU,"ŞCOALA GEORGE ENESCU",133,"MUNICIPIUL MOINEŞTI",20876,1,PART,PRCNCT,PRSD,PRSD_SV,"2025-05-18 21:46:03",1260,532,459,26,47,521,11,1400,868,315,206
4,BACĂU,"ŞCOALA GEORGE ENESCU",134,"MUNICIPIUL MOINEŞTI",20876,1,PART,PRCNCT,PRSD,PRSD_SV,"2025-05-18 21:49:17",1130,586,506,37,43,578,8,1200,614,258,320
4,BACĂU,"CLUBUL ELEVILOR",135,"MUNICIPIUL MOINEŞTI",20876,1,PART,PRCNCT,PRSD,PRSD_SV,"2025-05-18 21:47:54",1244,617,554,42,21,610,7,1400,783,388,222
4,BACĂU,"ŞCOALA TRISTAN TZARA",136,"MUNICIPIUL MOINEŞTI",20876,1,PART,PRCNCT,PRSD,PRSD_SV,"2025-05-18 21:34:37",1181,574,502,45,27,562,12,1300,726,292,270
4,BACĂU,"ŞCOALA TRISTAN TZARA",137,"MUNICIPIUL MOINEŞTI",20876,1,PART,PRCNCT,PRSD,PRSD_SV,"2025-05-18 21:32:55",1233,551,516,34,1,541,10,1400,849,296,245
4,BACĂU,"FOSTA ȘCOALĂ DE ARTE ȘI MESERII",138,"MUNICIPIUL MOINEŞTI",20876,1,PART,PRCNCT,PRSD,PRSD_SV,"2025-05-18 21:54:17",1145,484,461,23,0,473,11,1300,816,302,171
4,BACĂU,"ŞCOALA ”ALEXANDRU SEVER”",139,"MUNICIPIUL MOINEŞTI",20876,1,PART,PRCNCT,PRSD,PRSD_SV,"2025-05-18 21:53:41",620,310,279,30,1,303,7,700,390,167,136
4,BACĂU,"ŞCOALA ”ALEXANDRU SEVER”",140,"MUNICIPIUL MOINEŞTI",20876,1,PART,PRCNCT,PRSD,PRSD_SV,"2025-05-18 21:41:40",1094,517,498,19,0,512,5,1200,683,332,180
4,BACĂU,"ŞCOALA ”ALEXANDRU SEVER”",141,"MUNICIPIUL MOINEŞTI",20876,1,PART,PRCNCT,PRSD,PRSD_SV,"2025-05-18 21:44:16",1109,507,477,29,1,500,7,1200,693,343,157
4,BACĂU,"FOSTA ȘCOALĂ NR.8",142,"MUNICIPIUL MOINEŞTI",20876,1,PART,PRCNCT,PRSD,PRSD_SV,"2025-05-18 21:39:36",974,468,438,30,0,458,10,1100,632,262,196
4,BACĂU,"COLEGIUL NAŢIONAL ”GRIGORE C.MOISIL”",143,"MUNICIPIUL ONEŞTI",20563,1,PART,PRCNCT,PRSD,PRSD_SV,"2025-05-18 21:29:43",1287,580,560,19,1,574,6,1400,820,199,375
4,BACĂU,"COLEGIUL NAŢIONAL ”GRIGORE C.MOISIL”",144,"MUNICIPIUL ONEŞTI",20563,1,PART,PRCNCT,PRSD,PRSD_SV,"2025-05-18 21:42:44",995,487,408,79,0,483,4,1100,613,177,306
4,BACĂU,"COLEGIUL NAŢIONAL ”GRIGORE C.MOISIL”",145,"MUNICIPIUL ONEŞTI",20563,1,PART,PRCNCT,PRSD,PRSD_SV,"2025-05-18 21:50:03",1042,468,364,104,0,460,8,1100,632,189,271
4,BACĂU,"COLEGIUL NAŢIONAL ”GRIGORE C.MOISIL”",146,"MUNICIPIUL ONEŞTI",20563,1,PART,PRCNCT,PRSD,PRSD_SV,"2025-05-18 21:26:44",880,349,308,41,0,345,4,1000,651,155,190
4,BACĂU,"COLEGIUL NAȚIONAL ”GRIGORE C.MOISIL”",147,"MUNICIPIUL ONEŞTI",20563,2,PART,PRCNCT,PRSD,PRSD_SV,"2025-05-19 02:23:41",1313,596,553,22,21,582,14,1400,804,291,291
4,BACĂU,"ȘCOALA GIMNAZIALĂ ”SFÂNTUL VOIEVOD ȘTEFAN CEL MARE” (FOSTA NR.9)",148,"MUNICIPIUL ONEŞTI",20563,1,PART,PRCNCT,PRSD,PRSD_SV,"2025-05-18 21:27:36",1166,528,474,53,1,522,6,1300,772,187,335
4,BACĂU,"ȘCOALA GIMNAZIALĂ ”SFÂNTUL VOIEVOD ȘTEFAN CEL MARE”(FOSTA NR.9)",149,"MUNICIPIUL ONEŞTI",20563,1,PART,PRCNCT,PRSD,PRSD_SV,"2025-05-18 21:34:54",1298,603,563,40,0,595,8,1400,797,231,364
4,BACĂU,"ȘCOALA GIMNAZIALĂ ”SFÂNTUL VOIEVOD ȘTEFAN CEL MARE”(FOSTA NR.9)",150,"MUNICIPIUL ONEŞTI",20563,1,PART,PRCNCT,PRSD,PRSD_SV,"2025-05-18 21:35:31",1326,607,584,23,0,590,17,1500,893,264,326
4,BACĂU,"ȘCOALA GIMNAZIALĂ ”EMIL RACOVIȚĂ” (FOSTA NR.10)",151,"MUNICIPIUL ONEŞTI",20563,1,PART,PRCNCT,PRSD,PRSD_SV,"2025-05-18 21:40:26",1061,433,413,18,2,424,9,1200,767,189,235
4,BACĂU,"ȘCOALA GIMNAZIALĂ ”EMIL RACOVIȚĂ” (FOSTA NR.10)",152,"MUNICIPIUL ONEŞTI",20563,1,PART,PRCNCT,PRSD,PRSD_SV,"2025-05-18 21:36:50",1192,557,507,50,0,543,14,1300,743,242,301
4,BACĂU,"ȘCOALA GIMNAZIALĂ ”EMIL RACOVIȚĂ” (FOSTA NR.10)",153,"MUNICIPIUL ONEŞTI",20563,1,PART,PRCNCT,PRSD,PRSD_SV,"2025-05-18 21:55:00",943,416,343,73,0,409,7,1000,584,215,194
4,BACĂU,"ȘCOALA GIMNAZIALĂ ”EMIL RACOVIȚĂ” (FOSTA NR.10)",154,"MUNICIPIUL ONEŞTI",20563,1,PART,PRCNCT,PRSD,PRSD_SV,"2025-05-18 21:38:14",1410,656,615,40,1,646,10,1600,944,274,372
4,BACĂU,"ȘCOALA GIMNAZIALĂ ”EMIL RACOVIȚĂ” (FOSTA NR.10)",155,"MUNICIPIUL ONEŞTI",20563,1,PART,PRCNCT,PRSD,PRSD_SV,"2025-05-18 21:42:57",1485,652,624,28,0,647,5,1600,948,237,410
4,BACĂU,"LICEUL TEHNOLOGIC (FOSTA NR.7)",156,"MUNICIPIUL ONEŞTI",20563,1,PART,PRCNCT,PRSD,PRSD_SV,"2025-05-18 21:47:06",1156,469,392,77,0,459,10,1300,831,222,237
4,BACĂU,"LICEUL TEHNOLOGIC (FOSTA NR.7)",157,"MUNICIPIUL ONEŞTI",20563,1,PART,PRCNCT,PRSD,PRSD_SV,"2025-05-18 21:54:18",1044,456,425,31,0,444,12,1100,644,207,237
4,BACĂU,"LICEUL TEHNOLOGIC (FOSTA NR.7)",158,"MUNICIPIUL ONEŞTI",20563,1,PART,PRCNCT,PRSD,PRSD_SV,"2025-05-18 21:46:26",1121,515,478,37,0,509,6,1200,685,204,305
4,BACĂU,"LICEUL TEHNOLOGIC (FOSTA NR.7)",159,"MUNICIPIUL ONEŞTI",20563,1,PART,PRCNCT,PRSD,PRSD_SV,"2025-05-18 21:49:30",1084,501,474,26,1,491,10,1200,699,172,319
4,BACĂU,"LICEUL TEHNOLOGIC ”DACIA” (FOSTA NR.7)",160,"MUNICIPIUL ONEŞTI",20563,1,PART,PRCNCT,PRSD,PRSD_SV,"2025-05-18 21:40:10",1130,554,511,42,1,548,6,1200,646,180,368
4,BACĂU,"LICEUL TEHNOLOGIC ”DACIA” (FOSTA NR.7)",161,"MUNICIPIUL ONEŞTI",20563,1,PART,PRCNCT,PRSD,PRSD_SV,"2025-05-18 21:27:34",740,337,318,19,0,329,8,800,463,114,215
4,BACĂU,"COLEGIUL NAȚIONAL ”DIMITRIE CANTEMIR”",162,"MUNICIPIUL ONEŞTI",20563,1,PART,PRCNCT,PRSD,PRSD_SV,"2025-05-18 21:55:33",1247,622,561,61,0,612,10,1400,778,237,375
4,BACĂU,"LICEUL CU PROGRAM SPORTIV ”NADIA COMĂNECI”",163,"MUNICIPIUL ONEŞTI",20563,1,PART,PRCNCT,PRSD,PRSD_SV,"2025-05-18 21:43:12",1226,594,521,36,37,587,7,1300,706,208,379
4,BACĂU,"LICEUL CU PROGRAM SPORTIV ”NADIA COMĂNECI”",164,"MUNICIPIUL ONEŞTI",20563,1,PART,PRCNCT,PRSD,PRSD_SV,"2025-05-18 22:02:33",989,557,468,55,34,545,12,1100,543,197,348
4,BACĂU,"LICEUL CU PROGRAM SPORTIV ”NADIA COMĂNECI”",165,"MUNICIPIUL ONEŞTI",20563,1,PART,PRCNCT,PRSD,PRSD_SV,"2025-05-18 21:38:58",1061,504,436,33,35,494,10,1200,696,182,312
4,BACĂU,"LICEUL CU PROGRAM SPORTIV ”NADIA COMĂNECI”",166,"MUNICIPIUL ONEŞTI",20563,1,PART,PRCNCT,PRSD,PRSD_SV,"2025-05-18 21:31:28",1354,584,509,40,35,576,8,1500,916,269,307
4,BACĂU,"COLEGIU NAŢIONAL ”DIMITRIE CANTEMIR”",167,"MUNICIPIUL ONEŞTI",20563,1,PART,PRCNCT,PRSD,PRSD_SV,"2025-05-18 21:54:55",1172,569,519,50,0,561,8,1300,731,204,357
4,BACĂU,"COLEGIU NAŢIONAL ”DIMITRIE CANTEMIR”",168,"MUNICIPIUL ONEŞTI",20563,1,PART,PRCNCT,PRSD,PRSD_SV,"2025-05-18 21:35:57",1312,614,558,56,0,607,7,1400,786,232,375
4,BACĂU,"COLEGIU NAŢIONAL ”DIMITRIE CANTEMIR”",169,"MUNICIPIUL ONEŞTI",20563,1,PART,PRCNCT,PRSD,PRSD_SV,"2025-05-18 21:31:21",1145,526,471,55,0,517,9,1300,774,227,290
4,BACĂU,"LICEUL TEHNOLOGIC ”PETRU PONI”",170,"MUNICIPIUL ONEŞTI",20563,1,PART,PRCNCT,PRSD,PRSD_SV,"2025-05-18 21:59:58",846,413,367,46,0,408,5,900,487,160,248
4,BACĂU,"LICEUL TEHNOLOGIC ”PETRU PONI”",171,"MUNICIPIUL ONEŞTI",20563,1,PART,PRCNCT,PRSD,PRSD_SV,"2025-05-18 21:52:57",947,392,336,55,1,386,6,999,607,163,223
4,BACĂU,"ȘCOALA GIMNAZIALĂ ”GEORGE CĂLINESCU” (FOSTĂ NR.8)",172,"MUNICIPIUL ONEŞTI",20563,1,PART,PRCNCT,PRSD,PRSD_SV,"2025-05-18 21:58:33",1426,622,581,41,0,617,5,1600,978,237,380
4,BACĂU,"ȘCOALA GIMNAZIALĂ ”GEORGE CĂLINESCU” (FOSTĂ NR.8)",173,"MUNICIPIUL ONEŞTI",20563,1,PART,PRCNCT,PRSD,PRSD_SV,"2025-05-18 21:42:55",1253,614,574,40,0,602,12,1400,786,257,345
4,BACĂU,"COLEGIUL TEHNIC ”GHEORGHE ASACHI”",174,"MUNICIPIUL ONEŞTI",20563,1,PART,PRCNCT,PRSD,PRSD_SV,"2025-05-18 21:35:50",1316,640,557,83,0,634,6,1400,760,271,363
4,BACĂU,"COLEGIUL TEHNIC ”GHEORGHE ASACHI”",175,"MUNICIPIUL ONEŞTI",20563,1,PART,PRCNCT,PRSD,PRSD_SV,"2025-05-18 21:39:13",1138,525,481,44,0,516,9,1300,775,185,331
4,BACĂU,"LICEUL TEHNOLOGIC (TCR)",176,"MUNICIPIUL ONEŞTI",20563,1,PART,PRCNCT,PRSD,PRSD_SV,"2025-05-18 21:44:34",936,417,386,31,0,415,2,1000,583,190,225
4,BACĂU,"SERA BORZEŞTI",177,"MUNICIPIUL ONEŞTI",20563,1,PART,PRCNCT,PRSD,PRSD_SV,"2025-05-18 21:42:19",755,318,290,28,0,313,5,800,482,175,138
4,BACĂU,"CENTRUL SOCIAL SLOBOZIA",178,"MUNICIPIUL ONEŞTI",20563,1,PART,PRCNCT,PRSD,PRSD_SV,"2025-05-18 21:32:24",1049,473,441,32,0,467,6,1100,627,265,202
4,BACĂU,"PRIMĂRIA ORAŞ BUHUŞI",179,"ORAŞ BUHUŞI",20778,1,PART,PRCNCT,PRSD,PRSD_SV,"2025-05-18 21:36:05",1595,542,515,26,1,533,9,1800,1258,251,282
4,BACĂU,"LICEUL TEORETIC ”ION BORCEA”",180,"ORAŞ BUHUŞI",20778,1,PART,PRCNCT,PRSD,PRSD_SV,"2025-05-18 22:03:42",1348,469,438,31,0,464,5,1501,1032,255,209
4,BACĂU,"LICEUL TEORETIC ”ION BORCEA”",181,"ORAŞ BUHUŞI",20778,1,PART,PRCNCT,PRSD,PRSD_SV,"2025-05-18 21:57:54",1186,513,408,53,52,498,15,1300,787,273,225
4,BACĂU,"CASA DE CULTURĂ ”ELISABETA BOSTAN”",182,"ORAŞ BUHUŞI",20778,1,PART,PRCNCT,PRSD,PRSD_SV,"2025-05-18 21:42:22",1456,705,595,110,0,696,9,1600,895,441,255
4,BACĂU,"ŞCOALA GIMNAZIALĂ ”MIHAI EMINESCU”",183,"ORAŞ BUHUŞI",20778,1,PART,PRCNCT,PRSD,PRSD_SV,"2025-05-18 21:48:08",1474,569,549,20,0,560,9,1600,1031,267,293
4,BACĂU,"BIBLIOTECA ORĂŞENEASCĂ ”GEORGE BACOVIA”",184,"ORAŞ BUHUŞI",20778,1,PART,PRCNCT,PRSD,PRSD_SV,"2025-05-18 21:44:27",1630,568,524,38,6,552,16,1800,1232,276,276
4,BACĂU,"ŞCOALA GIMNAZIALĂ NR. 2 BUHUȘI",185,"ORAŞ BUHUŞI",20778,1,PART,PRCNCT,PRSD,PRSD_SV,"2025-05-18 21:52:31",1697,519,493,26,0,508,11,1900,1381,247,261
4,BACĂU,"COMPLEXUL DE SERVICII COMUNITARE ȘI CENTRUL DE CONSILIERE, INFORMARE ȘI SPRIJIN",186,"ORAŞ BUHUŞI",20778,1,PART,PRCNCT,PRSD,PRSD_SV,"2025-05-18 21:50:35",1758,482,467,15,0,473,9,1900,1418,281,192
4,BACĂU,"ŞCOALA GIMNAZIALĂ ŞTEFAN CEL MARE",187,"ORAŞ BUHUŞI",20778,1,PART,PRCNCT,PRSD,PRSD_SV,"2025-05-18 21:54:26",1514,485,447,37,1,471,14,1700,1215,268,203
4,BACĂU,"ŞCOALA GIMNAZIALĂ ”MIHAIL ANDREI”",188,"ORAŞ BUHUŞI",20778,1,PART,PRCNCT,PRSD,PRSD_SV,"2025-05-18 21:41:59",1591,547,516,31,0,535,12,1700,1153,316,219
4,BACĂU,"ŞCOALA GIMNAZIALĂ ”MIHAIL ANDREI”",189,"ORAŞ BUHUŞI",20778,1,PART,PRCNCT,PRSD,PRSD_SV,"2025-05-18 21:44:58",1644,584,551,33,0,578,6,1800,1216,300,278
4,BACĂU,"ŞCOALA GIMNAZIALĂ BUHUȘI",190,"ORAŞ BUHUŞI",20778,1,PART,PRCNCT,PRSD,PRSD_SV,"2025-05-18 21:36:01",1245,370,347,23,0,362,8,1400,1030,235,127
4,BACĂU,"CENTRUL 5",191,"ORAŞ COMĂNEŞTI",20821,1,PART,PRCNCT,PRSD,PRSD_SV,"2025-05-18 21:56:04",1071,613,540,72,1,594,19,1200,587,275,319
4,BACĂU,"ŞCOALA CIPRIAN PORUMBESCU",192,"ORAŞ COMĂNEŞTI",20821,1,PART,PRCNCT,PRSD,PRSD_SV,"2025-05-18 22:39:03",1187,524,506,18,0,515,9,1300,776,264,251
4,BACĂU,"ȘCOALA CIPRIAN PORUMBESCU",193,"ORAŞ COMĂNEŞTI",20821,1,PART,PRCNCT,PRSD,PRSD_SV,"2025-05-18 21:52:51",1177,562,499,12,51,557,5,1300,738,306,251
4,BACĂU,"SCOALA CIPRIAN PORUMBESCU",194,"ORAŞ COMĂNEŞTI",20821,1,PART,PRCNCT,PRSD,PRSD_SV,"2025-05-18 21:48:24",494,298,231,67,0,297,1,500,202,235,62
4,BACĂU,"BIBLIOTECA ORAŞULUI COMĂNEȘTI",195,"ORAŞ COMĂNEŞTI",20821,1,PART,PRCNCT,PRSD,PRSD_SV,"2025-05-18 22:01:00",1332,631,555,76,0,623,8,1500,869,286,337
4,BACĂU,"SCOALA LIVIU REBREANU",196,"ORAŞ COMĂNEŞTI",20821,1,PART,PRCNCT,PRSD,PRSD_SV,"2025-05-18 22:06:07",1513,639,632,7,0,631,8,1700,1061,306,325
4,BACĂU,"ŞCOALA LIVIU REBREANU",197,"ORAŞ COMĂNEŞTI",20821,1,PART,PRCNCT,PRSD,PRSD_SV,"2025-05-18 21:54:28",989,451,420,31,0,443,8,1100,649,190,253
4,BACĂU,"ŞCOALA LIVIU REBREANU",198,"ORAŞ COMĂNEŞTI",20821,1,PART,PRCNCT,PRSD,PRSD_SV,"2025-05-18 21:35:20",567,291,231,60,0,286,5,600,309,148,138
4,BACĂU,"PRIMĂRIA ORAȘULUI COMĂNEȘTI",199,"ORAŞ COMĂNEŞTI",20821,1,PART,PRCNCT,PRSD,PRSD_SV,"2025-05-18 22:06:46",1353,607,563,43,1,599,8,1500,893,298,301
4,BACĂU,"ŞCOALA ŞUPAN",200,"ORAŞ COMĂNEŞTI",20821,1,PART,PRCNCT,PRSD,PRSD_SV,"2025-05-18 21:55:32",1435,631,604,27,0,618,13,1600,969,461,157
4,BACĂU,"ŞCOALA LĂLOAIA",201,"ORAŞ COMĂNEŞTI",20821,1,PART,PRCNCT,PRSD,PRSD_SV,"2025-05-18 22:00:32",1171,627,578,48,1,619,8,1300,673,364,255
4,BACĂU,"ŞCOALA NR.5 BIS SUBLĂLOAIA",202,"ORAŞ COMĂNEŞTI",20821,1,PART,PRCNCT,PRSD,PRSD_SV,"2025-05-18 21:40:45",1446,726,677,48,1,719,7,1600,874,499,220
4,BACĂU,"ŞCOALA COSTACHI S.CIOCAN LĂLOAIA",203,"ORAŞ COMĂNEŞTI",20821,1,PART,PRCNCT,PRSD,PRSD_SV,"2025-05-18 21:53:07",674,333,305,28,0,328,5,700,367,207,121
4,BACĂU,"ŞCOALA NR.3 LEORDA",204,"ORAŞ COMĂNEŞTI",20821,2,PART,PRCNCT,PRSD,PRSD_SV,"2025-05-19 01:45:27",1301,654,625,29,0,638,16,1400,746,400,238
4,BACĂU,"ŞCOALA DIMITRIE GHICA ZĂVOI",205,"ORAŞ COMĂNEŞTI",20821,1,PART,PRCNCT,PRSD,PRSD_SV,"2025-05-18 22:06:42",1225,561,513,46,2,546,15,1300,739,273,273
4,BACĂU,"ŞCOALA VERMEŞTI",206,"ORAŞ COMĂNEŞTI",20821,1,PART,PRCNCT,PRSD,PRSD_SV,"2025-05-18 21:43:00",1016,428,396,32,0,423,5,1100,672,279,144
4,BACĂU,"CLĂDIRE ŞIPOTENI (FOSTĂ ȘCOALĂ ȘIPOTENI)",207,"ORAŞ COMĂNEŞTI",20821,1,PART,PRCNCT,PRSD,PRSD_SV,"2025-05-18 21:45:29",616,332,302,30,0,329,3,700,368,229,100
4,BACĂU,"ŞCOALA NR.2",208,"ORAŞ DĂRMĂNEŞTI",22166,1,PART,PRCNCT,PRSD,PRSD_SV,"2025-05-18 21:43:04",1308,624,601,23,0,617,7,1400,776,392,225
4,BACĂU,"ŞCOALA NR.2",209,"ORAŞ DĂRMĂNEŞTI",22166,1,PART,PRCNCT,PRSD,PRSD_SV,"2025-05-18 21:42:56",904,478,437,41,0,469,9,1000,522,249,220
4,BACĂU,"LICEUL TEHNOLOGIC DĂRMĂNEȘTI",210,"ORAŞ DĂRMĂNEŞTI",22166,1,PART,PRCNCT,PRSD,PRSD_SV,"2025-05-18 22:00:48",1489,699,643,54,2,690,9,1600,901,376,314
4,BACĂU,"SC MECANO ELECTRIC SERVICE SRL",211,"ORAŞ DĂRMĂNEŞTI",22166,1,PART,PRCNCT,PRSD,PRSD_SV,"2025-05-18 22:12:23",768,405,355,50,0,394,11,800,395,218,176
4,BACĂU,"ŞCOALA NR.3 DĂRMĂNEȘTI",212,"ORAŞ DĂRMĂNEŞTI",22166,1,PART,PRCNCT,PRSD,PRSD_SV,"2025-05-18 21:41:57",625,310,285,25,0,301,9,700,390,204,97
4,BACĂU,"ŞCOALA NR.3 DĂRMĂNEȘTI",213,"ORAŞ DĂRMĂNEŞTI",22166,1,PART,PRCNCT,PRSD,PRSD_SV,"2025-05-18 21:37:59",1138,406,395,11,0,394,12,1300,894,294,100
4,BACĂU,"GRĂDINIŢA SĂLĂTRUC",214,"ORAŞ DĂRMĂNEŞTI",22166,1,PART,PRCNCT,PRSD,PRSD_SV,"2025-05-18 21:51:56",661,345,324,21,0,338,7,700,355,236,102
4,BACĂU,"ŞCOALA CU CLASELE L-IV PĂGUBENI",215,"ORAŞ DĂRMĂNEŞTI",22166,1,PART,PRCNCT,PRSD,PRSD_SV,"2025-05-18 21:47:03",296,152,136,16,0,143,9,300,148,82,61
4,BACĂU,"PRIMĂRIA DĂRMĂNEȘTI",216,"ORAŞ DĂRMĂNEŞTI",22166,2,PART,PRCNCT,PRSD,PRSD_SV,"2025-05-19 03:31:16",1273,625,581,44,0,621,4,1400,775,422,199
4,BACĂU,"SCOALA CU CLASELE I-IV DĂRMĂNEASCA",217,"ORAŞ DĂRMĂNEŞTI",22166,1,PART,PRCNCT,PRSD,PRSD_SV,"2025-05-18 21:49:28",663,321,305,16,0,314,7,700,379,194,120
4,BACĂU,"SCOALA LAPOȘ",218,"ORAŞ DĂRMĂNEŞTI",22166,1,PART,PRCNCT,PRSD,PRSD_SV,"2025-05-18 21:30:38",785,385,363,22,0,381,4,900,515,304,77
4,BACĂU,"ŞCOALA CU CLASELE I-VIII PLOPU",219,"ORAŞ DĂRMĂNEŞTI",22166,1,PART,PRCNCT,PRSD,PRSD_SV,"2025-05-18 21:43:52",1256,550,497,36,17,543,7,1400,850,368,175
4,BACĂU,"SCOALA NR. 1 SLĂNIC",220,"ORAŞ SLĂNIC-MOLDOVA",20910,1,PART,PRCNCT,PRSD,PRSD_SV,"2025-05-18 22:19:03",1542,1072,577,491,4,1064,8,1700,628,472,592
4,BACĂU,"SCOALA GIMNAZIALA NR. 3",221,"ORAŞ SLĂNIC-MOLDOVA",20910,1,PART,PRCNCT,PRSD,PRSD_SV,"2025-05-18 22:00:00",1099,546,504,42,0,533,13,1200,654,355,178
4,BACĂU,"SCOALA NR. 2 CIRESOAIA",222,"ORAŞ SLĂNIC-MOLDOVA",20910,1,PART,PRCNCT,PRSD,PRSD_SV,"2025-05-18 21:48:52",1468,707,662,41,4,701,6,1600,893,458,243
4,BACĂU,"SCOALA GENERALA NR. 1",223,"ORAŞ TÂRGU OCNA",20965,1,PART,PRCNCT,PRSD,PRSD_SV,"2025-05-18 22:21:08",1360,815,612,95,108,804,11,1490,675,423,381
4,BACĂU,"CENTRUL CULTURAL ION TALIANU ( CASA DE CULTURA)",224,"ORAŞ TÂRGU OCNA",20965,1,PART,PRCNCT,PRSD,PRSD_SV,"2025-05-18 21:47:32",1316,866,635,231,0,855,11,1400,534,376,479
4,BACĂU,"COLEGIUL NATIONAL COSTACHE NEGRI",225,"ORAŞ TÂRGU OCNA",20965,1,PART,PRCNCT,PRSD,PRSD_SV,"2025-05-18 21:51:02",1373,822,633,145,44,781,41,1500,678,321,460
4,BACĂU,"GRADINITA NR. 2",226,"ORAŞ TÂRGU OCNA",20965,1,PART,PRCNCT,PRSD,PRSD_SV,"2025-05-18 22:07:42",1376,714,621,92,1,702,12,1500,786,317,385
4,BACĂU,"SCOALA GENERALA NR. 3",227,"ORAŞ TÂRGU OCNA",20965,1,PART,PRCNCT,PRSD,PRSD_SV,"2025-05-18 21:51:04",1041,492,464,27,1,483,9,1090,598,236,247
4,BACĂU,"SCOALA GENERALA NR. 3",228,"ORAŞ TÂRGU OCNA",20965,1,PART,PRCNCT,PRSD,PRSD_SV,"2025-05-18 21:37:15",893,478,433,44,1,475,3,1000,522,222,253
4,BACĂU,"CENTRU DE ZI PENTRU PERSOANE ADULTE CU DIZABILITATI",229,"ORAŞ TÂRGU OCNA",20965,1,PART,PRCNCT,PRSD,PRSD_SV,"2025-05-18 21:51:08",1119,671,561,52,58,661,10,1200,529,356,305
4,BACĂU,"SCOALA GENERALA NR. 5",230,"ORAŞ TÂRGU OCNA",20965,1,PART,PRCNCT,PRSD,PRSD_SV,"2025-05-18 21:34:36",749,356,333,23,0,351,5,800,444,208,143
4,BACĂU,"CAMIN CULTURAL",231,"ORAŞ TÂRGU OCNA",20965,1,PART,PRCNCT,PRSD,PRSD_SV,"2025-05-18 21:55:59",951,482,456,25,1,477,5,1000,518,279,198
4,BACĂU,"CONSILIUL LOCAL AGĂŞ",232,AGĂŞ,21007,1,PART,PRCNCT,PRSD,PRSD_SV,"2025-05-18 21:46:21",1281,609,559,49,1,596,13,1400,791,397,199
4,BACĂU,"CĂMINUL CULTURAL COȘNEA",233,AGĂŞ,21007,1,PART,PRCNCT,PRSD,PRSD_SV,"2025-05-18 21:42:25",320,168,134,34,0,167,1,282,114,33,134
4,BACĂU,"ŞCOALA CU CLASELE I-IV COTUMBA",234,AGĂŞ,21007,1,PART,PRCNCT,PRSD,PRSD_SV,"2025-05-18 21:44:46",764,375,301,61,13,372,3,800,425,238,134
4,BACĂU,"ŞCOALA GENERALĂ GOIOASA",235,AGĂŞ,21007,1,PART,PRCNCT,PRSD,PRSD_SV,"2025-05-18 21:30:46",662,311,277,34,0,308,3,700,389,198,110
4,BACĂU,"ŞCOALA GENERALĂ PRELUCI",236,AGĂŞ,21007,1,PART,PRCNCT,PRSD,PRSD_SV,"2025-05-18 21:33:25",976,470,424,46,0,464,6,1100,630,311,153
4,BACĂU,"ŞCOALA GENERALĂ SULŢA",237,AGĂŞ,21007,1,PART,PRCNCT,PRSD,PRSD_SV,"2025-05-18 21:39:41",775,398,341,57,0,391,7,800,402,273,118
4,BACĂU,"ŞCOALA NR.1 ARDEOANI",238,ARDEOANI,21098,1,PART,PRCNCT,PRSD,PRSD_SV,"2025-05-18 21:37:14",1274,775,552,223,0,765,10,1400,625,515,250
4,BACĂU,"ŞCOALA LEONTINEŞTI",239,ARDEOANI,21098,1,PART,PRCNCT,PRSD,PRSD_SV,"2025-05-18 21:30:20",663,387,332,55,0,376,11,700,313,248,128
4,BACĂU,"ŞCOALA GENERALA CU CLASELE I-VIII ASAU",240,ASĂU,21123,1,PART,PRCNCT,PRSD,PRSD_SV,"2025-05-18 21:38:33",834,418,376,42,0,415,3,900,482,263,152
4,BACĂU,"ŞCOALA GENERALĂ CU CLASELE I-VIII ASAU",241,ASĂU,21123,1,PART,PRCNCT,PRSD,PRSD_SV,"2025-05-18 21:46:00",843,435,393,42,0,431,4,900,465,274,157
4,BACĂU,"ŞCOALA GENERALĂ CU CLASELE I-VIII APA-ASĂU",242,ASĂU,21123,1,PART,PRCNCT,PRSD,PRSD_SV,"2025-05-18 21:38:11",641,332,300,32,0,330,2,700,368,248,82
4,BACĂU,"ŞCOALA GENERALĂ CU CLASELE I-VIII APA-ASĂU",243,ASĂU,21123,1,PART,PRCNCT,PRSD,PRSD_SV,"2025-05-18 21:37:50",560,289,264,25,0,288,1,600,311,216,72
4,BACĂU,"ŞCOALA CU CLASELE I-IV CIOBĂNUŞ",244,ASĂU,21123,1,PART,PRCNCT,PRSD,PRSD_SV,"2025-05-18 22:22:09",442,219,192,27,0,217,2,500,281,156,61
4,BACĂU,"CASA PRAZNICALA A PAROHIEI ADORMIREA MAICII DOMNULUI",245,ASĂU,21123,1,PART,PRCNCT,PRSD,PRSD_SV,"2025-05-18 21:40:57",616,328,300,28,0,320,8,700,372,221,99
4,BACĂU,"ŞCOALA CU CLASELE I-IV PĂLTINIŞ",246,ASĂU,21123,1,PART,PRCNCT,PRSD,PRSD_SV,"2025-05-18 21:29:36",484,263,239,24,0,259,4,500,237,206,53
4,BACĂU,"ŞCOALA CU CLASELE I-IV STRAJA",247,ASĂU,21123,1,PART,PRCNCT,PRSD,PRSD_SV,"2025-05-18 21:40:40",957,436,395,39,2,430,6,1110,674,301,129
4,BACĂU,"BIBLIOTECA PUBLICA ”CALISTRAT HOGAS” BALCANI",248,BALCANI,21196,1,PART,PRCNCT,PRSD,PRSD_SV,"2025-05-18 22:03:05",1073,383,354,29,0,379,4,1200,817,252,127
4,BACĂU,"GRĂDINIŢA FRUMOASA",249,BALCANI,21196,1,PART,PRCNCT,PRSD,PRSD_SV,"2025-05-18 21:57:57",975,341,306,35,0,337,4,1100,759,201,136
4,BACĂU,"GRĂDINIŢA FRUMOASA",250,BALCANI,21196,1,PART,PRCNCT,PRSD,PRSD_SV,"2025-05-18 21:36:26",1153,385,371,14,0,380,5,1300,915,220,160
4,BACĂU,"GRĂDINIŢA FRUMOASA",251,BALCANI,21196,1,PART,PRCNCT,PRSD,PRSD_SV,"2025-05-18 21:40:06",796,261,239,22,0,258,3,900,639,158,100
4,BACĂU,"ŞCOALA GIMNAZIALA LUDAŞI",252,BALCANI,21196,1,PART,PRCNCT,PRSD,PRSD_SV,"2025-05-18 21:43:27",739,279,254,25,0,279,0,800,521,197,82
4,BACĂU,"GRADINITA NR.2 SCHITU-FRUMOASA",253,BALCANI,21196,1,PART,PRCNCT,PRSD,PRSD_SV,"2025-05-18 21:28:46",620,229,211,17,1,228,1,700,471,162,66
4,BACĂU,"ŞCOALA GIMNAZIALA SCHITU-FRUMOASA",254,BALCANI,21196,1,PART,PRCNCT,PRSD,PRSD_SV,"2025-05-18 21:33:09",868,350,319,31,0,347,3,1000,650,246,101
4,BACĂU,"PRIMĂRIA BÎRSĂNEŞTI",255,BÂRSĂNEŞTI,21454,1,PART,PRCNCT,PRSD,PRSD_SV,"2025-05-18 21:38:33",1384,600,543,57,0,595,5,1500,900,368,227
4,BACĂU,"ŞCOALA GIMNAZIALĂ ALBELE",256,BÂRSĂNEŞTI,21454,1,PART,PRCNCT,PRSD,PRSD_SV,"2025-05-18 21:35:13",534,215,181,33,1,213,2,600,385,148,65
4,BACĂU,"ŞCOALA GIMNAZIALĂ BRĂTEŞTI",257,BÂRSĂNEŞTI,21454,1,PART,PRCNCT,PRSD,PRSD_SV,"2025-05-18 21:41:26",821,446,400,46,0,440,6,900,454,318,122
4,BACĂU,"ŞCOALA GIMNAZIALĂ CARACLĂU",258,BÂRSĂNEŞTI,21454,2,PART,PRCNCT,PRSD,PRSD_SV,"2025-05-19 01:09:16",857,441,394,47,0,435,6,900,459,257,178
4,BACĂU,"SCOALA GIMNAZIALA ”VASILE BORCEA”",259,BEREŞTI-BISTRIŢA,21249,1,PART,PRCNCT,PRSD,PRSD_SV,"2025-05-18 21:36:38",952,495,411,72,12,489,6,1000,505,314,175
4,BACĂU,"ŞCOALA GIMNAZIALĂ VASILE BORCEA BEREȘTI-BISTRIȚA",260,BEREŞTI-BISTRIŢA,21249,1,PART,PRCNCT,PRSD,PRSD_SV,"2025-05-18 21:13:38",228,151,110,41,0,151,0,300,149,96,55
4,BACĂU,"ŞCOALA CU CLASELE I-IV BRAD",261,BEREŞTI-BISTRIŢA,21249,1,PART,PRCNCT,PRSD,PRSD_SV,"2025-05-18 21:11:34",156,113,79,33,1,111,2,200,87,62,49
4,BACĂU,"SCOALA CU CLASELE I-IV PĂDURENI",262,BEREŞTI-BISTRIŢA,21249,1,PART,PRCNCT,PRSD,PRSD_SV,"2025-05-18 21:23:28",368,157,138,19,0,155,2,400,243,119,36
4,BACĂU,"PRIMĂRIA BEREȘTI TAZLĂU",263,BEREŞTI-TAZLĂU,21338,1,PART,PRCNCT,PRSD,PRSD_SV,"2025-05-18 21:47:26",884,394,363,30,1,391,3,1000,606,241,150
4,BACĂU,"ŞCOALA GENERALĂ BOŞOTENI",264,BEREŞTI-TAZLĂU,21338,1,PART,PRCNCT,PRSD,PRSD_SV,"2025-05-18 21:27:26",333,180,154,26,0,177,3,400,220,110,67
4,BACĂU,"ŞCOALA GENERALĂ ENĂCHEŞTI",265,BEREŞTI-TAZLĂU,21338,1,PART,PRCNCT,PRSD,PRSD_SV,"2025-05-18 21:25:32",614,311,270,41,0,307,4,700,389,184,123
4,BACĂU,"ŞCOALA GENERALĂ PRISACA",266,BEREŞTI-TAZLĂU,21338,1,PART,PRCNCT,PRSD,PRSD_SV,"2025-05-18 21:30:25",419,195,168,26,1,194,1,500,305,129,65
4,BACĂU,"ŞCOALA GENERALĂ ROMÂNEŞTI",267,BEREŞTI-TAZLĂU,21338,1,PART,PRCNCT,PRSD,PRSD_SV,"2025-05-18 21:36:20",375,213,190,23,0,211,2,400,187,115,96
4,BACĂU,"ŞCOALA GENERALĂ TESCANI",268,BEREŞTI-TAZLĂU,21338,1,PART,PRCNCT,PRSD,PRSD_SV,"2025-05-18 21:37:46",601,336,293,43,0,334,2,700,364,198,136
4,BACĂU,"ŞCOALA GENERALĂ TURLUIANU",269,BEREŞTI-TAZLĂU,21338,1,PART,PRCNCT,PRSD,PRSD_SV,"2025-05-18 21:59:46",1098,454,425,29,0,450,4,1200,746,338,112
4,BACĂU,"ŞCOALA CU CLASELE I-VIII ALEXANDRU CEL BUN BERZUNŢI",270,BERZUNŢI,21418,1,PART,PRCNCT,PRSD,PRSD_SV,"2025-05-18 21:54:23",1354,574,537,36,1,569,5,1500,926,383,186
4,BACĂU,"ŞCOALA CU CLASELE I-IV NR. 2 BERZUNŢI",271,BERZUNŢI,21418,1,PART,PRCNCT,PRSD,PRSD_SV,"2025-05-18 21:51:56",645,258,241,17,0,248,10,690,432,146,102
4,BACĂU,"SCOALA CU CLASELE I-IV BUDA",272,BERZUNŢI,21418,1,PART,PRCNCT,PRSD,PRSD_SV,"2025-05-18 21:34:59",413,192,157,35,0,188,4,500,308,132,56
4,BACĂU,"SCOALA CU CLASELE I-IV NR. 1 DRAGOMIR",273,BERZUNŢI,21418,1,PART,PRCNCT,PRSD,PRSD_SV,"2025-05-18 22:05:00",935,406,382,24,0,404,2,1000,594,267,137
4,BACĂU,"ŞCOALA CU CLASELE I-VIII NR.2 DRAGOMIR",274,BERZUNŢI,21418,1,PART,PRCNCT,PRSD,PRSD_SV,"2025-05-18 21:34:47",745,175,161,14,0,170,5,800,625,149,21
4,BACĂU,"ŞCOALA CU CLASELE I-VIII NR.1 BLĂGEŞTI",275,BLĂGEŞTI,21506,1,PART,PRCNCT,PRSD,PRSD_SV,"2025-05-18 21:36:21",951,391,356,35,0,386,5,1000,609,272,114
4,BACĂU,"ŞCOALA CU CLASELE .I-VIII NR.1 BLĂGEŞTI",276,BLĂGEŞTI,21506,1,PART,PRCNCT,PRSD,PRSD_SV,"2025-05-18 21:29:01",952,398,369,28,1,394,4,1000,602,237,157
4,BACĂU,"ŞCOALA CU CLASELE I-VIII NR.1 BUDA",277,BLĂGEŞTI,21506,1,PART,PRCNCT,PRSD,PRSD_SV,"2025-05-18 21:39:56",1598,623,580,43,0,616,7,1800,1177,421,195
4,BACĂU,"ŞCOALA CU CLASELE I-IV POIANA NEGUSTORULUI",278,BLĂGEŞTI,21506,1,PART,PRCNCT,PRSD,PRSD_SV,"2025-05-18 21:32:15",629,276,263,13,0,271,5,700,424,220,51
4,BACĂU,"ŞCOALA CU CLASELE I-IV ŢÎRDENII MARI",279,BLĂGEŞTI,21506,1,PART,PRCNCT,PRSD,PRSD_SV,"2025-05-18 21:26:03",550,225,198,27,0,221,4,600,375,136,85
4,BACĂU,"ŞCOALA CU CLASELE.I-VIII NR.1 VALEA LUI ION",280,BLĂGEŞTI,21506,1,PART,PRCNCT,PRSD,PRSD_SV,"2025-05-18 21:45:19",1150,555,511,44,0,550,5,1300,745,290,260
4,BACĂU,"ŞCOALA GIMNAZIALĂ BOGDĂNEŞTI",281,BOGDĂNEŞTI,21560,1,PART,PRCNCT,PRSD,PRSD_SV,"2025-05-18 21:43:57",887,370,336,33,1,366,4,1000,630,237,129
4,BACĂU,"ŞCOALA GIMNAZIALĂ BOGDĂNEŞTI",282,BOGDĂNEŞTI,21560,1,PART,PRCNCT,PRSD,PRSD_SV,"2025-05-18 21:27:17",801,355,330,25,0,349,6,900,545,243,106
4,BACĂU,"GRĂDINIŢA FILIPEŞTI",283,BOGDĂNEŞTI,21560,1,PART,PRCNCT,PRSD,PRSD_SV,"2025-05-18 21:29:13",517,257,213,44,0,254,3,600,343,133,121
4,BACĂU,"PRIMĂRIA BRUSTUROASA",284,BRUSTUROASA,21597,1,PART,PRCNCT,PRSD,PRSD_SV,"2025-05-18 21:49:10",1208,535,485,43,7,530,5,1300,765,350,180
4,BACĂU,"ŞCOALA PRIMARĂ CUCHINIŞ",285,BRUSTUROASA,21597,1,PART,PRCNCT,PRSD,PRSD_SV,"2025-05-18 21:29:11",634,261,220,39,2,255,6,700,439,157,98
4,BACĂU,"ŞCOALA PRIMARĂ CAMENCA",286,BRUSTUROASA,21597,1,PART,PRCNCT,PRSD,PRSD_SV,"2025-05-18 21:28:58",768,393,364,21,8,392,1,800,407,284,108
4,BACĂU,"ŞCOALA GIMNAZIALĂ BUCIUMI",287,BUCIUMI,26338,1,PART,PRCNCT,PRSD,PRSD_SV,"2025-05-18 21:43:29",1108,558,495,63,0,551,7,1200,642,326,225
4,BACĂU,"ŞCOALA GIMNAZIALĂ RĂCĂUŢI",288,BUCIUMI,26338,1,PART,PRCNCT,PRSD,PRSD_SV,"2025-05-18 21:58:31",1331,654,598,56,0,618,36,1500,846,310,308
4,BACĂU,"ŞCOALA GIMNAZIALA ”CONSTANTIN POPOVICI” BUHOCI(GRADINITA CU PROGRAM NORMAL BUHOCI)",289,BUHOCI,21668,1,PART,PRCNCT,PRSD,PRSD_SV,"2025-05-18 22:15:02",1436,698,586,111,1,689,9,1600,902,322,367
4,BACĂU,"GRĂDINIȚA BIJGHIR",290,BUHOCI,21668,1,PART,PRCNCT,PRSD,PRSD_SV,"2025-05-18 22:06:12",1121,457,400,57,0,448,9,1192,735,226,222
4,BACĂU,"GRĂDINIȚA BIJGHIR",291,BUHOCI,21668,1,PART,PRCNCT,PRSD,PRSD_SV,"2025-05-18 21:34:39",997,303,286,17,0,299,4,1100,797,160,139
4,BACĂU,"ŞCOALA CU CLASELE I-IV COTENI",292,BUHOCI,21668,1,PART,PRCNCT,PRSD,PRSD_SV,"2025-05-18 21:29:30",629,339,288,51,0,336,3,700,361,240,96
4,BACĂU,"CAMIN CULTURAL",293,CAŞIN,21720,1,PART,PRCNCT,PRSD,PRSD_SV,"2025-05-18 21:45:54",1447,689,636,53,0,679,10,1600,911,390,289
4,BACĂU,"CAMIN CULTURAL",294,CAŞIN,21720,1,PART,PRCNCT,PRSD,PRSD_SV,"2025-05-18 21:54:23",1425,620,569,51,0,610,10,1600,980,305,305
4,BACĂU,"GRĂDINIŢA CURIŢA",295,CAŞIN,21720,1,PART,PRCNCT,PRSD,PRSD_SV,"2025-05-18 21:37:07",585,304,271,33,0,303,1,600,296,165,138
4,BACĂU,"SCOALA GIMNAZIALA CAIUTI",296,CĂIUŢI,21757,1,PART,PRCNCT,PRSD,PRSD_SV,"2025-05-18 21:54:58",1299,555,511,43,1,546,9,1400,845,376,170
4,BACĂU,"ŞCOALA BLIDARI",297,CĂIUŢI,21757,1,PART,PRCNCT,PRSD,PRSD_SV,"2025-05-18 21:44:31",563,248,220,28,0,243,5,600,352,184,59
4,BACĂU,"ŞCOALA BOIŞTEA",298,CĂIUŢI,21757,1,PART,PRCNCT,PRSD,PRSD_SV,"2025-05-18 21:25:49",137,90,64,26,0,88,2,200,110,56,32
4,BACĂU,"ŞCOALA HELTIU",299,CĂIUŢI,21757,1,PART,PRCNCT,PRSD,PRSD_SV,"2025-05-18 21:47:40",285,158,129,29,0,157,1,298,140,106,51
4,BACĂU,"SCOALA PRIMARA MARCESTI",300,CĂIUŢI,21757,1,PART,PRCNCT,PRSD,PRSD_SV,"2025-05-18 21:27:54",123,69,50,19,0,69,0,100,31,55,14
4,BACĂU,"ŞCOALA POPENI",301,CĂIUŢI,21757,1,PART,PRCNCT,PRSD,PRSD_SV,"2025-05-18 21:38:28",674,346,311,35,0,342,4,700,354,216,126
4,BACĂU,"ŞCOALA PRALEA",302,CĂIUŢI,21757,1,PART,PRCNCT,PRSD,PRSD_SV,"2025-05-18 21:47:36",743,367,330,37,0,364,3,800,433,226,138
4,BACĂU,"ŞCOALA VRÂNCENI",303,CĂIUŢI,21757,1,PART,PRCNCT,PRSD,PRSD_SV,"2025-05-18 21:35:22",288,140,123,17,0,139,1,300,160,92,47
4,BACĂU,"GRĂDINIȚA NR.1 CLEJA",304,CLEJA,21855,1,PART,PRCNCT,PRSD,PRSD_SV,"2025-05-18 21:36:37",1158,437,401,36,0,430,7,1300,863,178,252
4,BACĂU,"GRĂDINIȚA NR.1 CLEJA",305,CLEJA,21855,1,PART,PRCNCT,PRSD,PRSD_SV,"2025-05-18 21:39:13",1156,413,389,24,0,407,6,1300,887,189,218
4,BACĂU,"ŞCOALA NR.2 CLEJA",306,CLEJA,21855,1,PART,PRCNCT,PRSD,PRSD_SV,"2025-05-18 21:50:34",1492,631,589,42,0,628,3,1600,969,274,354
4,BACĂU,"ŞCOALA SOMUŞCA",307,CLEJA,21855,1,PART,PRCNCT,PRSD,PRSD_SV,"2025-05-18 21:58:37",1180,491,469,22,0,482,9,1300,809,216,266
4,BACĂU,"ŞCOALA VALEA MICĂ",308,CLEJA,21855,1,PART,PRCNCT,PRSD,PRSD_SV,"2025-05-18 21:25:36",573,245,218,27,0,239,6,600,355,127,112
4,BACĂU,"ŞCOALA GIMNAZIALĂ COLONEŞTI",309,COLONEŞTI,21891,1,PART,PRCNCT,PRSD,PRSD_SV,"2025-05-18 21:44:52",1145,452,402,50,0,444,8,1300,848,277,167
4,BACĂU,"ŞCOALA PRIMARĂ SATU NOU",310,COLONEŞTI,21891,1,PART,PRCNCT,PRSD,PRSD_SV,"2025-05-18 21:21:50",278,126,111,15,0,125,1,300,174,92,33
4,BACĂU,"ŞCOALA GIMNAZIALĂ SPRIA",311,COLONEŞTI,21891,1,PART,PRCNCT,PRSD,PRSD_SV,"2025-05-18 21:22:16",267,141,104,37,0,139,2,300,159,55,84
4,BACĂU,"SCOALA GIMNAZIALA CU CLASELE I - VIII",312,CORBASCA,21971,1,PART,PRCNCT,PRSD,PRSD_SV,"2025-05-18 21:38:03",578,273,229,44,0,271,2,600,327,148,123
4,BACĂU,"ŞCOALA CU CLASELE.I-VIII BĂCIOIU",313,CORBASCA,21971,1,PART,PRCNCT,PRSD,PRSD_SV,"2025-05-18 21:20:51",1647,317,283,34,0,307,10,1800,1483,238,69
4,BACĂU,"ŞCOALA CU CLASELE I-VIII MARVILA",314,CORBASCA,21971,1,PART,PRCNCT,PRSD,PRSD_SV,"2025-05-18 21:34:12",464,168,149,19,0,165,3,500,332,99,66
4,BACĂU,"ŞCOALA CU CLASELE .I-IV ROGOAZA",315,CORBASCA,21971,1,PART,PRCNCT,PRSD,PRSD_SV,"2025-05-18 21:19:28",248,130,109,21,0,130,0,300,170,66,64
4,BACĂU,"ŞCOALA CU CLASELE I -IV SCARISOARA",316,CORBASCA,21971,1,PART,PRCNCT,PRSD,PRSD_SV,"2025-05-18 21:25:50",598,242,215,27,0,237,5,700,458,140,97
4,BACĂU,"ŞCOALA CU CLASELE.I-IV VÎLCELE",317,CORBASCA,21971,1,PART,PRCNCT,PRSD,PRSD_SV,"2025-05-18 21:27:19",498,156,141,15,0,151,5,600,444,97,54
4,BACĂU,"CĂMIN CULTURAL COȚOFĂNEȘTI",318,COŢOFĂNEŞTI,22059,1,PART,PRCNCT,PRSD,PRSD_SV,"2025-05-18 21:26:59",931,448,404,43,1,430,18,1000,552,269,161
4,BACĂU,"GRĂDINIȚA CU PROGRAM NORMAL BÎLCA",319,COŢOFĂNEŞTI,22059,1,PART,PRCNCT,PRSD,PRSD_SV,"2025-05-18 21:28:31",582,262,229,33,0,253,9,600,338,186,67
4,BACĂU,"CĂMINUL CULTURAL DIN SATUL BORŞANI",320,COŢOFĂNEŞTI,22059,1,PART,PRCNCT,PRSD,PRSD_SV,"2025-05-18 21:24:33",567,312,276,35,1,307,5,600,288,234,73
4,BACĂU,"ŞCOALA CU CLASELE I-IV TĂMĂSOAIA",321,COŢOFĂNEŞTI,22059,1,PART,PRCNCT,PRSD,PRSD_SV,"2025-05-18 21:23:00",402,172,151,21,0,168,4,400,228,143,25
4,BACĂU,"ŞCOALA GENERALĂ CU CLASELE I-IV DĂMIENEŞTI",322,DĂMIENEŞTI,22111,1,PART,PRCNCT,PRSD,PRSD_SV,"2025-05-18 21:28:09",442,242,200,42,0,238,4,500,258,124,114
4,BACĂU,"ŞCOALA GENERALĂ CU CLASELE I-VIII CĂLUGĂRENI",323,DĂMIENEŞTI,22111,1,PART,PRCNCT,PRSD,PRSD_SV,"2025-05-18 21:27:55",776,357,309,45,3,349,8,900,543,189,160
4,BACĂU,"GRADINITA CU PROGRAM NORMAL DRĂGEŞTI",324,DĂMIENEŞTI,22111,1,PART,PRCNCT,PRSD,PRSD_SV,"2025-05-18 21:19:51",244,130,83,47,0,128,2,300,170,60,68
4,BACĂU,"CAMIN CULTURAL DEALU MORII",325,"DEALU MORII",22237,1,PART,PRCNCT,PRSD,PRSD_SV,"2025-05-18 21:52:20",810,459,361,71,27,454,5,900,441,244,210
4,BACĂU,"ŞCOALA CU CLASELE I-IV CĂUIA",326,"DEALU MORII",22237,1,PART,PRCNCT,PRSD,PRSD_SV,"2025-05-18 21:26:14",481,280,227,40,13,277,3,500,220,171,106
4,BACĂU,"ŞCOALA CU CLASELE I-VIII NEGULEŞTI",327,"DEALU MORII",22237,1,PART,PRCNCT,PRSD,PRSD_SV,"2025-05-18 21:23:06",432,242,193,42,7,238,4,500,258,139,99
4,BACĂU,"ŞCOALA TĂVĂDĂRĂŞTI",328,"DEALU MORII",22237,1,PART,PRCNCT,PRSD,PRSD_SV,"2025-05-18 21:26:19",251,151,113,29,9,149,2,292,141,85,64
4,BACĂU,"SCOALA SCARLAT LONGHIN DOFTEANA",329,DOFTEANA,22380,1,PART,PRCNCT,PRSD,PRSD_SV,"2025-05-18 21:30:09",1630,723,677,46,0,718,5,1800,1077,498,220
4,BACĂU,"SCOALA SCARLAT LONGHIN DOFTEANA",330,DOFTEANA,22380,1,PART,PRCNCT,PRSD,PRSD_SV,"2025-05-18 21:23:55",1137,492,467,25,0,484,8,1200,708,340,144
4,BACĂU,"CAMINUL CULTURAL BOGATA",331,DOFTEANA,22380,1,PART,PRCNCT,PRSD,PRSD_SV,"2025-05-18 21:19:32",671,355,307,48,0,353,2,700,345,256,97
4,BACĂU,"SCOALA GENERALA CU CLASELE I-VIII CUCUIETI",332,DOFTEANA,22380,1,PART,PRCNCT,PRSD,PRSD_SV,"2025-05-18 21:25:56",862,425,400,25,0,417,8,1000,575,298,119
4,BACĂU,"SCOALA GENERALA CU CLASELE I-VIII CUCUIETI",333,DOFTEANA,22380,1,PART,PRCNCT,PRSD,PRSD_SV,"2025-05-18 21:20:55",1022,488,472,16,0,483,5,1100,612,347,136
4,BACĂU,"ŞCOALA GENERALA CU CLASELE I-VIII HĂGHIAC",334,DOFTEANA,22380,1,PART,PRCNCT,PRSD,PRSD_SV,"2025-05-18 21:24:56",1240,584,558,26,0,575,9,1400,816,444,131
4,BACĂU,"ŞCOALA GENERALA CU CLASELE I-VIII LARGA",335,DOFTEANA,22380,1,PART,PRCNCT,PRSD,PRSD_SV,"2025-05-18 21:28:07",1023,545,523,22,0,538,7,1100,555,405,133
4,BACĂU,"ŞCOALA GENERALA CU CLASELE I-IV SEACA",336,DOFTEANA,22380,1,PART,PRCNCT,PRSD,PRSD_SV,"2025-05-18 21:32:46",368,208,195,12,1,206,2,400,192,164,42
4,BACĂU,"ŞCOALA GENERALA CU CLASELE I-IV ŞTEFAN VODĂ",337,DOFTEANA,22380,1,PART,PRCNCT,PRSD,PRSD_SV,"2025-05-18 21:24:14",808,380,372,8,0,378,2,900,520,300,78
4,BACĂU,"GRĂDINIȚA FARAOANI",338,FARAOANI,22460,1,PART,PRCNCT,PRSD,PRSD_SV,"2025-05-18 21:57:21",1182,497,450,47,0,489,8,1300,803,190,299
4,BACĂU,"GRĂDINIȚA FARAOANI",339,FARAOANI,22460,1,PART,PRCNCT,PRSD,PRSD_SV,"2025-05-18 21:51:14",1286,516,496,20,0,509,7,1400,884,214,295
4,BACĂU,"ŞCOALA GIMNAZIALA NR.2 FARAOANI",340,FARAOANI,22460,1,PART,PRCNCT,PRSD,PRSD_SV,"2025-05-18 21:50:27",1137,464,416,48,0,463,1,1200,736,184,279
4,BACĂU,"ŞCOALA GIMNAZIALA NR.2 FARAOANI",341,FARAOANI,22460,1,PART,PRCNCT,PRSD,PRSD_SV,"2025-05-18 21:34:55",788,337,316,21,0,333,4,900,563,132,201
4,BACĂU,"PRIMĂRIA FILIPENI",342,FILIPENI,22488,1,PART,PRCNCT,PRSD,PRSD_SV,"2025-05-18 21:22:37",508,297,231,65,1,293,4,600,303,136,157
4,BACĂU,"ŞCOALA CU CLASELE I-IV FRUNTEŞTI",343,FILIPENI,22488,1,PART,PRCNCT,PRSD,PRSD_SV,"2025-05-18 21:17:18",331,187,157,30,0,185,2,400,213,95,90
4,BACĂU,"ŞCOALA CU CLASELE I-IV MĂRĂŞTI",344,FILIPENI,22488,1,PART,PRCNCT,PRSD,PRSD_SV,"2025-05-18 21:23:39",545,249,199,50,0,247,2,600,351,154,93
4,BACĂU,"ȘCOALA PRIMARĂ VALEA BOȚULUI",345,FILIPENI,22488,1,PART,PRCNCT,PRSD,PRSD_SV,"2025-05-18 21:16:02",247,105,86,19,0,104,1,300,195,73,31
4,BACĂU,"CASA DE CULTURA ”RADU BELIGAN” FILIPESTI",346,FILIPEŞTI,22576,1,PART,PRCNCT,PRSD,PRSD_SV,"2025-05-18 21:37:49",855,445,342,102,1,437,8,900,455,222,215
4,BACĂU,"CĂMINUL CULTURAL BOANŢA",347,FILIPEŞTI,22576,1,PART,PRCNCT,PRSD,PRSD_SV,"2025-05-18 21:32:10",245,146,107,39,0,143,3,300,154,87,56
4,BACĂU,"ŞCOALA CÎRLIGI",348,FILIPEŞTI,22576,1,PART,PRCNCT,PRSD,PRSD_SV,"2025-05-18 21:27:20",855,419,339,80,0,419,0,900,481,279,140
4,BACĂU,"ŞCOALA GALBENI",349,FILIPEŞTI,22576,1,PART,PRCNCT,PRSD,PRSD_SV,"2025-05-18 21:25:12",657,294,240,54,0,291,3,700,406,172,119
4,BACĂU,"CENTRU CULTURAL HÂRLEȘTI",350,FILIPEŞTI,22576,1,PART,PRCNCT,PRSD,PRSD_SV,"2025-05-18 21:15:01",663,390,335,54,1,383,7,700,310,260,123
4,BACĂU,"CENTRU MULTIFUNCȚIONAL ONIȘCANI",351,FILIPEŞTI,22576,1,PART,PRCNCT,PRSD,PRSD_SV,"2025-05-18 21:30:01",412,197,161,36,0,194,3,400,203,113,81
4,BACĂU,"PRIMĂRIA GĂICEANA",352,GĂICEANA,22665,1,PART,PRCNCT,PRSD,PRSD_SV,"2025-05-18 21:41:10",691,325,265,60,0,321,4,800,475,191,130
4,BACĂU,"ŞCOALA ARINI",353,GĂICEANA,22665,1,PART,PRCNCT,PRSD,PRSD_SV,"2025-05-18 21:44:04",941,415,392,23,0,410,5,1000,585,249,161
4,BACĂU,"ŞCOALA HUŢU",354,GĂICEANA,22665,1,PART,PRCNCT,PRSD,PRSD_SV,"2025-05-18 21:25:58",437,215,183,32,0,209,6,500,285,129,80
4,BACĂU,"ŞCOALA CU CL.I-VIII GÎRLENII DE SUS",355,GÂRLENI,22781,1,PART,PRCNCT,PRSD,PRSD_SV,"2025-05-18 21:48:59",1583,673,616,57,0,668,5,1700,1027,379,289
4,BACĂU,"ŞCOALA CU CL.I-VIII GÎRLENI",356,GÂRLENI,22781,1,PART,PRCNCT,PRSD,PRSD_SV,"2025-05-18 22:02:19",1085,467,429,38,0,458,9,1200,733,291,167
4,BACĂU,"ŞCOALA CU CL.I-VIII GÎRLENI",357,GÂRLENI,22781,1,PART,PRCNCT,PRSD,PRSD_SV,"2025-05-18 21:54:46",1004,445,404,41,0,440,5,1100,655,265,175
4,BACĂU,"ŞCOALA CU CL.I-VIII LESPEZI",358,GÂRLENI,22781,1,PART,PRCNCT,PRSD,PRSD_SV,"2025-05-18 21:37:27",795,330,292,38,0,321,9,900,570,157,164
4,BACĂU,"ŞCOALA CU CL.I-VIII LESPEZI",359,GÂRLENI,22781,1,PART,PRCNCT,PRSD,PRSD_SV,"2025-05-18 22:03:04",1337,552,537,15,0,548,4,1500,948,258,290
4,BACĂU,"CĂMIN CULTURAL FĂGET",360,GHIMEŞ-FĂGET,22718,1,PART,PRCNCT,PRSD,PRSD_SV,"2025-05-18 21:43:02",1112,489,445,44,0,486,3,1200,711,168,318
4,BACĂU,"ŞCOALA GENERALA CU CLASELE I-VIII BOLOVĂNIŞ",361,GHIMEŞ-FĂGET,22718,1,PART,PRCNCT,PRSD,PRSD_SV,"2025-05-18 21:41:54",705,285,261,24,0,285,0,800,515,197,88
4,BACĂU,"ŞCOALA GENERALA CU CLASELE I-IV FĂGETUL DE SUS",362,GHIMEŞ-FĂGET,22718,1,PART,PRCNCT,PRSD,PRSD_SV,"2025-05-18 21:34:17",203,99,86,13,0,98,1,200,101,27,71
4,BACĂU,"ŞCOALA GENERALA CU CLASELE I-VIII GHIMEŞ",363,GHIMEŞ-FĂGET,22718,1,PART,PRCNCT,PRSD,PRSD_SV,"2025-05-18 21:41:05",910,427,383,44,0,423,4,1000,573,80,343
4,BACĂU,"ŞCOALA GENERALA CU CLASELE I-IV RĂCHITIŞ",364,GHIMEŞ-FĂGET,22718,1,PART,PRCNCT,PRSD,PRSD_SV,"2025-05-18 21:32:12",189,84,68,16,0,84,0,200,116,51,33
4,BACĂU,"ŞCOALA GENERALA CU CLASELE I-VIII TĂRHĂUŞI",365,GHIMEŞ-FĂGET,22718,1,PART,PRCNCT,PRSD,PRSD_SV,"2025-05-18 21:39:08",628,266,241,25,0,262,4,700,434,204,58
4,BACĂU,"ŞCOALA GENERALA CU CLASELE I-VIII ION STRAT GIOSENI",366,GIOSENI,26346,1,PART,PRCNCT,PRSD,PRSD_SV,"2025-05-18 21:37:11",848,362,340,22,0,360,2,900,538,178,182
4,BACĂU,"ŞCOALA GENERALA CU CLASELE I-VIII ION STRAT GIOSENI",367,GIOSENI,26346,1,PART,PRCNCT,PRSD,PRSD_SV,"2025-05-18 21:42:42",1256,517,483,34,0,515,2,1400,883,240,275
4,BACĂU,"SCOALA GENERALA CU CLASELE I-VIII ION STRAT GIOSENI",368,GIOSENI,26346,1,PART,PRCNCT,PRSD,PRSD_SV,"2025-05-18 21:49:05",1157,417,382,14,21,410,7,1300,883,238,172
4,BACĂU,"CĂMINUL CULTURAL GLĂVĂNEŞTI",369,GLĂVĂNEŞTI,22834,1,PART,PRCNCT,PRSD,PRSD_SV,"2025-05-18 22:01:17",1298,663,567,96,0,656,7,1384,721,368,288
4,BACĂU,"CĂMINUL CULTURAL FRUMUŞELU",370,GLĂVĂNEŞTI,22834,1,PART,PRCNCT,PRSD,PRSD_SV,"2025-05-18 21:50:32",946,484,404,79,1,483,1,1000,516,265,218
4,BACĂU,"SCOALA MUNCELU",371,GLĂVĂNEŞTI,22834,1,PART,PRCNCT,PRSD,PRSD_SV,"2025-05-18 21:31:00",194,104,88,16,0,103,1,200,96,48,55
4,BACĂU,"PRIMĂRIA GURA VĂII",372,"GURA VĂII",20607,1,PART,PRCNCT,PRSD,PRSD_SV,"2025-05-18 21:30:43",1176,538,482,56,0,532,6,1300,762,340,192
4,BACĂU,"GRĂDINIŢA PĂTRĂŞCANI",373,"GURA VĂII",20607,1,PART,PRCNCT,PRSD,PRSD_SV,"2025-05-18 21:27:23",302,168,145,23,0,164,4,300,132,106,58
4,BACĂU,"ŞCOALA CAPĂTA",374,"GURA VĂII",20607,1,PART,PRCNCT,PRSD,PRSD_SV,"2025-05-18 21:20:21",266,147,125,22,0,144,3,300,153,104,40
4,BACĂU,"CĂMIN CULTURAL",375,"GURA VĂII",20607,1,PART,PRCNCT,PRSD,PRSD_SV,"2025-05-18 21:30:28",910,398,356,42,0,389,9,1000,602,250,139
4,BACĂU,"CLĂDIRE ADMINISTRATIVĂ",376,"GURA VĂII",20607,1,PART,PRCNCT,PRSD,PRSD_SV,"2025-05-18 21:13:26",89,66,43,22,1,65,1,100,34,39,26
4,BACĂU,"ŞCOALA PĂLTINATA",377,"GURA VĂII",20607,1,PART,PRCNCT,PRSD,PRSD_SV,"2025-05-18 21:42:03",326,173,149,24,0,170,3,400,227,112,58
4,BACĂU,"ŞCOALA TEMELIA",378,"GURA VĂII",20607,1,PART,PRCNCT,PRSD,PRSD_SV,"2025-05-18 21:20:58",783,238,222,16,0,231,7,900,662,192,39
4,BACĂU,"ŞCOALA GIMNAZIALĂ HELEGIU",379,HELEGIU,22898,1,PART,PRCNCT,PRSD,PRSD_SV,"2025-05-18 21:23:25",947,399,349,49,1,397,2,1000,601,210,187
4,BACĂU,"GRĂDINIȚA CU PROGRAM NORMAL BRĂTILA",380,HELEGIU,22898,1,PART,PRCNCT,PRSD,PRSD_SV,"2025-05-18 21:33:31",597,262,228,34,0,256,6,700,438,145,111
4,BACĂU,"CENTRU RECREERE",381,HELEGIU,22898,1,PART,PRCNCT,PRSD,PRSD_SV,"2025-05-18 21:34:58",803,353,325,27,1,349,4,900,547,188,161
4,BACĂU,"ȘCOALA GIMNAZIALĂ DELENI",382,HELEGIU,22898,1,PART,PRCNCT,PRSD,PRSD_SV,"2025-05-18 21:32:36",1257,470,437,33,0,462,8,1400,930,244,218
4,BACĂU,"SCOALA DRĂGUGEŞTI 1",383,HELEGIU,22898,1,PART,PRCNCT,PRSD,PRSD_SV,"2025-05-18 21:26:06",1162,407,382,25,0,403,4,1300,893,245,158
4,BACĂU,"ŞCOALA DRĂGUGEŞTI 2",384,HELEGIU,22898,1,PART,PRCNCT,PRSD,PRSD_SV,"2025-05-18 21:22:07",322,141,130,11,0,135,6,400,259,99,36
4,BACĂU,"CĂMINUL CULTURAL HEMEIUŞ",385,HEMEIUŞ,20313,1,PART,PRCNCT,PRSD,PRSD_SV,"2025-05-18 21:38:08",1598,1034,863,171,0,1024,10,1700,666,404,620
4,BACĂU,"ŞCOALA GENERALA GRIGORE TĂBĂCARU HEMEIUŞ",386,HEMEIUŞ,20313,1,PART,PRCNCT,PRSD,PRSD_SV,"2025-05-18 21:32:41",1410,978,775,203,0,964,14,1500,522,411,553
4,BACĂU,"SCOALA GENERALA ION SIMIONESCU, LILIECI",387,HEMEIUŞ,20313,1,PART,PRCNCT,PRSD,PRSD_SV,"2025-05-18 21:43:44",1601,971,838,133,0,966,5,1700,729,432,534
4,BACĂU,"ŞCOALA GIMNAZIALA ION SIMIONESCU LILIECI",388,HEMEIUŞ,20313,1,PART,PRCNCT,PRSD,PRSD_SV,"2025-05-18 21:34:03",1566,952,848,104,0,945,7,1700,748,438,507
4,BACĂU,"PRIMĂRIA HORGEŞTI",389,HORGEŞTI,22941,1,PART,PRCNCT,PRSD,PRSD_SV,"2025-05-18 21:40:47",1301,466,404,62,0,458,8,1400,934,208,250
4,BACĂU,"ŞCOALA RĂCĂTĂU",390,HORGEŞTI,22941,1,PART,PRCNCT,PRSD,PRSD_SV,"2025-05-18 21:46:30",946,378,336,42,0,375,3,1000,622,299,76
4,BACĂU,"ŞCOALA RECEA",391,HORGEŞTI,22941,1,PART,PRCNCT,PRSD,PRSD_SV,"2025-05-18 21:42:19",680,318,274,44,0,318,0,700,382,221,97
4,BACĂU,"ŞCOALA SOHODOR",392,HORGEŞTI,22941,2,PART,PRCNCT,PRSD,PRSD_SV,"2025-05-19 04:35:25",1165,403,383,20,0,398,5,1300,897,363,35
4,BACĂU,"PRIMĂRIA HURUIEŞTI",393,HURUIEŞTI,23047,1,PART,PRCNCT,PRSD,PRSD_SV,"2025-05-18 21:26:59",528,267,238,29,0,262,5,600,333,164,98
4,BACĂU,"SEDIUL PRIMARIEI COMUNEI HURUIESTI, JUDETUL BACAU",394,HURUIEŞTI,23047,1,PART,PRCNCT,PRSD,PRSD_SV,"2025-05-18 21:21:33",120,64,49,15,0,64,0,100,36,52,12
4,BACĂU,"FOSTUL LOCAL AL ŞCOLII CAPOTEŞTI",395,HURUIEŞTI,23047,1,PART,PRCNCT,PRSD,PRSD_SV,"2025-05-18 21:18:47",142,101,71,30,0,101,0,200,99,63,38
4,BACĂU,"LOCALUL ŞCOLII FUNDOAIA",396,HURUIEŞTI,23047,1,PART,PRCNCT,PRSD,PRSD_SV,"2025-05-18 21:24:11",288,125,99,26,0,124,1,300,175,63,61
4,BACĂU,"LOCALUL ŞCOLII OCHENI",397,HURUIEŞTI,23047,1,PART,PRCNCT,PRSD,PRSD_SV,"2025-05-18 21:24:17",248,111,93,18,0,109,2,300,189,72,37
4,BACĂU,"FOSTUL LOCAL AL ŞCOLII PERCHIU",398,HURUIEŞTI,23047,1,PART,PRCNCT,PRSD,PRSD_SV,"2025-05-18 21:18:47",106,78,51,27,0,78,0,100,22,62,16
4,BACĂU,"FOSTUL LOCAL AL ŞCOLII PRADAIŞ",399,HURUIEŞTI,23047,1,PART,PRCNCT,PRSD,PRSD_SV,"2025-05-18 21:22:34",250,155,112,43,0,150,5,300,145,58,92
4,BACĂU,"CĂMINUL CULTURAL ITEŞTI",400,ITEŞTI,26379,1,PART,PRCNCT,PRSD,PRSD_SV,"2025-05-18 21:38:59",713,392,331,58,3,386,6,750,358,259,127
4,BACĂU,"CĂMINUL CULTURAL CIUMAŞI",401,ITEŞTI,26379,1,PART,PRCNCT,PRSD,PRSD_SV,"2025-05-18 21:51:44",134,102,64,38,0,101,1,150,48,57,44
4,BACĂU,"ŞCOALA DUMBRAVA",402,ITEŞTI,26379,1,PART,PRCNCT,PRSD,PRSD_SV,"2025-05-18 21:48:03",365,282,210,72,0,279,3,400,118,140,139
4,BACĂU,"ŞCOALA CONSTANTIN MOSCU IZV.BERHECIULUI",403,"IZVORU BERHECIULUI",23127,1,PART,PRCNCT,PRSD,PRSD_SV,"2025-05-18 21:37:44",628,268,234,34,0,266,2,700,432,158,108
4,BACĂU,"ŞCOALA GIMNAZIALĂ ”CONSTANTIN MOSCU’’ IZVORU BERHECIULUI",404,"IZVORU BERHECIULUI",23127,1,PART,PRCNCT,PRSD,PRSD_SV,"2025-05-18 21:29:25",303,128,105,23,0,125,3,300,172,62,63
4,BACĂU,"ŞCOALA GENERALĂ ANTOHEŞTI",405,"IZVORU BERHECIULUI",23127,1,PART,PRCNCT,PRSD,PRSD_SV,"2025-05-18 21:21:32",309,144,111,33,0,142,2,300,156,84,58
4,BACĂU,"ŞCOALA COORDONATOARE LETEA VECHE",406,"LETEA VECHE",20359,1,PART,PRCNCT,PRSD,PRSD_SV,"2025-05-18 22:01:20",1573,895,796,99,0,887,8,1700,805,417,470
4,BACĂU,"SCOALA COORDONATOARE LETEA VECHE",407,"LETEA VECHE",20359,1,PART,PRCNCT,PRSD,PRSD_SV,"2025-05-18 21:59:11",1840,1000,938,62,0,989,11,2000,1000,446,543
4,BACĂU,GRADINITA,408,"LETEA VECHE",20359,1,PART,PRCNCT,PRSD,PRSD_SV,"2025-05-18 21:54:52",1511,846,751,95,0,835,11,1700,854,459,376
4,BACĂU,"SALA DE EVENIMENTE",409,"LETEA VECHE",20359,1,PART,PRCNCT,PRSD,PRSD_SV,"2025-05-18 21:38:29",342,198,164,34,0,195,3,400,202,110,85
4,BACĂU,"ŞCOALA RUŞI CIUTEA",410,"LETEA VECHE",20359,1,PART,PRCNCT,PRSD,PRSD_SV,"2025-05-18 21:45:13",703,409,344,65,0,406,3,800,391,234,172
4,BACĂU,"ŞCOALA SIRETU",411,"LETEA VECHE",20359,1,PART,PRCNCT,PRSD,PRSD_SV,"2025-05-18 21:30:37",537,319,258,61,0,313,6,600,281,191,122
4,BACĂU,"ŞCOALA CU CLASELE I-VIII M.EMINESCU LIPOVA",412,LIPOVA,23207,1,PART,PRCNCT,PRSD,PRSD_SV,"2025-05-18 21:40:49",483,213,183,30,0,207,6,500,287,106,101
4,BACĂU,"ŞCOALA CU CLASELE I-VIII MÎLOSU",413,LIPOVA,23207,1,PART,PRCNCT,PRSD,PRSD_SV,"2025-05-18 21:30:40",763,320,295,25,0,317,3,800,480,238,79
4,BACĂU,"ŞCOALA CU CLASELE I-VIII SATU NOU",414,LIPOVA,23207,1,PART,PRCNCT,PRSD,PRSD_SV,"2025-05-18 21:17:46",415,140,121,19,0,136,4,500,360,90,46
4,BACĂU,"ŞCOALA CU CLASELE I-IV VALEA CASELOR",415,LIPOVA,23207,1,PART,PRCNCT,PRSD,PRSD_SV,"2025-05-18 21:52:55",394,163,147,16,0,162,1,400,237,112,50
4,BACĂU,"ŞCOALA CU CLASELE I-IV VALEA HOGEI",416,LIPOVA,23207,1,PART,PRCNCT,PRSD,PRSD_SV,"2025-05-18 21:30:15",229,134,89,45,0,133,1,300,166,65,68
4,BACĂU,"ŞCOALA GIMNAZIALĂ NR.1 LIVEZI",417,LIVEZI,23289,1,PART,PRCNCT,PRSD,PRSD_SV,"2025-05-18 21:29:23",782,262,209,53,0,261,1,900,638,151,110
4,BACĂU,"ŞCOALA PRIMARĂ BĂLĂNEASA",418,LIVEZI,23289,1,PART,PRCNCT,PRSD,PRSD_SV,"2025-05-18 21:53:14",934,330,300,30,0,329,1,1000,670,270,59
4,BACĂU,"ŞCOALA PRIMARĂ ORĂŞA",419,LIVEZI,23289,1,PART,PRCNCT,PRSD,PRSD_SV,"2025-05-18 21:30:52",670,281,258,23,0,280,1,700,419,146,134
4,BACĂU,"ŞCOALA GIMNAZIALĂ POIANA",420,LIVEZI,23289,1,PART,PRCNCT,PRSD,PRSD_SV,"2025-05-18 21:38:12",736,306,277,29,0,304,2,800,494,220,84
4,BACĂU,"ŞCOALA PRIMARĂ PRĂJOAIA",421,LIVEZI,23289,1,PART,PRCNCT,PRSD,PRSD_SV,"2025-05-18 21:31:22",795,300,281,19,0,297,3,900,600,224,73
4,BACĂU,"ŞCOALA PRIMARĂ SCĂRIGA",422,LIVEZI,23289,1,PART,PRCNCT,PRSD,PRSD_SV,"2025-05-18 21:26:39",452,204,179,25,0,204,0,500,296,94,110
4,BACĂU,"ŞCOALA CU CLASELE I-VIII LUIZI CĂLUGĂRA",423,LUIZI-CĂLUGĂRA,23350,1,PART,PRCNCT,PRSD,PRSD_SV,"2025-05-18 21:45:21",1219,488,428,60,0,481,7,1300,812,221,260
4,BACĂU,"ŞCOALA CU CLASELE I-VIII LUIZI CĂLUGĂRA",424,LUIZI-CĂLUGĂRA,23350,1,PART,PRCNCT,PRSD,PRSD_SV,"2025-05-18 21:56:47",1204,438,375,63,0,435,3,1300,862,189,246
4,BACĂU,"ŞCOALA CU CLASELE I-VIII OSEBIŢI",425,LUIZI-CĂLUGĂRA,23350,1,PART,PRCNCT,PRSD,PRSD_SV,"2025-05-18 21:36:08",871,350,320,30,0,348,2,1000,650,158,190
4,BACĂU,"ŞCOALA CU CLASELE I-VIII OSEBIŢI",426,LUIZI-CĂLUGĂRA,23350,1,PART,PRCNCT,PRSD,PRSD_SV,"2025-05-18 21:52:02",881,386,343,43,0,382,4,1000,614,168,214
4,BACĂU,"CAMINUL CULTURAL MAGIRESTI",427,MĂGIREŞTI,23387,1,PART,PRCNCT,PRSD,PRSD_SV,"2025-05-18 21:49:01",1009,524,485,39,0,519,5,1100,576,294,225
4,BACĂU,"SCOALA CU CLASELE I-IV PRAJESTII",428,MĂGIREŞTI,23387,1,PART,PRCNCT,PRSD,PRSD_SV,"2025-05-18 21:37:44",466,243,204,39,0,237,6,500,257,153,84
4,BACĂU,"ŞCOALA CU CLASELE.I-IV STĂNEŞTI (CORP NOU)",429,MĂGIREŞTI,23387,1,PART,PRCNCT,PRSD,PRSD_SV,"2025-05-18 21:38:11",479,209,184,25,0,206,3,500,291,128,78
4,BACĂU,"SALA DE SPORT DIN SATUL ȘESURI",430,MĂGIREŞTI,23387,1,PART,PRCNCT,PRSD,PRSD_SV,"2025-05-18 21:38:35",408,213,202,11,0,211,2,400,187,143,68
4,BACĂU,"ŞCOALA CU CLASELE I-VIII VALEA ARINILOR",431,MĂGIREŞTI,23387,1,PART,PRCNCT,PRSD,PRSD_SV,"2025-05-18 21:30:37",905,472,440,32,0,462,10,1100,628,301,161
4,BACĂU,"ŞCOALA NR.2 MĂGURA-SALA 1",432,MĂGURA,20411,1,PART,PRCNCT,PRSD,PRSD_SV,"2025-05-18 22:02:58",1209,767,684,81,2,758,9,1300,533,299,459
4,BACĂU,"SCOALA NR.2 SAT MAGURA - SALA 2",433,MĂGURA,20411,1,PART,PRCNCT,PRSD,PRSD_SV,"2025-05-18 21:40:50",840,430,366,64,0,428,2,900,470,203,225
4,BACĂU,"GRĂDINIȚA CU 3 GRUPE, MĂGURA",434,MĂGURA,20411,1,PART,PRCNCT,PRSD,PRSD_SV,"2025-05-18 21:42:09",1657,1010,836,173,1,1004,6,1800,790,485,519
4,BACĂU,"ȘCOALA GENERALĂ CRIHAN",435,MĂGURA,20411,1,PART,PRCNCT,PRSD,PRSD_SV,"2025-05-18 21:57:28",1185,625,561,63,1,624,1,1300,675,316,308
4,BACĂU,"CĂMINUL CULTURAL SATUL MĂNĂSTIREA CAŞIN",436,"MĂNĂSTIREA CAŞIN",23449,1,PART,PRCNCT,PRSD,PRSD_SV,"2025-05-18 21:39:44",1476,637,588,49,0,629,8,1600,963,382,247
4,BACĂU,"ŞCOALA LUPEŞTI",437,"MĂNĂSTIREA CAŞIN",23449,1,PART,PRCNCT,PRSD,PRSD_SV,"2025-05-18 21:56:34",617,296,248,48,0,286,10,700,404,172,114
4,BACĂU,"CĂMINUL CULTURAL SATUL MĂNĂSTIREA CAŞIN",438,"MĂNĂSTIREA CAŞIN",23449,1,PART,PRCNCT,PRSD,PRSD_SV,"2025-05-18 21:31:27",544,231,219,12,0,228,3,600,369,155,73
4,BACĂU,"ŞCOALA GENERALA.NR.2 MĂNĂSTIREA CAŞIN",439,"MĂNĂSTIREA CAŞIN",23449,1,PART,PRCNCT,PRSD,PRSD_SV,"2025-05-18 21:52:24",1610,729,684,45,0,719,10,1800,1071,431,288
4,BACĂU,"ŞCOALA CU CLASELE I-VIII MĂRGINENI",440,MĂRGINENI,20466,1,PART,PRCNCT,PRSD,PRSD_SV,"2025-05-18 21:43:42",1178,626,538,88,0,623,3,1300,674,326,297
4,BACĂU,"ŞCOALA CU CLASELE I-VIII MĂRGINENI",441,MĂRGINENI,20466,1,PART,PRCNCT,PRSD,PRSD_SV,"2025-05-18 22:06:56",1490,642,576,66,0,634,8,1600,958,323,311
4,BACĂU,"ŞCOALA CU CLASELE I-VIII MĂRGINENI",442,MĂRGINENI,20466,1,PART,PRCNCT,PRSD,PRSD_SV,"2025-05-18 21:29:17",1179,515,459,56,0,510,5,1300,785,293,217
4,BACĂU,"ŞCOALA CU CLASELE I-VIII BARAŢI",443,MĂRGINENI,20466,1,PART,PRCNCT,PRSD,PRSD_SV,"2025-05-18 21:51:50",1761,889,785,103,1,883,6,1900,1011,432,451
4,BACĂU,"ŞCOALA CU CLASELE I-VIII LUNCANI",444,MĂRGINENI,20466,1,PART,PRCNCT,PRSD,PRSD_SV,"2025-05-18 21:37:39",1106,617,519,97,1,612,5,1200,583,331,281
4,BACĂU,"ŞCOALA CU CLASELE I - IV PĂDURENI",445,MĂRGINENI,20466,1,PART,PRCNCT,PRSD,PRSD_SV,"2025-05-18 21:21:20",319,183,158,25,0,183,0,400,217,104,79
4,BACĂU,"ŞCOALA CU CLASELE I - IV PODIȘ",446,MĂRGINENI,20466,1,PART,PRCNCT,PRSD,PRSD_SV,"2025-05-18 21:33:44",554,331,238,93,0,327,4,600,269,163,164
4,BACĂU,"ŞCOALA CU CLASELE I-VIII TREBEŞ",447,MĂRGINENI,20466,1,PART,PRCNCT,PRSD,PRSD_SV,"2025-05-18 21:17:59",700,295,265,30,0,292,3,800,505,165,127
4,BACĂU,"ŞCOALA CU CLASELE I - IV VALEA BUDULUI",448,MĂRGINENI,20466,1,PART,PRCNCT,PRSD,PRSD_SV,"2025-05-18 21:52:54",476,290,248,42,0,287,3,500,210,105,182
4,BACĂU,"CASA SATULUI SI TRADITIILOR",449,MOTOŞENI,23494,1,PART,PRCNCT,PRSD,PRSD_SV,"2025-05-18 21:39:51",834,386,338,48,0,379,7,900,514,203,176
4,BACĂU,"ŞCOALA SATUL COCIU",450,MOTOŞENI,23494,1,PART,PRCNCT,PRSD,PRSD_SV,"2025-05-18 21:46:10",202,100,80,20,0,98,2,200,100,57,41
4,BACĂU,"ŞCOALA SATUL FÎNTÎNELE",451,MOTOŞENI,23494,1,PART,PRCNCT,PRSD,PRSD_SV,"2025-05-18 21:25:35",489,245,198,47,0,243,2,500,255,157,86
4,BACĂU,"ŞCOALA SATUL POIANA",452,MOTOŞENI,23494,1,PART,PRCNCT,PRSD,PRSD_SV,"2025-05-18 21:40:30",225,144,102,42,0,144,0,230,86,67,77
4,BACĂU,"ŞCOALA SATUL ŞENDREŞTI",453,MOTOŞENI,23494,1,PART,PRCNCT,PRSD,PRSD_SV,"2025-05-18 21:30:16",267,179,134,43,2,179,0,300,121,92,87
4,BACĂU,"ŞCOALA SATUL ŢEPOAIA",454,MOTOŞENI,23494,1,PART,PRCNCT,PRSD,PRSD_SV,"2025-05-18 21:22:36",391,184,156,28,0,180,4,400,216,111,69
4,BACĂU,"ŞCOALA COSTACHE NEGRI SATUL NEGRI",455,NEGRI,23644,1,PART,PRCNCT,PRSD,PRSD_SV,"2025-05-18 21:36:56",1015,479,381,98,0,475,4,1100,621,253,222
4,BACĂU,"ŞCOALA ION IONESCU DE LA BRAD SATUL POIANA-NEGRI",456,NEGRI,23644,1,PART,PRCNCT,PRSD,PRSD_SV,"2025-05-18 21:30:59",1143,445,395,50,0,443,2,1300,855,245,198
4,BACĂU,"SCOALA NICOLAE BALCESCU",457,"NICOLAE BĂLCESCU",23715,1,PART,PRCNCT,PRSD,PRSD_SV,"2025-05-18 21:18:30",1252,520,492,28,0,518,2,1400,880,168,350
4,BACĂU,"SCOALA NICOLAE BALCESCU",458,"NICOLAE BĂLCESCU",23715,1,PART,PRCNCT,PRSD,PRSD_SV,"2025-05-18 21:31:12",1632,729,675,54,0,724,5,1800,1071,259,465
4,BACĂU,"SCOALA NICOLAE BALCESCU",459,"NICOLAE BĂLCESCU",23715,1,PART,PRCNCT,PRSD,PRSD_SV,"2025-05-18 21:25:42",1696,682,635,46,1,673,9,1900,1218,258,415
4,BACĂU,"ŞCOALA SATUL GALBENI",460,"NICOLAE BĂLCESCU",23715,1,PART,PRCNCT,PRSD,PRSD_SV,"2025-05-18 21:18:50",1198,559,506,53,0,551,8,1300,741,236,315
4,BACĂU,"ŞCOALA SATUL LĂRGUŢA",461,"NICOLAE BĂLCESCU",23715,1,PART,PRCNCT,PRSD,PRSD_SV,"2025-05-18 21:10:54",161,84,64,20,0,81,3,212,128,44,37
4,BACĂU,"GRĂDINIȚA VALEA SEACĂ NR. 1",462,"NICOLAE BĂLCESCU",23715,2,PART,PRCNCT,PRSD,PRSD_SV,"2025-05-18 23:04:23",764,292,272,20,0,287,5,800,508,157,130
4,BACĂU,"GRĂDINIȚA VALEA SEACĂ NR. 1",463,"NICOLAE BĂLCESCU",23715,1,PART,PRCNCT,PRSD,PRSD_SV,"2025-05-18 21:21:29",1045,395,373,22,0,391,4,1100,705,205,186
4,BACĂU,"GRĂDINIȚA VALEA SEACĂ NR. 1",464,"NICOLAE BĂLCESCU",23715,1,PART,PRCNCT,PRSD,PRSD_SV,"2025-05-18 21:26:03",639,259,228,31,0,258,1,700,441,124,134
4,BACĂU,"ŞCOALA CU CLASELE I-IV ODOBEŞTI",465,ODOBEŞTI,26353,1,PART,PRCNCT,PRSD,PRSD_SV,"2025-05-18 21:45:59",353,199,157,42,0,194,5,400,201,128,66
4,BACĂU,"ŞCOALA CU CLASELE I-VIII CIUTUREŞTI",466,ODOBEŞTI,26353,1,PART,PRCNCT,PRSD,PRSD_SV,"2025-05-18 21:44:00",625,300,268,32,0,297,3,700,400,176,121
4,BACĂU,"GRĂDINIȚA TISA - SILVESTRI",467,ODOBEŞTI,26353,1,PART,PRCNCT,PRSD,PRSD_SV,"2025-05-18 21:51:55",904,460,393,61,6,456,4,1000,540,246,210
4,BACĂU,"ȘCOALĂ GIMNAZIALĂ COMUNA OITUZ ( GRĂDINIȚA NR.2 OITUZ)",468,OITUZ,23797,1,PART,PRCNCT,PRSD,PRSD_SV,"2025-05-18 21:28:15",540,264,226,38,0,262,2,600,336,139,123
4,BACĂU,"ȘCOALĂ GIMNAZIALĂ COMUNA OITUZ ( GRĂDINIȚA NR.2 OITUZ)",469,OITUZ,23797,1,PART,PRCNCT,PRSD,PRSD_SV,"2025-05-18 21:24:22",898,368,346,22,0,365,3,1000,632,212,153
4,BACĂU,"SCOALA GIMNAZIALA NR. 1 OITUZ",470,OITUZ,23797,1,PART,PRCNCT,PRSD,PRSD_SV,"2025-05-18 21:39:17",1281,541,519,22,0,539,2,1400,859,327,212
4,BACĂU,"ȘCOALA GIMNAZIALĂ NR.1 OITUZ",471,OITUZ,23797,1,PART,PRCNCT,PRSD,PRSD_SV,"2025-05-18 21:42:23",1446,622,562,60,0,619,3,1600,978,343,276
4,BACĂU,"CĂMINUL CULTURAL ”OLGA MARIA TUDORACHE” OITUZ",472,OITUZ,23797,1,PART,PRCNCT,PRSD,PRSD_SV,"2025-05-18 21:44:20",1005,459,417,42,0,449,10,1100,641,318,131
4,BACĂU,"GRĂDINIŢA CĂLCÂI",473,OITUZ,23797,1,PART,PRCNCT,PRSD,PRSD_SV,"2025-05-18 21:29:47",386,169,154,15,0,168,1,400,231,103,65
4,BACĂU,"GRĂDINIȚA CU PROGRAM NORMAL FERESTRĂU",474,OITUZ,23797,1,PART,PRCNCT,PRSD,PRSD_SV,"2025-05-18 21:36:34",861,409,375,34,0,409,0,1000,591,229,180
4,BACĂU,"ASOCIAȚIA ”SFÂNTUL VOIEVOD ŞTEFAN CEL MARE- HÂRJA”",475,OITUZ,23797,1,PART,PRCNCT,PRSD,PRSD_SV,"2025-05-18 21:22:40",236,178,74,104,0,174,4,300,122,81,93
4,BACĂU,"GRĂDINIŢA CU PROGRAM NORMAL MARGINEA",476,OITUZ,23797,1,PART,PRCNCT,PRSD,PRSD_SV,"2025-05-18 21:21:22",604,272,262,10,0,268,4,700,428,207,61
4,BACĂU,"GRĂDINIȚA CU PROGRAM NORMAL POIANA-SĂRATĂ",477,OITUZ,23797,1,PART,PRCNCT,PRSD,PRSD_SV,"2025-05-18 21:20:54",237,183,111,72,0,180,3,300,117,75,105
4,BACĂU,"CĂMINUL CULTURAL SATUL ONCEŞTI",478,ONCEŞTI,23868,1,PART,PRCNCT,PRSD,PRSD_SV,"2025-05-18 21:58:03",720,363,293,70,0,350,13,800,437,194,156
4,BACĂU,"SALA DE FESTIVITĂŢI SATUL TARNIŢA",479,ONCEŞTI,23868,1,PART,PRCNCT,PRSD,PRSD_SV,"2025-05-18 21:37:53",509,235,205,30,0,231,4,600,365,138,93
4,BACĂU,"ŞCOALA CU CLASELE I-VIII SATUL ORBENI",480,ORBENI,23948,1,PART,PRCNCT,PRSD,PRSD_SV,"2025-05-18 21:54:53",885,422,352,70,0,418,4,1000,578,247,171
4,BACĂU,"ŞCOALA PRIMARĂ NR.2 SATUL ORBENI",481,ORBENI,23948,1,PART,PRCNCT,PRSD,PRSD_SV,"2025-05-18 21:57:20",631,307,275,32,0,304,3,700,393,236,68
4,BACĂU,"SCOALA PRIMARA NR 3 SCURTA",482,ORBENI,23948,2,PART,PRCNCT,PRSD,PRSD_SV,"2025-05-19 01:18:49",815,316,293,23,0,313,3,900,584,240,73
4,BACĂU,"ŞCOALA GIMNAZIALA NR. 1 SATUL SCURTA",483,ORBENI,23948,1,PART,PRCNCT,PRSD,PRSD_SV,"2025-05-18 21:39:48",572,237,195,42,0,233,4,600,363,150,83
4,BACĂU,"PRIMĂRIA PALANCA",484,PALANCA,23975,1,PART,PRCNCT,PRSD,PRSD_SV,"2025-05-18 21:32:04",1188,584,492,92,0,581,3,1300,716,357,224
4,BACĂU,"ŞCOALA SATUL CĂDĂRĂŞTI",485,PALANCA,23975,1,PART,PRCNCT,PRSD,PRSD_SV,"2025-05-18 21:11:50",77,57,25,32,0,57,0,100,43,24,33
4,BACĂU,"CĂMINUL CULTURAL SATUL CIUGHEŞ",486,PALANCA,23975,1,PART,PRCNCT,PRSD,PRSD_SV,"2025-05-18 21:30:52",1352,646,588,58,0,635,11,1500,854,386,249
4,BACĂU,"PRIMARIA COMUNEI PARAVA (SALA DE FESTIVITATI)",487,PARAVA,24034,1,PART,PRCNCT,PRSD,PRSD_SV,"2025-05-18 21:29:43",738,381,328,46,7,377,4,800,419,249,128
4,BACĂU,"ŞCOALA GIMNAZIALA PARAVA (GRADINITA CU PROGRAM NORMAL PARAVA)",488,PARAVA,24034,1,PART,PRCNCT,PRSD,PRSD_SV,"2025-05-18 21:21:04",222,131,102,27,2,130,1,200,69,69,61
4,BACĂU,"ŞCOALA GIMNAZIALĂ SATUL DRĂGUŞANI",489,PARAVA,24034,1,PART,PRCNCT,PRSD,PRSD_SV,"2025-05-18 21:59:27",652,336,262,72,2,332,4,700,364,205,127
4,BACĂU,"ŞCOALA GIMNAZIALĂ SATUL RĂDOAIA",490,PARAVA,24034,1,PART,PRCNCT,PRSD,PRSD_SV,"2025-05-18 21:44:53",974,222,199,17,6,217,5,1100,878,197,20
4,BACĂU,"LICEUL TEHNOLOGIC ”G.J.CANCICOV” PARINCEA",491,PARINCEA,24089,1,PART,PRCNCT,PRSD,PRSD_SV,"2025-05-18 21:44:22",694,345,262,56,27,338,7,800,455,218,120
4,BACĂU,"ŞCOALA MILEŞTII DE JOS",492,PARINCEA,24089,2,PART,PRCNCT,PRSD,PRSD_SV,"2025-05-19 01:52:07",224,121,90,27,4,120,1,200,79,70,50
4,BACĂU,"ŞCOALA NĂNEŞTI",493,PARINCEA,24089,1,PART,PRCNCT,PRSD,PRSD_SV,"2025-05-18 21:31:28",546,268,213,50,5,266,2,600,332,140,126
4,BACĂU,"CENTRU EVENIMENTE POIENI",494,PARINCEA,24089,1,PART,PRCNCT,PRSD,PRSD_SV,"2025-05-18 21:18:36",219,91,76,15,0,86,5,200,109,48,38
4,BACĂU,"ŞCOALA VĂLENI",495,PARINCEA,24089,1,PART,PRCNCT,PRSD,PRSD_SV,"2025-05-18 21:33:26",411,192,151,41,0,188,4,500,308,94,94
4,BACĂU,"ŞCOALA GIMNAZIALA VLADNIC",496,PARINCEA,24089,1,PART,PRCNCT,PRSD,PRSD_SV,"2025-05-18 21:43:53",659,310,261,49,0,309,1,700,390,198,111
4,BACĂU,"CĂMINUL CULTURAL PÂNCEŞTI",497,PÂNCEŞTI,24187,1,PART,PRCNCT,PRSD,PRSD_SV,"2025-05-18 21:48:02",1108,423,357,66,0,420,3,1200,777,280,140
4,BACĂU,"ŞCOALA SATUL DIENEŢ",498,PÂNCEŞTI,24187,1,PART,PRCNCT,PRSD,PRSD_SV,"2025-05-18 21:21:45",541,231,183,48,0,229,2,600,369,138,91
4,BACĂU,"ŞCOALA GENERALĂ SATUL FULGERIŞ",499,PÂNCEŞTI,24187,1,PART,PRCNCT,PRSD,PRSD_SV,"2025-05-18 21:29:39",430,122,97,25,0,122,0,500,378,97,25
4,BACĂU,"ŞCOALA GENERALĂ SATUL PETREŞTI",500,PÂNCEŞTI,24187,1,PART,PRCNCT,PRSD,PRSD_SV,"2025-05-18 21:56:12",642,316,263,53,0,312,4,700,384,178,134
4,BACĂU,"ŞCOALA GENERALĂ SATUL SOCI",501,PÂNCEŞTI,24187,1,PART,PRCNCT,PRSD,PRSD_SV,"2025-05-18 21:30:01",618,241,206,35,0,237,4,700,459,165,72
4,BACĂU,"ŞCOALA GIMNAZIALĂ DUMITRU MĂRTINAŞ SATUL PÎRGĂREŞTI",502,PÂRGĂREŞTI,24276,1,PART,PRCNCT,PRSD,PRSD_SV,"2025-05-18 21:24:55",789,286,251,34,1,285,1,900,614,146,139
4,BACĂU,"GRĂDINIŢA CU PROGRAM NORMAL BAHNA",503,PÂRGĂREŞTI,24276,1,PART,PRCNCT,PRSD,PRSD_SV,"2025-05-18 21:31:11",465,188,167,21,0,188,0,500,312,119,69
4,BACĂU,"ŞCOALA GIMNAZIALĂ CONSTANTIN MUŞAT SATUL NICOREŞTI",504,PÂRGĂREŞTI,24276,1,PART,PRCNCT,PRSD,PRSD_SV,"2025-05-18 21:24:27",809,293,280,13,0,291,2,900,607,159,132
4,BACĂU,"GRĂDINIŢA CU PROGRAM NORMAL SATUL PÎRÎU BOGHII",505,PÂRGĂREŞTI,24276,1,PART,PRCNCT,PRSD,PRSD_SV,"2025-05-18 21:24:33",342,199,181,18,0,197,2,400,201,131,66
4,BACĂU,"ŞCOALA GIMNAZIALĂ VASILE GH.RADUSATUL SATU NOU",506,PÂRGĂREŞTI,24276,1,PART,PRCNCT,PRSD,PRSD_SV,"2025-05-18 21:35:38",1327,455,436,19,0,447,8,1500,1045,286,161
4,BACĂU,"ŞCOALA SATUL PÎRJOL",507,PÂRJOL,24338,1,PART,PRCNCT,PRSD,PRSD_SV,"2025-05-18 21:37:08",761,333,270,63,0,333,0,800,467,189,144
4,BACĂU,"ŞCOALA SATUL BĂHNĂŞENI",508,PÂRJOL,24338,1,PART,PRCNCT,PRSD,PRSD_SV,"2025-05-18 21:34:16",673,294,269,25,0,292,2,700,406,201,91
4,BACĂU,"ŞCOALA SATUL BĂRNEŞTI",509,PÂRJOL,24338,1,PART,PRCNCT,PRSD,PRSD_SV,"2025-05-18 21:14:02",171,79,60,19,0,78,1,200,121,41,37
4,BACĂU,"ŞCOALA SATUL BĂSEŞTI",510,PÂRJOL,24338,1,PART,PRCNCT,PRSD,PRSD_SV,"2025-05-18 21:27:32",416,190,155,35,0,189,1,500,310,112,77
4,BACĂU,"ŞCOALA SATUL CÎMPENI",511,PÂRJOL,24338,1,PART,PRCNCT,PRSD,PRSD_SV,"2025-05-18 21:23:54",474,206,176,28,2,200,6,500,294,125,75
4,BACĂU,"ŞCOALA SATUL HĂINEALA",512,PÂRJOL,24338,1,PART,PRCNCT,PRSD,PRSD_SV,"2025-05-18 21:19:22",199,97,76,21,0,97,0,200,103,62,35
4,BACĂU,"GRĂDINIŢA PUSTIANA",513,PÂRJOL,24338,1,PART,PRCNCT,PRSD,PRSD_SV,"2025-05-18 21:23:24",657,251,222,29,0,246,5,700,449,85,161
4,BACĂU,"ŞCOALA CU CLASELE .I-VIII PUSTIANA",514,PÂRJOL,24338,1,PART,PRCNCT,PRSD,PRSD_SV,"2025-05-18 21:22:43",802,307,258,49,0,303,4,900,593,106,197
4,BACĂU,"ȘCOALA GIMNAZIALĂ TĂRÂȚA",515,PÂRJOL,24338,1,PART,PRCNCT,PRSD,PRSD_SV,"2025-05-18 21:35:49",823,353,311,40,2,350,3,900,547,178,172
4,BACĂU,"PRIMĂRIA PLOPANA",516,PLOPANA,24427,1,PART,PRCNCT,PRSD,PRSD_SV,"2025-05-18 21:37:35",717,289,255,28,6,281,8,750,461,151,130
4,BACĂU,"ŞCOALA CU CLASELE I-IV SATUL FUNDU TUTOVEI",517,PLOPANA,24427,1,PART,PRCNCT,PRSD,PRSD_SV,"2025-05-18 21:41:07",458,188,158,30,0,188,0,500,312,115,73
4,BACĂU,"ŞCOALA CU CLASELE I-IV SATUL IŢCANI",518,PLOPANA,24427,1,PART,PRCNCT,PRSD,PRSD_SV,"2025-05-18 21:24:24",608,240,211,22,7,236,4,700,460,112,124
4,BACĂU,"ŞCOALA CU CLASELE I-VIII SATUL RUSENII-RĂZEŞI",519,PLOPANA,24427,1,PART,PRCNCT,PRSD,PRSD_SV,"2025-05-18 21:23:45",285,147,109,37,1,146,1,300,153,58,88
4,BACĂU,"ŞCOALA CU CLASELE I-IV SATUL STRĂMINOASA",520,PLOPANA,24427,1,PART,PRCNCT,PRSD,PRSD_SV,"2025-05-18 21:33:47",331,166,134,32,0,162,4,400,234,80,82
4,BACĂU,"ŞCOALA SATUL PODURI",521,PODURI,24631,1,PART,PRCNCT,PRSD,PRSD_SV,"2025-05-18 21:31:49",1078,513,458,53,2,504,9,1200,687,293,211
4,BACĂU,"ŞCOALA SATUL PODURI",522,PODURI,24631,1,PART,PRCNCT,PRSD,PRSD_SV,"2025-05-18 21:25:22",1148,576,540,36,0,570,6,1300,724,320,250
4,BACĂU,"ŞCOALA SATUL BUCŞEŞTI",523,PODURI,24631,1,PART,PRCNCT,PRSD,PRSD_SV,"2025-05-18 21:28:18",1275,554,517,37,0,541,13,1400,846,342,199
4,BACĂU,"ŞCOALA SATUL CERNU",524,PODURI,24631,1,PART,PRCNCT,PRSD,PRSD_SV,"2025-05-18 21:40:57",1179,479,431,48,0,473,6,1300,821,306,167
4,BACĂU,"ŞCOALA SATUL PROHOZEŞTI",525,PODURI,24631,1,PART,PRCNCT,PRSD,PRSD_SV,"2025-05-18 21:32:16",761,400,351,49,0,394,6,800,400,229,165
4,BACĂU,"ŞCOALA SATUL VALEA ŞOSII",526,PODURI,24631,1,PART,PRCNCT,PRSD,PRSD_SV,"2025-05-18 21:25:13",954,392,379,13,0,387,5,1000,608,241,146
4,BACĂU,"CĂMINUL CULTURAL PODU TURCULUI",527,"PODU TURCULUI",24524,1,PART,PRCNCT,PRSD,PRSD_SV,"2025-05-18 22:39:24",1740,927,792,133,2,915,12,1900,973,524,391
4,BACĂU,"ȘCOALA GENERALĂ NR. 3 PODU TURCULUI",528,"PODU TURCULUI",24524,1,PART,PRCNCT,PRSD,PRSD_SV,"2025-05-18 21:31:26",493,283,254,29,0,281,2,500,217,142,139
4,BACĂU,"CĂMINUL CULTURAL SATUL CĂBEŞTI",529,"PODU TURCULUI",24524,1,PART,PRCNCT,PRSD,PRSD_SV,"2025-05-18 21:56:40",637,337,268,69,0,330,7,700,363,186,144
4,BACĂU,"CAMINUL CULTURAL SAT LEHANCEA",530,"PODU TURCULUI",24524,1,PART,PRCNCT,PRSD,PRSD_SV,"2025-05-18 21:25:01",488,244,211,32,1,243,1,500,256,151,92
4,BACĂU,"ŞCOALA GENERALĂ SATUL SÎRBI",531,"PODU TURCULUI",24524,1,PART,PRCNCT,PRSD,PRSD_SV,"2025-05-18 21:14:14",315,159,140,19,0,158,1,300,141,59,99
4,BACĂU,"SCOALA GIMNAZIALA GHEORGHE AVRAMESCU PRAJESTI",532,PRĂJEŞTI,26361,1,PART,PRCNCT,PRSD,PRSD_SV,"2025-05-18 21:43:13",987,385,331,36,18,382,3,1100,715,169,213
4,BACĂU,"SCOALA GIMNAZIALA GHEORGHE AVRAMESCU PRĂJEŞTI",533,PRĂJEŞTI,26361,1,PART,PRCNCT,PRSD,PRSD_SV,"2025-05-18 21:39:14",936,367,279,70,18,366,1,1000,633,180,186
4,BACĂU,"ŞCOALA NR.1 IOAN BORCEA RACOVA",534,RACOVA,24711,1,PART,PRCNCT,PRSD,PRSD_SV,"2025-05-18 21:47:21",1291,617,552,65,0,611,6,1400,783,392,219
4,BACĂU,"ŞCOALA NR.2 RACOVA-ŞES",535,RACOVA,24711,1,PART,PRCNCT,PRSD,PRSD_SV,"2025-05-18 21:27:20",639,319,291,28,0,317,2,700,381,194,123
4,BACĂU,"ŞCOALA SATUL GURA VĂII",536,RACOVA,24711,2,PART,PRCNCT,PRSD,PRSD_SV,"2025-05-19 00:04:59",994,438,386,48,4,433,5,1100,662,297,136
4,BACĂU,"BAZA SPORTIVA ”LIA MANOLIU” RĂCĂCIUNI",537,RĂCĂCIUNI,24766,1,PART,PRCNCT,PRSD,PRSD_SV,"2025-05-18 21:58:42",1571,660,590,70,0,653,7,1700,1040,366,287
4,BACĂU,"GRĂDINIŢA NR.2 SATUL RĂCĂCIUNI",538,RĂCĂCIUNI,24766,1,PART,PRCNCT,PRSD,PRSD_SV,"2025-05-18 21:33:39",1340,552,473,79,0,548,4,1500,948,334,214
4,BACĂU,"ŞCOALA CU CLASELE I-IV SATUL CIUCANI",539,RĂCĂCIUNI,24766,1,PART,PRCNCT,PRSD,PRSD_SV,"2025-05-18 21:24:14",462,213,199,14,0,213,0,500,287,142,71
4,BACĂU,"ŞCOALA CU CLASELE I-VIII SATUL FUNDU RĂCĂCIUNI",540,RĂCĂCIUNI,24766,1,PART,PRCNCT,PRSD,PRSD_SV,"2025-05-18 21:32:38",1467,521,496,25,0,511,10,1600,1079,274,237
4,BACĂU,"ŞCOALA CU CLASELE I-VIII SATUL GÎŞTENI",541,RĂCĂCIUNI,24766,1,PART,PRCNCT,PRSD,PRSD_SV,"2025-05-18 21:36:54",800,372,304,68,0,347,25,900,528,265,82
4,BACĂU,"ŞCOALA CU CLASELE I-VIII SATUL GHEORGHE DOJA",542,RĂCĂCIUNI,24766,1,PART,PRCNCT,PRSD,PRSD_SV,"2025-05-18 21:31:47",894,388,347,41,0,387,1,1000,612,208,179
4,BACĂU,"CĂMINUL CULTURAL SATUL RĂCHITOASA",543,RĂCHITOASA,24837,1,PART,PRCNCT,PRSD,PRSD_SV,"2025-05-18 21:31:04",1049,487,420,54,13,478,9,1200,713,278,200
4,BACĂU,"ŞCOALA PRIMARĂ BARCANA",544,RĂCHITOASA,24837,1,PART,PRCNCT,PRSD,PRSD_SV,"2025-05-18 21:19:16",504,194,179,15,0,190,4,600,406,110,80
4,BACĂU,"GRĂDINIȚA CU PROGRAM NORMAL BUDA",545,RĂCHITOASA,24837,1,PART,PRCNCT,PRSD,PRSD_SV,"2025-05-18 21:37:54",504,235,198,37,0,231,4,585,350,124,107
4,BACĂU,"ŞCOALA GIMNAZIALĂ BURDUSACI",546,RĂCHITOASA,24837,1,PART,PRCNCT,PRSD,PRSD_SV,"2025-05-18 21:41:23",649,300,260,40,0,296,4,700,400,170,126
4,BACĂU,"ȘCOALA PRIMARĂ DUMBRAVA",547,RĂCHITOASA,24837,1,PART,PRCNCT,PRSD,PRSD_SV,"2025-05-18 21:32:17",516,228,205,23,0,226,2,600,372,175,51
4,BACĂU,"ŞCOALA CU CLASELE .I-IV SATUL FUNDĂTURA-RĂCHITOASA",548,RĂCHITOASA,24837,1,PART,PRCNCT,PRSD,PRSD_SV,"2025-05-18 21:14:07",204,88,77,11,0,86,2,200,112,63,23
4,BACĂU,"ŞCOALA GIMNAZIALĂ NR.1 SATUL ROŞIORI",549,ROŞIORI,24999,1,PART,PRCNCT,PRSD,PRSD_SV,"2025-05-18 21:33:37",1023,501,449,52,0,494,7,1100,599,369,125
4,BACĂU,"ŞCOALA PRIMARĂ SATUL POIENI",550,ROŞIORI,24999,1,PART,PRCNCT,PRSD,PRSD_SV,"2025-05-18 21:15:37",277,144,111,33,0,143,1,300,156,99,44
4,BACĂU,"ŞCOALA PRIMARĂ VALEA MARE",551,ROŞIORI,24999,1,PART,PRCNCT,PRSD,PRSD_SV,"2025-05-18 21:23:03",503,232,190,42,0,231,1,600,368,158,73
4,BACĂU,"LICEUL JACQUES MENACHEN ELIAS SASCUT",552,SASCUT,25068,1,PART,PRCNCT,PRSD,PRSD_SV,"2025-05-18 22:05:14",1481,636,578,58,0,628,8,1200,564,340,288
4,BACĂU,"LICEUL JACQUES MENACHEN ELIAS SASCUT",553,SASCUT,25068,1,PART,PRCNCT,PRSD,PRSD_SV,"2025-05-18 21:47:24",1119,486,436,50,0,480,6,1200,714,260,220
4,BACĂU,"SCOALA GENERALA CU CLASELE I-IV BERESTI",554,SASCUT,25068,1,PART,PRCNCT,PRSD,PRSD_SV,"2025-05-18 21:41:03",1090,554,484,69,1,547,7,1600,1046,377,170
4,BACĂU,"CENTRU DE SOCIALIZARE PENTRU PERSOANE VÂRSNICE DIN SAT CONȚEȘTI",555,SASCUT,25068,1,PART,PRCNCT,PRSD,PRSD_SV,"2025-05-18 21:30:52",402,241,190,50,1,241,0,400,159,158,83
4,BACĂU,"SCOALA CU CLASELE I-VIII NR 1 PANCESTI",556,SASCUT,25068,1,PART,PRCNCT,PRSD,PRSD_SV,"2025-05-18 21:38:31",835,406,352,54,0,398,8,900,494,221,177
4,BACĂU,"SCOALA CU CLASELE I-VIII NR 1 PANCESTI",557,SASCUT,25068,1,PART,PRCNCT,PRSD,PRSD_SV,"2025-05-18 21:38:09",1221,547,484,62,1,541,6,1300,753,324,217
4,BACĂU,"SCOALA CU CLASELE I-VIII SATUL SASCUT-SAT",558,SASCUT,25068,1,PART,PRCNCT,PRSD,PRSD_SV,"2025-05-18 21:54:04",816,341,305,36,0,339,2,900,559,186,153
4,BACĂU,"SCOALA CU CLASELE I-VIII SATUL SASCUT-SAT",559,SASCUT,25068,1,PART,PRCNCT,PRSD,PRSD_SV,"2025-05-18 21:39:18",786,380,344,36,0,373,7,900,520,194,179
4,BACĂU,"ŞOALA GENERALĂ CU CLASELE I-VIII SĂNDULENI",560,SĂNDULENI,25148,1,PART,PRCNCT,PRSD,PRSD_SV,"2025-05-18 21:54:05",1591,677,609,68,0,668,9,1700,1023,372,296
4,BACĂU,"ŞCOALA GENERALĂ CU CLASELE I-VIII COMAN",561,SĂNDULENI,25148,1,PART,PRCNCT,PRSD,PRSD_SV,"2025-05-18 21:34:08",1035,367,336,31,0,362,5,1100,733,233,129
4,BACĂU,"ŞCOALA GENERALĂ CU CLASELE I-IV STUFU",562,SĂNDULENI,25148,1,PART,PRCNCT,PRSD,PRSD_SV,"2025-05-18 21:22:08",268,150,119,31,0,148,2,300,150,90,58
4,BACĂU,"ŞCOALA GENERALA CU CLASELE I-VIII VERŞEŞTI",563,SĂNDULENI,25148,1,PART,PRCNCT,PRSD,PRSD_SV,"2025-05-18 21:33:26",633,311,277,34,0,309,2,700,389,147,162
4,BACĂU,"SCOALA NR. 1 SĂRATA",564,SĂRATA,26320,1,PART,PRCNCT,PRSD,PRSD_SV,"2025-05-18 21:32:28",673,344,284,60,0,335,9,700,356,151,184
4,BACĂU,"SCOALA NR. 2 SĂRATA",565,SĂRATA,26320,1,PART,PRCNCT,PRSD,PRSD_SV,"2025-05-18 21:49:12",913,474,402,72,0,470,4,982,508,221,249
4,BACĂU,"SCOALA NR. 3 SĂRATA",566,SĂRATA,26320,1,PART,PRCNCT,PRSD,PRSD_SV,"2025-05-18 21:22:25",376,187,153,34,0,183,4,400,213,77,106
4,BACĂU,"CAMIN CULTURAL SAUCESTI",567,SĂUCEŞTI,25228,1,PART,PRCNCT,PRSD,PRSD_SV,"2025-05-18 21:43:13",1164,654,559,93,2,641,13,1300,646,361,280
4,BACĂU,"CENTRU TIP AFTER SCHOOL SĂUCEȘTI",568,SĂUCEŞTI,25228,1,PART,PRCNCT,PRSD,PRSD_SV,"2025-05-18 21:51:15",1012,572,504,68,0,567,5,1100,528,269,298
4,BACĂU,"ŞCOALA SATUL BOGDAN VODĂ",569,SĂUCEŞTI,25228,1,PART,PRCNCT,PRSD,PRSD_SV,"2025-05-18 21:34:22",703,453,396,57,0,445,8,800,347,192,253
4,BACĂU,"ŞCOALA SATUL SCHINENI",570,SĂUCEŞTI,25228,1,PART,PRCNCT,PRSD,PRSD_SV,"2025-05-18 21:30:11",731,374,319,55,0,371,3,800,426,168,203
4,BACĂU,"ŞCOALA SATUL SIRETU",571,SĂUCEŞTI,25228,1,PART,PRCNCT,PRSD,PRSD_SV,"2025-05-18 21:19:12",614,359,288,71,0,352,7,700,341,222,130
4,BACĂU,"ŞCOALA SATUL ŞERBEŞTI",572,SĂUCEŞTI,25228,1,PART,PRCNCT,PRSD,PRSD_SV,"2025-05-18 21:27:59",518,289,240,49,0,288,1,600,311,173,115
4,BACĂU,"ŞCOALA CU CLASELE I-VIII SATUL SCORŢENI",573,SCORŢENI,25291,1,PART,PRCNCT,PRSD,PRSD_SV,"2025-05-18 22:05:01",1180,486,449,37,0,481,5,1300,814,307,174
4,BACĂU,"CAMIN CULTURAL FLORESTI",574,SCORŢENI,25291,1,PART,PRCNCT,PRSD,PRSD_SV,"2025-05-18 21:48:50",557,261,218,43,0,258,3,600,339,155,103
4,BACĂU,"CAMIN CULTURAL GRIGORENI",575,SCORŢENI,25291,1,PART,PRCNCT,PRSD,PRSD_SV,"2025-05-18 21:42:06",642,326,261,65,0,322,4,700,374,181,141
4,BACĂU,"ŞCOALA GIMNAZIALĂ SATUL SECUIENI",576,SECUIENI,25362,1,PART,PRCNCT,PRSD,PRSD_SV,"2025-05-18 22:06:22",1135,498,426,72,0,489,9,1200,702,328,161
4,BACĂU,"ŞCOALA SATUL CHITICENI",577,SECUIENI,25362,1,PART,PRCNCT,PRSD,PRSD_SV,"2025-05-18 21:12:42",150,83,65,18,0,82,1,200,117,53,29
4,BACĂU,"ŞCOALA SATUL FUNDENI",578,SECUIENI,25362,1,PART,PRCNCT,PRSD,PRSD_SV,"2025-05-18 21:30:33",293,205,145,60,0,205,0,300,95,122,83
4,BACĂU,"ŞCOALA SATUL GLODIŞOARELE",579,SECUIENI,25362,1,PART,PRCNCT,PRSD,PRSD_SV,"2025-05-18 21:18:49",237,103,90,13,0,101,2,300,197,71,30
4,BACĂU,"ŞCOALA CU CLASELE I-VIII SATUL SOLONŢ",580,SOLONŢ,25488,1,PART,PRCNCT,PRSD,PRSD_SV,"2025-05-18 21:44:27",1169,476,447,28,1,467,9,1300,824,304,163
4,BACĂU,"ŞCOALA CU CLASELE I-VIII SATUL CUCUIEȚI",581,SOLONŢ,25488,1,PART,PRCNCT,PRSD,PRSD_SV,"2025-05-18 21:41:20",952,418,371,47,0,411,7,1000,582,260,151
4,BACĂU,"CABINET MEDICAL",582,SOLONŢ,25488,1,PART,PRCNCT,PRSD,PRSD_SV,"2025-05-18 21:35:52",636,253,230,23,0,250,3,700,447,151,99
4,BACĂU,"ȘCOALA GIMNAZIALĂ ”GEORGE APOSTU” STĂNIȘEȘTI",583,STĂNIŞEŞTI,25521,1,PART,PRCNCT,PRSD,PRSD_SV,"2025-05-18 22:08:30",679,309,280,29,0,307,2,700,391,170,137
4,BACĂU,"SCOALA BENESTI",584,STĂNIŞEŞTI,25521,1,PART,PRCNCT,PRSD,PRSD_SV,"2025-05-18 21:28:16",375,149,125,24,0,144,5,400,251,97,47
4,BACĂU,"SCOALA SATUL CRĂIEŞTI",585,STĂNIŞEŞTI,25521,1,PART,PRCNCT,PRSD,PRSD_SV,"2025-05-18 21:36:14",381,151,131,20,0,151,0,400,249,102,49
4,BACĂU,"CONTAINER MODULAR",586,STĂNIŞEŞTI,25521,1,PART,PRCNCT,PRSD,PRSD_SV,"2025-05-18 21:17:41",431,212,165,47,0,206,6,400,188,113,93
4,BACĂU,"ŞCOALA 1 SATUL SLOBOZIA",587,STĂNIŞEŞTI,25521,1,PART,PRCNCT,PRSD,PRSD_SV,"2025-05-18 21:20:01",744,248,198,50,0,244,4,800,552,171,73
4,BACĂU,"ŞCOALA SATUL SLOBOZIA NOUĂ",588,STĂNIŞEŞTI,25521,1,PART,PRCNCT,PRSD,PRSD_SV,"2025-05-18 21:25:25",619,266,249,17,0,263,3,700,434,204,59
4,BACĂU,"CONTAINER MODULAR",589,STĂNIŞEŞTI,25521,1,PART,PRCNCT,PRSD,PRSD_SV,"2025-05-18 21:20:42",107,61,41,20,0,59,2,100,39,31,28
4,BACĂU,"ŞCOALA GENERALĂ SATUL STRUGARI",590,STRUGARI,25629,1,PART,PRCNCT,PRSD,PRSD_SV,"2025-05-18 21:27:17",766,370,322,48,0,367,3,800,430,200,167
4,BACĂU,"SCOALA GENERALA CETATUIA",591,STRUGARI,25629,1,PART,PRCNCT,PRSD,PRSD_SV,"2025-05-18 21:14:04",214,104,84,20,0,103,1,200,96,59,44
4,BACĂU,"ŞCOALA GENERALĂ SATUL PETRICICA",592,STRUGARI,25629,1,PART,PRCNCT,PRSD,PRSD_SV,"2025-05-18 21:12:55",562,246,209,37,0,244,2,600,354,156,88
4,BACĂU,"ŞCOALA GENERALĂ SATUL RĂCHITIŞ",593,STRUGARI,25629,1,PART,PRCNCT,PRSD,PRSD_SV,"2025-05-18 21:17:19",325,142,127,15,0,139,3,400,258,88,51
4,BACĂU,"CAMIN CULTURAL",594,"ŞTEFAN CEL MARE",20670,1,PART,PRCNCT,PRSD,PRSD_SV,"2025-05-18 21:33:00",756,392,344,48,0,390,2,800,408,218,172
4,BACĂU,"SCOALA GENERALA SATUL BOGDANA",595,"ŞTEFAN CEL MARE",20670,1,PART,PRCNCT,PRSD,PRSD_SV,"2025-05-18 21:27:08",443,257,225,31,1,255,2,500,243,161,94
4,BACĂU,"GRĂDINIŢA CU PROGRAM NORMAL SATUL GUTINAŞ",596,"ŞTEFAN CEL MARE",20670,1,PART,PRCNCT,PRSD,PRSD_SV,"2025-05-18 21:24:46",342,187,151,36,0,186,1,392,205,100,86
4,BACĂU,"GRADINITA CU PROGRAM NORMAL NEGOIESTI",597,"ŞTEFAN CEL MARE",20670,1,PART,PRCNCT,PRSD,PRSD_SV,"2025-05-18 21:24:31",730,383,341,42,0,375,8,800,417,233,142
4,BACĂU,"GRĂDINIŢA CU PROGRAM NORMAL SATUL RĂDEANA",598,"ŞTEFAN CEL MARE",20670,1,PART,PRCNCT,PRSD,PRSD_SV,"2025-05-18 21:35:50",1258,452,421,31,0,437,15,1400,948,285,152
4,BACĂU,"GRĂDINIŢA CU PROGRAM NORMAL SATUL VIIŞOARA",599,"ŞTEFAN CEL MARE",20670,1,PART,PRCNCT,PRSD,PRSD_SV,"2025-05-18 21:25:12",467,250,220,30,0,248,2,500,250,144,104
4,BACĂU,"ȘCOALA GIMNAZIALĂ NR. 1 TAMAȘI",600,TAMAŞI,25692,1,PART,PRCNCT,PRSD,PRSD_SV,"2025-05-18 21:55:12",570,300,251,48,1,296,4,600,300,162,134
4,BACĂU,"CENTRUL EDUCAŢIONAL ÎNV.DUMITRU NEDIŢĂ TAMAŞI",601,TAMAŞI,25692,1,PART,PRCNCT,PRSD,PRSD_SV,"2025-05-18 21:42:26",720,330,294,36,0,325,5,800,470,225,100
4,BACĂU,"ŞCOALA CU CLASELE I-VIII SATUL CHETRIŞ",602,TAMAŞI,25692,2,PART,PRCNCT,PRSD,PRSD_SV,"2025-05-19 01:19:17",741,438,353,85,0,427,11,800,362,252,175
4,BACĂU,"ŞCOALA CU CLASELE I-IV SATUL FURNICARI",603,TAMAŞI,25692,1,PART,PRCNCT,PRSD,PRSD_SV,"2025-05-18 21:49:45",570,250,227,23,0,245,5,600,350,147,98
4,BACĂU,"PRIMĂRIA TĂTĂRĂŞTI",604,TĂTĂRĂŞTI,25745,1,PART,PRCNCT,PRSD,PRSD_SV,"2025-05-18 21:25:13",387,197,166,31,0,192,5,400,203,114,78
4,BACĂU,"ŞCOALA GIMNAZIALA SATUL CORNII DE SUS",605,TĂTĂRĂŞTI,25745,1,PART,PRCNCT,PRSD,PRSD_SV,"2025-05-18 21:35:51",687,331,277,54,0,318,13,800,469,212,106
4,BACĂU,"ŞCOALA PRIMARA SATUL DRĂGEŞTI",606,TĂTĂRĂŞTI,25745,1,PART,PRCNCT,PRSD,PRSD_SV,"2025-05-18 21:20:32",299,188,154,34,0,186,2,300,112,141,45
4,BACĂU,"ŞCOALA PRIMARA SATUL GHERDANA",607,TĂTĂRĂŞTI,25745,1,PART,PRCNCT,PRSD,PRSD_SV,"2025-05-18 21:13:29",270,139,116,23,0,139,0,276,137,93,46
4,BACĂU,"ŞCOALA PRIMARA SATUL GIURGENI",608,TĂTĂRĂŞTI,25745,1,PART,PRCNCT,PRSD,PRSD_SV,"2025-05-18 21:19:24",184,121,95,26,0,120,1,200,79,79,41
4,BACĂU,"GRĂDINIŢA CU PROGRAM NORMAL TG.TROTUŞ",609,"TÂRGU TROTUŞ",25825,1,PART,PRCNCT,PRSD,PRSD_SV,"2025-05-18 21:54:47",950,430,402,28,0,428,2,987,557,234,194
4,BACĂU,"GRĂDINIŢA CU PROGRAM NORMAL TG.TROTUŞ",610,"TÂRGU TROTUŞ",25825,1,PART,PRCNCT,PRSD,PRSD_SV,"2025-05-18 21:37:11",871,396,357,39,0,391,5,1000,604,204,187
4,BACĂU,"GRĂDINIŢA CU PROGRAM NORMAL SATUL TUTA",611,"TÂRGU TROTUŞ",25825,1,PART,PRCNCT,PRSD,PRSD_SV,"2025-05-18 21:53:44",900,422,407,15,0,417,5,1000,578,180,237
4,BACĂU,"GRĂDINIŢA CU PROGRAM NORMAL SATUL TUTA",612,"TÂRGU TROTUŞ",25825,1,PART,PRCNCT,PRSD,PRSD_SV,"2025-05-18 22:11:37",885,442,417,25,0,439,3,979,537,201,238
4,BACĂU,"GRĂDINIŢA CU PROGRAM NORMAL SATUL VIIŞOARA",613,"TÂRGU TROTUŞ",25825,1,PART,PRCNCT,PRSD,PRSD_SV,"2025-05-18 21:50:02",849,483,421,62,0,479,4,900,417,288,191
4,BACĂU,"ŞCOALA GIMNAZIALĂ TRAIAN",614,TRAIAN,25861,1,PART,PRCNCT,PRSD,PRSD_SV,"2025-05-18 21:47:39",1588,759,645,114,0,750,9,1700,941,339,411
4,BACĂU,"ŞCOALA CU CLASELE I-IV SATUL BOGDĂNEŞTI",615,TRAIAN,25861,1,PART,PRCNCT,PRSD,PRSD_SV,"2025-05-18 21:27:30",425,185,155,28,2,183,2,500,315,97,86
4,BACĂU,"ŞCOALA CU CLASELE I-IV SATUL HERTIOANA DE JOS",616,TRAIAN,25861,1,PART,PRCNCT,PRSD,PRSD_SV,"2025-05-18 21:34:49",151,105,71,34,0,104,1,221,116,69,35
4,BACĂU,"ŞCOALA CU CLASELE I-IV SATUL ZĂPODIA",617,TRAIAN,25861,1,PART,PRCNCT,PRSD,PRSD_SV,"2025-05-18 21:22:12",548,201,172,29,0,200,1,594,393,90,110
4,BACĂU,"CĂMINUL CULTURAL UNGURENI",618,UNGURENI,25932,1,PART,PRCNCT,PRSD,PRSD_SV,"2025-05-18 21:42:11",748,376,297,64,15,363,13,808,432,215,148
4,BACĂU,"ŞCOALA SATUL BĂRTĂŞEŞTI",619,UNGURENI,25932,1,PART,PRCNCT,PRSD,PRSD_SV,"2025-05-18 21:19:10",333,118,104,14,0,116,2,400,282,113,3
4,BACĂU,"SCOALA BIBIRESTI II",620,UNGURENI,25932,1,PART,PRCNCT,PRSD,PRSD_SV,"2025-05-18 21:36:34",739,375,332,43,0,365,10,800,425,256,109
4,BACĂU,"CĂMINUL CULTURAL SATUL BOTEŞTI",621,UNGURENI,25932,1,PART,PRCNCT,PRSD,PRSD_SV,"2025-05-18 21:28:06",720,263,227,36,0,260,3,800,537,155,105
4,BACĂU,"SCOALA VIFORENI",622,UNGURENI,25932,1,PART,PRCNCT,PRSD,PRSD_SV,"2025-05-18 21:16:57",358,156,126,30,0,155,1,400,244,100,55
4,BACĂU,"SALA DE CEREMONII",623,URECHEŞTI,26029,1,PART,PRCNCT,PRSD,PRSD_SV,"2025-05-18 22:03:07",1312,600,529,71,0,587,13,1400,800,346,241
4,BACĂU,"CĂMINUL CULTURAL SATUL CORNĂŢEL",624,URECHEŞTI,26029,1,PART,PRCNCT,PRSD,PRSD_SV,"2025-05-18 21:43:17",712,363,324,39,0,357,6,800,437,223,134
4,BACĂU,"ŞCOALA GENERALA CU CASELE I-IV SATUL LUNCA DOCHIEI",625,URECHEŞTI,26029,1,PART,PRCNCT,PRSD,PRSD_SV,"2025-05-18 21:23:15",233,116,97,19,0,114,2,300,184,60,54
4,BACĂU,"ŞCOALA GENERALA CU CLASELE I-IV SATUL SATU NOU",626,URECHEŞTI,26029,1,PART,PRCNCT,PRSD,PRSD_SV,"2025-05-18 21:41:55",229,123,105,18,0,121,2,300,177,84,37
4,BACĂU,"GRĂDINIŢA SATUL SLOBOZIA",627,URECHEŞTI,26029,1,PART,PRCNCT,PRSD,PRSD_SV,"2025-05-18 21:26:57",419,234,195,39,0,230,4,500,266,139,91
4,BACĂU,"ŞCOALA GIMNAZIALĂ NR.1 VALEA SEACĂ",628,"VALEA SEACĂ",26083,1,PART,PRCNCT,PRSD,PRSD_SV,"2025-05-18 21:28:50",935,316,276,40,0,312,4,1000,684,186,126
4,BACĂU,"ŞCOALA PRIMARĂ NR.2 VALEA SEACĂ",629,"VALEA SEACĂ",26083,1,PART,PRCNCT,PRSD,PRSD_SV,"2025-05-18 21:18:46",712,287,240,47,0,285,2,800,513,156,129
4,BACĂU,"ŞCOALA PRIMARĂ NR.3 VALEA SEACĂ",630,"VALEA SEACĂ",26083,1,PART,PRCNCT,PRSD,PRSD_SV,"2025-05-18 21:25:08",764,303,261,42,0,295,8,800,497,196,99
4,BACĂU,"ŞCOALA PRIMARĂ CUCOVA",631,"VALEA SEACĂ",26083,1,PART,PRCNCT,PRSD,PRSD_SV,"2025-05-18 21:21:01",512,266,210,56,0,262,4,600,334,173,89
4,BACĂU,"CENTRU DE ZI LICHITISENI",632,VULTURENI,26118,1,PART,PRCNCT,PRSD,PRSD_SV,"2025-05-18 21:31:57",384,160,134,24,2,159,1,400,240,99,60
4,BACĂU,"ŞCOALA GHILĂVEŞTI",633,VULTURENI,26118,1,PART,PRCNCT,PRSD,PRSD_SV,"2025-05-18 21:19:13",201,102,79,23,0,102,0,213,111,55,47
4,BACĂU,"GRADINIȚA CU PROGRAM NORMAL GODINEŞTII DE JOS",634,VULTURENI,26118,1,PART,PRCNCT,PRSD,PRSD_SV,"2025-05-18 21:22:26",286,132,101,31,0,131,1,300,168,79,52
4,BACĂU,"ŞCOALA MEDELENI",635,VULTURENI,26118,1,PART,PRCNCT,PRSD,PRSD_SV,"2025-05-18 21:17:54",130,90,62,28,0,87,3,100,10,58,29
4,BACĂU,"SCOALA VULTURENI",636,VULTURENI,26118,1,PART,PRCNCT,PRSD,PRSD_SV,"2025-05-18 21:37:23",366,188,144,43,1,187,1,400,212,113,74
4,BACĂU,"ŞCOALA MIHAI EMINESCU ZEMEŞ",637,ZEMEŞ,26289,1,PART,PRCNCT,PRSD,PRSD_SV,"2025-05-18 21:49:17",1091,527,487,40,0,521,6,1200,673,328,193
4,BACĂU,"ŞCOALA ŞTEFAN CEL MARE ZEMEŞ",638,ZEMEŞ,26289,1,PART,PRCNCT,PRSD,PRSD_SV,"2025-05-18 22:00:21",1108,540,515,24,1,531,9,1200,660,281,250
4,BACĂU,"ŞCOALA ŞTEFAN CEL MARE ZEMEŞ",639,ZEMEŞ,26289,1,PART,PRCNCT,PRSD,PRSD_SV,"2025-05-18 22:03:39",656,316,291,25,0,311,5,700,384,163,148
4,BACĂU,"ŞCOALA ION CREANGĂ ZEMEŞ",640,ZEMEŞ,26289,1,PART,PRCNCT,PRSD,PRSD_SV,"2025-05-18 22:04:21",863,460,428,32,0,456,4,987,527,349,107
5,BIHOR,"COLEGIUL ECONOMIC ” PARTENIE COSMA ”",1,"MUNICIPIUL ORADEA",26564,1,PART,PRCNCT,PRSD,PRSD_SV,"2025-05-18 22:42:06",1597,1450,888,559,3,1437,13,1759,309,241,1196
5,BIHOR,"ȘCOALA GIMNAZIALĂ ” LUCREŢIA SUCIU ”",2,"MUNICIPIUL ORADEA",26564,1,PART,PRCNCT,PRSD,PRSD_SV,"2025-05-18 22:25:07",1160,587,504,55,28,582,5,1275,688,162,420
5,BIHOR,"LICEUL SANITAR ”VASILE VOICULESCU”",3,"MUNICIPIUL ORADEA",26564,1,PART,PRCNCT,PRSD,PRSD_SV,"2025-05-18 22:16:42",1180,607,556,51,0,597,10,1297,690,204,393
5,BIHOR,"LICEUL SANITAR ”VASILE VOICULESCU”",4,"MUNICIPIUL ORADEA",26564,1,PART,PRCNCT,PRSD,PRSD_SV,"2025-05-18 22:02:15",1277,587,547,40,0,580,7,1404,817,197,383
5,BIHOR,"GRĂDINIŢA CU PROGRAM PRELUNGIT NR.22",5,"MUNICIPIUL ORADEA",26564,1,PART,PRCNCT,PRSD,PRSD_SV,"2025-05-18 21:35:12",1257,571,539,32,0,565,6,1181,610,190,375
5,BIHOR,"GRĂDINIŢA CU PROGRAM PRELUNGIT NR.22",6,"MUNICIPIUL ORADEA",26564,1,PART,PRCNCT,PRSD,PRSD_SV,"2025-05-18 22:27:09",1374,794,721,73,0,779,15,1510,716,261,518
5,BIHOR,"CREȘA NR. 2 ” PICIORUȘE VESELE ”",7,"MUNICIPIUL ORADEA",26564,1,PART,PRCNCT,PRSD,PRSD_SV,"2025-05-18 21:49:28",727,360,303,57,0,356,4,800,440,115,241
5,BIHOR,"GRĂDINIȚA CU PROGRAM PRELUNGIT NR. 22",8,"MUNICIPIUL ORADEA",26564,1,PART,PRCNCT,PRSD,PRSD_SV,"2025-05-18 22:04:07",1109,539,476,63,0,534,5,1220,681,181,353
5,BIHOR,"CREŞA NR.2 ”PICIORUŞE VESELE”",9,"MUNICIPIUL ORADEA",26564,1,PART,PRCNCT,PRSD,PRSD_SV,"2025-05-18 22:00:09",1115,542,495,47,0,533,9,1228,686,171,362
5,BIHOR,"ŞCOALA GIMNAZIALĂ ”IOAN SLAVICI”",10,"MUNICIPIUL ORADEA",26564,1,PART,PRCNCT,PRSD,PRSD_SV,"2025-05-18 22:22:13",1327,801,711,89,1,789,12,1461,660,314,475
5,BIHOR,"ŞCOALA GIMNAZIALĂ ”IOAN SLAVICI”",11,"MUNICIPIUL ORADEA",26564,1,PART,PRCNCT,PRSD,PRSD_SV,"2025-05-18 21:58:47",1486,799,752,47,0,790,9,1634,835,296,494
5,BIHOR,"ŞCOALA GIMNAZIALĂ ”IOAN SLAVICI”",12,"MUNICIPIUL ORADEA",26564,1,PART,PRCNCT,PRSD,PRSD_SV,"2025-05-18 21:51:03",1754,1048,963,84,1,1037,11,1898,850,378,659
5,BIHOR,"ŞCOALA GIMNAZIALĂ ”IOAN SLAVICI”",13,"MUNICIPIUL ORADEA",26564,1,PART,PRCNCT,PRSD,PRSD_SV,"2025-05-18 21:40:33",1443,687,633,54,0,674,13,1198,511,363,311
5,BIHOR,"ŞCOALA GIMNAZIALĂ ”IOAN SLAVICI”",14,"MUNICIPIUL ORADEA",26564,1,PART,PRCNCT,PRSD,PRSD_SV,"2025-05-18 21:41:49",807,410,386,24,0,402,8,887,477,162,240
5,BIHOR,"GRĂDINIŢA CU PROGRAM PRELUNGIT NR.25",15,"MUNICIPIUL ORADEA",26564,1,PART,PRCNCT,PRSD,PRSD_SV,"2025-05-18 21:59:40",765,368,334,34,0,352,16,842,474,111,241
5,BIHOR,"GRĂDINIŢA CU PROGRAM PRELUNGIT NR.25",16,"MUNICIPIUL ORADEA",26564,1,PART,PRCNCT,PRSD,PRSD_SV,"2025-05-18 21:45:15",949,420,383,37,0,417,3,1045,625,136,281
5,BIHOR,"ŞCOALA GIMNAZIALĂ ”DIMITRIE CANTEMIR”",17,"MUNICIPIUL ORADEA",26564,1,PART,PRCNCT,PRSD,PRSD_SV,"2025-05-18 21:48:04",1029,675,579,95,1,665,10,1133,458,143,522
5,BIHOR,"ŞCOALA GIMNAZIALĂ ”DIMITRIE CANTEMIR”",18,"MUNICIPIUL ORADEA",26564,1,PART,PRCNCT,PRSD,PRSD_SV,"2025-05-18 21:32:18",951,592,508,84,0,585,7,1045,453,124,461
5,BIHOR,"ŞCOALA GIMNAZIALĂ ”DIMITRIE CANTEMIR”",19,"MUNICIPIUL ORADEA",26564,1,PART,PRCNCT,PRSD,PRSD_SV,"2025-05-18 21:35:57",1457,859,803,56,0,844,15,1604,745,170,674
5,BIHOR,"ŞCOALA GIMNAZIALĂ ”DIMITRIE CANTEMIR”",20,"MUNICIPIUL ORADEA",26564,1,PART,PRCNCT,PRSD,PRSD_SV,"2025-05-18 22:52:00",1620,914,835,78,1,904,10,1784,870,303,601
5,BIHOR,"ŞCOALA GIMNAZIALĂ ”DIMITRIE CANTEMIR”",21,"MUNICIPIUL ORADEA",26564,1,PART,PRCNCT,PRSD,PRSD_SV,"2025-05-18 21:56:48",1347,802,683,119,0,785,17,1481,679,224,561
5,BIHOR,"GRĂDINIŢA CU PROGRAM PRELUNGIT NR.24",22,"MUNICIPIUL ORADEA",26564,1,PART,PRCNCT,PRSD,PRSD_SV,"2025-05-18 22:10:30",1272,784,686,98,0,779,5,1351,567,174,605
5,BIHOR,"COLEGIUL NAȚIONAL ”ONISIFOR GHIBU”",23,"MUNICIPIUL ORADEA",26564,1,PART,PRCNCT,PRSD,PRSD_SV,"2025-05-18 21:54:17",1666,1134,866,249,19,1125,8,1833,699,299,826
5,BIHOR,"COLEGIUL NAȚIONAL ”ONISIFOR GHIBU”",24,"MUNICIPIUL ORADEA",26564,1,PART,PRCNCT,PRSD,PRSD_SV,"2025-05-18 21:41:21",1278,793,599,194,0,778,15,1405,612,274,504
5,BIHOR,"COLEGIUL NAȚIONAL ”ONISIFOR GHIBU”",25,"MUNICIPIUL ORADEA",26564,2,PART,PRCNCT,PRSD,PRSD_SV,"2025-05-18 22:23:23",1617,857,724,132,1,851,6,1780,923,270,581
5,BIHOR,"COLEGIUL NAȚIONAL ”ONISIFOR GHIBU”",26,"MUNICIPIUL ORADEA",26564,1,PART,PRCNCT,PRSD,PRSD_SV,"2025-05-18 21:51:55",1463,798,650,148,0,785,13,1609,811,274,511
5,BIHOR,"COLEGIUL NAȚIONAL ”ONISIFOR GHIBU”",27,"MUNICIPIUL ORADEA",26564,1,PART,PRCNCT,PRSD,PRSD_SV,"2025-05-18 22:06:06",1366,714,648,66,0,702,12,1502,788,200,502
5,BIHOR,"GRĂDINIȚA CU PROGRAM PRELUNGIT NR. 56",28,"MUNICIPIUL ORADEA",26564,1,PART,PRCNCT,PRSD,PRSD_SV,"2025-05-18 22:12:42",1966,1425,1217,208,0,1401,24,2162,737,427,974
5,BIHOR,"GRĂDINIȚA CU PROGRAM PRELUNGIT NR. 56",29,"MUNICIPIUL ORADEA",26564,1,PART,PRCNCT,PRSD,PRSD_SV,"2025-05-18 22:24:56",2008,1254,1170,83,1,1226,28,2213,559,386,840
5,BIHOR,"GRĂDINIȚA CU PROGRAM PRELUNGIT NR. 56",30,"MUNICIPIUL ORADEA",26564,1,PART,PRCNCT,PRSD,PRSD_SV,"2025-05-18 22:19:13",1763,1073,956,117,0,1065,8,1938,865,304,761
5,BIHOR,"GRĂDINIȚA CU PROGRAM PRELUNGIT NR. 56",31,"MUNICIPIUL ORADEA",26564,1,PART,PRCNCT,PRSD,PRSD_SV,"2025-05-18 22:03:11",1640,882,794,87,1,872,10,1803,921,260,612
5,BIHOR,"GRĂDINIȚA CU PROGRAM PRELUNGIT NR. 56",32,"MUNICIPIUL ORADEA",26564,1,PART,PRCNCT,PRSD,PRSD_SV,"2025-05-18 22:27:33",1908,1112,1042,70,0,1095,17,2101,989,372,723
5,BIHOR,"GRĂDINIŢA CU PROGRAM NORMAL NR.2",33,"MUNICIPIUL ORADEA",26564,1,PART,PRCNCT,PRSD,PRSD_SV,"2025-05-18 22:27:05",1534,1164,824,340,0,1148,16,1686,522,396,752
5,BIHOR,"GRĂDINIŢA CU PROGRAM PRELUNGIT NR. 28",34,"MUNICIPIUL ORADEA",26564,1,PART,PRCNCT,PRSD,PRSD_SV,"2025-05-18 23:07:50",1312,789,658,131,0,776,13,1446,657,248,528
5,BIHOR,"GRĂDINIŢA CU PROGRAM PRELUNGIT NR. 28",35,"MUNICIPIUL ORADEA",26564,1,PART,PRCNCT,PRSD,PRSD_SV,"2025-05-18 22:54:36",1425,846,749,97,0,829,17,1568,722,270,559
5,BIHOR,"GRĂDINIȚA CU PROGRAM PRELUNGIT NR. 28",36,"MUNICIPIUL ORADEA",26564,1,PART,PRCNCT,PRSD,PRSD_SV,"2025-05-18 22:54:53",1311,777,675,102,0,765,12,1442,665,190,575
5,BIHOR,"CREȘA ORADEA",37,"MUNICIPIUL ORADEA",26564,1,PART,PRCNCT,PRSD,PRSD_SV,"2025-05-18 22:51:50",1838,1124,980,144,0,1109,15,2021,897,325,784
5,BIHOR,"GRĂDINIŢA CU PROGRAM PRELUNGIT NR.46",38,"MUNICIPIUL ORADEA",26564,1,PART,PRCNCT,PRSD,PRSD_SV,"2025-05-18 21:24:13",693,428,337,91,0,427,1,761,333,106,321
5,BIHOR,"GRĂDINIŢA CU PROGRAM PRELUNGIT NR.46",39,"MUNICIPIUL ORADEA",26564,1,PART,PRCNCT,PRSD,PRSD_SV,"2025-05-18 21:35:49",990,535,407,128,0,530,5,1088,553,183,347
5,BIHOR,"ŞCOALA GIMNAZIALĂ ”NICOLAE BĂLCESCU”",40,"MUNICIPIUL ORADEA",26564,1,PART,PRCNCT,PRSD,PRSD_SV,"2025-05-18 21:43:49",1011,684,603,81,0,680,4,1112,428,127,553
5,BIHOR,"ŞCOALA GIMNAZIALĂ ”NICOLAE BĂLCESCU”",41,"MUNICIPIUL ORADEA",26564,1,PART,PRCNCT,PRSD,PRSD_SV,"2025-05-18 21:32:18",905,530,412,118,0,524,6,997,467,111,413
5,BIHOR,"ŞCOALA GIMNAZIALĂ",42,"MUNICIPIUL ORADEA",26564,1,PART,PRCNCT,PRSD,PRSD_SV,"2025-05-18 21:40:49",943,625,592,33,0,620,5,1036,411,113,507
5,BIHOR,"GRĂDINIŢA CU PROGRAM PRELUNGIT NR.53",43,"MUNICIPIUL ORADEA",26564,1,PART,PRCNCT,PRSD,PRSD_SV,"2025-05-18 21:26:06",830,440,397,43,0,435,5,912,472,130,305
5,BIHOR,"GRĂDINIŢA CU PROGRAM PRELUNGIT NR.53",44,"MUNICIPIUL ORADEA",26564,1,PART,PRCNCT,PRSD,PRSD_SV,"2025-05-18 21:49:49",783,433,396,37,0,425,8,861,428,93,332
5,BIHOR,"GRĂDINIŢA CU PROGRAM PRELUNGIT NR.52",45,"MUNICIPIUL ORADEA",26564,1,PART,PRCNCT,PRSD,PRSD_SV,"2025-05-18 21:32:03",773,366,334,30,2,359,7,849,483,155,204
5,BIHOR,"GRĂDINIŢA CU PROGRAM PRELUNGIT NR.52",46,"MUNICIPIUL ORADEA",26564,1,PART,PRCNCT,PRSD,PRSD_SV,"2025-05-18 22:15:34",1249,621,568,52,1,612,9,1373,752,192,420
5,BIHOR,"GRĂDINIŢA CU PROGRAM PRELUNGIT NR.52",47,"MUNICIPIUL ORADEA",26564,1,PART,PRCNCT,PRSD,PRSD_SV,"2025-05-18 21:33:43",963,463,402,59,2,457,6,1058,595,147,310
5,BIHOR,"ŞCOALA GIMNAZIALĂ NR.16",48,"MUNICIPIUL ORADEA",26564,1,PART,PRCNCT,PRSD,PRSD_SV,"2025-05-18 22:29:15",995,530,500,29,1,526,4,1094,564,124,402
5,BIHOR,"ŞCOALA GIMNAZIALĂ NR.16",49,"MUNICIPIUL ORADEA",26564,2,PART,PRCNCT,PRSD,PRSD_SV,"2025-05-18 22:39:01",765,410,370,40,0,406,4,841,431,142,264
5,BIHOR,"ŞCOALA GIMNAZIALĂ NR.16",50,"MUNICIPIUL ORADEA",26564,1,PART,PRCNCT,PRSD,PRSD_SV,"2025-05-18 22:15:17",934,562,483,79,0,558,4,1026,464,121,437
5,BIHOR,"ŞCOALA GIMNAZIALĂ NR.16",51,"MUNICIPIUL ORADEA",26564,1,PART,PRCNCT,PRSD,PRSD_SV,"2025-05-18 21:53:16",1305,810,675,134,1,798,12,1435,625,239,559
5,BIHOR,"LICEUL TEORETIC ”LUCIAN BLAGA”",52,"MUNICIPIUL ORADEA",26564,1,PART,PRCNCT,PRSD,PRSD_SV,"2025-05-18 21:57:33",1156,692,584,107,1,687,5,1271,579,168,519
5,BIHOR,"LICEUL TEORETIC ”LUCIAN BLAGA”",53,"MUNICIPIUL ORADEA",26564,1,PART,PRCNCT,PRSD,PRSD_SV,"2025-05-18 22:06:11",1548,822,750,72,0,810,12,1703,881,231,579
5,BIHOR,"LICEUL TEORETIC ”LUCIAN BLAGA”",54,"MUNICIPIUL ORADEA",26564,1,PART,PRCNCT,PRSD,PRSD_SV,"2025-05-18 22:05:55",1242,724,644,80,0,713,11,1366,642,159,554
5,BIHOR,"LICEUL TEORETIC ”LUCIAN BLAGA”",55,"MUNICIPIUL ORADEA",26564,1,PART,PRCNCT,PRSD,PRSD_SV,"2025-05-18 21:39:19",1344,629,569,59,1,624,5,1479,850,151,473
5,BIHOR,"GRĂDINIŢA CU PROGRAM NORMAL NR.17",56,"MUNICIPIUL ORADEA",26564,1,PART,PRCNCT,PRSD,PRSD_SV,"2025-05-18 21:58:16",1473,791,709,80,2,779,12,1619,828,141,638
5,BIHOR,"GRĂDINIŢA CU PROGRAM PRELUNGIT NR.20",57,"MUNICIPIUL ORADEA",26564,1,PART,PRCNCT,PRSD,PRSD_SV,"2025-05-18 22:17:32",1262,712,572,140,0,709,3,1387,675,211,498
5,BIHOR,"LICEUL ORTODOX ”EPISCOP ROMAN CIOROGARIU”",58,"MUNICIPIUL ORADEA",26564,1,PART,PRCNCT,PRSD,PRSD_SV,"2025-05-18 22:05:56",744,465,354,111,0,456,9,817,352,109,347
5,BIHOR,"LICEUL ORTODOX ”EPISCOP ROMAN CIOROGARIU”",59,"MUNICIPIUL ORADEA",26564,1,PART,PRCNCT,PRSD,PRSD_SV,"2025-05-18 22:05:34",768,558,424,133,1,551,7,845,287,150,401
5,BIHOR,"LICEUL ORTODOX ”EPISCOP ROMAN CIOROGARIU”",60,"MUNICIPIUL ORADEA",26564,1,PART,PRCNCT,PRSD,PRSD_SV,"2025-05-18 21:37:11",819,430,391,39,0,420,10,900,470,108,312
5,BIHOR,"LICEUL ORTODOX ”EPISCOP ROMAN CIOROGARIU”",61,"MUNICIPIUL ORADEA",26564,1,PART,PRCNCT,PRSD,PRSD_SV,"2025-05-18 21:44:52",1152,668,618,50,0,664,4,1266,598,154,510
5,BIHOR,"LICEUL ORTODOX ”EPISCOP ROMAN CIOROGARIU”",62,"MUNICIPIUL ORADEA",26564,1,PART,PRCNCT,PRSD,PRSD_SV,"2025-05-18 21:47:55",1392,757,722,35,0,748,9,1530,772,199,549
5,BIHOR,"LICEUL ORTODOX ”EPISCOP ROMAN CIOROGARIU”",63,"MUNICIPIUL ORADEA",26564,1,PART,PRCNCT,PRSD,PRSD_SV,"2025-05-18 21:56:58",1203,672,645,27,0,663,9,1322,650,119,544
5,BIHOR,"GRĂDINIŢA CU PROGRAM PRELUNGIT NR. 54",64,"MUNICIPIUL ORADEA",26564,2,PART,PRCNCT,PRSD,PRSD_SV,"2025-05-18 22:41:39",947,593,513,80,0,586,7,1041,448,125,461
5,BIHOR,"GRĂDINIŢA CU PROGRAM PRELUNGIT NR. 54",65,"MUNICIPIUL ORADEA",26564,1,PART,PRCNCT,PRSD,PRSD_SV,"2025-05-18 21:56:47",935,595,509,83,3,585,10,1028,433,132,453
5,BIHOR,"ŞCOALA GIMNAZIALĂ ”DACIA”",66,"MUNICIPIUL ORADEA",26564,1,PART,PRCNCT,PRSD,PRSD_SV,"2025-05-18 21:47:56",1098,705,551,154,0,695,10,1207,502,184,511
5,BIHOR,"ŞCOALA GIMNAZIALĂ ”DACIA”",67,"MUNICIPIUL ORADEA",26564,1,PART,PRCNCT,PRSD,PRSD_SV,"2025-05-18 21:59:20",1286,722,639,82,1,709,13,1414,692,180,529
5,BIHOR,"ŞCOALA GIMNAZIALĂ ”DACIA”",68,"MUNICIPIUL ORADEA",26564,1,PART,PRCNCT,PRSD,PRSD_SV,"2025-05-18 21:57:20",997,542,503,37,2,536,6,1096,554,89,447
5,BIHOR,"GRĂDINIŢA CU PROGRAM PRELUNGIT NR. 45",69,"MUNICIPIUL ORADEA",26564,1,PART,PRCNCT,PRSD,PRSD_SV,"2025-05-18 21:35:38",954,589,487,102,0,582,7,1048,459,143,439
5,BIHOR,"GRĂDINIŢA CU PROGRAM PRELUNGIT NR. 45",70,"MUNICIPIUL ORADEA",26564,1,PART,PRCNCT,PRSD,PRSD_SV,"2025-05-18 22:56:34",1258,735,667,68,0,727,8,1384,649,145,582
5,BIHOR,"GRĂDINIŢA CU PROGRAM PRELUNGIT NR. 45",71,"MUNICIPIUL ORADEA",26564,1,PART,PRCNCT,PRSD,PRSD_SV,"2025-05-18 21:58:31",1318,704,671,33,0,699,5,1450,746,177,522
5,BIHOR,"GRĂDINIŢA CU PROGRAM PRELUNGIT NR. 45",72,"MUNICIPIUL ORADEA",26564,1,PART,PRCNCT,PRSD,PRSD_SV,"2025-05-18 22:05:42",1092,618,577,40,1,606,12,1202,584,121,485
5,BIHOR,"LICEUL DE ARTE",73,"MUNICIPIUL ORADEA",26564,1,PART,PRCNCT,PRSD,PRSD_SV,"2025-05-18 22:38:59",1497,821,771,50,0,807,14,1649,828,193,614
5,BIHOR,"LICEUL DE ARTE",74,"MUNICIPIUL ORADEA",26564,1,PART,PRCNCT,PRSD,PRSD_SV,"2025-05-18 22:10:34",1390,878,750,128,0,862,16,1530,652,216,646
5,BIHOR,"LICEUL DE ARTE",75,"MUNICIPIUL ORADEA",26564,1,PART,PRCNCT,PRSD,PRSD_SV,"2025-05-18 21:38:13",1457,950,831,119,0,934,16,1605,655,156,778
5,BIHOR,"LICEUL DE ARTE",76,"MUNICIPIUL ORADEA",26564,1,PART,PRCNCT,PRSD,PRSD_SV,"2025-05-18 21:43:43",1197,696,644,52,0,688,8,1317,621,165,523
5,BIHOR,"LICEUL DE ARTE",77,"MUNICIPIUL ORADEA",26564,1,PART,PRCNCT,PRSD,PRSD_SV,"2025-05-18 22:16:31",1266,692,647,40,5,684,8,1401,709,113,571
5,BIHOR,"LICEUL DE ARTE",78,"MUNICIPIUL ORADEA",26564,1,PART,PRCNCT,PRSD,PRSD_SV,"2025-05-18 22:06:06",1399,798,751,46,1,786,12,1538,740,191,595
5,BIHOR,"LICEUL DE ARTE",79,"MUNICIPIUL ORADEA",26564,1,PART,PRCNCT,PRSD,PRSD_SV,"2025-05-18 21:56:35",967,603,480,93,30,600,3,1065,462,98,502
5,BIHOR,"ORĂŞELUL COPIILOR",80,"MUNICIPIUL ORADEA",26564,1,PART,PRCNCT,PRSD,PRSD_SV,"2025-05-18 22:57:15",1427,948,759,139,50,939,9,1573,625,223,716
5,BIHOR,"GRĂDINIŢA CU PROGRAM NORMAL NR. 15",81,"MUNICIPIUL ORADEA",26564,1,PART,PRCNCT,PRSD,PRSD_SV,"2025-05-18 22:13:38",1987,1136,1057,78,1,1132,4,2186,1050,284,848
5,BIHOR,"ŞCOALA GIMNAZIALĂ ”JUHASZ GYULA”",82,"MUNICIPIUL ORADEA",26564,1,PART,PRCNCT,PRSD,PRSD_SV,"2025-05-18 21:58:32",1410,840,810,29,1,831,9,1552,712,147,684
5,BIHOR,"ŞCOALA GIMNAZIALĂ ”JUHASZ GYULA”",83,"MUNICIPIUL ORADEA",26564,1,PART,PRCNCT,PRSD,PRSD_SV,"2025-05-18 21:46:08",1004,516,477,39,0,510,6,1107,591,94,416
5,BIHOR,"GRĂDINIȚA CU PROGRAM PRELUNGIT NR.42",84,"MUNICIPIUL ORADEA",26564,1,PART,PRCNCT,PRSD,PRSD_SV,"2025-05-18 21:49:13",1468,861,781,80,0,855,6,1615,754,241,614
5,BIHOR,"GRĂDINIȚA CU PROGRAM PRELUNGIT NR.42",85,"MUNICIPIUL ORADEA",26564,1,PART,PRCNCT,PRSD,PRSD_SV,"2025-05-18 21:34:03",813,499,428,70,1,490,9,893,394,162,328
5,BIHOR,"GRĂDINIȚA CU PROGRAM PRELUNGIT NR.42",86,"MUNICIPIUL ORADEA",26564,2,PART,PRCNCT,PRSD,PRSD_SV,"2025-05-18 23:04:53",1404,831,778,52,1,823,8,1546,715,166,657
5,BIHOR,"ŞCOALA GIMNAZIALĂ ”OCTAVIAN GOGA”",87,"MUNICIPIUL ORADEA",26564,1,PART,PRCNCT,PRSD,PRSD_SV,"2025-05-18 21:44:04",1259,777,677,100,0,770,7,1384,607,204,566
5,BIHOR,"ŞCOALA GIMNAZIALĂ ”OCTAVIAN GOGA”",88,"MUNICIPIUL ORADEA",26564,1,PART,PRCNCT,PRSD,PRSD_SV,"2025-05-18 21:58:47",1010,642,523,119,0,637,5,1111,469,177,460
5,BIHOR,"ŞCOALA GIMNAZIALĂ ”OCTAVIAN GOGA”",89,"MUNICIPIUL ORADEA",26564,1,PART,PRCNCT,PRSD,PRSD_SV,"2025-05-18 21:32:48",839,553,463,90,0,544,9,922,369,170,374
5,BIHOR,"LICEUL TEHNOLOGIC ”CONSTANTIN BRÂNCUȘI”",90,"MUNICIPIUL ORADEA",26564,1,PART,PRCNCT,PRSD,PRSD_SV,"2025-05-18 22:06:12",1429,829,724,105,0,819,10,1574,745,214,605
5,BIHOR,"LICEUL TEHNOLOGIC ”CONSTANTIN BRÂNCUȘI”",91,"MUNICIPIUL ORADEA",26564,2,PART,PRCNCT,PRSD,PRSD_SV,"2025-05-18 23:02:05",1442,759,688,69,2,753,6,1585,826,286,467
5,BIHOR,"GRĂDINIŢA CU PROGRAM PRELUNGIT NR. 55",92,"MUNICIPIUL ORADEA",26564,1,PART,PRCNCT,PRSD,PRSD_SV,"2025-05-18 21:45:53",1123,738,680,58,0,728,10,1234,496,209,519
5,BIHOR,"FUNDAŢIA DE SCLEROZĂ MULTIPLĂ",93,"MUNICIPIUL ORADEA",26564,2,PART,PRCNCT,PRSD,PRSD_SV,"2025-05-18 22:11:42",1018,569,515,54,0,557,12,1120,551,149,408
5,BIHOR,"FUNDAŢIA DE SCLEROZĂ MULTIPLĂ",94,"MUNICIPIUL ORADEA",26564,1,PART,PRCNCT,PRSD,PRSD_SV,"2025-05-18 22:04:40",1204,606,582,24,0,597,9,1323,717,156,441
5,BIHOR,"GRĂDINIŢA CU PROGRAM PRELUNGIT NR. 35",95,"MUNICIPIUL ORADEA",26564,1,PART,PRCNCT,PRSD,PRSD_SV,"2025-05-18 22:02:54",1055,582,496,86,0,575,7,1161,579,158,417
5,BIHOR,"GRĂDINIŢA CU PROGRAM PRELUNGIT NR. 35",96,"MUNICIPIUL ORADEA",26564,1,PART,PRCNCT,PRSD,PRSD_SV,"2025-05-18 21:36:41",924,567,482,85,0,559,8,1015,448,145,414
5,BIHOR,"CENTRUL DE ÎNGRIJIRE DE ZI",97,"MUNICIPIUL ORADEA",26564,1,PART,PRCNCT,PRSD,PRSD_SV,"2025-05-18 21:43:35",1230,711,672,37,2,706,5,1353,642,194,512
5,BIHOR,"CENTRUL DE ÎNGRIJIRE DE ZI",98,"MUNICIPIUL ORADEA",26564,1,PART,PRCNCT,PRSD,PRSD_SV,"2025-05-18 21:26:58",1054,538,507,31,0,534,4,1158,620,158,376
5,BIHOR,"CENTRU ŞCOLAR PENTRU EDUCAŢIE INCLUZIVĂ ”ORIZONT”",99,"MUNICIPIUL ORADEA",26564,1,PART,PRCNCT,PRSD,PRSD_SV,"2025-05-18 21:47:41",1230,595,554,41,0,586,9,1353,758,184,402
5,BIHOR,"ŞCOALA GIMNAZIALĂ NR. 11",100,"MUNICIPIUL ORADEA",26564,1,PART,PRCNCT,PRSD,PRSD_SV,"2025-05-18 22:09:58",976,736,489,130,117,727,9,1073,337,207,520
5,BIHOR,"ŞCOALA GIMNAZIALĂ NR. 11",101,"MUNICIPIUL ORADEA",26564,1,PART,PRCNCT,PRSD,PRSD_SV,"2025-05-18 21:59:06",1421,809,718,91,0,794,15,1563,754,187,607
5,BIHOR,"ŞCOALA GIMNAZIALĂ NR. 11",102,"MUNICIPIUL ORADEA",26564,1,PART,PRCNCT,PRSD,PRSD_SV,"2025-05-18 21:25:05",1109,578,526,52,0,571,7,1219,641,162,409
5,BIHOR,"ŞCOALA GIMNAZIALĂ NR. 11",103,"MUNICIPIUL ORADEA",26564,1,PART,PRCNCT,PRSD,PRSD_SV,"2025-05-18 21:46:09",950,495,458,37,0,492,3,1044,549,137,355
5,BIHOR,"ŞCOALA GIMNAZIALĂ NR. 11",104,"MUNICIPIUL ORADEA",26564,1,PART,PRCNCT,PRSD,PRSD_SV,"2025-05-18 21:35:06",1294,758,665,93,0,746,12,1422,664,207,539
5,BIHOR,"ŞCOALA GIMNAZIALĂ NR. 11",105,"MUNICIPIUL ORADEA",26564,1,PART,PRCNCT,PRSD,PRSD_SV,"2025-05-18 22:11:42",1193,658,615,41,2,654,4,1311,653,195,459
5,BIHOR,"ŞCOALA GIMNAZIALĂ NR. 11",106,"MUNICIPIUL ORADEA",26564,1,PART,PRCNCT,PRSD,PRSD_SV,"2025-05-18 22:08:26",740,445,418,27,0,439,6,814,369,133,306
5,BIHOR,"ŞCOALA GIMNAZIALĂ NR. 11",107,"MUNICIPIUL ORADEA",26564,1,PART,PRCNCT,PRSD,PRSD_SV,"2025-05-18 21:30:58",1277,656,623,30,3,646,10,1405,749,177,469
5,BIHOR,"GRĂDINIŢA CU PROGRAM PRELUNGIT NR. 41",108,"MUNICIPIUL ORADEA",26564,1,PART,PRCNCT,PRSD,PRSD_SV,"2025-05-18 22:19:33",1566,834,765,67,2,820,14,1722,888,213,607
5,BIHOR,"GRĂDINIŢA CU PROGRAM PRELUNGIT NR. 41",109,"MUNICIPIUL ORADEA",26564,1,PART,PRCNCT,PRSD,PRSD_SV,"2025-05-18 23:04:14",1582,866,798,68,0,858,8,1744,878,229,629
5,BIHOR,"ŞCOALA GIMNAZIALĂ ”ION BOGDAN”",110,"MUNICIPIUL ORADEA",26564,1,PART,PRCNCT,PRSD,PRSD_SV,"2025-05-18 22:08:41",1536,1069,965,101,3,1041,28,1689,620,284,757
5,BIHOR,"ŞCOALA GIMNAZIALĂ ”ION BOGDAN”",111,"MUNICIPIUL ORADEA",26564,1,PART,PRCNCT,PRSD,PRSD_SV,"2025-05-18 22:36:12",1516,934,853,81,0,914,20,1667,733,297,617
5,BIHOR,"ŞCOALA GIMNAZIALĂ ”ION BOGDAN”",112,"MUNICIPIUL ORADEA",26564,1,PART,PRCNCT,PRSD,PRSD_SV,"2025-05-18 22:36:12",1692,1188,1133,55,0,1167,21,1862,674,293,874
5,BIHOR,"GRĂDINIȚA CU PROGRAM PRELUNGIT NR.5",113,"MUNICIPIUL ORADEA",26564,1,PART,PRCNCT,PRSD,PRSD_SV,"2025-05-18 21:37:38",1234,746,705,41,0,729,17,1356,610,149,580
5,BIHOR,"GRĂDINIȚA CU PROGRAM PRELUNGIT NR.5",114,"MUNICIPIUL ORADEA",26564,1,PART,PRCNCT,PRSD,PRSD_SV,"2025-05-18 21:37:43",1646,991,927,33,31,971,20,1812,821,240,731
5,BIHOR,"LICEUL ORTODOX ” EPISCOP ROMAN CIOROGARIU ”",115,"MUNICIPIUL ORADEA",26564,1,PART,PRCNCT,PRSD,PRSD_SV,"2025-05-18 22:26:40",1075,733,528,135,70,723,10,1182,449,160,563
5,BIHOR,"LICEUL ORTODOX ” EPISCOP ROMAN CIOROGARIU ”",116,"MUNICIPIUL ORADEA",26564,1,PART,PRCNCT,PRSD,PRSD_SV,"2025-05-18 22:59:20",1906,1276,1074,51,151,1257,19,2097,821,264,993
5,BIHOR,"ŞCOALA GIMNAZIALĂ ”OLTEA DOAMNA” (FOSTA GRĂDINIȚĂ CU PROGRAM NORMAL NR.16)",117,"MUNICIPIUL ORADEA",26564,1,PART,PRCNCT,PRSD,PRSD_SV,"2025-05-18 22:18:22",2097,1381,1233,148,0,1365,16,2308,927,315,1050
5,BIHOR,"UNIVERSITATEA DIN ORADEA - FACULTATEA DE CONSTRUCȚII, CADASTRU ȘI ARHITECTURĂ",118,"MUNICIPIUL ORADEA",26564,2,PART,PRCNCT,PRSD,PRSD_SV,"2025-05-18 22:59:33",1048,596,514,76,6,589,7,1152,556,101,488
5,BIHOR,"UNIVERSITATEA DIN ORADEA - FACULTATEA DE CONSTRUCȚII, CADASTRU ȘI ARHITECTURĂ",119,"MUNICIPIUL ORADEA",26564,1,PART,PRCNCT,PRSD,PRSD_SV,"2025-05-18 21:37:01",972,599,538,59,2,590,9,1072,473,93,497
5,BIHOR,"PALATUL COPIILOR ŞI ELEVILOR",120,"MUNICIPIUL ORADEA",26564,1,PART,PRCNCT,PRSD,PRSD_SV,"2025-05-18 21:45:12",1402,846,697,118,31,836,10,1542,696,167,669
5,BIHOR,"COLEGIUL NAŢIONAL ”MIHAI EMINESCU”",121,"MUNICIPIUL ORADEA",26564,1,PART,PRCNCT,PRSD,PRSD_SV,"2025-05-18 21:47:29",1027,641,502,139,0,633,8,1130,489,112,521
5,BIHOR,"ŞCOALA GIMNAZIALĂ ”SZACSVAY IMRE”",122,"MUNICIPIUL ORADEA",26564,1,PART,PRCNCT,PRSD,PRSD_SV,"2025-05-18 21:42:18",1238,740,628,73,39,725,15,1363,623,148,577
5,BIHOR,"LICEUL TEORETIC ”ADY ENDRE”",123,"MUNICIPIUL ORADEA",26564,1,PART,PRCNCT,PRSD,PRSD_SV,"2025-05-18 22:33:05",1186,955,572,247,136,949,6,1306,351,249,700
5,BIHOR,"LICEUL REFORMAT ”LORANTFFY ZSUZSANNA”",124,"MUNICIPIUL ORADEA",26564,1,PART,PRCNCT,PRSD,PRSD_SV,"2025-05-18 21:44:24",1330,899,614,148,137,888,11,1463,564,242,646
5,BIHOR,"COLEGIUL NAŢIONAL ”EMANUIL GOJDU”",125,"MUNICIPIUL ORADEA",26564,1,PART,PRCNCT,PRSD,PRSD_SV,"2025-05-18 21:44:55",734,538,353,62,123,517,21,806,268,164,353
5,BIHOR,"COLEGIUL NAŢIONAL ”EMANUIL GOJDU”",126,"MUNICIPIUL ORADEA",26564,1,PART,PRCNCT,PRSD,PRSD_SV,"2025-05-18 21:52:41",676,707,353,193,161,702,5,946,239,235,467
5,BIHOR,"LICEUL TEORETIC ”AUREL LAZĂR”",127,"MUNICIPIUL ORADEA",26564,1,PART,PRCNCT,PRSD,PRSD_SV,"2025-05-18 22:21:12",1412,662,477,183,2,656,6,1551,889,154,502
5,BIHOR,"LICEUL GRECO-CATOLIC ”IULIU MANIU”",128,"MUNICIPIUL ORADEA",26564,1,PART,PRCNCT,PRSD,PRSD_SV,"2025-05-18 21:50:03",997,600,419,180,1,593,7,1096,496,159,434
5,BIHOR,"LICEUL GRECO-CATOLIC ”IULIU MANIU”",129,"MUNICIPIUL ORADEA",26564,1,PART,PRCNCT,PRSD,PRSD_SV,"2025-05-18 22:08:01",1035,575,425,149,1,564,11,1138,563,150,414
5,BIHOR,"COLEGIUL NAŢIONAL ”IOSIF VULCAN”",130,"MUNICIPIUL ORADEA",26564,1,PART,PRCNCT,PRSD,PRSD_SV,"2025-05-18 22:20:30",727,477,370,106,1,469,8,799,322,95,374
5,BIHOR,"COLEGIUL NAŢIONAL ”IOSIF VULCAN”",131,"MUNICIPIUL ORADEA",26564,1,PART,PRCNCT,PRSD,PRSD_SV,"2025-05-18 21:47:33",869,481,353,128,0,475,6,955,474,87,388
5,BIHOR,"COLEGIUL NAȚIONAL ”IOSIF VULCAN”",132,"MUNICIPIUL ORADEA",26564,1,PART,PRCNCT,PRSD,PRSD_SV,"2025-05-18 22:27:20",1708,1044,895,149,0,1030,14,1877,833,262,768
5,BIHOR,"COLEGIUL NAȚIONAL ”IOSIF VULCAN”",133,"MUNICIPIUL ORADEA",26564,1,PART,PRCNCT,PRSD,PRSD_SV,"2025-05-18 22:31:53",1250,864,678,186,0,854,10,1374,510,243,611
5,BIHOR,"COLEGIUL NAȚIONAL ”IOSIF VULCAN”",134,"MUNICIPIUL ORADEA",26564,1,PART,PRCNCT,PRSD,PRSD_SV,"2025-05-18 21:52:50",1027,669,523,146,0,659,10,1114,445,200,459
5,BIHOR,"COLEGIUL NAȚIONAL ”IOSIF VULCAN”",135,"MUNICIPIUL ORADEA",26564,1,PART,PRCNCT,PRSD,PRSD_SV,"2025-05-18 21:58:26",1129,724,611,113,0,718,6,1241,517,200,518
5,BIHOR,"LICEUL TEORETIC GERMAN ”FRIEDRICH SCHILLER”",136,"MUNICIPIUL ORADEA",26564,1,PART,PRCNCT,PRSD,PRSD_SV,"2025-05-18 21:46:46",836,464,408,55,1,459,5,919,455,106,353
5,BIHOR,"LICEUL TEORETIC GERMAN ”FRIEDRICH SCHILLER”",137,"MUNICIPIUL ORADEA",26564,1,PART,PRCNCT,PRSD,PRSD_SV,"2025-05-18 21:38:24",1412,728,690,38,0,715,13,1552,824,149,566
5,BIHOR,"LICEUL TEORETIC GERMAN ”FRIEDRICH SCHILLER”",138,"MUNICIPIUL ORADEA",26564,1,PART,PRCNCT,PRSD,PRSD_SV,"2025-05-18 22:07:01",1080,697,526,171,0,692,5,1187,490,190,502
5,BIHOR,"LICEUL TEORETIC GERMAN ”FRIEDRICH SCHILLER”",139,"MUNICIPIUL ORADEA",26564,1,PART,PRCNCT,PRSD,PRSD_SV,"2025-05-18 22:24:00",918,550,467,81,2,537,13,1010,460,106,431
5,BIHOR,"ŞCOALA GIMNAZIALĂ ”AVRAM IANCU”",140,"MUNICIPIUL ORADEA",26564,1,PART,PRCNCT,PRSD,PRSD_SV,"2025-05-18 21:44:46",1090,694,645,49,0,684,10,1200,506,202,482
5,BIHOR,"ŞCOALA GIMNAZIALĂ ”AVRAM IANCU”",141,"MUNICIPIUL ORADEA",26564,1,PART,PRCNCT,PRSD,PRSD_SV,"2025-05-18 23:00:13",1336,854,782,71,1,839,15,1449,595,222,617
5,BIHOR,"GRĂDINIŢA CU PROGRAM PRELUNGIT NR. 44",142,"MUNICIPIUL ORADEA",26564,1,PART,PRCNCT,PRSD,PRSD_SV,"2025-05-18 22:11:18",1985,1477,1150,327,0,1457,20,2183,706,403,1054
5,BIHOR,"GRĂDINIŢA CU PROGRAM PRELUNGIT NR. 44",143,"MUNICIPIUL ORADEA",26564,1,PART,PRCNCT,PRSD,PRSD_SV,"2025-05-18 21:59:35",1720,1283,1063,218,2,1266,17,1897,614,298,968
5,BIHOR,"LICEUL TEOLOGIC BAPTIST „EMANUEL” - SALA DE SPORT",144,"MUNICIPIUL ORADEA",26564,1,PART,PRCNCT,PRSD,PRSD_SV,"2025-05-18 22:22:29",1153,943,659,284,0,929,14,1268,325,188,741
5,BIHOR,"BLOCURILE ANL",145,"MUNICIPIUL ORADEA",26564,1,PART,PRCNCT,PRSD,PRSD_SV,"2025-05-18 22:09:27",1843,1243,1154,88,1,1221,22,2029,786,391,830
5,BIHOR,"PRIMĂRIA MUNICIPIULUI BEIUŞ",146,"MUNICIPIUL BEIUŞ",26804,1,PART,PRCNCT,PRSD,PRSD_SV,"2025-05-18 22:05:56",1298,763,664,99,0,750,13,1428,665,295,455
5,BIHOR,"LICEUL PEDAGOGIC",147,"MUNICIPIUL BEIUŞ",26804,1,PART,PRCNCT,PRSD,PRSD_SV,"2025-05-18 21:43:29",1255,803,681,118,4,799,4,1380,577,269,530
5,BIHOR,"COLEGIUL NAŢIONAL ”SAMUIL VULCAN” BEIUŞ",148,"MUNICIPIUL BEIUŞ",26804,1,PART,PRCNCT,PRSD,PRSD_SV,"2025-05-18 22:27:37",1035,540,431,74,35,530,10,1138,598,200,330
5,BIHOR,"COLEGIUL TEHNIC ”IOAN CIORDAŞ”",149,"MUNICIPIUL BEIUŞ",26804,1,PART,PRCNCT,PRSD,PRSD_SV,"2025-05-18 22:07:45",1129,638,551,82,5,622,16,1244,606,241,381
5,BIHOR,"ŞCOALA GIMNAZIALĂ ”NICOLAE POPOVICIU”",150,"MUNICIPIUL BEIUŞ",26804,1,PART,PRCNCT,PRSD,PRSD_SV,"2025-05-18 23:14:27",1387,897,769,124,4,892,5,1527,630,326,566
5,BIHOR,"GRĂDINIŢA ” FLOARE DE COLŢ”",151,"MUNICIPIUL BEIUŞ",26804,1,PART,PRCNCT,PRSD,PRSD_SV,"2025-05-18 22:12:33",1134,628,566,62,0,617,11,1246,618,190,427
5,BIHOR,"BLOC PARTER",152,"MUNICIPIUL BEIUŞ",26804,1,PART,PRCNCT,PRSD,PRSD_SV,"2025-05-18 22:34:10",1164,684,626,58,0,679,5,1281,597,252,427
5,BIHOR,"CĂMIN CULTURAL DELANI",153,"MUNICIPIUL BEIUŞ",26804,1,PART,PRCNCT,PRSD,PRSD_SV,"2025-05-18 21:25:26",273,192,160,32,0,186,6,299,107,113,73
5,BIHOR,"COLEGIUL NAŢIONAL ”OCTAVIAN GOGA”",154,"MUNICIPIUL MARGHITA",26877,1,PART,PRCNCT,PRSD,PRSD_SV,"2025-05-18 21:45:00",1504,885,762,55,68,875,10,1658,773,211,664
5,BIHOR,"COLEGIUL NAŢIONAL ”OCTAVIAN GOGA”",155,"MUNICIPIUL MARGHITA",26877,1,PART,PRCNCT,PRSD,PRSD_SV,"2025-05-18 21:38:21",1456,749,695,38,16,745,4,1601,852,204,541
5,BIHOR,"COLEGIUL NAŢIONAL ”OCTAVIAN GOGA”",156,"MUNICIPIUL MARGHITA",26877,1,PART,PRCNCT,PRSD,PRSD_SV,"2025-05-18 21:53:57",1199,609,555,51,3,600,9,1318,709,169,431
5,BIHOR,"COLEGIUL NAŢIONAL ”OCTAVIAN GOGA”",157,"MUNICIPIUL MARGHITA",26877,1,PART,PRCNCT,PRSD,PRSD_SV,"2025-05-18 21:25:00",1120,567,523,41,3,562,5,1231,664,144,418
5,BIHOR,"COLEGIUL NAŢIONAL ”OCTAVIAN GOGA”",158,"MUNICIPIUL MARGHITA",26877,1,PART,PRCNCT,PRSD,PRSD_SV,"2025-05-18 21:28:58",1213,566,530,30,6,561,5,1333,767,161,400
5,BIHOR,"CASA DE CULTURĂ MARGHITA",159,"MUNICIPIUL MARGHITA",26877,1,PART,PRCNCT,PRSD,PRSD_SV,"2025-05-18 21:26:21",1135,480,432,47,1,471,9,1248,768,110,361
5,BIHOR,"CLUBUL COPIILOR",160,"MUNICIPIUL MARGHITA",26877,1,PART,PRCNCT,PRSD,PRSD_SV,"2025-05-18 22:07:04",1178,543,489,49,5,542,1,1297,754,148,394
5,BIHOR,"LICEUL TEORETIC ”HORVÁTH JÁNOS”",161,"MUNICIPIUL MARGHITA",26877,1,PART,PRCNCT,PRSD,PRSD_SV,"2025-05-18 22:04:11",1260,625,551,60,14,619,6,1385,760,163,456
5,BIHOR,"GRĂDINIŢA CU PROGRAM PRELUNGIT NR.4",162,"MUNICIPIUL MARGHITA",26877,1,PART,PRCNCT,PRSD,PRSD_SV,"2025-05-18 21:46:48",989,401,366,35,0,397,4,1087,686,138,259
5,BIHOR,"LICEUL TEORETIC ” HORVÁTH JÁNOS ”",163,"MUNICIPIUL MARGHITA",26877,1,PART,PRCNCT,PRSD,PRSD_SV,"2025-05-18 21:53:37",1387,715,662,32,21,708,7,1523,808,166,542
5,BIHOR,"ŞCOALA CU CLASELE I-VIII CHEŢ",164,"MUNICIPIUL MARGHITA",26877,1,PART,PRCNCT,PRSD,PRSD_SV,"2025-05-18 21:35:38",948,441,410,31,0,437,4,1042,601,100,337
5,BIHOR,"ŞCOALA CU CLASELE I-VIII GHENETEA",165,"MUNICIPIUL MARGHITA",26877,1,PART,PRCNCT,PRSD,PRSD_SV,"2025-05-18 21:44:34",569,279,238,41,0,278,1,625,346,162,116
5,BIHOR,"FOSTUL MAGAZIN WAGNER",166,"MUNICIPIUL SALONTA",26975,1,PART,PRCNCT,PRSD,PRSD_SV,"2025-05-18 22:02:35",1485,712,668,39,5,687,25,1633,921,180,507
5,BIHOR,"GRĂDINIȚA FLOAREA SOARELUI",167,"MUNICIPIUL SALONTA",26975,1,PART,PRCNCT,PRSD,PRSD_SV,"2025-05-18 22:00:50",1505,807,728,30,49,796,11,1655,848,175,621
5,BIHOR,"LICEUL TEORETIC ARANY JANOS",168,"MUNICIPIUL SALONTA",26975,1,PART,PRCNCT,PRSD,PRSD_SV,"2025-05-18 21:56:58",1118,557,513,40,4,552,5,1230,673,88,464
5,BIHOR,"GRĂDINIȚA CURCUBEU",169,"MUNICIPIUL SALONTA",26975,1,PART,PRCNCT,PRSD,PRSD_SV,"2025-05-18 21:41:54",839,431,411,18,2,424,7,922,491,87,337
5,BIHOR,"CASA DE CULTURĂ ZILAHY LAJOS",170,"MUNICIPIUL SALONTA",26975,1,PART,PRCNCT,PRSD,PRSD_SV,"2025-05-18 21:56:49",1360,615,544,66,5,608,7,1495,880,153,455
5,BIHOR,"GRĂDINIȚA TOLDI",171,"MUNICIPIUL SALONTA",26975,1,PART,PRCNCT,PRSD,PRSD_SV,"2025-05-18 22:04:53",1071,519,456,63,0,514,5,1177,658,140,374
5,BIHOR,"COLEGIUL NAȚIONAL TEODOR NEŞ",172,"MUNICIPIUL SALONTA",26975,1,PART,PRCNCT,PRSD,PRSD_SV,"2025-05-18 22:19:11",730,405,359,46,0,402,3,802,397,127,275
5,BIHOR,"CENTRU ECONOMIC DE EDUCAȚIE ȘI AFACERI",173,"MUNICIPIUL SALONTA",26975,1,PART,PRCNCT,PRSD,PRSD_SV,"2025-05-18 22:06:42",1216,581,538,42,1,577,4,1337,756,213,364
5,BIHOR,"GRĂDINIȚA CU PROGRAM PRELUNGIT ”URSULEȚ„SALONTA",174,"MUNICIPIUL SALONTA",26975,1,PART,PRCNCT,PRSD,PRSD_SV,"2025-05-18 21:37:29",554,207,192,15,0,201,6,608,401,64,137
5,BIHOR,"CASA SFÂNTUL ANTON",175,"MUNICIPIUL SALONTA",26975,1,PART,PRCNCT,PRSD,PRSD_SV,"2025-05-18 21:46:22",471,261,243,18,0,252,9,517,256,60,192
5,BIHOR,"ȘCOALA GENERALĂ",176,"MUNICIPIUL SALONTA",26975,1,PART,PRCNCT,PRSD,PRSD_SV,"2025-05-18 21:33:21",1135,509,484,25,0,501,8,1250,741,217,284
5,BIHOR,"GRĂDINIȚA FLUIERAȘUL FERMECAT",177,"MUNICIPIUL SALONTA",26975,1,PART,PRCNCT,PRSD,PRSD_SV,"2025-05-18 22:04:01",1547,796,759,33,4,790,6,1701,905,144,646
5,BIHOR,"LICEUL TEHNOLOGIC NR.1",178,"MUNICIPIUL SALONTA",26975,1,PART,PRCNCT,PRSD,PRSD_SV,"2025-05-18 21:25:45",812,430,381,49,0,425,5,892,462,128,297
5,BIHOR,"GRĂDINIȚA PRICHINDEL",179,"MUNICIPIUL SALONTA",26975,1,PART,PRCNCT,PRSD,PRSD_SV,"2025-05-18 21:56:47",804,430,405,25,0,422,8,885,455,133,289
5,BIHOR,"ȘCOALA GENERALĂ FÜVESKERT",180,"MUNICIPIUL SALONTA",26975,1,PART,PRCNCT,PRSD,PRSD_SV,"2025-05-18 21:22:02",745,394,375,19,0,391,3,820,426,176,215
5,BIHOR,"PRIMĂRIA ALEȘD- SALA MARE",181,"ORAŞ ALEŞD",26699,1,PART,PRCNCT,PRSD,PRSD_SV,"2025-05-18 22:53:02",1430,921,768,125,28,911,10,1572,651,312,599
5,BIHOR,"LICEUL TEORETIC CONSTANTIN ȘERBAN",182,"ORAŞ ALEŞD",26699,1,PART,PRCNCT,PRSD,PRSD_SV,"2025-05-18 22:03:45",1280,691,594,95,2,685,6,1407,716,302,383
5,BIHOR,"COLEGIUL TEHNIC ALEXANDRU ROMAN",183,"ORAŞ ALEŞD",26699,1,PART,PRCNCT,PRSD,PRSD_SV,"2025-05-18 22:54:38",1434,751,662,89,0,743,8,1576,825,329,414
5,BIHOR,"GRĂDINIȚA CU PROGRAM NORMAL NR. 1",184,"ORAŞ ALEŞD",26699,1,PART,PRCNCT,PRSD,PRSD_SV,"2025-05-18 22:22:41",1182,705,637,56,12,696,9,1299,594,223,473
5,BIHOR,"CENTRUL MULTIFUNCȚIONAL",185,"ORAŞ ALEŞD",26699,1,PART,PRCNCT,PRSD,PRSD_SV,"2025-05-18 22:03:24",1177,506,486,20,0,485,21,1294,788,324,161
5,BIHOR,"ȘCOALA PRIMARĂ NR. 2",186,"ORAŞ ALEŞD",26699,1,PART,PRCNCT,PRSD,PRSD_SV,"2025-05-18 21:25:56",524,213,174,39,0,209,4,575,362,82,127
5,BIHOR,"CĂMIN CULTURAL",187,"ORAŞ ALEŞD",26699,1,PART,PRCNCT,PRSD,PRSD_SV,"2025-05-18 21:47:53",1066,668,591,77,0,656,12,1172,504,395,261
5,BIHOR,"ŞCOALA PRIMARĂ NR. 2",188,"ORAŞ ALEŞD",26699,1,PART,PRCNCT,PRSD,PRSD_SV,"2025-05-18 22:03:32",664,429,357,72,0,412,17,729,300,189,223
5,BIHOR,"ŞCOALA GIMNAZIALĂ NR. 1 NUCET",189,"ORAŞ NUCET",26920,1,PART,PRCNCT,PRSD,PRSD_SV,"2025-05-18 22:16:50",1220,704,606,53,45,694,10,1342,638,378,316
5,BIHOR,"CĂMINUL CULTURAL BĂIŢA",190,"ORAŞ NUCET",26920,1,PART,PRCNCT,PRSD,PRSD_SV,"2025-05-18 21:23:33",490,285,251,29,5,278,7,538,253,139,139
5,BIHOR,"ȘCOALA CU CLASELE I-IV",191,"ORAŞ SĂCUENI",30915,1,PART,PRCNCT,PRSD,PRSD_SV,"2025-05-18 22:34:11",1146,515,500,15,0,507,8,1260,745,134,373
5,BIHOR,"GRĂDINIȚA ȘI ȘCOALA CU CLASELE I-IV",192,"ORAŞ SĂCUENI",30915,1,PART,PRCNCT,PRSD,PRSD_SV,"2025-05-18 22:37:57",1498,788,758,23,7,756,32,1647,859,221,535
5,BIHOR,"GRĂDINIȚĂ CU PROGRAM PRELUNGIT",193,"ORAŞ SĂCUENI",30915,1,PART,PRCNCT,PRSD,PRSD_SV,"2025-05-18 22:11:14",1168,585,551,33,1,577,8,1284,699,92,485
5,BIHOR,"GRĂDINIȚA DE LA LOCUL DE CASĂ",194,"ORAŞ SĂCUENI",30915,1,PART,PRCNCT,PRSD,PRSD_SV,"2025-05-18 22:04:14",859,390,372,18,0,389,1,944,554,92,297
5,BIHOR,"CLĂDIREA MUZEULUI",195,"ORAŞ SĂCUENI",30915,1,PART,PRCNCT,PRSD,PRSD_SV,"2025-05-18 22:14:19",1426,666,623,43,0,656,10,1568,902,154,502
5,BIHOR,"ŞCOALA GENERALĂ",196,"ORAŞ SĂCUENI",30915,1,PART,PRCNCT,PRSD,PRSD_SV,"2025-05-18 22:01:11",862,436,407,20,9,425,11,947,511,83,342
5,BIHOR,"CLUBUL TINERETULUI",197,"ORAŞ SĂCUENI",30915,1,PART,PRCNCT,PRSD,PRSD_SV,"2025-05-18 22:22:26",757,515,449,35,31,505,10,823,308,53,452
5,BIHOR,"ŞCOALA GENERALĂ",198,"ORAŞ SĂCUENI",30915,1,PART,PRCNCT,PRSD,PRSD_SV,"2025-05-18 22:15:14",693,439,402,16,21,428,11,761,322,59,369
5,BIHOR,"ŞCOALA GENERALĂ",199,"ORAŞ SĂCUENI",30915,1,PART,PRCNCT,PRSD,PRSD_SV,"2025-05-18 22:01:14",424,214,194,20,0,213,1,465,251,28,185
5,BIHOR,"ŞCOALA GENERALĂ",200,"ORAŞ SĂCUENI",30915,1,PART,PRCNCT,PRSD,PRSD_SV,"2025-05-18 21:41:40",715,352,323,19,10,347,5,786,434,40,307
5,BIHOR,"CASA DE CULTURĂ „MIRON POMPILIU” ŞTEI",201,"ORAŞ ŞTEI",26840,1,PART,PRCNCT,PRSD,PRSD_SV,"2025-05-18 21:49:47",1193,654,510,144,0,648,6,1311,657,300,348
5,BIHOR,"ŞCOALA GIMNAZIALĂ CU CLASELE I-VIII „MIRON POMPILIU” ŞTEI - ŞCOALA MICĂ",202,"ORAŞ ŞTEI",26840,1,PART,PRCNCT,PRSD,PRSD_SV,"2025-05-18 21:51:37",870,425,382,33,10,416,9,956,531,145,271
5,BIHOR,"COLEGIUL TEHNIC„UNIREA” ŞTEI",203,"ORAŞ ŞTEI",26840,1,PART,PRCNCT,PRSD,PRSD_SV,"2025-05-18 21:47:22",970,484,424,59,1,476,8,1067,583,153,323
5,BIHOR,"COLEGIUL TEHNIC „UNIREA” ŞTEI - ŞCOALA DE ŞOFERI",204,"ORAŞ ŞTEI",26840,1,PART,PRCNCT,PRSD,PRSD_SV,"2025-05-18 22:24:26",1207,649,569,77,3,644,4,1327,679,337,307
5,BIHOR,"ŞCOALA GIMNAZIALĂ CU CLASELE I-VIII „MIRON POMPILIU” ŞTEI",205,"ORAŞ ŞTEI",26840,1,PART,PRCNCT,PRSD,PRSD_SV,"2025-05-18 21:41:50",1186,692,595,62,35,677,15,1305,613,245,432
5,BIHOR,"ŞCOALA GIMNAZIALĂ VALEA LUI MIHAI",206,"ORAŞ VALEA LUI MIHAI",32027,1,PART,PRCNCT,PRSD,PRSD_SV,"2025-05-18 22:02:02",1226,629,533,93,3,621,8,1348,719,86,535
5,BIHOR,"ŞCOALA GIMNAZIALĂ VALEA LUI MIHAI",207,"ORAŞ VALEA LUI MIHAI",32027,1,PART,PRCNCT,PRSD,PRSD_SV,"2025-05-18 21:43:29",1381,660,600,49,11,656,4,1519,859,77,579
5,BIHOR,"ŞCOALA GIMNAZIALĂ VALEA LUI MIHAI",208,"ORAŞ VALEA LUI MIHAI",32027,1,PART,PRCNCT,PRSD,PRSD_SV,"2025-05-18 21:38:03",1354,544,519,24,1,535,9,1488,944,113,422
5,BIHOR,"ŞCOALA GIMNAZIALĂ VALEA LUI MIHAI",209,"ORAŞ VALEA LUI MIHAI",32027,1,PART,PRCNCT,PRSD,PRSD_SV,"2025-05-18 21:36:34",1217,584,543,23,18,573,11,1338,754,81,492
5,BIHOR,"ŞCOALA GIMNAZIALĂ VALEA LUI MIHAI",210,"ORAŞ VALEA LUI MIHAI",32027,1,PART,PRCNCT,PRSD,PRSD_SV,"2025-05-18 21:50:30",1286,516,491,20,5,511,5,1414,898,113,398
5,BIHOR,"ŞCOALA GIMNAZIALĂ ”ZELK ZOLTÁN” GRĂDINIŢA CU PROGRAM NORMAL NR.1",211,"ORAŞ VALEA LUI MIHAI",32027,1,PART,PRCNCT,PRSD,PRSD_SV,"2025-05-18 21:39:59",1162,576,534,38,4,570,6,1277,701,75,495
5,BIHOR,"LICEUL TEHNOLOGIC NR.1 - VALEA LUI MIHAI",212,"ORAŞ VALEA LUI MIHAI",32027,1,PART,PRCNCT,PRSD,PRSD_SV,"2025-05-18 21:44:45",1208,562,533,25,4,559,3,1328,766,69,490
5,BIHOR,"CASA DE CULTURĂ",213,"ORAŞ VAŞCĂU",27007,1,PART,PRCNCT,PRSD,PRSD_SV,"2025-05-18 22:05:34",1222,724,622,96,6,714,10,1343,619,306,408
5,BIHOR,"CĂMINUL CULTURAL",214,"ORAŞ VAŞCĂU",27007,1,PART,PRCNCT,PRSD,PRSD_SV,"2025-05-18 21:19:10",149,82,72,10,0,82,0,163,81,51,31
5,BIHOR,"ŞCOALA GENERALĂ",215,"ORAŞ VAŞCĂU",27007,1,PART,PRCNCT,PRSD,PRSD_SV,"2025-05-18 21:14:25",38,27,16,11,0,27,0,41,14,15,12
5,BIHOR,"CĂMINUL CULTURAL",216,"ORAŞ VAŞCĂU",27007,1,PART,PRCNCT,PRSD,PRSD_SV,"2025-05-18 21:15:38",118,79,56,22,1,79,0,129,50,30,49
5,BIHOR,"CĂMINUL CULTURAL",217,"ORAŞ VAŞCĂU",27007,1,PART,PRCNCT,PRSD,PRSD_SV,"2025-05-18 21:17:34",172,111,97,14,0,111,0,188,77,63,48
5,BIHOR,"CĂMINUL CULTURAL",218,"ORAŞ VAŞCĂU",27007,1,PART,PRCNCT,PRSD,PRSD_SV,"2025-05-18 21:22:11",108,79,54,25,0,79,0,118,39,41,38
5,BIHOR,"PRIMĂRIA ABRAM",219,ABRAM,27070,1,PART,PRCNCT,PRSD,PRSD_SV,"2025-05-18 21:32:14",770,367,334,32,1,367,0,846,479,176,191
5,BIHOR,"CĂMIN CULTURAL",220,ABRAM,27070,1,PART,PRCNCT,PRSD,PRSD_SV,"2025-05-18 21:29:02",231,113,92,21,0,112,1,253,140,80,32
5,BIHOR,"CĂMIN CULTURAL",221,ABRAM,27070,1,PART,PRCNCT,PRSD,PRSD_SV,"2025-05-18 21:18:31",229,116,91,24,1,115,1,251,135,59,56
5,BIHOR,"ȘCOALĂ PRIMARĂ",222,ABRAM,27070,1,PART,PRCNCT,PRSD,PRSD_SV,"2025-05-18 21:25:11",96,66,49,16,1,66,0,105,39,19,47
5,BIHOR,"ȘCOALĂ PRIMARĂ NR. 1",223,ABRAM,27070,1,PART,PRCNCT,PRSD,PRSD_SV,"2025-05-18 21:36:17",377,235,205,28,2,234,1,414,179,122,112
5,BIHOR,"CĂMIN CULTURAL",224,ABRAM,27070,1,PART,PRCNCT,PRSD,PRSD_SV,"2025-05-18 21:41:06",222,133,108,25,0,132,1,243,110,75,57
5,BIHOR,"ȘCOALĂ PRIMARĂ NR. 3",225,ABRAM,27070,1,PART,PRCNCT,PRSD,PRSD_SV,"2025-05-18 21:21:38",434,249,191,28,30,244,5,476,227,125,119
5,BIHOR,"ȘCOALA GIMNAZIALĂ NR 1 AȘTILEU",226,AŞTILEU,26742,1,PART,PRCNCT,PRSD,PRSD_SV,"2025-05-18 21:54:48",1241,677,638,39,0,668,9,1364,687,392,276
5,BIHOR,"CĂMIN CULTURAL CĂLĂȚEA",227,AŞTILEU,26742,1,PART,PRCNCT,PRSD,PRSD_SV,"2025-05-18 21:23:42",243,146,123,23,0,146,0,266,120,85,61
5,BIHOR,"CĂMIN CULTURAL CORNET",228,AŞTILEU,26742,1,PART,PRCNCT,PRSD,PRSD_SV,"2025-05-18 21:21:18",208,134,115,19,0,134,0,228,94,86,48
5,BIHOR,"CĂMIN CULTURAL",229,AŞTILEU,26742,1,PART,PRCNCT,PRSD,PRSD_SV,"2025-05-18 22:01:42",514,319,272,46,1,318,1,564,245,145,173
5,BIHOR,"ȘCOALA PRIMARĂ NR 2 PEŞTERE",230,AŞTILEU,26742,1,PART,PRCNCT,PRSD,PRSD_SV,"2025-05-18 21:41:27",656,422,388,34,0,415,7,721,299,239,176
5,BIHOR,"CĂMINUL CULTURAL AUŞEU",231,AUŞEU,27212,1,PART,PRCNCT,PRSD,PRSD_SV,"2025-05-18 21:46:08",755,488,418,60,10,482,6,830,342,252,230
5,BIHOR,"ŞCOALA PRIMARĂ",232,AUŞEU,27212,1,PART,PRCNCT,PRSD,PRSD_SV,"2025-05-18 22:11:22",815,450,399,45,6,443,7,899,449,225,218
5,BIHOR,"CĂMIN CULTURAL",233,AUŞEU,27212,1,PART,PRCNCT,PRSD,PRSD_SV,"2025-05-18 21:49:10",733,398,343,52,3,395,3,805,407,246,149
5,BIHOR,"SALA SPORT ȘCOALA",234,"AVRAM IANCU",27285,1,PART,PRCNCT,PRSD,PRSD_SV,"2025-05-18 21:56:25",1474,824,757,67,0,817,7,1620,796,539,278
5,BIHOR,"CĂMINUL CULTURAL",235,"AVRAM IANCU",27285,1,PART,PRCNCT,PRSD,PRSD_SV,"2025-05-18 21:21:55",183,87,45,42,0,87,0,200,113,21,66
5,BIHOR,"ȘCOALA NOUĂ TĂMAȘDA",236,"AVRAM IANCU",27285,1,PART,PRCNCT,PRSD,PRSD_SV,"2025-05-18 21:55:47",957,425,399,25,1,423,2,1052,627,341,82
5,BIHOR,"CĂMINUL CULTURAL BALC",237,BALC,27329,1,PART,PRCNCT,PRSD,PRSD_SV,"2025-05-18 21:39:26",1011,463,407,39,17,457,6,1111,648,146,311
5,BIHOR,"CĂMINUL CULTURAL ALMAŞU MARE",238,BALC,27329,1,PART,PRCNCT,PRSD,PRSD_SV,"2025-05-18 21:28:53",603,296,265,31,0,295,1,662,364,203,92
5,BIHOR,"ȘCOALA PRIMARĂ NR.1 ALMAȘU MIC",239,BALC,27329,1,PART,PRCNCT,PRSD,PRSD_SV,"2025-05-18 21:44:56",291,132,107,22,3,124,8,319,187,60,64
5,BIHOR,"CĂMINUL CULTURAL GHIDA",240,BALC,27329,1,PART,PRCNCT,PRSD,PRSD_SV,"2025-05-18 21:32:11",138,55,38,17,0,53,2,151,96,33,20
5,BIHOR,"CĂMINUL CULTURAL SĂLDĂBAGIU DE BARCĂU",241,BALC,27329,1,PART,PRCNCT,PRSD,PRSD_SV,"2025-05-18 21:26:36",424,203,166,36,1,201,2,465,262,120,81
5,BIHOR,"ȘCOALA GIMNAZIALĂ NR.1 BATĂR",242,BATĂR,27383,1,PART,PRCNCT,PRSD,PRSD_SV,"2025-05-18 21:33:38",1350,477,418,55,4,468,9,1484,1007,300,168
5,BIHOR,"ȘCOALA GIMNAZIALĂ NR. 4 ARPĂȘEL",243,BATĂR,27383,1,PART,PRCNCT,PRSD,PRSD_SV,"2025-05-18 21:29:55",717,303,274,27,2,301,2,788,485,75,226
5,BIHOR,"GRĂDINIȚA TALPOȘ",244,BATĂR,27383,1,PART,PRCNCT,PRSD,PRSD_SV,"2025-05-18 21:44:06",1379,515,459,56,0,500,15,1517,1002,394,106
5,BIHOR,"ŞCOALA GIMNAZIALĂ NR.3",245,BATĂR,27383,1,PART,PRCNCT,PRSD,PRSD_SV,"2025-05-18 21:38:44",750,371,313,58,0,367,4,824,453,203,164
5,BIHOR,"ȘCOALA GENERALĂ CU CLASELE V-VIII GASPAR ANDRAS",246,BIHARIA,27436,1,PART,PRCNCT,PRSD,PRSD_SV,"2025-05-18 22:08:55",1695,1088,934,113,41,1079,9,1865,777,205,874
5,BIHOR,"GRĂDINIȚA DE COPII BIHARIA",247,BIHARIA,27436,1,PART,PRCNCT,PRSD,PRSD_SV,"2025-05-18 22:33:52",1621,985,841,117,27,975,10,1782,797,154,821
5,BIHOR,"ȘCOALA GENERALĂ CU CLASELE I-IV CAUACEU",248,BIHARIA,27436,1,PART,PRCNCT,PRSD,PRSD_SV,"2025-05-18 22:37:01",635,416,353,49,14,411,5,699,283,45,366
5,BIHOR,"ȘCOALA CU CLASELE I- IV, BOIANU-MARE",249,"BOIANU MARE",27506,1,PART,PRCNCT,PRSD,PRSD_SV,"2025-05-18 21:47:00",447,226,208,18,0,225,1,491,265,153,72
5,BIHOR,"ȘCOALA CU CLASELE I- VIII ” ÎNVĂȚĂTOR GÂLGĂU IOSIF” PĂGAIA",250,"BOIANU MARE",27506,1,PART,PRCNCT,PRSD,PRSD_SV,"2025-05-18 21:45:03",510,258,237,19,2,255,3,560,302,135,120
5,BIHOR,"CĂMIN CULTURAL BOROD",251,BOROD,27560,1,PART,PRCNCT,PRSD,PRSD_SV,"2025-05-18 22:30:10",1285,689,615,72,2,678,11,1413,724,505,173
5,BIHOR,"ŞCOALA CU CLASELE I-IV",252,BOROD,27560,1,PART,PRCNCT,PRSD,PRSD_SV,"2025-05-18 22:33:13",487,307,280,27,0,299,8,535,228,166,133
5,BIHOR,"GRĂDINIȚA CETEA",253,BOROD,27560,1,PART,PRCNCT,PRSD,PRSD_SV,"2025-05-18 21:27:51",177,144,101,43,0,144,0,194,50,52,92
5,BIHOR,"CĂMINUL CULTURAL CORNIȚEL",254,BOROD,27560,1,PART,PRCNCT,PRSD,PRSD_SV,"2025-05-18 21:42:40",414,354,225,129,0,343,11,454,100,216,127
5,BIHOR,"ȘCOALA CU CLASELE I-IV",255,BOROD,27560,1,PART,PRCNCT,PRSD,PRSD_SV,"2025-05-18 21:20:15",86,55,40,15,0,55,0,94,39,44,11
5,BIHOR,"ȘCOALA CU CLASELE. I-VIII",256,BOROD,27560,1,PART,PRCNCT,PRSD,PRSD_SV,"2025-05-18 21:25:53",209,115,71,44,0,115,0,229,114,82,33
5,BIHOR,"ȘCOALA CU CLASELE I-IV",257,BOROD,27560,1,PART,PRCNCT,PRSD,PRSD_SV,"2025-05-18 21:56:56",373,254,216,38,0,247,7,409,155,146,101
5,BIHOR,"LICEUL TECHNOLOGIC AGROINDUSTRIAL ”TAMASI ARON” BORȘ",258,BORŞ,27631,1,PART,PRCNCT,PRSD,PRSD_SV,"2025-05-18 22:07:38",1240,989,748,210,31,982,7,1363,374,107,875
5,BIHOR,"CASĂ COMUNALĂ SANTĂUL MARE",259,BORŞ,27631,1,PART,PRCNCT,PRSD,PRSD_SV,"2025-05-18 21:57:24",352,314,177,77,60,313,1,386,72,36,277
5,BIHOR,"ȘCOALA PRIMARĂ SANTĂUL MIC",260,BORŞ,27631,1,PART,PRCNCT,PRSD,PRSD_SV,"2025-05-18 21:31:28",487,331,288,34,9,329,2,535,204,57,272
5,BIHOR,"CENTRUL DE PROMOVARE A CULTURII SÂNTION",261,BORŞ,27631,1,PART,PRCNCT,PRSD,PRSD_SV,"2025-05-18 23:25:26",1708,1171,1047,96,28,1160,11,1878,707,116,1044
5,BIHOR,"CĂMINUL CULTURAL BRATCA",262,BRATCA,27686,1,PART,PRCNCT,PRSD,PRSD_SV,"2025-05-18 22:29:23",1120,621,528,93,0,618,3,1231,610,342,276
5,BIHOR,"CĂMINUL CULTURAL",263,BRATCA,27686,1,PART,PRCNCT,PRSD,PRSD_SV,"2025-05-18 21:49:24",1046,525,443,82,0,516,9,1150,625,331,185
5,BIHOR,"CĂMINUL CULTURAL",264,BRATCA,27686,1,PART,PRCNCT,PRSD,PRSD_SV,"2025-05-18 21:34:47",372,208,153,55,0,204,4,408,200,140,64
5,BIHOR,"CĂMINUL CULTURAL",265,BRATCA,27686,1,PART,PRCNCT,PRSD,PRSD_SV,"2025-05-18 21:43:49",336,202,173,29,0,198,4,369,167,127,71
5,BIHOR,"CĂMINUL CULTURAL",266,BRATCA,27686,1,PART,PRCNCT,PRSD,PRSD_SV,"2025-05-18 21:58:32",440,261,231,30,0,261,0,483,222,218,43
5,BIHOR,"CĂMINUL CULTURAL",267,BRATCA,27686,1,PART,PRCNCT,PRSD,PRSD_SV,"2025-05-18 21:23:01",343,199,177,22,0,195,4,376,177,112,83
5,BIHOR,"ȘCOALA GIMNAZIALĂ NR. 1 BRUSTURI",268,BRUSTURI,27757,1,PART,PRCNCT,PRSD,PRSD_SV,"2025-05-18 21:49:11",877,425,361,64,0,421,4,964,539,248,173
5,BIHOR,"ŞCOALA CUIEŞD",269,BRUSTURI,27757,1,PART,PRCNCT,PRSD,PRSD_SV,"2025-05-18 21:31:35",368,178,129,40,9,175,3,404,226,72,103
5,BIHOR,"ŞCOALA ORVIŞELE",270,BRUSTURI,27757,1,PART,PRCNCT,PRSD,PRSD_SV,"2025-05-18 21:43:02",252,136,102,34,0,135,1,276,140,95,40
5,BIHOR,"CĂMINUL CULTURAL PĂULEȘTI",271,BRUSTURI,27757,1,PART,PRCNCT,PRSD,PRSD_SV,"2025-05-18 21:21:29",243,140,107,33,0,139,1,266,126,83,56
5,BIHOR,"CĂMINUL CULTURAL PICLEU",272,BRUSTURI,27757,1,PART,PRCNCT,PRSD,PRSD_SV,"2025-05-18 21:37:58",701,341,291,50,0,340,1,770,429,183,157
5,BIHOR,"ŞCOALA GIMNAZIALĂ ȚIGĂNEȘTII DE CRIȘ",273,BRUSTURI,27757,1,PART,PRCNCT,PRSD,PRSD_SV,"2025-05-18 21:24:48",246,143,104,39,0,141,2,270,127,76,65
5,BIHOR,"CĂMINUL CULTURAL",274,BUDUREASA,27846,1,PART,PRCNCT,PRSD,PRSD_SV,"2025-05-18 21:42:54",818,541,464,74,3,530,11,899,358,259,271
5,BIHOR,"ȘCOALA I-IV BUDUREASA",275,BUDUREASA,27846,1,PART,PRCNCT,PRSD,PRSD_SV,"2025-05-18 21:41:41",484,221,209,12,0,217,4,531,310,158,59
5,BIHOR,"CĂMINUL CULTURAL",276,BUDUREASA,27846,1,PART,PRCNCT,PRSD,PRSD_SV,"2025-05-18 21:46:36",313,184,161,22,1,183,1,343,159,90,93
5,BIHOR,"CĂMINUL CULTURAL",277,BUDUREASA,27846,1,PART,PRCNCT,PRSD,PRSD_SV,"2025-05-18 21:23:59",155,88,76,12,0,88,0,170,82,43,45
5,BIHOR,"CĂMINUL CULTURAL",278,BUDUREASA,27846,1,PART,PRCNCT,PRSD,PRSD_SV,"2025-05-18 21:34:06",191,133,117,16,0,133,0,209,76,73,60
5,BIHOR,"CĂMINUL CULTURAL",279,BUDUREASA,27846,1,PART,PRCNCT,PRSD,PRSD_SV,"2025-05-18 21:16:13",120,81,63,18,0,80,1,131,50,60,20
5,BIHOR,"PRIMĂRIA BUDUSLĂU",280,BUDUSLĂU,27908,1,PART,PRCNCT,PRSD,PRSD_SV,"2025-05-18 21:32:08",829,470,425,32,13,463,7,911,441,51,412
5,BIHOR,"ŞCOALA GENERALĂ ALBIŞ",281,BUDUSLĂU,27908,1,PART,PRCNCT,PRSD,PRSD_SV,"2025-05-18 21:43:12",773,408,375,22,11,405,3,849,441,17,388
5,BIHOR,"CĂMIN CULTURAL BULZ",282,BULZ,27935,1,PART,PRCNCT,PRSD,PRSD_SV,"2025-05-18 21:56:52",633,398,328,69,1,393,5,695,297,240,153
5,BIHOR,"GRĂDINIȚA CU PROGRAM NORMAL NR. 3 MUNTENI",283,BULZ,27935,1,PART,PRCNCT,PRSD,PRSD_SV,"2025-05-18 21:36:46",392,275,216,58,1,272,3,430,155,148,124
5,BIHOR,"ȘCOALA PRIMARĂ NR. 1 REMEȚI",284,BULZ,27935,1,PART,PRCNCT,PRSD,PRSD_SV,"2025-05-18 21:51:36",607,468,338,129,1,465,3,667,199,221,244
5,BIHOR,"PRIMĂRIA COMUNEI BUNTEȘTI",285,BUNTEŞTI,27971,1,PART,PRCNCT,PRSD,PRSD_SV,"2025-05-18 21:29:16",479,361,292,63,6,359,2,526,165,173,186
5,BIHOR,"CĂMIN CULTURAL",286,BUNTEŞTI,27971,1,PART,PRCNCT,PRSD,PRSD_SV,"2025-05-18 21:30:32",534,375,321,46,8,366,9,586,211,168,198
5,BIHOR,"CĂMIN CULTURAL",287,BUNTEŞTI,27971,1,PART,PRCNCT,PRSD,PRSD_SV,"2025-05-18 21:19:14",233,151,136,15,0,144,7,255,104,83,61
5,BIHOR,"ȘCOALA GIMNAZIALĂ FERICE",288,BUNTEŞTI,27971,1,PART,PRCNCT,PRSD,PRSD_SV,"2025-05-18 21:54:19",391,232,206,26,0,232,0,429,197,169,63
5,BIHOR,"CĂMIN CULTURAL LELEȘTI",289,BUNTEŞTI,27971,1,PART,PRCNCT,PRSD,PRSD_SV,"2025-05-18 21:49:35",318,248,213,35,0,245,3,349,101,127,118
5,BIHOR,"ŞCOALA CU CLASELE I-VIII",290,BUNTEŞTI,27971,1,PART,PRCNCT,PRSD,PRSD_SV,"2025-05-18 21:59:28",482,302,258,41,3,299,3,530,228,168,131
5,BIHOR,"CĂMIN CULTURAL",291,BUNTEŞTI,27971,1,PART,PRCNCT,PRSD,PRSD_SV,"2025-05-18 21:43:38",518,329,293,32,4,327,2,569,240,174,153
5,BIHOR,"GRĂDINIŢA CU PROGRAM NORMAL",292,BUNTEŞTI,27971,1,PART,PRCNCT,PRSD,PRSD_SV,"2025-05-18 21:39:06",368,239,210,28,1,238,1,405,166,150,88
5,BIHOR,"ȘCOALA GIMNAZIALĂ NR.3",293,BUNTEŞTI,27971,1,PART,PRCNCT,PRSD,PRSD_SV,"2025-05-18 21:32:08",240,188,152,33,3,185,3,263,75,77,108
5,BIHOR,"ȘCOALA GIMNAZIALĂ NR. 1 CĂBEȘTI",294,CĂBEŞTI,28077,1,PART,PRCNCT,PRSD,PRSD_SV,"2025-05-18 21:45:55",733,444,397,44,3,440,4,805,361,219,221
5,BIHOR,"CĂMINUL CULTURAL",295,CĂBEŞTI,28077,1,PART,PRCNCT,PRSD,PRSD_SV,"2025-05-18 22:19:52",136,105,79,26,0,104,1,149,44,62,42
5,BIHOR,"ȘCOALA CU CLASELE. I-IV JOSANI",296,CĂBEŞTI,28077,1,PART,PRCNCT,PRSD,PRSD_SV,"2025-05-18 22:00:43",380,257,225,32,0,257,0,417,160,138,119
5,BIHOR,"CĂMINUL CULTURAL",297,CĂBEŞTI,28077,1,PART,PRCNCT,PRSD,PRSD_SV,"2025-05-18 21:46:18",220,146,129,17,0,144,2,241,95,90,54
5,BIHOR,"PRIMĂRIA CĂPÎLNA",298,CĂPÂLNA,28139,1,PART,PRCNCT,PRSD,PRSD_SV,"2025-05-18 21:36:56",231,177,115,60,2,176,1,253,76,59,117
5,BIHOR,"ȘCOALA GENERALĂ",299,CĂPÂLNA,28139,1,PART,PRCNCT,PRSD,PRSD_SV,"2025-05-18 21:21:41",229,134,84,50,0,133,1,251,117,49,84
5,BIHOR,"CĂMIN CULTURAL ROHANI",300,CĂPÂLNA,28139,1,PART,PRCNCT,PRSD,PRSD_SV,"2025-05-18 21:18:32",87,72,37,31,4,72,0,95,23,28,44
5,BIHOR,"GRĂDINIȚA SĂLDĂBAGIU MIC",301,CĂPÂLNA,28139,1,PART,PRCNCT,PRSD,PRSD_SV,"2025-05-18 21:27:06",313,210,162,45,3,206,4,343,133,94,112
5,BIHOR,"ȘCOALA GENERALĂ",302,CĂPÂLNA,28139,1,PART,PRCNCT,PRSD,PRSD_SV,"2025-05-18 21:54:46",294,201,128,63,10,199,2,322,121,85,114
5,BIHOR,"CĂMINUL CULTURAL CĂRPINET",303,CĂRPINET,28193,1,PART,PRCNCT,PRSD,PRSD_SV,"2025-05-18 21:41:21",419,246,225,21,0,242,4,460,214,126,116
5,BIHOR,"CĂMIN CULTURAL CĂLUGĂRI",304,CĂRPINET,28193,1,PART,PRCNCT,PRSD,PRSD_SV,"2025-05-18 21:55:04",347,223,179,44,0,218,5,381,158,100,118
5,BIHOR,"CĂMIN CULTURAL IZBUC",305,CĂRPINET,28193,1,PART,PRCNCT,PRSD,PRSD_SV,"2025-05-18 21:49:52",376,293,217,76,0,286,7,414,121,175,111
5,BIHOR,"CĂMIN CULTURAL LEHECENI",306,CĂRPINET,28193,1,PART,PRCNCT,PRSD,PRSD_SV,"2025-05-18 21:56:40",290,154,141,13,0,151,3,318,164,61,90
5,BIHOR,"ȘCOALA GIMNAZIALĂ ”GEORGIU POPA” CÂMPANI",307,CÂMPANI,28709,1,PART,PRCNCT,PRSD,PRSD_SV,"2025-05-18 21:44:38",692,427,387,39,1,423,4,761,334,189,234
5,BIHOR,"ŞCOALA PRIMARĂ FÎNAŢE",308,CÂMPANI,28709,1,PART,PRCNCT,PRSD,PRSD_SV,"2025-05-18 21:30:07",480,343,309,32,2,341,2,527,184,154,187
5,BIHOR,"ŞCOALA PRIMARĂ HÎRSEŞTI",309,CÂMPANI,28709,1,PART,PRCNCT,PRSD,PRSD_SV,"2025-05-18 21:33:07",253,160,141,19,0,157,3,277,117,79,78
5,BIHOR,"ŞCOALA PRIMARĂ SIGHIŞTEL",310,CÂMPANI,28709,1,PART,PRCNCT,PRSD,PRSD_SV,"2025-05-18 21:51:37",247,171,149,22,0,164,7,271,100,103,61
5,BIHOR,"CĂMINUL CULTURAL VALEA DE SUS",311,CÂMPANI,28709,1,PART,PRCNCT,PRSD,PRSD_SV,"2025-05-18 21:38:07",217,149,128,21,0,147,2,238,89,116,31
5,BIHOR,"CENTRUL DE AFACERI",312,CEFA,28246,1,PART,PRCNCT,PRSD,PRSD_SV,"2025-05-18 21:33:43",1007,542,465,76,1,537,5,1107,565,295,242
5,BIHOR,GRĂDINIŢA,313,CEFA,28246,1,PART,PRCNCT,PRSD,PRSD_SV,"2025-05-18 21:21:42",160,100,69,31,0,100,0,175,75,53,47
5,BIHOR,"CĂMIN CULTURAL",314,CEFA,28246,1,PART,PRCNCT,PRSD,PRSD_SV,"2025-05-18 21:45:17",708,419,375,42,2,416,3,778,359,256,160
5,BIHOR,"ȘCOALA GIMNAZIALĂ NR.1",315,CEICA,28335,1,PART,PRCNCT,PRSD,PRSD_SV,"2025-05-18 21:32:11",778,455,378,77,0,451,4,855,400,274,177
5,BIHOR,"ȘCOALA BUCIUM",316,CEICA,28335,1,PART,PRCNCT,PRSD,PRSD_SV,"2025-05-18 21:25:27",174,108,83,25,0,107,1,190,82,75,32
5,BIHOR,"ȘCOALA GIMNAZIALĂ, NR. 2",317,CEICA,28335,1,PART,PRCNCT,PRSD,PRSD_SV,"2025-05-18 21:43:41",444,207,171,36,0,203,4,487,280,142,61
5,BIHOR,"ȘCOALA CORBEȘTI",318,CEICA,28335,1,PART,PRCNCT,PRSD,PRSD_SV,"2025-05-18 21:19:05",337,174,137,37,0,169,5,370,196,112,57
5,BIHOR,"ȘCOALA COTIGLET",319,CEICA,28335,1,PART,PRCNCT,PRSD,PRSD_SV,"2025-05-18 21:17:22",279,140,113,27,0,139,1,306,166,99,40
5,BIHOR,"ȘCOALA DUȘEȘTI",320,CEICA,28335,1,PART,PRCNCT,PRSD,PRSD_SV,"2025-05-18 21:31:34",435,244,205,39,0,242,2,478,234,165,77
5,BIHOR,"ȘCOALA INCEȘTI",321,CEICA,28335,1,PART,PRCNCT,PRSD,PRSD_SV,"2025-05-18 21:31:46",301,146,109,37,0,143,3,330,184,106,37
5,BIHOR,"CLĂDIRE ADMINISTRATIVĂ",322,CETARIU,28415,1,PART,PRCNCT,PRSD,PRSD_SV,"2025-05-18 22:52:49",921,595,496,79,20,594,1,1012,417,70,524
5,BIHOR,"ŞCOALA GENERALĂ",323,CETARIU,28415,1,PART,PRCNCT,PRSD,PRSD_SV,"2025-05-18 21:42:25",505,239,191,46,2,236,3,555,316,44,192
5,BIHOR,"ŞCOALA GENERALĂ",324,CETARIU,28415,1,PART,PRCNCT,PRSD,PRSD_SV,"2025-05-18 21:27:14",193,114,75,39,0,114,0,211,97,72,42
5,BIHOR,"CĂMIN CULTURAL",325,CETARIU,28415,1,PART,PRCNCT,PRSD,PRSD_SV,"2025-05-18 21:44:15",200,128,85,39,4,128,0,219,91,22,106
5,BIHOR,"ȘCOALA GIMNAZIALĂ ”BOCSKAI ISTVAN”",326,CHERECHIU,28497,1,PART,PRCNCT,PRSD,PRSD_SV,"2025-05-18 21:41:36",581,342,300,23,19,336,6,638,296,48,288
5,BIHOR,"CĂMIN CULTURAL CHEȘEREU",327,CHERECHIU,28497,1,PART,PRCNCT,PRSD,PRSD_SV,"2025-05-18 21:50:50",803,487,440,28,19,478,9,882,395,77,401
5,BIHOR,"CĂMIN CULTURAL - TÂRGUȘOR",328,CHERECHIU,28497,1,PART,PRCNCT,PRSD,PRSD_SV,"2025-05-18 21:45:40",451,253,222,18,13,248,5,495,242,38,210
5,BIHOR,"CĂMINUL CULTURAL CHIȘLAZ",329,CHIŞLAZ,28530,1,PART,PRCNCT,PRSD,PRSD_SV,"2025-05-18 21:51:18",398,203,168,34,1,197,6,439,236,117,80
5,BIHOR,"ŞCOALA PRIMARĂ NR.1 CHIRALEU",330,CHIŞLAZ,28530,1,PART,PRCNCT,PRSD,PRSD_SV,"2025-05-18 21:25:33",471,236,208,28,0,235,1,517,281,129,106
5,BIHOR,"CĂMINUL CULTURAL MIȘCA",331,CHIŞLAZ,28530,1,PART,PRCNCT,PRSD,PRSD_SV,"2025-05-18 21:38:26",765,498,440,40,18,496,2,841,343,48,448
5,BIHOR,"ȘCOALA POCLUȘA DE BARCĂU",332,CHIŞLAZ,28530,1,PART,PRCNCT,PRSD,PRSD_SV,"2025-05-18 21:35:42",331,144,117,25,2,142,2,363,219,61,81
5,BIHOR,"FOSTA ŞCOALA PRIMARĂ DIN SĂRSIG",333,CHIŞLAZ,28530,1,PART,PRCNCT,PRSD,PRSD_SV,"2025-05-18 21:25:51",210,126,78,48,0,124,2,230,104,71,53
5,BIHOR,"CĂMINUL CULTURAL SÂNLAZĂR",334,CHIŞLAZ,28530,1,PART,PRCNCT,PRSD,PRSD_SV,"2025-05-18 21:43:56",313,211,156,44,11,208,3,343,132,126,82
5,BIHOR,"CĂMINUL CULTURAL CIUMEGHIU",335,CIUMEGHIU,28665,1,PART,PRCNCT,PRSD,PRSD_SV,"2025-05-18 22:18:02",1569,663,603,60,0,657,6,1725,1062,473,184
5,BIHOR,"ȘCOALA GIMNAZIALĂ BOIU",336,CIUMEGHIU,28665,1,PART,PRCNCT,PRSD,PRSD_SV,"2025-05-18 22:02:58",596,289,253,36,0,288,1,655,366,105,183
5,BIHOR,"ȘCOALA GENERALĂ GHIORAC",337,CIUMEGHIU,28665,1,PART,PRCNCT,PRSD,PRSD_SV,"2025-05-18 22:22:05",1254,492,460,32,0,488,4,1378,886,205,283
5,BIHOR,"CĂMINUL CULTURAL",338,"COCIUBA MARE",28763,1,PART,PRCNCT,PRSD,PRSD_SV,"2025-05-18 22:00:50",709,496,400,78,18,489,7,779,283,219,270
5,BIHOR,"CĂMINUL CULTURAL",339,"COCIUBA MARE",28763,1,PART,PRCNCT,PRSD,PRSD_SV,"2025-05-18 21:42:05",576,253,190,41,22,250,3,633,380,92,158
5,BIHOR,"CĂMINUL CULTURAL",340,"COCIUBA MARE",28763,1,PART,PRCNCT,PRSD,PRSD_SV,"2025-05-18 21:40:04",405,309,221,74,14,308,1,445,136,113,195
5,BIHOR,"GRĂDINIȚA PETID",341,"COCIUBA MARE",28763,1,PART,PRCNCT,PRSD,PRSD_SV,"2025-05-18 21:46:30",478,404,279,99,26,404,0,525,121,180,224
5,BIHOR,"GRĂDINIȚĂ CU PROGRAM NORMAL NR.3",342,COPĂCEL,28816,1,PART,PRCNCT,PRSD,PRSD_SV,"2025-05-18 21:47:18",354,182,130,51,1,178,4,388,206,118,60
5,BIHOR,"ȘCOALA GIMNAZIALĂ NR.2",343,COPĂCEL,28816,1,PART,PRCNCT,PRSD,PRSD_SV,"2025-05-18 21:26:38",253,138,105,33,0,136,2,277,139,61,75
5,BIHOR,"CĂMIN CULTURAL",344,COPĂCEL,28816,1,PART,PRCNCT,PRSD,PRSD_SV,"2025-05-18 21:30:27",205,164,114,50,0,163,1,225,61,110,53
5,BIHOR,"ȘCOALA PRIMARĂ NR.4",345,COPĂCEL,28816,1,PART,PRCNCT,PRSD,PRSD_SV,"2025-05-18 21:20:37",125,88,60,28,0,88,0,137,49,55,33
5,BIHOR,"CĂMINUL CULTURAL",346,COPĂCEL,28816,1,PART,PRCNCT,PRSD,PRSD_SV,"2025-05-18 21:21:30",407,238,171,67,0,235,3,447,209,102,133
5,BIHOR,"CĂMIN CULTURAL",347,COPĂCEL,28816,1,PART,PRCNCT,PRSD,PRSD_SV,"2025-05-18 21:53:46",304,184,138,46,0,183,1,333,149,110,73
5,BIHOR,"CĂMINUL CULTURAL",348,"CRIŞTIORU DE JOS",28889,1,PART,PRCNCT,PRSD,PRSD_SV,"2025-05-18 21:41:09",289,171,144,24,3,170,1,317,146,87,83
5,BIHOR,"CĂMINUL CULTURAL",349,"CRIŞTIORU DE JOS",28889,1,PART,PRCNCT,PRSD,PRSD_SV,"2025-05-18 21:20:30",61,26,15,11,0,26,0,66,40,13,13
5,BIHOR,"CĂMINUL CULTURAL",350,"CRIŞTIORU DE JOS",28889,1,PART,PRCNCT,PRSD,PRSD_SV,"2025-05-18 21:33:14",357,213,195,16,2,209,4,392,179,108,101
5,BIHOR,"ȘCOALA GIMNAZIALĂ NR. 1 SĂLIȘTE DE VAȘCĂU",351,"CRIŞTIORU DE JOS",28889,1,PART,PRCNCT,PRSD,PRSD_SV,"2025-05-18 21:46:24",313,204,169,32,3,203,1,343,139,90,113
5,BIHOR,"ŞCOALA GIMNAZIALĂ NR.1 CURĂŢELE",352,CURĂŢELE,28941,1,PART,PRCNCT,PRSD,PRSD_SV,"2025-05-18 21:23:57",646,384,344,40,0,380,4,711,327,194,186
5,BIHOR,"ŞCOALA GENERALĂ CU CLASELE I-IV BEIUŞELE",353,CURĂŢELE,28941,1,PART,PRCNCT,PRSD,PRSD_SV,"2025-05-18 21:21:38",335,221,209,11,1,220,1,368,147,133,87
5,BIHOR,"CĂMIN CULTURAL",354,CURĂŢELE,28941,1,PART,PRCNCT,PRSD,PRSD_SV,"2025-05-18 21:48:49",339,220,192,28,0,218,2,372,152,142,76
5,BIHOR,"CĂMIN CULTURAL NIMĂIEŞTI",355,CURĂŢELE,28941,1,PART,PRCNCT,PRSD,PRSD_SV,"2025-05-18 21:53:29",651,438,377,57,4,433,5,716,278,171,262
5,BIHOR,"SEDIUL VECHI AL PRIMĂRIEI CURTUIȘENI",356,CURTUIŞENI,29001,1,PART,PRCNCT,PRSD,PRSD_SV,"2025-05-18 21:52:00",1009,477,449,27,1,469,8,1109,632,72,397
5,BIHOR,"PRIMĂRIA CURTUIŞENI",357,CURTUIŞENI,29001,1,PART,PRCNCT,PRSD,PRSD_SV,"2025-05-18 21:48:05",1279,569,543,26,0,566,3,1406,837,118,448
5,BIHOR,"ŞCOALA GENERALĂ CU CLASELE I-VIII NR. 24",358,CURTUIŞENI,29001,1,PART,PRCNCT,PRSD,PRSD_SV,"2025-05-18 22:06:28",667,341,284,57,0,337,4,734,393,165,172
5,BIHOR,"PRIMĂRIA DERNA",359,DERNA,29038,1,PART,PRCNCT,PRSD,PRSD_SV,"2025-05-18 21:55:45",723,300,255,44,1,299,1,795,495,184,115
5,BIHOR,"ȘCOALA GIMNAZIALĂ NR.2",360,DERNA,29038,1,PART,PRCNCT,PRSD,PRSD_SV,"2025-05-18 21:40:22",401,186,147,39,0,186,0,440,254,118,68
5,BIHOR,"ȘCOALA PRIMARĂ NR.1",361,DERNA,29038,1,PART,PRCNCT,PRSD,PRSD_SV,"2025-05-18 21:38:12",370,206,169,37,0,206,0,406,200,84,122
5,BIHOR,"ȘCOALA PRIMARĂ NR.2",362,DERNA,29038,1,PART,PRCNCT,PRSD,PRSD_SV,"2025-05-18 21:30:01",205,43,30,13,0,43,0,225,182,22,21
5,BIHOR,"GRĂDINIȚA CU PROGRAM NORMAL NR.3",363,DERNA,29038,1,PART,PRCNCT,PRSD,PRSD_SV,"2025-05-18 21:52:58",207,112,83,29,0,110,2,228,116,79,31
5,BIHOR,"CENTRU SOCIAL DE ZI PENTRU PERSOANE VÂRSTNICE (CANTINA SOCIALĂ)",364,DIOSIG,29092,1,PART,PRCNCT,PRSD,PRSD_SV,"2025-05-18 22:09:37",1135,496,449,46,1,492,4,1248,752,89,403
5,BIHOR,"ŞCOALA GIMNAZIALĂ NR.1 DIOSIG,",365,DIOSIG,29092,1,PART,PRCNCT,PRSD,PRSD_SV,"2025-05-18 21:46:48",900,474,445,23,6,465,9,989,515,85,380
5,BIHOR,"ŞCOALA GIMNAZIALĂ NR.1 DIOSIG",366,DIOSIG,29092,1,PART,PRCNCT,PRSD,PRSD_SV,"2025-05-18 22:06:02",957,505,463,39,3,496,9,1054,549,81,415
5,BIHOR,"ŞCOALA GIMNAZIALĂ NR.1 DIOSIG",367,DIOSIG,29092,1,PART,PRCNCT,PRSD,PRSD_SV,"2025-05-18 21:44:57",1243,630,548,80,2,621,9,1366,736,311,310
5,BIHOR,"ŞCOALA GIMNAZIALĂ NR.1 DIOSIG",368,DIOSIG,29092,1,PART,PRCNCT,PRSD,PRSD_SV,"2025-05-18 22:22:08",1108,707,674,33,0,664,43,1218,511,157,507
5,BIHOR,"ŞCOALA GIMNAZIALĂ NR.1 DIOSIG",369,DIOSIG,29092,1,PART,PRCNCT,PRSD,PRSD_SV,"2025-05-18 21:40:37",219,118,93,24,1,117,1,240,122,14,103
5,BIHOR,"HALA PIAŢĂ",370,DOBREŞTI,29154,1,PART,PRCNCT,PRSD,PRSD_SV,"2025-05-18 23:27:43",1567,784,708,75,1,772,12,1723,889,544,228
5,BIHOR,"CĂMINUL CULTURAL CORNIŞEŞTI",371,DOBREŞTI,29154,1,PART,PRCNCT,PRSD,PRSD_SV,"2025-05-18 21:41:47",146,82,60,22,0,81,1,160,78,47,34
5,BIHOR,"CĂMINUL CULTURAL CRINCEŞTI",372,DOBREŞTI,29154,1,PART,PRCNCT,PRSD,PRSD_SV,"2025-05-18 21:51:23",320,182,145,37,0,174,8,351,169,126,48
5,BIHOR,"CĂMINUL CULTURAL HIDIŞEL",373,DOBREŞTI,29154,1,PART,PRCNCT,PRSD,PRSD_SV,"2025-05-18 22:02:15",541,342,285,57,0,331,11,594,252,210,121
5,BIHOR,"CĂMINUL CULTURAL LUNCASPRIE",374,DOBREŞTI,29154,1,PART,PRCNCT,PRSD,PRSD_SV,"2025-05-18 21:41:33",727,378,339,39,0,375,3,799,421,231,144
5,BIHOR,"ŞCOALA S04 TOPA DE JOS",375,DOBREŞTI,29154,1,PART,PRCNCT,PRSD,PRSD_SV,"2025-05-18 21:31:27",146,102,81,21,0,100,2,159,57,53,47
5,BIHOR,"CĂMINUL CULTURAL TOPA DE SUS",376,DOBREŞTI,29154,1,PART,PRCNCT,PRSD,PRSD_SV,"2025-05-18 21:44:20",469,251,208,43,0,246,5,515,264,180,66
5,BIHOR,"PRIMARIA DRAGANESTI",377,DRĂGĂNEŞTI,29243,1,PART,PRCNCT,PRSD,PRSD_SV,"2025-05-18 21:49:18",376,263,235,16,12,261,2,413,150,117,144
5,BIHOR,"SCOALA PRIMARA BELEJENI",378,DRĂGĂNEŞTI,29243,1,PART,PRCNCT,PRSD,PRSD_SV,"2025-05-18 21:33:30",242,168,149,14,5,167,1,265,97,64,103
5,BIHOR,"SCOALA MAGHIARA GRADINARI",379,DRĂGĂNEŞTI,29243,1,PART,PRCNCT,PRSD,PRSD_SV,"2025-05-18 21:37:15",377,238,206,29,3,235,3,414,176,73,162
5,BIHOR,"SCOALA PRIMARA LIVADA",380,DRĂGĂNEŞTI,29243,1,PART,PRCNCT,PRSD,PRSD_SV,"2025-05-18 21:28:21",112,90,79,9,2,88,2,122,32,55,33
5,BIHOR,"CĂMIN CULTURAL MIZIEȘ",381,DRĂGĂNEŞTI,29243,1,PART,PRCNCT,PRSD,PRSD_SV,"2025-05-18 21:30:23",457,292,267,20,5,290,2,502,210,122,168
5,BIHOR,"CAMINUL CULTURAL PACALESTI",382,DRĂGĂNEŞTI,29243,1,PART,PRCNCT,PRSD,PRSD_SV,"2025-05-18 21:34:28",172,132,112,19,1,131,1,188,56,62,69
5,BIHOR,"CAMINUL CULTURAL PANTASESTI",383,DRĂGĂNEŞTI,29243,1,PART,PRCNCT,PRSD,PRSD_SV,"2025-05-18 21:45:54",113,95,77,17,1,95,0,123,28,48,47
5,BIHOR,"SCOALA SEBIS",384,DRĂGĂNEŞTI,29243,1,PART,PRCNCT,PRSD,PRSD_SV,"2025-05-18 21:41:34",248,181,145,33,3,178,3,272,91,76,102
5,BIHOR,"SCOALA PRIMARA TALPE",385,DRĂGĂNEŞTI,29243,1,PART,PRCNCT,PRSD,PRSD_SV,"2025-05-18 21:36:26",194,121,110,10,1,121,0,212,91,78,43
5,BIHOR,"CAMINUL CULTURAL TIGANESTI",386,DRĂGĂNEŞTI,29243,1,PART,PRCNCT,PRSD,PRSD_SV,"2025-05-18 21:24:17",123,89,70,19,0,89,0,134,45,46,43
5,BIHOR,"PRIMĂRIA DRĂGEŞTI",387,DRĂGEŞTI,29341,1,PART,PRCNCT,PRSD,PRSD_SV,"2025-05-18 21:27:07",277,232,143,80,9,230,2,304,72,93,137
5,BIHOR,"CĂMINUL CULTURAL",388,DRĂGEŞTI,29341,1,PART,PRCNCT,PRSD,PRSD_SV,"2025-05-18 21:46:40",226,186,135,47,4,183,3,248,62,108,75
5,BIHOR,"ŞCOALA CU CLASELE I-IV",389,DRĂGEŞTI,29341,1,PART,PRCNCT,PRSD,PRSD_SV,"2025-05-18 21:16:05",166,125,83,27,15,125,0,182,57,53,72
5,BIHOR,"CENTRU COMUNITAR INTEGRAT",390,DRĂGEŞTI,29341,1,PART,PRCNCT,PRSD,PRSD_SV,"2025-05-18 21:42:56",1131,655,516,107,32,646,9,1243,588,349,297
5,BIHOR,"CĂMINUL CULTURAL TOPEŞTI",391,DRĂGEŞTI,29341,1,PART,PRCNCT,PRSD,PRSD_SV,"2025-05-18 21:17:16",166,126,80,38,8,126,0,182,56,77,49
5,BIHOR,"CĂMINUL CULTURAL",392,FINIŞ,29403,1,PART,PRCNCT,PRSD,PRSD_SV,"2025-05-18 22:23:15",1336,784,709,42,33,778,6,1469,685,309,469
5,BIHOR,"GRĂDINIŢA FIZIŞ",393,FINIŞ,29403,1,PART,PRCNCT,PRSD,PRSD_SV,"2025-05-18 21:44:09",187,115,88,27,0,113,2,205,90,62,51
5,BIHOR,"ŞCOALA GENERALĂ IOANIŞ",394,FINIŞ,29403,1,PART,PRCNCT,PRSD,PRSD_SV,"2025-05-18 21:39:04",627,272,249,23,0,272,0,689,417,172,100
5,BIHOR,"GRĂDINIŢA ŞUNCUIŞ",395,FINIŞ,29403,1,PART,PRCNCT,PRSD,PRSD_SV,"2025-05-18 21:45:33",674,215,204,10,1,212,3,740,525,112,100
5,BIHOR,"CĂMIN CULTURAL GEPIU",396,GEPIU,32195,1,PART,PRCNCT,PRSD,PRSD_SV,"2025-05-18 22:04:34",1181,795,594,186,15,787,8,1298,503,372,415
5,BIHOR,"CĂMIN CULTURAL BICACI",397,GEPIU,32195,1,PART,PRCNCT,PRSD,PRSD_SV,"2025-05-18 21:57:01",519,309,241,68,0,308,1,570,261,165,143
5,BIHOR,"CĂMIN CULTURAL GIRIŞU DE CRIŞ",398,"GIRIŞU DE CRIŞ",29467,1,PART,PRCNCT,PRSD,PRSD_SV,"2025-05-18 21:55:44",1241,717,608,109,0,707,10,1364,647,395,312
5,BIHOR,"GRĂDINIȚA TĂRIAN",399,"GIRIŞU DE CRIŞ",29467,1,PART,PRCNCT,PRSD,PRSD_SV,"2025-05-18 22:07:00",985,585,510,70,5,579,6,1083,498,178,401
5,BIHOR,"CĂMIN CULTURAL TĂRIAN",400,"GIRIŞU DE CRIŞ",29467,1,PART,PRCNCT,PRSD,PRSD_SV,"2025-05-18 22:38:58",985,489,420,69,0,484,5,1083,594,320,164
5,BIHOR,"CĂMIN CULTURAL HIDIȘELU DE SUS",401,"HIDIŞELU DE SUS",29519,1,PART,PRCNCT,PRSD,PRSD_SV,"2025-05-18 22:04:13",875,613,477,136,0,607,6,963,350,312,295
5,BIHOR,"ȘCOALA PRIMARĂ HIDIȘELU DE JOS",402,"HIDIŞELU DE SUS",29519,1,PART,PRCNCT,PRSD,PRSD_SV,"2025-05-18 21:30:13",551,375,305,70,0,374,1,606,231,207,167
5,BIHOR,"CĂMIN CULTURAL MIERLĂU",403,"HIDIŞELU DE SUS",29519,1,PART,PRCNCT,PRSD,PRSD_SV,"2025-05-18 21:40:18",562,334,271,62,1,329,5,617,283,193,136
5,BIHOR,"ȘCOALA PRIMARĂ SÎNTELEC",404,"HIDIŞELU DE SUS",29519,1,PART,PRCNCT,PRSD,PRSD_SV,"2025-05-18 21:32:17",323,195,144,51,0,195,0,354,159,114,81
5,BIHOR,"CĂMIN CULTURAL ȘUMUGIU",405,"HIDIŞELU DE SUS",29519,1,PART,PRCNCT,PRSD,PRSD_SV,"2025-05-18 21:48:23",326,214,140,72,2,210,4,358,144,149,61
5,BIHOR,"CENTRUL AFTER SCHOOL HOLOD",406,HOLOD,29573,1,PART,PRCNCT,PRSD,PRSD_SV,"2025-05-18 21:39:26",374,242,183,51,8,240,2,413,171,139,101
5,BIHOR,"CĂMIN CULTURAL",407,HOLOD,29573,1,PART,PRCNCT,PRSD,PRSD_SV,"2025-05-18 21:45:17",645,232,202,30,0,231,1,709,477,174,57
5,BIHOR,"CĂMIN CULTURAL",408,HOLOD,29573,1,PART,PRCNCT,PRSD,PRSD_SV,"2025-05-18 21:20:04",111,94,48,45,1,93,1,121,27,44,49
5,BIHOR,"CĂMIN CULTURAL",409,HOLOD,29573,1,PART,PRCNCT,PRSD,PRSD_SV,"2025-05-18 21:30:12",106,84,53,31,0,84,0,116,32,47,37
5,BIHOR,"CĂMIN CULTURAL HODIȘ",410,HOLOD,29573,1,PART,PRCNCT,PRSD,PRSD_SV,"2025-05-18 21:33:48",121,96,51,41,4,96,0,132,36,45,51
5,BIHOR,"CĂMINUL CULTURAL LUPOAIA",411,HOLOD,29573,1,PART,PRCNCT,PRSD,PRSD_SV,"2025-05-18 21:33:37",492,167,138,29,0,164,3,440,273,119,45
5,BIHOR,"ȘCOALA CU CLASELE I-IV",412,HOLOD,29573,1,PART,PRCNCT,PRSD,PRSD_SV,"2025-05-18 21:24:13",57,60,18,42,0,60,0,162,102,35,25
5,BIHOR,"CĂMINUL CULTURAL VINTERE",413,HOLOD,29573,1,PART,PRCNCT,PRSD,PRSD_SV,"2025-05-18 21:41:31",558,310,246,51,13,304,6,613,303,192,112
5,BIHOR,"GRĂDINIȚA DE COPII",414,"HUSASĂU DE TINCA",29662,1,PART,PRCNCT,PRSD,PRSD_SV,"2025-05-18 21:47:08",673,412,289,92,31,408,4,739,327,218,190
5,BIHOR,"ȘCOALA CU CLASELE I-IV FONĂU",415,"HUSASĂU DE TINCA",29662,1,PART,PRCNCT,PRSD,PRSD_SV,"2025-05-18 21:19:46",191,83,63,20,0,83,0,209,126,53,30
5,BIHOR,"ȘCOALA CU CLASELE I-IV MIERSIG",416,"HUSASĂU DE TINCA",29662,1,PART,PRCNCT,PRSD,PRSD_SV,"2025-05-18 21:31:25",322,245,136,76,33,242,3,353,108,132,110
5,BIHOR,"ȘCOALA CU CLASELE I-IV OȘAND",417,"HUSASĂU DE TINCA",29662,1,PART,PRCNCT,PRSD,PRSD_SV,"2025-05-18 21:47:18",430,212,181,31,0,211,1,472,260,133,78
5,BIHOR,"ȘCOALA CU CLASELE I-IV SITITELEC",418,"HUSASĂU DE TINCA",29662,1,PART,PRCNCT,PRSD,PRSD_SV,"2025-05-18 21:30:33",280,212,136,68,8,203,9,307,95,107,96
5,BIHOR,"ȘCOALA GIMNAZIALĂ ”PUIU SEVER”",419,INEU,29724,1,PART,PRCNCT,PRSD,PRSD_SV,"2025-05-18 22:23:04",887,493,403,90,0,490,3,975,482,164,326
5,BIHOR,"ȘCOALA GIMNAZIALĂ ”PUIU SEVER”",420,INEU,29724,1,PART,PRCNCT,PRSD,PRSD_SV,"2025-05-18 21:42:22",1313,386,357,29,0,382,4,1443,1057,281,101
5,BIHOR,"CĂMINUL CULTURAL BOTEAN",421,INEU,29724,1,PART,PRCNCT,PRSD,PRSD_SV,"2025-05-18 21:37:20",514,251,218,33,0,248,3,564,313,165,83
5,BIHOR,"CĂMINUL CULTURAL HUSASĂU DE CRIȘ",422,INEU,29724,1,PART,PRCNCT,PRSD,PRSD_SV,"2025-05-18 21:40:15",1051,535,465,70,0,532,3,1155,620,335,197
5,BIHOR,PRIMĂRIA,423,"LAZURI DE BEIUŞ",29760,1,PART,PRCNCT,PRSD,PRSD_SV,"2025-05-18 21:34:46",285,225,188,27,10,223,2,313,88,71,152
5,BIHOR,"CĂMIN CULTURAL BĂLENI",424,"LAZURI DE BEIUŞ",29760,1,PART,PRCNCT,PRSD,PRSD_SV,"2025-05-18 21:37:20",157,120,93,27,0,118,2,172,52,52,66
5,BIHOR,"ȘCOALA CU CLASELE I-IV",425,"LAZURI DE BEIUŞ",29760,1,PART,PRCNCT,PRSD,PRSD_SV,"2025-05-18 21:35:58",361,243,199,36,8,236,7,396,153,117,119
5,BIHOR,"CĂMIN CULTURAL",426,"LAZURI DE BEIUŞ",29760,1,PART,PRCNCT,PRSD,PRSD_SV,"2025-05-18 21:37:11",505,383,341,32,10,373,10,555,172,133,240
5,BIHOR,"ȘCOALA GIMNAZIALĂ NR. 1 LĂZĂRENI",427,LĂZĂRENI,29813,1,PART,PRCNCT,PRSD,PRSD_SV,"2025-05-18 21:26:32",715,444,385,59,0,431,13,786,342,309,122
5,BIHOR,"CĂMIN CULTURAL",428,LĂZĂRENI,29813,1,PART,PRCNCT,PRSD,PRSD_SV,"2025-05-18 21:18:32",505,298,247,51,0,293,5,556,258,150,143
5,BIHOR,"CĂMIN CULTURAL CĂRĂNDENI",429,LĂZĂRENI,29813,1,PART,PRCNCT,PRSD,PRSD_SV,"2025-05-18 21:19:27",349,217,157,60,0,213,4,383,166,122,91
5,BIHOR,"CENTRU COMUNITAR INTEGRAT",430,LĂZĂRENI,29813,1,PART,PRCNCT,PRSD,PRSD_SV,"2025-05-18 21:16:30",72,64,34,30,0,64,0,78,14,35,29
5,BIHOR,"CĂMIN CULTURAL",431,LĂZĂRENI,29813,1,PART,PRCNCT,PRSD,PRSD_SV,"2025-05-18 21:33:46",629,328,265,61,2,317,11,691,363,241,76
5,BIHOR,"CĂMIN CULTURAL",432,LĂZĂRENI,29813,1,PART,PRCNCT,PRSD,PRSD_SV,"2025-05-18 21:26:39",96,66,39,27,0,65,1,105,39,39,26
5,BIHOR,"CĂMIN CULTURAL",433,LĂZĂRENI,29813,1,PART,PRCNCT,PRSD,PRSD_SV,"2025-05-18 21:19:59",159,104,62,42,0,102,2,174,70,57,45
5,BIHOR,"CĂMINUL CULTURAL LUGAȘU DE JOS",434,"LUGAŞU DE JOS",29902,1,PART,PRCNCT,PRSD,PRSD_SV,"2025-05-18 22:26:14",1385,846,728,90,28,830,16,1523,677,493,337
5,BIHOR,"CLĂDIRE ADMINISTRATIVĂ",435,"LUGAŞU DE JOS",29902,1,PART,PRCNCT,PRSD,PRSD_SV,"2025-05-18 21:46:44",175,115,89,21,5,112,3,192,77,59,53
5,BIHOR,"CĂMINUL CULTURAL LUGAȘU DE SUS",436,"LUGAŞU DE JOS",29902,1,PART,PRCNCT,PRSD,PRSD_SV,"2025-05-18 21:55:33",504,320,270,32,18,315,5,553,233,191,124
5,BIHOR,"CĂMINUL CULTURAL URVIND",437,"LUGAŞU DE JOS",29902,1,PART,PRCNCT,PRSD,PRSD_SV,"2025-05-18 21:59:59",747,613,441,128,44,610,3,821,208,143,467
5,BIHOR,"CĂMINUL CULTURAL LUNCA",438,LUNCA,29948,1,PART,PRCNCT,PRSD,PRSD_SV,"2025-05-18 21:51:38",751,412,377,35,0,405,7,827,415,247,158
5,BIHOR,"CĂMINUL CULTURAL BRIHENI",439,LUNCA,29948,1,PART,PRCNCT,PRSD,PRSD_SV,"2025-05-18 21:38:06",231,161,127,34,0,160,1,253,92,74,86
5,BIHOR,"CĂMINUL CULTURAL HOTĂREL",440,LUNCA,29948,1,PART,PRCNCT,PRSD,PRSD_SV,"2025-05-18 21:46:30",213,162,127,35,0,162,0,233,71,87,75
5,BIHOR,"CAMINUL CULTURAL SIRBESTI",441,LUNCA,29948,1,PART,PRCNCT,PRSD,PRSD_SV,"2025-05-18 21:29:54",222,189,134,50,5,186,3,243,54,55,131
5,BIHOR,"CĂMINUL CULTURAL SEGHIŞTE",442,LUNCA,29948,1,PART,PRCNCT,PRSD,PRSD_SV,"2025-05-18 21:50:01",462,299,275,24,0,293,6,507,208,139,154
5,BIHOR,"CĂMINUL CULTURAL ŞUŞTIU",443,LUNCA,29948,1,PART,PRCNCT,PRSD,PRSD_SV,"2025-05-18 21:34:07",363,230,206,19,5,226,4,398,168,107,119
5,BIHOR,"ȘCOALA CU CLASELE I.-VIII",444,MĂDĂRAS,30014,1,PART,PRCNCT,PRSD,PRSD_SV,"2025-05-18 21:47:08",787,446,377,67,2,443,3,866,420,192,251
5,BIHOR,"GRĂDINIȚA HOMOROG",445,MĂDĂRAS,30014,1,PART,PRCNCT,PRSD,PRSD_SV,"2025-05-18 21:35:26",556,341,283,55,3,338,3,611,270,184,154
5,BIHOR,"ŞCOALA CU CLASELE I-VIII",446,MĂDĂRAS,30014,1,PART,PRCNCT,PRSD,PRSD_SV,"2025-05-18 22:07:29",754,434,347,71,16,427,7,828,394,211,216
5,BIHOR,"CĂMINUL CULTURAL",447,MĂDĂRAS,30014,1,PART,PRCNCT,PRSD,PRSD_SV,"2025-05-18 21:33:54",189,121,91,30,0,119,2,207,86,85,34
5,BIHOR,"PRIMĂRIA MĂGEŞTI",448,MĂGEŞTI,30069,1,PART,PRCNCT,PRSD,PRSD_SV,"2025-05-18 21:23:49",214,123,110,13,0,123,0,234,111,64,59
5,BIHOR,"CĂMINUL CULTURAL BUTANI",449,MĂGEŞTI,30069,1,PART,PRCNCT,PRSD,PRSD_SV,"2025-05-18 21:36:01",282,170,153,17,0,169,1,309,139,85,84
5,BIHOR,"CĂMINUL CULTURAL CACUCIU NOU",450,MĂGEŞTI,30069,1,PART,PRCNCT,PRSD,PRSD_SV,"2025-05-18 21:34:16",298,197,161,36,0,195,2,328,131,102,93
5,BIHOR,"CĂMIN CULTURAL",451,MĂGEŞTI,30069,1,PART,PRCNCT,PRSD,PRSD_SV,"2025-05-18 21:24:13",371,231,195,33,3,230,1,408,177,105,125
5,BIHOR,"CĂMINUL CULTURAL GĂLĂŞENI",452,MĂGEŞTI,30069,1,PART,PRCNCT,PRSD,PRSD_SV,"2025-05-18 21:19:49",215,103,89,14,0,101,2,236,133,70,31
5,BIHOR,"CĂMINUL CULTURAL JOSANI",453,MĂGEŞTI,30069,1,PART,PRCNCT,PRSD,PRSD_SV,"2025-05-18 21:38:07",261,147,127,20,0,147,0,389,242,87,60
5,BIHOR,"ŞCOALA GENERALĂ",454,MĂGEŞTI,30069,1,PART,PRCNCT,PRSD,PRSD_SV,"2025-05-18 21:30:38",462,230,191,39,0,229,1,507,277,138,91
5,BIHOR,"CĂMINUL CULTURAL NOJORID",455,NOJORID,30149,1,PART,PRCNCT,PRSD,PRSD_SV,"2025-05-18 22:10:16",1352,944,807,137,0,934,10,1494,550,383,551
5,BIHOR,"CĂMINUL CULTURAL NOJORID",456,NOJORID,30149,1,PART,PRCNCT,PRSD,PRSD_SV,"2025-05-18 21:39:15",1405,1007,857,148,2,996,11,1545,538,362,634
5,BIHOR,"SCOALA CU CLASELE I-IV APATEU , LOC. APATEU NR 41",457,NOJORID,30149,1,PART,PRCNCT,PRSD,PRSD_SV,"2025-05-18 21:39:45",374,274,200,74,0,271,3,410,136,100,171
5,BIHOR,"ȘCOALA CU CL. I-IV CHIȘIRID, LOC CHIȘIRID NR 168",458,NOJORID,30149,1,PART,PRCNCT,PRSD,PRSD_SV,"2025-05-18 21:56:35",241,201,118,82,1,199,2,264,63,88,111
5,BIHOR,"ȘCOALA PRIMARĂ NR.1",459,NOJORID,30149,1,PART,PRCNCT,PRSD,PRSD_SV,"2025-05-18 21:56:23",782,454,347,107,0,451,3,859,405,239,212
5,BIHOR,"GRĂDINIȚA CU PROGRAM PRELUNGIT ”CLOPOȚEL” LIVADA",460,NOJORID,30149,1,PART,PRCNCT,PRSD,PRSD_SV,"2025-05-18 22:54:29",1368,910,765,142,3,899,11,1504,594,465,434
5,BIHOR,"ȘCOALA CU CL.I-IV PĂUȘA , NR 37/B",461,NOJORID,30149,1,PART,PRCNCT,PRSD,PRSD_SV,"2025-05-18 22:04:14",295,176,133,43,0,175,1,324,148,107,68
5,BIHOR,"ȘCOALA CU CL. I-IV ȘAUAIEU, LOC. ȘAUAIEU NR 101",462,NOJORID,30149,1,PART,PRCNCT,PRSD,PRSD_SV,"2025-05-18 21:30:09",263,158,115,43,0,157,1,288,130,95,62
5,BIHOR,"ŞCOALA GIMNAZIALĂ NR. 1 OLCEA",463,OLCEA,30229,1,PART,PRCNCT,PRSD,PRSD_SV,"2025-05-18 21:26:45",475,246,211,33,2,245,1,522,276,142,103
5,BIHOR,"ŞCOALA GIMNAZIALĂ NR. 2 CĂLACEA",464,OLCEA,30229,1,PART,PRCNCT,PRSD,PRSD_SV,"2025-05-18 21:41:07",965,467,430,37,0,460,7,1061,594,292,168
5,BIHOR,"ŞCOALA PRIMARĂ NR. 1 HODIŞEL",465,OLCEA,30229,1,PART,PRCNCT,PRSD,PRSD_SV,"2025-05-18 21:31:47",221,169,147,13,9,169,0,242,73,100,69
5,BIHOR,"GRĂDINIŢA CU PROGRAM NORMAL NR. 4 UCURIŞ",466,OLCEA,30229,1,PART,PRCNCT,PRSD,PRSD_SV,"2025-05-18 21:32:09",443,213,164,49,0,212,1,486,273,147,65
5,BIHOR,"ȘCOALA GIMNAZIALA „AUREL POP” OȘORHEI",467,OŞORHEI,30274,1,PART,PRCNCT,PRSD,PRSD_SV,"2025-05-18 22:42:45",1610,928,792,136,0,908,20,1770,842,363,545
5,BIHOR,"ȘCOALA GIMNAZIALA „AUREL POP” OȘORHEI",468,OŞORHEI,30274,1,PART,PRCNCT,PRSD,PRSD_SV,"2025-05-18 22:52:48",1656,985,834,151,0,968,17,1821,820,473,495
5,BIHOR,"CĂMIN CULTURAL ALPAREA",469,OŞORHEI,30274,1,PART,PRCNCT,PRSD,PRSD_SV,"2025-05-18 22:04:56",1025,669,565,104,0,661,8,1127,458,329,332
5,BIHOR,"CAMIN CULTURAL CHERIU",470,OŞORHEI,30274,1,PART,PRCNCT,PRSD,PRSD_SV,"2025-05-18 22:05:12",759,467,355,112,0,460,7,834,367,192,268
5,BIHOR,"CĂMIN CULTURAL FELCHERIU",471,OŞORHEI,30274,1,PART,PRCNCT,PRSD,PRSD_SV,"2025-05-18 21:39:21",262,218,145,73,0,213,5,287,69,79,134
5,BIHOR,"CĂMIN CULTURAL FUGHIU",472,OŞORHEI,30274,1,PART,PRCNCT,PRSD,PRSD_SV,"2025-05-18 21:58:09",1092,695,594,101,0,682,13,1200,505,306,376
5,BIHOR,"GRĂDINIȚA CU PROGRAM PRELUNGIT",473,PALEU,32161,1,PART,PRCNCT,PRSD,PRSD_SV,"2025-05-18 21:52:59",803,594,501,92,1,588,6,882,288,127,461
5,BIHOR,"ȘCOALA CU CLASELE I-IV",474,PALEU,32161,1,PART,PRCNCT,PRSD,PRSD_SV,"2025-05-18 22:03:59",982,715,613,101,1,712,3,1079,364,130,582
5,BIHOR,"ȘCOALA CU CLASELE I-IV",475,PALEU,32161,1,PART,PRCNCT,PRSD,PRSD_SV,"2025-05-18 21:45:52",1018,689,597,82,10,685,4,1120,431,112,573
5,BIHOR,"ȘCOALA CU CLASELE I-IV",476,PALEU,32161,1,PART,PRCNCT,PRSD,PRSD_SV,"2025-05-18 21:38:49",416,273,213,45,15,270,3,457,184,35,235
5,BIHOR,"GRĂDINIȚA CU PROGRAM NORMAL NR.1 PETREU",477,PETREU,27169,1,PART,PRCNCT,PRSD,PRSD_SV,"2025-05-18 21:43:09",1425,746,682,40,24,734,12,1567,821,214,520
5,BIHOR,"VECHIUL SEDIU AL PRIMĂRIEI ABRĂMUȚ",478,PETREU,27169,1,PART,PRCNCT,PRSD,PRSD_SV,"2025-05-18 21:41:10",360,175,146,29,0,171,4,395,220,79,92
5,BIHOR,"CĂMINUL CULTURAL CRESTUR",479,PETREU,27169,1,PART,PRCNCT,PRSD,PRSD_SV,"2025-05-18 21:39:19",413,199,172,26,1,194,5,453,254,44,150
5,BIHOR,"ȘCOALA GENERALĂ FĂNCICA",480,PETREU,27169,1,PART,PRCNCT,PRSD,PRSD_SV,"2025-05-18 21:26:25",236,113,88,25,0,110,3,259,146,61,49
5,BIHOR,"ȘCOALA GIMNAZIALĂ NR.1 PIETROASA",481,PIETROASA,30336,1,PART,PRCNCT,PRSD,PRSD_SV,"2025-05-18 21:43:02",631,408,333,74,1,407,1,693,285,232,175
5,BIHOR,"ȘCOALA GIMAZIALĂ NR.2 CHIȘCĂU",482,PIETROASA,30336,1,PART,PRCNCT,PRSD,PRSD_SV,"2025-05-18 21:43:25",594,312,274,38,0,306,6,652,340,227,79
5,BIHOR,"ȘCOALA PRIMARĂ NR.2 COCIUBA MICĂ",483,PIETROASA,30336,1,PART,PRCNCT,PRSD,PRSD_SV,"2025-05-18 22:08:11",366,157,148,9,0,156,1,402,245,109,47
5,BIHOR,"ȘCOALA PRIMARĂ NR.4 GIULEȘTI",484,PIETROASA,30336,1,PART,PRCNCT,PRSD,PRSD_SV,"2025-05-18 21:21:10",114,69,57,12,0,69,0,124,55,43,26
5,BIHOR,"ȘCOALA PRIMARĂ NR.1 GURANI",485,PIETROASA,30336,1,PART,PRCNCT,PRSD,PRSD_SV,"2025-05-18 21:53:41",456,251,226,24,1,248,3,501,250,143,105
5,BIHOR,"ȘCOALA PRIMARĂ NR.3 MĂGURA",486,PIETROASA,30336,1,PART,PRCNCT,PRSD,PRSD_SV,"2025-05-18 21:57:00",234,135,120,15,0,135,0,257,122,71,64
5,BIHOR,"ȘCOALA PRIMARĂ NR.5 MOȚEȘTI",487,PIETROASA,30336,1,PART,PRCNCT,PRSD,PRSD_SV,"2025-05-18 21:22:39",71,54,39,15,0,53,1,77,23,26,27
5,BIHOR,"CAMINUL CULTURAL POCOLA",488,POCOLA,30416,1,PART,PRCNCT,PRSD,PRSD_SV,"2025-05-18 21:21:45",429,337,273,64,0,330,7,471,134,197,133
5,BIHOR,"CAMINUL CULTURAL FENERIȘ",489,POCOLA,30416,1,PART,PRCNCT,PRSD,PRSD_SV,"2025-05-18 21:18:07",278,201,157,44,0,200,1,305,104,92,108
5,BIHOR,"CAMIN CULTURAL PETRANI",490,POCOLA,30416,1,PART,PRCNCT,PRSD,PRSD_SV,"2025-05-18 21:30:44",267,215,172,42,1,211,4,294,79,125,86
5,BIHOR,"CAMIN CULTURAL SINMARTIN DE BEIUȘ",491,POCOLA,30416,1,PART,PRCNCT,PRSD,PRSD_SV,"2025-05-18 21:23:22",185,132,109,23,0,130,2,203,71,65,65
5,BIHOR,"ȘCOALA GIMNAZIALĂ NR.1 POMEZEU",492,POMEZEU,30470,1,PART,PRCNCT,PRSD,PRSD_SV,"2025-05-18 21:24:04",95,79,55,23,1,79,0,104,25,34,45
5,BIHOR,"ȘCOALA PRIMARĂ NR.2 CÎMPANI",493,POMEZEU,30470,1,PART,PRCNCT,PRSD,PRSD_SV,"2025-05-18 21:59:34",334,193,148,37,8,192,1,366,173,97,95
5,BIHOR,"CĂMIN CULTURAL COȘDENI",494,POMEZEU,30470,1,PART,PRCNCT,PRSD,PRSD_SV,"2025-05-18 22:12:54",413,245,188,36,21,242,3,453,208,135,107
5,BIHOR,"CĂMIN CULTURAL HIDIȘ",495,POMEZEU,30470,1,PART,PRCNCT,PRSD,PRSD_SV,"2025-05-18 21:16:25",239,214,157,52,5,214,0,262,48,113,101
5,BIHOR,"ȘCOALA GENERALĂ LACU SĂRAT",496,POMEZEU,30470,1,PART,PRCNCT,PRSD,PRSD_SV,"2025-05-18 21:11:48",36,38,26,12,0,37,1,89,51,20,17
5,BIHOR,"GRĂDINIȚA CU PROGRAM NORMAL NR.2 SITANI",497,POMEZEU,30470,1,PART,PRCNCT,PRSD,PRSD_SV,"2025-05-18 21:33:53",346,224,194,28,2,219,5,380,156,142,77
5,BIHOR,"CĂMIN CULTURAL SPINUȘ DE POMEZEU",498,POMEZEU,30470,1,PART,PRCNCT,PRSD,PRSD_SV,"2025-05-18 21:25:33",150,102,76,25,1,102,0,164,62,50,52
5,BIHOR,"CĂMIN CULTURAL VĂLANI DE POMEZEU",499,POMEZEU,30470,1,PART,PRCNCT,PRSD,PRSD_SV,"2025-05-18 21:42:51",424,242,212,30,0,240,2,465,223,153,87
5,BIHOR,"LICEUL TEHNOLOGIC NR 1 POPESTI",500,POPEŞTI,30568,1,PART,PRCNCT,PRSD,PRSD_SV,"2025-05-18 21:51:00",858,354,315,36,3,347,7,943,589,195,152
5,BIHOR,"LICEUL TEHNOLOGIC NR 1 POPESTI",501,POPEŞTI,30568,2,PART,PRCNCT,PRSD,PRSD_SV,"2025-05-19 04:01:33",857,504,407,32,65,494,10,945,441,230,264
5,BIHOR,"CĂMIN CULTURAL BISTRA",502,POPEŞTI,30568,1,PART,PRCNCT,PRSD,PRSD_SV,"2025-05-18 22:19:53",775,325,304,21,0,320,5,852,527,214,106
5,BIHOR,"LICEUL ”JOSEF KOZACEK” BUDOI",503,POPEŞTI,30568,1,PART,PRCNCT,PRSD,PRSD_SV,"2025-05-18 21:36:01",732,234,213,21,0,233,1,804,570,161,72
5,BIHOR,"ȘCOALA GENERALĂ CUZAP",504,POPEŞTI,30568,1,PART,PRCNCT,PRSD,PRSD_SV,"2025-05-18 21:57:11",874,428,369,58,1,424,4,960,532,271,153
5,BIHOR,"CĂMIN CULTURAL VARVIZ",505,POPEŞTI,30568,1,PART,PRCNCT,PRSD,PRSD_SV,"2025-05-18 21:49:30",401,199,180,19,0,195,4,440,241,85,110
5,BIHOR,"ȘCOALA GENERALĂ VĂRZARI",506,POPEŞTI,30568,1,PART,PRCNCT,PRSD,PRSD_SV,"2025-05-18 21:31:34",245,116,100,16,0,115,1,269,153,57,58
5,BIHOR,"ŞCOALA GENERALĂ VOIVOZI",507,POPEŞTI,30568,1,PART,PRCNCT,PRSD,PRSD_SV,"2025-05-18 21:59:31",749,335,301,34,0,331,4,824,489,195,136
5,BIHOR,"ŞCOALA GENERALĂ VOIVOZI",508,POPEŞTI,30568,1,PART,PRCNCT,PRSD,PRSD_SV,"2025-05-18 22:18:06",578,265,230,34,1,263,2,635,370,138,125
5,BIHOR,"CĂMINUL CULTURAL",509,RĂBĂGANI,30648,1,PART,PRCNCT,PRSD,PRSD_SV,"2025-05-18 21:32:50",548,309,259,42,8,308,1,602,293,176,132
5,BIHOR,"CĂMINUL CULTURAL",510,RĂBĂGANI,30648,1,PART,PRCNCT,PRSD,PRSD_SV,"2025-05-18 21:32:31",183,137,108,28,1,134,3,201,64,61,73
5,BIHOR,"CLĂDIRE MULTIFUNCȚIONALĂ",511,RĂBĂGANI,30648,1,PART,PRCNCT,PRSD,PRSD_SV,"2025-05-18 21:21:54",97,73,46,27,0,73,0,106,33,35,38
5,BIHOR,"CĂMIN CULTURAL",512,RĂBĂGANI,30648,1,PART,PRCNCT,PRSD,PRSD_SV,"2025-05-18 21:14:16",95,67,49,17,1,66,1,104,37,32,34
5,BIHOR,"CĂMINUL CULTURAL",513,RĂBĂGANI,30648,1,PART,PRCNCT,PRSD,PRSD_SV,"2025-05-18 21:29:00",356,234,174,50,10,232,2,391,157,141,91
5,BIHOR,"CĂMINUL CULTURAL",514,RĂBĂGANI,30648,1,PART,PRCNCT,PRSD,PRSD_SV,"2025-05-18 21:35:20",303,171,139,32,0,171,0,332,161,104,67
5,BIHOR,"ȘCOALA GIMNAZIALĂ NR 1",515,REMETEA,30719,1,PART,PRCNCT,PRSD,PRSD_SV,"2025-05-18 21:31:36",682,419,362,57,0,415,4,749,330,147,268
5,BIHOR,"ȘCOALA PRIMARĂ NR. 2",516,REMETEA,30719,1,PART,PRCNCT,PRSD,PRSD_SV,"2025-05-18 21:31:38",292,215,174,40,1,213,2,321,106,139,74
5,BIHOR,"ȘCOALA GIMNAZIALĂ NR 2",517,REMETEA,30719,1,PART,PRCNCT,PRSD,PRSD_SV,"2025-05-18 21:47:04",877,559,490,37,32,552,7,964,405,296,256
5,BIHOR,"CĂMINUL CULTURAL PETREASA",518,REMETEA,30719,1,PART,PRCNCT,PRSD,PRSD_SV,"2025-05-18 21:46:08",360,199,173,26,0,193,6,395,196,109,84
5,BIHOR,"CĂMINUL CULTURAL ŞOIMUŞ",519,REMETEA,30719,1,PART,PRCNCT,PRSD,PRSD_SV,"2025-05-18 21:24:21",101,71,50,21,0,70,1,110,39,25,45
5,BIHOR,"CĂMINUL CULTURAL RIENI",520,RIENI,30773,1,PART,PRCNCT,PRSD,PRSD_SV,"2025-05-18 21:30:17",401,314,251,48,15,311,3,440,126,101,210
5,BIHOR,"CĂMIN CULTURAL GHIGHIȘENI",521,RIENI,30773,2,PART,PRCNCT,PRSD,PRSD_SV,"2025-05-19 00:23:19",799,512,442,38,32,505,7,879,367,210,295
5,BIHOR,"CĂMIN CULTURAL PETRILENI",522,RIENI,30773,1,PART,PRCNCT,PRSD,PRSD_SV,"2025-05-18 21:17:28",445,256,222,26,8,252,4,489,232,115,137
5,BIHOR,"CĂMIN CULTURAL SUDRIGIU",523,RIENI,30773,1,PART,PRCNCT,PRSD,PRSD_SV,"2025-05-18 21:45:37",268,184,156,26,2,179,5,294,110,72,107
5,BIHOR,"CĂMINUL CULTURAL VALEA DE JOS",524,RIENI,30773,1,PART,PRCNCT,PRSD,PRSD_SV,"2025-05-18 21:31:05",481,330,278,35,17,327,3,528,198,128,199
5,BIHOR,"ȘCOALA GIMNAZIALĂ NR. 1 ROȘIA - CORP B",525,ROŞIA,30844,1,PART,PRCNCT,PRSD,PRSD_SV,"2025-05-18 21:42:11",484,337,298,36,3,333,4,531,194,179,154
5,BIHOR,"AFTER SCHOOL",526,ROŞIA,30844,1,PART,PRCNCT,PRSD,PRSD_SV,"2025-05-18 21:32:55",490,314,287,18,9,313,1,538,224,184,129
5,BIHOR,"FOSTĂ GRADINIȚA PONIȚA",527,ROŞIA,30844,1,PART,PRCNCT,PRSD,PRSD_SV,"2025-05-18 21:38:48",585,337,313,22,2,336,1,643,306,178,158
5,BIHOR,"ŞCOALA CU CLASELE I-IV LAZURI",528,ROŞIA,30844,1,PART,PRCNCT,PRSD,PRSD_SV,"2025-05-18 21:31:36",319,221,196,23,2,219,2,350,129,146,73
5,BIHOR,"ŞCOALA GIMNAZIALĂ ”JAKO ZSIGMOND”",529,ROŞIORI,32187,1,PART,PRCNCT,PRSD,PRSD_SV,"2025-05-18 22:44:15",1110,680,606,54,20,674,6,1221,541,143,531
5,BIHOR,"ŞCOALA GIMNAZIALĂ NR.1",530,ROŞIORI,32187,1,PART,PRCNCT,PRSD,PRSD_SV,"2025-05-18 21:51:29",814,431,359,72,0,425,6,896,465,268,157
5,BIHOR,"ŞCOALA PRIMARĂ NR.1",531,ROŞIORI,32187,2,PART,PRCNCT,PRSD,PRSD_SV,"2025-05-19 00:21:51",375,234,193,36,5,232,2,412,178,28,204
5,BIHOR,"GRĂDINIȚA CU PROGRAM NORMAL SĂCĂDAT",532,SĂCĂDAT,30871,1,PART,PRCNCT,PRSD,PRSD_SV,"2025-05-18 22:32:04",777,482,369,113,0,477,5,854,372,227,250
5,BIHOR,"FOSTA ȘCOALĂ CU CLS.I-IV",533,SĂCĂDAT,30871,1,PART,PRCNCT,PRSD,PRSD_SV,"2025-05-18 21:48:33",143,110,52,58,0,108,2,159,49,38,70
5,BIHOR,"CĂMIN CULTURAL",534,SĂCĂDAT,30871,1,PART,PRCNCT,PRSD,PRSD_SV,"2025-05-18 21:43:56",602,351,273,78,0,346,5,661,310,218,128
5,BIHOR,"CĂMIN CULTURAL SĂLACEA",535,SĂLACEA,30988,1,PART,PRCNCT,PRSD,PRSD_SV,"2025-05-18 21:55:02",958,581,530,26,25,570,11,1053,472,73,497
5,BIHOR,"SCOALĂ GENERALĂ",536,SĂLACEA,30988,1,PART,PRCNCT,PRSD,PRSD_SV,"2025-05-18 21:48:25",921,561,500,20,41,558,3,1012,451,41,517
5,BIHOR,"CĂMINUL CULTURAL",537,SĂLACEA,30988,1,PART,PRCNCT,PRSD,PRSD_SV,"2025-05-18 22:09:05",602,386,328,30,28,383,3,661,275,58,325
5,BIHOR,"ȘCOALA GIMNAZIALĂ SZALARDI JANOS SĂLARD",538,SĂLARD,31011,1,PART,PRCNCT,PRSD,PRSD_SV,"2025-05-18 21:55:46",1208,658,581,77,0,653,5,1330,672,234,419
5,BIHOR,"ȘCOALA GIMNAZIALĂ SZALARDI JANOS SĂLARD",539,SĂLARD,31011,1,PART,PRCNCT,PRSD,PRSD_SV,"2025-05-18 22:04:32",1355,805,722,40,43,800,5,1490,685,199,601
5,BIHOR,"ȘCOALA PRIMARĂ NR.1",540,SĂLARD,31011,1,PART,PRCNCT,PRSD,PRSD_SV,"2025-05-18 22:12:09",607,367,330,34,3,367,0,667,300,43,324
5,BIHOR,"ȘCOALA PRIMARĂ NR. 2",541,SĂLARD,31011,1,PART,PRCNCT,PRSD,PRSD_SV,"2025-05-18 21:39:06",518,273,239,26,8,269,4,569,296,29,240
5,BIHOR,"CAMINUL CULTURAL",542,SÂMBĂTA,31057,1,PART,PRCNCT,PRSD,PRSD_SV,"2025-05-18 21:48:37",283,229,136,88,5,228,1,311,82,102,126
5,BIHOR,"CAMINUL CULTURAL",543,SÂMBĂTA,31057,1,PART,PRCNCT,PRSD,PRSD_SV,"2025-05-18 21:48:03",102,90,52,37,1,90,0,161,71,40,50
5,BIHOR,"GRĂDINIȚA CU PROGRAM NORMAL NR. 3 OGEȘTI",544,SÂMBĂTA,31057,1,PART,PRCNCT,PRSD,PRSD_SV,"2025-05-18 21:33:03",171,121,92,20,9,120,1,187,66,70,50
5,BIHOR,"GRĂDINIȚA CU PROGRAM NORMAL NR.4 ROGOZ",545,SÂMBĂTA,31057,1,PART,PRCNCT,PRSD,PRSD_SV,"2025-05-18 21:52:09",223,140,100,35,5,138,2,194,54,91,47
5,BIHOR,"CAMINUL CULTURAL",546,SÂMBĂTA,31057,1,PART,PRCNCT,PRSD,PRSD_SV,"2025-05-18 21:48:04",102,99,59,35,5,99,0,161,62,35,64
5,BIHOR,"GRĂDINIȚA CU PROGRAM NORMAL NR. 2 ZĂVOIU",547,SÂMBĂTA,31057,1,PART,PRCNCT,PRSD,PRSD_SV,"2025-05-18 21:47:07",194,134,88,46,0,130,4,212,78,77,53
5,BIHOR,"CLĂDIRE ADMINISTRATIVĂ",548,SÂNIOB,28610,1,PART,PRCNCT,PRSD,PRSD_SV,"2025-05-18 22:24:27",1084,743,637,66,40,736,7,1191,448,77,659
5,BIHOR,"CĂMIN CULTURAL",549,SÂNIOB,28610,1,PART,PRCNCT,PRSD,PRSD_SV,"2025-05-18 21:34:49",201,116,77,39,0,115,1,220,104,53,62
5,BIHOR,"CĂMIN CULTURAL",550,SÂNIOB,28610,1,PART,PRCNCT,PRSD,PRSD_SV,"2025-05-18 21:33:02",296,174,127,47,0,173,1,324,150,110,63
5,BIHOR,"ȘCOALA CU CLASELE I-IV",551,SÂNIOB,28610,1,PART,PRCNCT,PRSD,PRSD_SV,"2025-05-18 21:26:30",202,136,105,31,0,135,1,221,85,69,66
5,BIHOR,"GRĂDINIŢA CU PROGRAM PRELUNGIT ”PRIETENII COPILĂRIEI” SÂNMARTIN",552,SÂNMARTIN,26582,1,PART,PRCNCT,PRSD,PRSD_SV,"2025-05-18 22:45:59",1452,907,761,141,5,896,11,1597,690,336,560
5,BIHOR,"ŞCOALA GIMNAZIALĂ ”FLOARE DE LOTUS” SÂNMARTIN",553,SÂNMARTIN,26582,1,PART,PRCNCT,PRSD,PRSD_SV,"2025-05-18 22:50:40",1869,1443,1137,302,4,1425,18,2055,612,409,1016
5,BIHOR,"LICEUL TEHNOLOGIC ”FELIX” SÂNMARTIN",554,SÂNMARTIN,26582,1,PART,PRCNCT,PRSD,PRSD_SV,"2025-05-18 22:20:20",1114,851,663,187,1,845,6,1226,375,301,544
5,BIHOR,"GRĂDINIŢA CU PROGRAM PRELUNGIT ”ALBĂ CA ZĂPADA” BĂILE FELIX",555,SÂNMARTIN,26582,1,PART,PRCNCT,PRSD,PRSD_SV,"2025-05-18 22:48:22",457,1773,278,1417,78,1743,30,2104,331,673,1070
5,BIHOR,"GRĂDINIŢA CU PROGRAM PRELUNGIT ”CĂSUŢA POVEŞTILOR” BETFIA",556,SÂNMARTIN,26582,1,PART,PRCNCT,PRSD,PRSD_SV,"2025-05-18 21:39:22",423,321,255,66,0,316,5,464,143,135,181
5,BIHOR,"ŞCOALA PRIMARĂ",557,SÂNMARTIN,26582,1,PART,PRCNCT,PRSD,PRSD_SV,"2025-05-18 23:00:39",1777,1394,1146,248,0,1372,22,1554,160,596,776
5,BIHOR,"GRĂDINIŢA CU PROGRAM NORMAL ”101 DALMAŢIENI” CORDĂU",558,SÂNMARTIN,26582,2,PART,PRCNCT,PRSD,PRSD_SV,"2025-05-19 00:12:14",1423,906,761,114,31,899,7,1565,659,513,386
5,BIHOR,"GRĂDINIŢA CU PROGRAM PRELUNGIT ”PINOCCHIO” HAIEU",559,SÂNMARTIN,26582,1,PART,PRCNCT,PRSD,PRSD_SV,"2025-05-18 22:59:55",1165,1267,702,509,56,1251,16,1481,214,531,720
5,BIHOR,"GRĂDINIŢA CU PROGRAM PRELUNGIT ”5 URSULEŢI” RONTĂU",560,SÂNMARTIN,26582,1,PART,PRCNCT,PRSD,PRSD_SV,"2025-05-18 21:49:45",1197,658,588,70,0,651,7,1316,658,376,275
5,BIHOR,"CAMIN CULTURAL",561,"SÂNNICOLAU ROMÂN",32179,2,PART,PRCNCT,PRSD,PRSD_SV,"2025-05-18 23:12:41",980,584,487,97,0,579,5,1077,493,303,276
5,BIHOR,"SCOALA GENERALA",562,"SÂNNICOLAU ROMÂN",32179,1,PART,PRCNCT,PRSD,PRSD_SV,"2025-05-18 21:49:12",275,216,159,55,2,215,1,302,86,113,102
5,BIHOR,GRADINITA,563,"SÂNNICOLAU ROMÂN",32179,1,PART,PRCNCT,PRSD,PRSD_SV,"2025-05-18 21:55:02",560,300,255,45,0,297,3,615,315,237,60
5,BIHOR,"ȘCOALA GIMNAZIALĂ, NR.1 SÂNTANDREI",564,SÂNTANDREI,26653,1,PART,PRCNCT,PRSD,PRSD_SV,"2025-05-18 22:42:35",1399,1033,922,110,1,1027,6,1886,853,306,721
5,BIHOR,"ȘCOALA GIMNAZIALĂ, NR.1 SÂNTANDREI",565,SÂNTANDREI,26653,1,PART,PRCNCT,PRSD,PRSD_SV,"2025-05-18 21:59:50",1365,957,863,91,3,946,11,1399,442,265,681
5,BIHOR,"ȘCOALA GIMNAZIALĂ, NR.1 SÂNTANDREI",566,SÂNTANDREI,26653,1,PART,PRCNCT,PRSD,PRSD_SV,"2025-05-18 22:31:33",1443,1068,972,96,0,1058,10,1552,484,269,789
5,BIHOR,"ȘCOALA GIMNAZIALĂ, NR.1 SÂNTANDREI",567,SÂNTANDREI,26653,1,PART,PRCNCT,PRSD,PRSD_SV,"2025-05-18 22:19:18",1202,860,696,163,1,850,10,1213,353,232,618
5,BIHOR,"ȘCOALA GIMNAZIALĂ, NR.1 SÂNTANDREI",568,SÂNTANDREI,26653,1,PART,PRCNCT,PRSD,PRSD_SV,"2025-05-18 22:46:44",1681,1160,1033,127,0,1142,18,1746,586,405,737
5,BIHOR,"CAMIN CULTURAL PALOTA",569,SÂNTANDREI,26653,1,PART,PRCNCT,PRSD,PRSD_SV,"2025-05-18 21:34:56",594,330,289,41,0,327,3,652,322,95,232
5,BIHOR,"CAMIN CULTURAL",570,SÂRBI,31128,1,PART,PRCNCT,PRSD,PRSD_SV,"2025-05-18 21:45:16",828,485,389,77,19,479,6,910,425,279,200
5,BIHOR,"SCOALA GENERALA",571,SÂRBI,31128,1,PART,PRCNCT,PRSD,PRSD_SV,"2025-05-18 21:39:59",81,61,32,29,0,61,0,89,28,41,20
5,BIHOR,"CAMIN CULTURAL",572,SÂRBI,31128,1,PART,PRCNCT,PRSD,PRSD_SV,"2025-05-18 21:52:45",613,338,281,51,6,338,0,673,335,218,120
5,BIHOR,"SPAȚIU PENTRU ALEGERI GENERALE",573,SÂRBI,31128,1,PART,PRCNCT,PRSD,PRSD_SV,"2025-05-18 21:42:26",112,88,57,27,4,88,0,122,34,32,56
5,BIHOR,"SCOALA GENERALA",574,SÂRBI,31128,1,PART,PRCNCT,PRSD,PRSD_SV,"2025-05-18 21:40:12",279,144,112,32,0,139,5,306,162,81,58
5,BIHOR,"SPAȚIU PENTRU ALEGERI",575,SÂRBI,31128,1,PART,PRCNCT,PRSD,PRSD_SV,"2025-05-18 21:42:52",48,44,21,23,0,44,0,83,39,22,22
5,BIHOR,"SCOALA GIMNAZIALA NR.1 SPINUS",576,SPINUŞ,31208,1,PART,PRCNCT,PRSD,PRSD_SV,"2025-05-18 21:28:06",298,148,112,36,0,142,6,327,179,52,90
5,BIHOR,"CĂMIN CULTURAL CIULEȘTI",577,SPINUŞ,31208,1,PART,PRCNCT,PRSD,PRSD_SV,"2025-05-18 21:27:10",148,84,65,19,0,84,0,162,78,43,41
5,BIHOR,"FOSTA SCOALA CU CLASELE I-IV GURBEŞTI",578,SPINUŞ,31208,1,PART,PRCNCT,PRSD,PRSD_SV,"2025-05-18 21:23:49",83,55,34,21,0,55,0,90,35,28,27
5,BIHOR,"FOSTA SCOALA CU CLASELE I-IV NĂDAR",579,SPINUŞ,31208,1,PART,PRCNCT,PRSD,PRSD_SV,"2025-05-18 21:20:31",172,107,81,26,0,103,4,188,81,70,33
5,BIHOR,"SCOALA PRIMARĂ NR.1 SĂLIŞTE",580,SPINUŞ,31208,1,PART,PRCNCT,PRSD,PRSD_SV,"2025-05-18 21:29:40",196,122,94,28,0,120,2,215,93,47,73
5,BIHOR,"LIC. TEHNOLOGIC NR1 SUPLACU DE BARCAU",581,"SUPLACU DE BARCĂU",31262,1,PART,PRCNCT,PRSD,PRSD_SV,"2025-05-18 21:50:12",965,453,429,23,1,444,9,1061,608,186,258
5,BIHOR,"FOST SEDIU PRIMARIE",582,"SUPLACU DE BARCĂU",31262,1,PART,PRCNCT,PRSD,PRSD_SV,"2025-05-18 22:00:33",992,538,476,61,1,533,5,1091,553,188,345
5,BIHOR,"CAMIN CULTURAL",583,"SUPLACU DE BARCĂU",31262,1,PART,PRCNCT,PRSD,PRSD_SV,"2025-05-18 21:56:53",734,361,328,33,0,354,7,806,445,215,139
5,BIHOR,"CĂMIN CULTURAL DOLEA",584,"SUPLACU DE BARCĂU",31262,1,PART,PRCNCT,PRSD,PRSD_SV,"2025-05-18 21:48:12",123,70,46,24,0,70,0,134,64,18,52
5,BIHOR,"SCOALA PRIMARA NR. 5",585,"SUPLACU DE BARCĂU",31262,1,PART,PRCNCT,PRSD,PRSD_SV,"2025-05-18 21:36:02",164,78,65,13,0,77,1,179,101,43,34
5,BIHOR,"SCOALA PRIMARA NR. 3",586,"SUPLACU DE BARCĂU",31262,1,PART,PRCNCT,PRSD,PRSD_SV,"2025-05-18 21:42:39",343,163,139,13,11,163,0,376,213,74,89
5,BIHOR,"SCOALA PRIMARA NR. 4",587,"SUPLACU DE BARCĂU",31262,1,PART,PRCNCT,PRSD,PRSD_SV,"2025-05-18 21:40:48",191,109,96,12,1,107,2,209,100,70,37
5,BIHOR,"GRĂDINIȚA CU PROGRAM NORMAL NR,3",588,ŞIMIAN,31333,1,PART,PRCNCT,PRSD,PRSD_SV,"2025-05-18 21:48:19",258,152,133,16,3,150,2,283,131,42,108
5,BIHOR,"ȘCOALA GIMNAZIALĂ ”KAZINCZY FERENC” ȘIMIAN",589,ŞIMIAN,31333,1,PART,PRCNCT,PRSD,PRSD_SV,"2025-05-18 22:01:49",1586,937,857,54,26,926,11,1744,807,96,830
5,BIHOR,"FOSTA ȘCOALĂ PRIMARĂ CU CLASELE I-IV",590,ŞIMIAN,31333,1,PART,PRCNCT,PRSD,PRSD_SV,"2025-05-18 23:40:30",143,111,88,19,4,109,2,156,45,20,89
5,BIHOR,"ȘCOALA PRIMARĂ CU NR,1",591,ŞIMIAN,31333,1,PART,PRCNCT,PRSD,PRSD_SV,"2025-05-18 21:56:38",757,403,337,55,11,394,9,832,429,94,300
5,BIHOR,"ȘCOALA PRIMARĂ NR,2",592,ŞIMIAN,31333,1,PART,PRCNCT,PRSD,PRSD_SV,"2025-05-18 21:22:46",310,146,105,41,0,146,0,340,194,84,62
5,BIHOR,"CĂMIN CULTURAL ȘINTEU",593,ŞINTEU,31379,1,PART,PRCNCT,PRSD,PRSD_SV,"2025-05-18 21:58:22",907,325,223,101,1,323,2,997,672,189,134
5,BIHOR,"FOSTA ȘCOALĂ CU CLASELE I-IV ȘOIMI",594,ŞOIMI,31422,1,PART,PRCNCT,PRSD,PRSD_SV,"2025-05-18 21:37:55",645,131,96,35,0,127,4,709,578,60,67
5,BIHOR,"FOSTA ȘCOALĂ CU CLASELE I - IV",595,ŞOIMI,31422,1,PART,PRCNCT,PRSD,PRSD_SV,"2025-05-18 21:33:20",123,81,59,22,0,80,1,134,53,33,47
5,BIHOR,"FOSTA ȘCOALĂ CU CLASELE I- IV",596,ŞOIMI,31422,1,PART,PRCNCT,PRSD,PRSD_SV,"2025-05-18 21:22:00",126,64,50,14,0,62,2,138,74,49,13
5,BIHOR,"CĂMIN CULTURAL",597,ŞOIMI,31422,1,PART,PRCNCT,PRSD,PRSD_SV,"2025-05-18 21:55:29",224,139,101,38,0,139,0,245,106,68,71
5,BIHOR,"FOSTA ȘCOALĂ CU CLASELE I - IV",598,ŞOIMI,31422,1,PART,PRCNCT,PRSD,PRSD_SV,"2025-05-18 21:23:44",60,61,38,23,0,61,0,115,54,39,22
5,BIHOR,"FOSTA ŞCOALĂ CU CLASELE I - IV",599,ŞOIMI,31422,1,PART,PRCNCT,PRSD,PRSD_SV,"2025-05-18 21:18:47",87,69,41,28,0,68,1,95,26,23,45
5,BIHOR,"FOSTA ȘCOALĂ CU CLASELE I - VIII",600,ŞOIMI,31422,1,PART,PRCNCT,PRSD,PRSD_SV,"2025-05-18 21:29:46",104,65,38,27,0,65,0,113,48,17,48
5,BIHOR,"ŞCOALA CU CLASELE I - VIII",601,ŞOIMI,31422,1,PART,PRCNCT,PRSD,PRSD_SV,"2025-05-18 21:36:23",405,258,213,45,0,256,2,445,187,102,154
5,BIHOR,"LICEUL TEHNOLOGIC NR. 1 - ŞUNCUIUŞ",602,ŞUNCUIUŞ,31510,1,PART,PRCNCT,PRSD,PRSD_SV,"2025-05-18 22:06:13",1207,674,558,96,20,656,18,1327,593,326,330
5,BIHOR,"SCOALA CU CLS. I+IV ”POJORATA”",603,ŞUNCUIUŞ,31510,1,PART,PRCNCT,PRSD,PRSD_SV,"2025-05-18 21:15:25",92,40,27,13,0,40,0,100,60,15,25
5,BIHOR,"CĂMIN CULTURAL BĂLNACA",604,ŞUNCUIUŞ,31510,1,PART,PRCNCT,PRSD,PRSD_SV,"2025-05-18 21:40:34",762,350,309,41,0,345,5,837,487,177,168
5,BIHOR,"CAMIN CULTURAL SAT BALNACA GROSI",605,ŞUNCUIUŞ,31510,1,PART,PRCNCT,PRSD,PRSD_SV,"2025-05-18 21:25:04",47,48,25,23,0,48,0,111,63,28,20
5,BIHOR,"CAMIN CULTURAL CATUN CARMAZAN",606,ŞUNCUIUŞ,31510,1,PART,PRCNCT,PRSD,PRSD_SV,"2025-05-18 21:26:02",107,60,43,17,0,59,1,117,57,34,25
5,BIHOR,"SCOALA CU CLASELE I-VIII ZECEHOTARE",607,ŞUNCUIUŞ,31510,1,PART,PRCNCT,PRSD,PRSD_SV,"2025-05-18 21:23:34",133,83,68,15,0,83,0,145,62,36,47
5,BIHOR,"CĂMINUL CULTURAL",608,TARCEA,31565,1,PART,PRCNCT,PRSD,PRSD_SV,"2025-05-18 21:55:48",733,349,313,36,0,336,13,805,456,85,251
5,BIHOR,"CĂMINUL CULTURAL",609,TARCEA,31565,1,PART,PRCNCT,PRSD,PRSD_SV,"2025-05-18 21:34:43",582,320,281,39,0,317,3,639,319,28,289
5,BIHOR,"CASA ROTH",610,TARCEA,31565,1,PART,PRCNCT,PRSD,PRSD_SV,"2025-05-18 21:38:41",733,334,308,26,0,332,2,805,471,53,279
5,BIHOR,"CĂMINUL CULTURAL",611,TĂMĂŞEU,32153,1,PART,PRCNCT,PRSD,PRSD_SV,"2025-05-18 22:27:10",909,556,498,46,12,554,2,999,443,83,471
5,BIHOR,"CĂMINUL CULTURAL",612,TĂMĂŞEU,32153,1,PART,PRCNCT,PRSD,PRSD_SV,"2025-05-18 21:46:10",197,134,104,30,0,134,0,216,82,27,107
5,BIHOR,"ŞCOALA GENERALĂ",613,TĂMĂŞEU,32153,1,PART,PRCNCT,PRSD,PRSD_SV,"2025-05-18 22:08:35",404,229,196,33,0,226,3,443,214,98,128
5,BIHOR,"CĂMINUL CULTURAL",614,TĂMĂŞEU,32153,1,PART,PRCNCT,PRSD,PRSD_SV,"2025-05-18 21:23:40",199,116,87,29,0,113,3,218,102,18,95
5,BIHOR,"PRIMARIA TARCAIA",615,TĂRCAIA,31609,1,PART,PRCNCT,PRSD,PRSD_SV,"2025-05-18 21:38:18",890,515,468,28,19,510,5,978,463,45,465
5,BIHOR,"SCOALA CU CLASELE I-IV",616,TĂRCAIA,31609,1,PART,PRCNCT,PRSD,PRSD_SV,"2025-05-18 21:32:14",149,118,102,16,0,116,2,163,45,70,46
5,BIHOR,"CAMIN CULTURAL",617,TĂRCAIA,31609,1,PART,PRCNCT,PRSD,PRSD_SV,"2025-05-18 21:20:44",325,208,180,25,3,207,1,357,149,88,119
5,BIHOR,"CAMIN CULTURAL",618,TĂRCAIA,31609,1,PART,PRCNCT,PRSD,PRSD_SV,"2025-05-18 21:22:14",221,182,143,39,0,182,0,242,60,74,108
5,BIHOR,"CĂMINUL CULTURAL GITTAI ISTVÁN",619,TĂUTEU,31654,1,PART,PRCNCT,PRSD,PRSD_SV,"2025-05-18 21:34:26",899,549,501,37,11,546,3,988,439,47,499
5,BIHOR,"ȘCOALA GIMNAZIALĂ NR. 2",620,TĂUTEU,31654,1,PART,PRCNCT,PRSD,PRSD_SV,"2025-05-18 21:30:46",1205,399,377,22,0,391,8,1325,926,317,74
5,BIHOR,"CĂMINUL CULTURAL",621,TĂUTEU,31654,1,PART,PRCNCT,PRSD,PRSD_SV,"2025-05-18 21:26:25",647,337,291,46,0,331,6,711,374,187,144
5,BIHOR,"ŞCOALA GIMNAZIALĂ NR.4 CIUTELEC",622,TĂUTEU,31654,1,PART,PRCNCT,PRSD,PRSD_SV,"2025-05-18 21:35:32",525,241,200,29,12,236,5,577,336,132,104
5,BIHOR,"SCOALA PRIMARA",623,TĂUTEU,31654,1,PART,PRCNCT,PRSD,PRSD_SV,"2025-05-18 21:26:52",216,118,97,21,0,118,0,237,119,53,65
5,BIHOR,"CENTRUL CULTURAL MULTIFUNCTIONAL",624,TILEAGD,31716,1,PART,PRCNCT,PRSD,PRSD_SV,"2025-05-18 22:07:44",1854,892,786,99,7,878,14,2041,1149,385,493
5,BIHOR,"SCOALA CU CLS.I-IV",625,TILEAGD,31716,1,PART,PRCNCT,PRSD,PRSD_SV,"2025-05-18 22:03:11",1288,511,453,51,7,497,14,1416,905,295,202
5,BIHOR,"CLĂDIRE MULTIFUNCȚIONALĂ DE INTERES PUBLIC",626,TILEAGD,31716,2,PART,PRCNCT,PRSD,PRSD_SV,"2025-05-19 02:48:41",465,252,220,31,1,251,1,511,259,151,100
5,BIHOR,"SCOALA CU CLS.I-IV",627,TILEAGD,31716,1,PART,PRCNCT,PRSD,PRSD_SV,"2025-05-18 21:32:49",148,90,65,25,0,88,2,161,71,53,35
5,BIHOR,"CĂMIN CULTURAL",628,TILEAGD,31716,1,PART,PRCNCT,PRSD,PRSD_SV,"2025-05-18 21:29:12",342,146,120,26,0,144,2,375,229,69,75
5,BIHOR,"CĂMIN CULTURAL",629,TILEAGD,31716,1,PART,PRCNCT,PRSD,PRSD_SV,"2025-05-18 21:43:03",664,410,336,74,0,408,2,729,319,246,162
5,BIHOR,"CĂMIN CULTURAL",630,TILEAGD,31716,1,PART,PRCNCT,PRSD,PRSD_SV,"2025-05-18 21:47:43",680,337,284,48,5,337,0,749,412,142,195
5,BIHOR,"LICEUL TEORETIC N.JIGA",631,TINCA,31789,1,PART,PRCNCT,PRSD,PRSD_SV,"2025-05-18 22:14:32",1425,596,474,68,54,565,31,1600,1004,274,291
5,BIHOR,"SCOALA PRIMARA I-IV",632,TINCA,31789,1,PART,PRCNCT,PRSD,PRSD_SV,"2025-05-18 22:01:14",1283,678,566,105,7,665,13,1410,732,321,344
5,BIHOR,"GRĂDINIȚA CU PROGRAM PRELUNGIT NR.1 TINCA",633,TINCA,31789,1,PART,PRCNCT,PRSD,PRSD_SV,"2025-05-18 21:34:02",1065,577,438,70,69,569,8,1171,594,235,334
5,BIHOR,"GRĂDINIȚA CU PROGRAM NORMAL BELFIR",634,TINCA,31789,1,PART,PRCNCT,PRSD,PRSD_SV,"2025-05-18 21:28:25",463,167,139,28,0,165,2,508,341,54,111
5,BIHOR,"CĂMIN CULTURAL”ELISABETA PAVEL” GIRIȘU NEGRU",635,TINCA,31789,1,PART,PRCNCT,PRSD,PRSD_SV,"2025-05-18 21:31:00",528,310,223,80,7,307,3,580,270,198,109
5,BIHOR,"SCOALA GENERALA",636,TINCA,31789,1,PART,PRCNCT,PRSD,PRSD_SV,"2025-05-18 21:33:36",913,407,364,40,3,396,11,1004,597,212,184
5,BIHOR,"CLĂDIRE MULTIFUNCȚIONALĂ RÂPA",637,TINCA,31789,1,PART,PRCNCT,PRSD,PRSD_SV,"2025-05-18 21:50:55",421,263,186,49,28,259,4,462,199,95,164
5,BIHOR,"ȘCOALA GIMNAZIALĂ TOBOLIU",638,TOBOLIU,32201,1,PART,PRCNCT,PRSD,PRSD_SV,"2025-05-18 21:28:01",747,492,398,82,12,486,6,821,329,264,222
5,BIHOR,"ȘCOALA GIMNAZIALĂ NR. 1 CHERESIG",639,TOBOLIU,32201,1,PART,PRCNCT,PRSD,PRSD_SV,"2025-05-18 21:38:43",960,590,503,68,19,586,4,1055,465,274,312
5,BIHOR,"GRĂDINIŢA CU PROGRAM NORMAL TULCA",640,TULCA,31841,1,PART,PRCNCT,PRSD,PRSD_SV,"2025-05-18 21:40:22",1585,837,764,61,12,821,16,1744,907,421,400
5,BIHOR,"ȘCOALA CU CLASELE I-IV TULCA NOUĂ",641,TULCA,31841,1,PART,PRCNCT,PRSD,PRSD_SV,"2025-05-18 21:31:55",202,141,118,22,1,141,0,221,80,67,74
5,BIHOR,"CĂMINUL CULTURAL CĂUAȘD",642,TULCA,31841,1,PART,PRCNCT,PRSD,PRSD_SV,"2025-05-18 21:43:02",381,212,173,35,4,211,1,418,206,120,91
5,BIHOR,"CĂMIN CULTURAL",643,ŢEŢCHEA,31878,1,PART,PRCNCT,PRSD,PRSD_SV,"2025-05-18 21:31:06",684,358,305,39,14,357,1,751,393,267,90
5,BIHOR,"CĂMIN CULTURAL",644,ŢEŢCHEA,31878,1,PART,PRCNCT,PRSD,PRSD_SV,"2025-05-18 21:46:38",662,369,320,49,0,366,3,727,358,222,144
5,BIHOR,"CĂMIN CULTURAL",645,ŢEŢCHEA,31878,1,PART,PRCNCT,PRSD,PRSD_SV,"2025-05-18 21:37:29",461,248,216,32,0,246,2,506,258,120,126
5,BIHOR,"CĂMIN CULTURAL",646,ŢEŢCHEA,31878,1,PART,PRCNCT,PRSD,PRSD_SV,"2025-05-18 22:00:30",682,363,333,30,0,350,13,749,386,180,170
5,BIHOR,"ŞCOALA GIMNAZIALĂ NR.1",647,"UILEACU DE BEIUŞ",31921,1,PART,PRCNCT,PRSD,PRSD_SV,"2025-05-18 21:32:11",476,295,245,45,5,291,4,523,228,86,205
5,BIHOR,"ŞCOALA PRIMARĂ NR.1",648,"UILEACU DE BEIUŞ",31921,1,PART,PRCNCT,PRSD,PRSD_SV,"2025-05-18 21:51:29",599,339,313,26,0,336,3,658,319,250,86
5,BIHOR,"GRĂDINIŢA CU PROGRAM NORMAL NR.3",649,"UILEACU DE BEIUŞ",31921,1,PART,PRCNCT,PRSD,PRSD_SV,"2025-05-18 21:29:15",322,194,175,18,1,190,4,353,159,85,105
5,BIHOR,"CĂMIN CULTURAL VĂLANII DE BEIUȘ",650,"UILEACU DE BEIUŞ",31921,1,PART,PRCNCT,PRSD,PRSD_SV,"2025-05-18 21:19:51",189,104,91,13,0,102,2,207,103,69,33
5,BIHOR,"CĂMIN CULTURAL VADU CRIŞULUI",651,"VADU CRIŞULUI",31976,1,PART,PRCNCT,PRSD,PRSD_SV,"2025-05-18 22:21:47",1444,873,764,104,5,860,13,1587,714,314,546
5,BIHOR,"ŞCOALA GENERALĂ VADU CRIŞULUI",652,"VADU CRIŞULUI",31976,1,PART,PRCNCT,PRSD,PRSD_SV,"2025-05-18 22:20:29",886,387,340,47,0,377,10,975,588,149,228
5,BIHOR,"CĂMIN CULTURAL BIRTIN",653,"VADU CRIŞULUI",31976,1,PART,PRCNCT,PRSD,PRSD_SV,"2025-05-18 21:31:11",269,204,176,27,1,203,1,295,91,86,117
5,BIHOR,"ŞCOALA GENERALĂ TOMNATIC",654,"VADU CRIŞULUI",31976,1,PART,PRCNCT,PRSD,PRSD_SV,"2025-05-18 21:26:49",194,69,52,17,0,69,0,212,143,43,26
5,BIHOR,"ŞCOALA GENERALĂ TOPA DE CRIŞ",655,"VADU CRIŞULUI",31976,1,PART,PRCNCT,PRSD,PRSD_SV,"2025-05-18 21:34:00",334,219,173,46,0,217,2,366,147,101,116
5,BIHOR,"CĂMINUL CULTURAL",656,VÂRCIOROG,32090,1,PART,PRCNCT,PRSD,PRSD_SV,"2025-05-18 21:35:10",789,473,415,58,0,468,5,867,394,261,207
5,BIHOR,"CĂMINUL CULTURAL FÂȘCA",657,VÂRCIOROG,32090,1,PART,PRCNCT,PRSD,PRSD_SV,"2025-05-18 21:28:07",330,197,173,24,0,195,2,362,165,112,83
5,BIHOR,"ȘCOALA GIMNAZIALĂ NR.2",658,VÂRCIOROG,32090,1,PART,PRCNCT,PRSD,PRSD_SV,"2025-05-18 21:30:12",428,266,193,73,0,261,5,470,204,156,105
5,BIHOR,"ȘCOALA GIMNAZIALĂ NR.1 VIIȘOARA",659,VIIŞOARA,32045,1,PART,PRCNCT,PRSD,PRSD_SV,"2025-05-18 21:59:46",888,607,525,48,34,597,10,976,369,130,467
5,BIHOR,"CĂMIN CULTURAL",660,VIIŞOARA,32045,1,PART,PRCNCT,PRSD,PRSD_SV,"2025-05-18 21:25:27",150,82,55,22,5,82,0,164,82,34,48
6,BISTRIŢA-NĂSĂUD,"CENTRUL CULTURAL MUNICIPAL GEORGE COȘBUC",1,"MUNICIPIUL BISTRIŢA",32394,1,PART,PRCNCT,PRSD,PRSD_SV,"2025-05-18 23:20:56",1290,760,671,73,16,757,3,1400,640,230,527
6,BISTRIŢA-NĂSĂUD,"GRĂDINIŢA CU PROGRAM PRELUNGIT ”DUMBRAVA MINUNATĂ”",2,"MUNICIPIUL BISTRIŢA",32394,1,PART,PRCNCT,PRSD,PRSD_SV,"2025-05-18 22:02:06",989,450,374,76,0,445,5,1100,650,202,243
6,BISTRIŢA-NĂSĂUD,"LICEUL DE MUZICĂ ”TUDOR JARDA”",3,"MUNICIPIUL BISTRIŢA",32394,1,PART,PRCNCT,PRSD,PRSD_SV,"2025-05-18 22:11:57",1339,677,596,62,19,667,10,1500,823,236,431
6,BISTRIŢA-NĂSĂUD,"PRIMĂRIA MUNICIPIULUI BISTRIŢA, DIRECŢIA ECONOMICĂ-VENITURI",4,"MUNICIPIUL BISTRIŢA",32394,1,PART,PRCNCT,PRSD,PRSD_SV,"2025-05-18 22:21:33",1862,1176,1069,106,1,1165,11,2008,832,382,783
6,BISTRIŢA-NĂSĂUD,"GRĂDINIŢA CU PROGRAM PRELUNGIT NR. 6",5,"MUNICIPIUL BISTRIŢA",32394,1,PART,PRCNCT,PRSD,PRSD_SV,"2025-05-18 22:35:03",1354,734,678,56,0,727,7,1500,766,228,499
6,BISTRIŢA-NĂSĂUD,"GRĂDINIŢA CU PROGRAM PRELUNGIT NR. 6",6,"MUNICIPIUL BISTRIŢA",32394,1,PART,PRCNCT,PRSD,PRSD_SV,"2025-05-18 21:59:40",1246,593,558,35,0,587,6,1400,807,189,398
6,BISTRIŢA-NĂSĂUD,"ȘCOALA PROFESIONALĂ SPECIALĂ ”SFÂNTA MARIA” BISTRIŢA",7,"MUNICIPIUL BISTRIŢA",32394,1,PART,PRCNCT,PRSD,PRSD_SV,"2025-05-18 22:36:03",1203,711,620,91,0,698,13,1350,639,231,467
6,BISTRIŢA-NĂSĂUD,"ŞCOALA GIMNAZIALĂ NR. 1",8,"MUNICIPIUL BISTRIŢA",32394,1,PART,PRCNCT,PRSD,PRSD_SV,"2025-05-18 22:09:52",996,634,491,143,0,628,6,1100,466,200,428
6,BISTRIŢA-NĂSĂUD,"ŞCOALA GIMNAZIALĂ NR. 1",9,"MUNICIPIUL BISTRIŢA",32394,1,PART,PRCNCT,PRSD,PRSD_SV,"2025-05-18 22:00:21",1084,555,501,54,0,549,6,1200,645,192,357
6,BISTRIŢA-NĂSĂUD,"ŞCOALA GIMNAZIALĂ NR. 1",10,"MUNICIPIUL BISTRIŢA",32394,1,PART,PRCNCT,PRSD,PRSD_SV,"2025-05-18 22:23:27",1353,710,663,45,2,703,7,1500,790,221,482
6,BISTRIŢA-NĂSĂUD,"ŞCOALA GIMNAZIALĂ NR. 1",11,"MUNICIPIUL BISTRIŢA",32394,1,PART,PRCNCT,PRSD,PRSD_SV,"2025-05-18 22:07:56",1103,622,573,22,27,613,9,1200,578,160,453
6,BISTRIŢA-NĂSĂUD,"ȘCOALA GIMNAZIALĂ LUCIAN BLAGA",12,"MUNICIPIUL BISTRIŢA",32394,1,PART,PRCNCT,PRSD,PRSD_SV,"2025-05-18 23:12:04",1257,713,620,93,0,709,4,1400,687,235,474
6,BISTRIŢA-NĂSĂUD,"ŞCOALA GIMNAZIALĂ ”LUCIAN BLAGA”",13,"MUNICIPIUL BISTRIŢA",32394,1,PART,PRCNCT,PRSD,PRSD_SV,"2025-05-18 22:53:33",1587,856,777,79,0,853,3,1750,894,271,582
6,BISTRIŢA-NĂSĂUD,"ŞCOALA GIMNAZIALĂ ”LUCIAN BLAGA”",14,"MUNICIPIUL BISTRIŢA",32394,1,PART,PRCNCT,PRSD,PRSD_SV,"2025-05-18 23:05:13",1556,843,771,72,0,838,5,1700,857,262,576
6,BISTRIŢA-NĂSĂUD,"ŞCOALA GIMNAZIALĂ ”LUCIAN BLAGA”",15,"MUNICIPIUL BISTRIŢA",32394,1,PART,PRCNCT,PRSD,PRSD_SV,"2025-05-18 22:56:13",1592,893,847,46,0,887,6,1750,857,267,620
6,BISTRIŢA-NĂSĂUD,"LICEUL TEHNOLOGIC ”GRIGORE MOISIL”",16,"MUNICIPIUL BISTRIŢA",32394,1,PART,PRCNCT,PRSD,PRSD_SV,"2025-05-18 22:51:35",1784,1042,966,74,2,1027,15,1950,908,335,692
6,BISTRIŢA-NĂSĂUD,"LICEUL TEHNOLOGIC ”GRIGORE MOISIL”",17,"MUNICIPIUL BISTRIŢA",32394,1,PART,PRCNCT,PRSD,PRSD_SV,"2025-05-18 22:11:32",1594,853,797,56,0,843,10,1750,897,285,558
6,BISTRIŢA-NĂSĂUD,"LICEUL TEHNOLOGIC GRIGORE MOISIL",18,"MUNICIPIUL BISTRIŢA",32394,1,PART,PRCNCT,PRSD,PRSD_SV,"2025-05-18 23:10:21",1606,858,776,82,0,852,6,1750,892,326,526
6,BISTRIŢA-NĂSĂUD,"LICEUL TEHNOLOGIC GRIGORE MOISIL",19,"MUNICIPIUL BISTRIŢA",32394,1,PART,PRCNCT,PRSD,PRSD_SV,"2025-05-19 00:22:42",1835,1007,939,68,0,999,8,2000,993,396,603
6,BISTRIŢA-NĂSĂUD,"GRĂDINIŢA CU PROGRAM PRELUNGIT ”TRENULEŢUL VESELIEI”",20,"MUNICIPIUL BISTRIŢA",32394,1,PART,PRCNCT,PRSD,PRSD_SV,"2025-05-18 22:13:14",1231,688,596,74,18,682,6,1350,662,267,415
6,BISTRIŢA-NĂSĂUD,"LICEUL TEHNOLOGIC",21,"MUNICIPIUL BISTRIŢA",32394,1,PART,PRCNCT,PRSD,PRSD_SV,"2025-05-18 22:27:00",1822,1103,916,71,116,1094,9,2000,897,488,606
6,BISTRIŢA-NĂSĂUD,"POLIȚIA LOCALĂ-PUNCT DE LUCRU SUBCETATE",22,"MUNICIPIUL BISTRIŢA",32394,1,PART,PRCNCT,PRSD,PRSD_SV,"2025-05-18 22:26:03",1524,1109,905,88,116,1094,15,1650,541,564,530
6,BISTRIŢA-NĂSĂUD,"COLEGIUL NAŢIONAL ”ANDREI MUREŞANU”",23,"MUNICIPIUL BISTRIŢA",32394,1,PART,PRCNCT,PRSD,PRSD_SV,"2025-05-18 22:07:19",1261,772,631,140,1,764,8,1400,628,262,502
6,BISTRIŢA-NĂSĂUD,"GRĂDINIŢA CU PROGRAM PRELUNGIT ”CĂSUŢA CU POVEŞTI”",24,"MUNICIPIUL BISTRIŢA",32394,1,PART,PRCNCT,PRSD,PRSD_SV,"2025-05-18 22:19:28",1158,565,515,50,0,560,5,1300,735,198,362
6,BISTRIŢA-NĂSĂUD,"COLEGIUL NAȚIONAL LIVIU REBREANU",25,"MUNICIPIUL BISTRIŢA",32394,1,PART,PRCNCT,PRSD,PRSD_SV,"2025-05-18 22:04:34",998,478,432,46,0,472,6,1100,622,173,299
6,BISTRIŢA-NĂSĂUD,"COLEGIUL NAŢIONAL LIVIU REBREANU",26,"MUNICIPIUL BISTRIŢA",32394,1,PART,PRCNCT,PRSD,PRSD_SV,"2025-05-18 21:57:32",1255,718,588,129,1,711,7,1400,682,243,468
6,BISTRIŢA-NĂSĂUD,"COLEGIUL NAŢIONAL ”LIVIU REBREANU”, ŞCOALA PRIMARĂ",27,"MUNICIPIUL BISTRIŢA",32394,1,PART,PRCNCT,PRSD,PRSD_SV,"2025-05-18 22:15:52",1177,586,532,54,0,579,7,1300,714,221,358
6,BISTRIŢA-NĂSĂUD,"GRĂDINIŢA CU PROGRAM NORMAL NR. 9",28,"MUNICIPIUL BISTRIŢA",32394,1,PART,PRCNCT,PRSD,PRSD_SV,"2025-05-18 22:50:22",1182,769,621,147,1,765,4,1300,531,218,547
6,BISTRIŢA-NĂSĂUD,"UNIVERSITATEA ”BABEŞ-BOLYAI” CLUJ-NAPOCA, EXTENSIA UNIVERSITARĂ BISTRIŢA",29,"MUNICIPIUL BISTRIŢA",32394,1,PART,PRCNCT,PRSD,PRSD_SV,"2025-05-18 23:13:50",1658,812,744,67,1,805,7,1850,1037,327,478
6,BISTRIŢA-NĂSĂUD,"UNIVERSITATEA ”BABEŞ-BOLYAI” CLUJ-NAPOCA, EXTENSIA UNIVERSITARĂ BISTRIŢA",30,"MUNICIPIUL BISTRIŢA",32394,1,PART,PRCNCT,PRSD,PRSD_SV,"2025-05-18 22:14:55",1424,830,582,121,127,818,12,1600,770,376,442
6,BISTRIŢA-NĂSĂUD,"ŞCOALA GIMNAZIALĂ NR. 4",31,"MUNICIPIUL BISTRIŢA",32394,1,PART,PRCNCT,PRSD,PRSD_SV,"2025-05-18 22:36:05",1685,1002,948,52,2,989,13,1850,848,306,683
6,BISTRIŢA-NĂSĂUD,"ŞCOALA GIMNAZIALĂ NR. 4",32,"MUNICIPIUL BISTRIŢA",32394,1,PART,PRCNCT,PRSD,PRSD_SV,"2025-05-18 22:28:50",1759,1068,937,130,1,1058,10,1900,832,426,632
6,BISTRIŢA-NĂSĂUD,"ȘCOALA GIMNAZIALĂ NR. 4",33,"MUNICIPIUL BISTRIŢA",32394,1,PART,PRCNCT,PRSD,PRSD_SV,"2025-05-18 22:21:21",1217,690,567,123,0,676,14,1350,660,265,411
6,BISTRIŢA-NĂSĂUD,"GRĂDINIŢA CU PROGRAM PRELUNGIT NR. 12",34,"MUNICIPIUL BISTRIŢA",32394,1,PART,PRCNCT,PRSD,PRSD_SV,"2025-05-18 22:26:48",1216,666,591,75,0,660,6,1400,734,198,462
6,BISTRIŢA-NĂSĂUD,"ȘCOALA GIMNAZIALĂ ”AVRAM IANCU”",35,"MUNICIPIUL BISTRIŢA",32394,1,PART,PRCNCT,PRSD,PRSD_SV,"2025-05-18 22:59:59",1182,607,571,35,1,596,11,1300,693,236,360
6,BISTRIŢA-NĂSĂUD,"ŞCOALA GIMNAZIALĂ ”AVRAM IANCU”",36,"MUNICIPIUL BISTRIŢA",32394,1,PART,PRCNCT,PRSD,PRSD_SV,"2025-05-18 22:52:48",1180,661,581,80,0,654,7,1300,639,170,484
6,BISTRIŢA-NĂSĂUD,"ŞCOALA GIMNAZIALĂ ”AVRAM IANCU”",37,"MUNICIPIUL BISTRIŢA",32394,1,PART,PRCNCT,PRSD,PRSD_SV,"2025-05-18 23:07:22",1152,609,561,48,0,606,3,1200,591,170,436
6,BISTRIŢA-NĂSĂUD,"GRĂDINIŢA CU PROGRAM PRELUNGIT NR. 13",38,"MUNICIPIUL BISTRIŢA",32394,1,PART,PRCNCT,PRSD,PRSD_SV,"2025-05-18 21:53:31",1238,689,647,41,1,682,7,1300,611,187,495
6,BISTRIŢA-NĂSĂUD,"ŞCOALA GIMNAZIALĂ ”ŞTEFAN CEL MARE”",39,"MUNICIPIUL BISTRIŢA",32394,1,PART,PRCNCT,PRSD,PRSD_SV,"2025-05-18 22:16:53",1151,790,600,87,103,780,10,1250,460,249,531
6,BISTRIŢA-NĂSĂUD,"ŞCOALA GIMNAZIALĂ ”ŞTEFAN CEL MARE”",40,"MUNICIPIUL BISTRIŢA",32394,1,PART,PRCNCT,PRSD,PRSD_SV,"2025-05-18 22:08:15",1288,718,635,83,0,715,3,1450,732,195,520
6,BISTRIŢA-NĂSĂUD,"ȘCOALA GIMNAZIALĂ ȘTEFAN CEL MARE",41,"MUNICIPIUL BISTRIŢA",32394,2,PART,PRCNCT,PRSD,PRSD_SV,"2025-05-18 23:45:22",1303,711,680,31,0,696,15,1400,689,235,461
6,BISTRIŢA-NĂSĂUD,"ȘCOALA GIMNAZIALĂ ȘTEFAN CEL MARE",42,"MUNICIPIUL BISTRIŢA",32394,1,PART,PRCNCT,PRSD,PRSD_SV,"2025-05-18 22:05:30",866,469,435,34,0,464,5,950,481,145,319
6,BISTRIŢA-NĂSĂUD,"GRĂDINIȚA CU PROGRAM PRELUNGIT NR.3",43,"MUNICIPIUL BISTRIŢA",32394,1,PART,PRCNCT,PRSD,PRSD_SV,"2025-05-18 22:28:08",1139,715,630,84,1,708,7,1250,535,168,540
6,BISTRIŢA-NĂSĂUD,"GRĂDINIȚA CU PROGRASM PRELUNGIT NR.3",44,"MUNICIPIUL BISTRIŢA",32394,1,PART,PRCNCT,PRSD,PRSD_SV,"2025-05-18 21:53:24",955,537,489,47,1,531,6,1050,513,162,369
6,BISTRIŢA-NĂSĂUD,"COLEGIUL TEHNIC INFOEL",45,"MUNICIPIUL BISTRIŢA",32394,1,PART,PRCNCT,PRSD,PRSD_SV,"2025-05-18 23:20:42",1693,1034,956,67,11,1019,15,1850,816,297,722
6,BISTRIŢA-NĂSĂUD,"GRĂDINIŢA CU PROGRAM PRELUNGIT ”RAZĂ DE SOARE”",46,"MUNICIPIUL BISTRIŢA",32394,1,PART,PRCNCT,PRSD,PRSD_SV,"2025-05-18 22:30:20",1230,682,619,62,1,678,4,1350,668,209,469
6,BISTRIŢA-NĂSĂUD,"COLEGIUL TEHNIC ”INFOEL”",47,"MUNICIPIUL BISTRIŢA",32394,1,PART,PRCNCT,PRSD,PRSD_SV,"2025-05-18 22:37:18",1844,940,878,62,0,925,15,2000,1060,297,628
6,BISTRIŢA-NĂSĂUD,"LICEUL CU PROGRAM SPORTIV",48,"MUNICIPIUL BISTRIŢA",32394,1,PART,PRCNCT,PRSD,PRSD_SV,"2025-05-18 23:00:06",1728,1038,823,182,33,1025,13,1900,862,375,650
6,BISTRIŢA-NĂSĂUD,"LICEUL CU PROGRAM SPORTIV",49,"MUNICIPIUL BISTRIŢA",32394,1,PART,PRCNCT,PRSD,PRSD_SV,"2025-05-18 22:20:16",1546,1017,895,122,0,1010,7,1700,683,343,667
6,BISTRIŢA-NĂSĂUD,"LICEUL CREȘTIN LOGOS",50,"MUNICIPIUL BISTRIŢA",32394,1,PART,PRCNCT,PRSD,PRSD_SV,"2025-05-18 22:05:38",996,736,533,98,105,726,10,1150,414,322,404
6,BISTRIŢA-NĂSĂUD,"GRĂDINIŢA CU PROGRAM NORMAL GHINDA",51,"MUNICIPIUL BISTRIŢA",32394,1,PART,PRCNCT,PRSD,PRSD_SV,"2025-05-18 22:45:23",667,328,309,19,0,326,2,750,422,203,123
6,BISTRIŢA-NĂSĂUD,"ŞCOALA PRIMARĂ SĂRATA",52,"MUNICIPIUL BISTRIŢA",32394,1,PART,PRCNCT,PRSD,PRSD_SV,"2025-05-18 22:59:58",1039,509,478,30,1,502,7,1150,641,285,217
6,BISTRIŢA-NĂSĂUD,"CASA DE CULTURĂ SIGMIR",53,"MUNICIPIUL BISTRIŢA",32394,1,PART,PRCNCT,PRSD,PRSD_SV,"2025-05-18 22:24:31",996,633,589,41,3,631,2,1100,467,282,349
6,BISTRIŢA-NĂSĂUD,"GRĂDINIȚA CU PROGRAM NORMAL ”DIMITRIE COJOCARU” SLĂTINIŢA",54,"MUNICIPIUL BISTRIŢA",32394,1,PART,PRCNCT,PRSD,PRSD_SV,"2025-05-18 21:44:04",633,290,275,15,0,289,1,700,410,224,65
6,BISTRIŢA-NĂSĂUD,"GRĂDINIŢA CU PROGRAM NORMAL UNIREA",55,"MUNICIPIUL BISTRIŢA",32394,1,PART,PRCNCT,PRSD,PRSD_SV,"2025-05-18 22:30:31",1877,1172,1050,122,0,1155,17,2000,828,444,711
6,BISTRIŢA-NĂSĂUD,"GRĂDINIŢA CU PROGRAM NORMAL UNIREA",56,"MUNICIPIUL BISTRIŢA",32394,1,PART,PRCNCT,PRSD,PRSD_SV,"2025-05-18 22:14:50",1896,1145,1063,81,1,1136,9,2150,1005,409,727
6,BISTRIŢA-NĂSĂUD,"ŞCOALA GIMNAZIALĂ NR. 7 VIIŞOARA",57,"MUNICIPIUL BISTRIŢA",32394,1,PART,PRCNCT,PRSD,PRSD_SV,"2025-05-18 22:08:47",1607,826,753,65,8,819,7,1750,924,441,378
6,BISTRIŢA-NĂSĂUD,"ŞCOALA GIMNAZIALĂ NR.7 VIIŞOARA",58,"MUNICIPIUL BISTRIŢA",32394,1,PART,PRCNCT,PRSD,PRSD_SV,"2025-05-18 22:16:31",1267,734,700,34,0,721,13,1400,666,317,404
6,BISTRIŢA-NĂSĂUD,"BIBLIOTECA ORĂȘENEASCĂ BECLEAN „LIVIU REBREANU”",59,"ORAŞ BECLEAN",32483,1,PART,PRCNCT,PRSD,PRSD_SV,"2025-05-18 22:18:24",1545,866,749,68,49,838,28,1698,832,295,543
6,BISTRIŢA-NĂSĂUD,"PRIMĂRIA ORAȘULUI BECLEAN",60,"ORAŞ BECLEAN",32483,1,PART,PRCNCT,PRSD,PRSD_SV,"2025-05-18 22:03:47",1667,933,779,110,44,916,17,1800,867,361,555
6,BISTRIŢA-NĂSĂUD,"CLUBUL COPIILOR BECLEAN",61,"ORAŞ BECLEAN",32483,1,PART,PRCNCT,PRSD,PRSD_SV,"2025-05-18 21:38:55",708,347,324,23,0,343,4,750,403,136,207
6,BISTRIŢA-NĂSĂUD,"CLUBUL COPIILOR BECLEAN",62,"ORAŞ BECLEAN",32483,1,PART,PRCNCT,PRSD,PRSD_SV,"2025-05-18 21:59:02",770,371,341,30,0,366,5,850,479,135,231
6,BISTRIŢA-NĂSĂUD,"ŞCOALA GIMNAZIALĂ ”GRIGORE SILAŞI”",63,"ORAŞ BECLEAN",32483,1,PART,PRCNCT,PRSD,PRSD_SV,"2025-05-18 22:04:03",1505,876,720,110,46,870,6,1650,774,366,504
6,BISTRIŢA-NĂSĂUD,"LICEUL TEHNOLOGIC AGRICOL BECLEAN",64,"ORAŞ BECLEAN",32483,1,PART,PRCNCT,PRSD,PRSD_SV,"2025-05-18 21:43:02",1518,773,701,69,3,767,6,1646,873,311,456
6,BISTRIŢA-NĂSĂUD,"ŞCOALA GENERALĂ BECLENUŢ",65,"ORAŞ BECLEAN",32483,1,PART,PRCNCT,PRSD,PRSD_SV,"2025-05-18 21:49:27",319,194,164,28,2,194,0,350,156,81,113
6,BISTRIŢA-NĂSĂUD,"GRĂDINIȚA CU PROGRAM NORMAL VALEA VIILOR",66,"ORAŞ BECLEAN",32483,1,PART,PRCNCT,PRSD,PRSD_SV,"2025-05-18 21:14:31",346,199,176,23,0,199,0,400,201,117,82
6,BISTRIŢA-NĂSĂUD,"GRĂDINIȚA CU PROGRAM NORMAL COLDĂU",67,"ORAŞ BECLEAN",32483,1,PART,PRCNCT,PRSD,PRSD_SV,"2025-05-18 21:46:05",655,378,317,61,0,374,4,700,322,153,221
6,BISTRIŢA-NĂSĂUD,"ȘCOALA PRIMARĂ FIGA",68,"ORAŞ BECLEAN",32483,1,PART,PRCNCT,PRSD,PRSD_SV,"2025-05-18 22:15:17",445,243,211,30,2,243,0,500,257,131,112
6,BISTRIŢA-NĂSĂUD,"GRĂDINIȚA CU PROGRAM NORMAL RUSU DE JOS",69,"ORAŞ BECLEAN",32483,1,PART,PRCNCT,PRSD,PRSD_SV,"2025-05-18 21:26:10",278,144,130,14,0,141,3,350,206,95,46
6,BISTRIŢA-NĂSĂUD,"CASA DE CULTURĂ ”LIVIU REBREANU”",70,"ORAŞ NĂSĂUD",32544,1,PART,PRCNCT,PRSD,PRSD_SV,"2025-05-18 22:15:39",1347,760,651,107,2,755,5,1450,690,314,441
6,BISTRIŢA-NĂSĂUD,"ŞCOALA GIMNAZIALĂ ”MIHAI EMINESCU”",71,"ORAŞ NĂSĂUD",32544,1,PART,PRCNCT,PRSD,PRSD_SV,"2025-05-18 22:25:04",1500,798,691,78,29,789,9,1600,802,343,446
6,BISTRIŢA-NĂSĂUD,"LICEUL TEHNOLOGIC ECONOMIC NĂSĂUD",72,"ORAŞ NĂSĂUD",32544,1,PART,PRCNCT,PRSD,PRSD_SV,"2025-05-18 23:00:00",1078,496,453,42,1,492,4,1150,654,231,261
6,BISTRIŢA-NĂSĂUD,"LICEUL TEHNOLOGIC SILVIC ”TRANSILVANIA” NĂSĂUD",73,"ORAŞ NĂSĂUD",32544,1,PART,PRCNCT,PRSD,PRSD_SV,"2025-05-18 21:58:58",1261,589,512,76,1,584,5,1369,780,242,342
6,BISTRIŢA-NĂSĂUD,"AUTOGARA CĂLĂTORI",74,"ORAŞ NĂSĂUD",32544,1,PART,PRCNCT,PRSD,PRSD_SV,"2025-05-18 22:34:59",1650,785,693,92,0,772,13,1800,1015,363,409
6,BISTRIŢA-NĂSĂUD,"ŞCOALA GIMNAZIALĂ ” VALEA SPINULUI”",75,"ORAŞ NĂSĂUD",32544,1,PART,PRCNCT,PRSD,PRSD_SV,"2025-05-18 21:45:10",1045,549,514,35,0,542,7,1150,601,354,188
6,BISTRIŢA-NĂSĂUD,"CĂMINUL CULTURAL LIVIU REBREANU",76,"ORAŞ NĂSĂUD",32544,1,PART,PRCNCT,PRSD,PRSD_SV,"2025-05-18 21:43:53",560,271,252,19,0,268,3,650,379,127,141
6,BISTRIŢA-NĂSĂUD,"CĂMINUL CULTURAL LUŞCA",77,"ORAŞ NĂSĂUD",32544,1,PART,PRCNCT,PRSD,PRSD_SV,"2025-05-18 21:24:53",548,290,255,35,0,289,1,650,360,116,173
6,BISTRIŢA-NĂSĂUD,"ȘCOALA GIMNAZIALĂ ”ARTEMIU PUBLIU ALEXI” SÎNGEORZ-BĂI",78,"ORAŞ SÂNGEORZ-BĂI",32599,1,PART,PRCNCT,PRSD,PRSD_SV,"2025-05-18 21:44:00",1331,593,554,38,1,583,10,1450,857,304,279
6,BISTRIŢA-NĂSĂUD,"ŞCOALA GIMNAZIALĂ ”ARTEMIU PUBLIU ALEXI” SÎNGEORZ-BĂI",79,"ORAŞ SÂNGEORZ-BĂI",32599,1,PART,PRCNCT,PRSD,PRSD_SV,"2025-05-18 21:43:19",1457,673,653,20,0,668,5,1550,877,427,241
6,BISTRIŢA-NĂSĂUD,"GRĂDINIȚA CU PROGRAM NORMAL NR. 4 SÂNGEORZ-BĂI",80,"ORAŞ SÂNGEORZ-BĂI",32599,1,PART,PRCNCT,PRSD,PRSD_SV,"2025-05-18 21:55:20",1342,547,527,20,0,545,2,1450,903,401,144
6,BISTRIŢA-NĂSĂUD,"GRĂDINIȚA CU PROGRAM NORMAL NR. 2",81,"ORAŞ SÂNGEORZ-BĂI",32599,1,PART,PRCNCT,PRSD,PRSD_SV,"2025-05-18 21:47:22",1337,665,634,31,0,661,4,1450,785,413,248
6,BISTRIŢA-NĂSĂUD,"LICEUL TEORETIC ”SOLOMON HALIȚĂ”",82,"ORAŞ SÂNGEORZ-BĂI",32599,1,PART,PRCNCT,PRSD,PRSD_SV,"2025-05-18 21:55:16",1303,538,500,37,1,536,2,1450,912,327,209
6,BISTRIŢA-NĂSĂUD,"CENTRUL MISIONAR DE TINERET ”IOAN BUNEA” SÂNGEORZ-BĂI",83,"ORAŞ SÂNGEORZ-BĂI",32599,1,PART,PRCNCT,PRSD,PRSD_SV,"2025-05-18 21:46:33",1521,701,656,45,0,698,3,1650,949,489,209
6,BISTRIŢA-NĂSĂUD,"ŞCOALA GIMNAZIALĂ CORMAIA",84,"ORAŞ SÂNGEORZ-BĂI",32599,1,PART,PRCNCT,PRSD,PRSD_SV,"2025-05-18 21:24:28",795,378,330,48,0,376,2,900,522,300,76
6,BISTRIŢA-NĂSĂUD,"CĂMINUL CULTURAL BISTRIŢA BÎRGĂULUI",85,"BISTRIŢA BÂRGĂULUI",32633,1,PART,PRCNCT,PRSD,PRSD_SV,"2025-05-18 23:02:19",1377,758,696,61,1,748,10,1450,692,523,225
6,BISTRIŢA-NĂSĂUD,"ŞCOALA GIMNAZIALĂ NR. 2 BISTRIŢA BÎRGĂULUI",86,"BISTRIŢA BÂRGĂULUI",32633,1,PART,PRCNCT,PRSD,PRSD_SV,"2025-05-18 21:54:53",960,478,414,64,0,470,8,1050,572,302,168
6,BISTRIŢA-NĂSĂUD,"SALA DE NUNŢI BISTRIŢA BÎRGĂULUI",87,"BISTRIŢA BÂRGĂULUI",32633,1,PART,PRCNCT,PRSD,PRSD_SV,"2025-05-18 21:58:55",1050,461,428,33,0,455,6,1150,689,339,116
6,BISTRIŢA-NĂSĂUD,"CĂMINUL CULTURAL COLIBIȚA",88,"BISTRIŢA BÂRGĂULUI",32633,1,PART,PRCNCT,PRSD,PRSD_SV,"2025-05-18 21:41:05",244,199,103,96,0,198,1,300,101,101,97
6,BISTRIŢA-NĂSĂUD,"PRIMĂRIA COMUNEI BRANIŞTEA",89,BRANIŞTEA,32660,1,PART,PRCNCT,PRSD,PRSD_SV,"2025-05-18 21:44:05",922,518,429,86,3,511,7,1000,482,193,318
6,BISTRIŢA-NĂSĂUD,"CĂMINUL CULTURAL CIREŞOAIA",90,BRANIŞTEA,32660,1,PART,PRCNCT,PRSD,PRSD_SV,"2025-05-18 22:04:15",1080,616,551,55,10,613,3,1150,534,39,574
6,BISTRIŢA-NĂSĂUD,"CĂMINUL CULTURAL MĂLUŢ",91,BRANIŞTEA,32660,1,PART,PRCNCT,PRSD,PRSD_SV,"2025-05-18 21:52:14",455,278,246,31,1,277,1,500,222,110,167
6,BISTRIŢA-NĂSĂUD,"PRIMĂRIA COMUNEI BUDACU DE JOS",92,"BUDACU DE JOS",32704,1,PART,PRCNCT,PRSD,PRSD_SV,"2025-05-18 21:54:39",785,400,337,48,15,395,5,900,500,287,108
6,BISTRIŢA-NĂSĂUD,"ŞCOALA GIMNAZIALĂ BUDUŞ",93,"BUDACU DE JOS",32704,1,PART,PRCNCT,PRSD,PRSD_SV,"2025-05-18 21:48:15",445,249,207,35,7,249,0,500,251,129,120
6,BISTRIŢA-NĂSĂUD,"CENTRUL LOCAL DE INFORMARE TURISTICĂ",94,"BUDACU DE JOS",32704,1,PART,PRCNCT,PRSD,PRSD_SV,"2025-05-18 21:35:09",851,492,420,71,1,485,7,950,458,241,244
6,BISTRIŢA-NĂSĂUD,"ŞCOALA GIMNAZIALĂ MONARIU",95,"BUDACU DE JOS",32704,1,PART,PRCNCT,PRSD,PRSD_SV,"2025-05-18 21:30:08",424,266,227,39,0,263,3,450,184,206,57
6,BISTRIŢA-NĂSĂUD,"ŞCOALA GIMNAZIALĂ SIMIONEŞTI",96,"BUDACU DE JOS",32704,1,PART,PRCNCT,PRSD,PRSD_SV,"2025-05-18 21:40:40",181,119,96,23,0,117,2,200,81,68,49
6,BISTRIŢA-NĂSĂUD,"ŞCOALA GIMNAZIALĂ BUDEŞTI",97,BUDEŞTI,32768,1,PART,PRCNCT,PRSD,PRSD_SV,"2025-05-18 23:12:45",427,242,190,52,0,239,3,500,258,127,112
6,BISTRIŢA-NĂSĂUD,"ŞCOALA PRIMARĂ BUDEŞTI-FÎNAŢE",98,BUDEŞTI,32768,1,PART,PRCNCT,PRSD,PRSD_SV,"2025-05-18 21:52:21",225,148,117,30,1,146,2,250,102,71,75
6,BISTRIŢA-NĂSĂUD,"ŞCOALA PRIMARĂ ŢAGU",99,BUDEŞTI,32768,1,PART,PRCNCT,PRSD,PRSD_SV,"2025-05-18 22:22:56",480,244,197,44,3,240,4,550,306,158,82
6,BISTRIŢA-NĂSĂUD,"CĂMINUL CULTURAL ŢĂGŞORU",100,BUDEŞTI,32768,1,PART,PRCNCT,PRSD,PRSD_SV,"2025-05-18 21:46:50",198,137,90,47,0,136,1,200,63,74,62
6,BISTRIŢA-NĂSĂUD,"PRIMĂRIA COMUNEI CĂIANU MIC",101,"CĂIANU MIC",32811,1,PART,PRCNCT,PRSD,PRSD_SV,"2025-05-18 21:37:04",1195,570,497,33,40,567,3,1300,730,369,198
6,BISTRIŢA-NĂSĂUD,"CĂMIN CULTURAL CĂIANU MARE",102,"CĂIANU MIC",32811,1,PART,PRCNCT,PRSD,PRSD_SV,"2025-05-18 21:43:12",432,243,200,37,6,240,3,500,257,137,103
6,BISTRIŢA-NĂSĂUD,"CĂMINUL CULTURAL CICEU-POIENI",103,"CĂIANU MIC",32811,1,PART,PRCNCT,PRSD,PRSD_SV,"2025-05-18 21:47:50",512,251,202,22,27,250,1,550,299,185,65
6,BISTRIŢA-NĂSĂUD,"ŞCOALA GIMNAZIALĂ DOBRIC",104,"CĂIANU MIC",32811,1,PART,PRCNCT,PRSD,PRSD_SV,"2025-05-18 21:30:11",1178,485,415,21,49,478,7,1270,785,408,70
6,BISTRIŢA-NĂSĂUD,"BIBLIOTECA COMUNALĂ SATU NOU",105,CETATE,32884,1,PART,PRCNCT,PRSD,PRSD_SV,"2025-05-18 21:49:20",613,328,293,34,1,326,2,650,322,132,194
6,BISTRIŢA-NĂSĂUD,"CĂMINUL CULTURAL ORHEIU BISTRIŢEI",106,CETATE,32884,1,PART,PRCNCT,PRSD,PRSD_SV,"2025-05-18 21:54:42",732,383,327,56,0,381,2,800,417,246,135
6,BISTRIŢA-NĂSĂUD,"ŞCOALA CLASELE I - IV PETRIŞ",107,CETATE,32884,1,PART,PRCNCT,PRSD,PRSD_SV,"2025-05-18 22:36:22",1043,527,486,41,0,525,2,1150,623,389,136
6,BISTRIŢA-NĂSĂUD,"PRIMĂRIA COMUNEI CHIOCHIŞ",108,CHIOCHIŞ,33015,1,PART,PRCNCT,PRSD,PRSD_SV,"2025-05-18 21:23:46",282,160,134,26,0,160,0,350,190,89,71
6,BISTRIŢA-NĂSĂUD,"ŞCOALA PRIMARĂ APATIU",109,CHIOCHIŞ,33015,1,PART,PRCNCT,PRSD,PRSD_SV,"2025-05-18 21:15:07",223,129,106,23,0,129,0,250,121,62,67
6,BISTRIŢA-NĂSĂUD,"GRĂDINIȚA BOZIEŞ",110,CHIOCHIŞ,33015,1,PART,PRCNCT,PRSD,PRSD_SV,"2025-05-18 21:39:31",501,267,232,32,3,266,1,550,283,118,148
6,BISTRIŢA-NĂSĂUD,"CĂMINUL CULTURAL BUZA-CĂTUN",111,CHIOCHIŞ,33015,1,PART,PRCNCT,PRSD,PRSD_SV,"2025-05-18 21:10:45",91,61,42,19,0,61,0,100,39,30,31
6,BISTRIŢA-NĂSĂUD,"ŞCOALA PRIMARĂ CHEŢIU",112,CHIOCHIŞ,33015,1,PART,PRCNCT,PRSD,PRSD_SV,"2025-05-18 21:31:42",262,132,112,16,4,130,2,300,168,66,64
6,BISTRIŢA-NĂSĂUD,"CĂMINUL CULTURAL JIMBOR",113,CHIOCHIŞ,33015,1,PART,PRCNCT,PRSD,PRSD_SV,"2025-05-18 21:18:36",337,193,161,32,0,192,1,400,207,110,82
6,BISTRIŢA-NĂSĂUD,"ŞCOALA PRIMARĂ MANIC",114,CHIOCHIŞ,33015,1,PART,PRCNCT,PRSD,PRSD_SV,"2025-05-18 21:20:25",174,94,75,19,0,94,0,200,106,59,35
6,BISTRIŢA-NĂSĂUD,"ŞCOALA PRIMARĂ SÎNNICOARĂ",115,CHIOCHIŞ,33015,1,PART,PRCNCT,PRSD,PRSD_SV,"2025-05-18 21:16:03",80,51,28,23,0,51,0,100,49,13,38
6,BISTRIŢA-NĂSĂUD,"ŞCOALA PRIMARĂ STRUGURENI",116,CHIOCHIŞ,33015,1,PART,PRCNCT,PRSD,PRSD_SV,"2025-05-18 21:26:49",156,102,79,23,0,101,1,200,98,22,79
6,BISTRIŢA-NĂSĂUD,"ŞCOALA PRIMARĂ ŢENTEA",117,CHIOCHIŞ,33015,1,PART,PRCNCT,PRSD,PRSD_SV,"2025-05-18 21:13:58",79,62,38,24,0,62,0,100,38,26,36
6,BISTRIŢA-NĂSĂUD,"ŞCOALA GIMNAZIALĂ ”LIVIU REBREANU” CHIUZA",118,CHIUZA,33122,1,PART,PRCNCT,PRSD,PRSD_SV,"2025-05-18 21:41:15",733,369,318,48,3,367,2,800,431,190,177
6,BISTRIŢA-NĂSĂUD,"CĂMINUL CULTURAL MIREŞ",119,CHIUZA,33122,1,PART,PRCNCT,PRSD,PRSD_SV,"2025-05-18 21:08:21",113,66,58,8,0,66,0,150,84,48,18
6,BISTRIŢA-NĂSĂUD,"ŞCOALA PRIMARĂ PIATRA",120,CHIUZA,33122,1,PART,PRCNCT,PRSD,PRSD_SV,"2025-05-18 21:14:11",402,213,174,37,2,209,4,450,237,101,108
6,BISTRIŢA-NĂSĂUD,"CĂMINUL CULTURAL SĂSARM",121,CHIUZA,33122,1,PART,PRCNCT,PRSD,PRSD_SV,"2025-05-18 21:39:55",572,313,264,48,1,310,3,650,337,160,150
6,BISTRIŢA-NĂSĂUD,"ŞCOALA GIMNAZIALĂ CICEU-GIURGEŞTI",122,CICEU-GIURGEŞTI,32955,1,PART,PRCNCT,PRSD,PRSD_SV,"2025-05-18 21:48:24",703,369,307,58,4,365,4,750,381,192,173
6,BISTRIŢA-NĂSĂUD,"CĂMINUL CULTURAL DUMBRĂVENI",123,CICEU-GIURGEŞTI,32955,1,PART,PRCNCT,PRSD,PRSD_SV,"2025-05-18 22:07:58",448,260,197,63,0,259,1,500,240,117,142
6,BISTRIŢA-NĂSĂUD,"CĂMINUL CULTURAL CICEU-MIHĂIEŞTI",124,CICEU-MIHĂIEŞTI,179953,1,PART,PRCNCT,PRSD,PRSD_SV,"2025-05-18 22:08:02",733,322,281,41,0,318,4,800,478,178,140
6,BISTRIŢA-NĂSĂUD,"ŞCOALA GENERALĂ CICEU-CORABIA",125,CICEU-MIHĂIEŞTI,179953,1,PART,PRCNCT,PRSD,PRSD_SV,"2025-05-18 21:39:59",110,86,53,32,1,84,2,150,64,39,45
6,BISTRIŢA-NĂSĂUD,"ŞCOALA GENERALĂ LELEŞTI",126,CICEU-MIHĂIEŞTI,179953,1,PART,PRCNCT,PRSD,PRSD_SV,"2025-05-18 21:41:31",107,94,40,54,0,94,0,150,56,45,49
6,BISTRIŢA-NĂSĂUD,"ŞCOALA GIMNAZIALĂ „GEORGE COŞBUC”",127,COŞBUC,33177,1,PART,PRCNCT,PRSD,PRSD_SV,"2025-05-18 22:24:16",1554,676,615,59,2,673,3,1700,1024,400,273
6,BISTRIŢA-NĂSĂUD,"ŞCOALA GENERALĂ DUMITRA",128,DUMITRA,33202,1,PART,PRCNCT,PRSD,PRSD_SV,"2025-05-18 21:45:35",1140,490,465,24,1,489,1,1250,760,313,176
6,BISTRIŢA-NĂSĂUD,"ŞCOALA GENERALĂ DUMITRA",129,DUMITRA,33202,1,PART,PRCNCT,PRSD,PRSD_SV,"2025-05-18 21:38:40",1455,652,616,36,0,650,2,1550,898,472,178
6,BISTRIŢA-NĂSĂUD,"ŞCOALA GENERALĂ CEPARI",130,DUMITRA,33202,1,PART,PRCNCT,PRSD,PRSD_SV,"2025-05-18 21:34:18",964,403,376,26,1,396,7,1050,647,292,104
6,BISTRIŢA-NĂSĂUD,"ŞCOALA GENERALĂ TĂRPIU",131,DUMITRA,33202,1,PART,PRCNCT,PRSD,PRSD_SV,"2025-05-18 22:04:36",815,315,277,38,0,312,3,900,585,244,68
6,BISTRIŢA-NĂSĂUD,"ȘCOALA GIMNAZIALĂ DUMITRIȚA",132,DUMITRIŢA,179686,1,PART,PRCNCT,PRSD,PRSD_SV,"2025-05-18 21:49:12",1064,508,467,39,2,506,2,1150,642,372,134
6,BISTRIŢA-NĂSĂUD,"ŞCOALA GIMNAZIALĂ BUDACU DE SUS",133,DUMITRIŢA,179686,1,PART,PRCNCT,PRSD,PRSD_SV,"2025-05-18 22:43:58",1550,652,615,37,0,648,4,1700,1048,527,121
6,BISTRIŢA-NĂSĂUD,"PRIMĂRIA COMUNEI FELDRU",134,FELDRU,33248,1,PART,PRCNCT,PRSD,PRSD_SV,"2025-05-18 22:15:25",1466,550,517,33,0,546,4,1550,1000,342,204
6,BISTRIŢA-NĂSĂUD,"LICEUL TEHNOLOGIC FELDRU",135,FELDRU,33248,1,PART,PRCNCT,PRSD,PRSD_SV,"2025-05-18 21:46:22",1349,498,462,34,2,492,6,1450,952,327,165
6,BISTRIŢA-NĂSĂUD,"CĂMINUL CULTURAL FELDRU",136,FELDRU,33248,1,PART,PRCNCT,PRSD,PRSD_SV,"2025-05-18 21:42:05",1317,512,473,39,0,510,2,1450,938,309,201
6,BISTRIŢA-NĂSĂUD,"ŞCOALA GENERALĂ PODEREE",137,FELDRU,33248,1,PART,PRCNCT,PRSD,PRSD_SV,"2025-05-18 21:28:30",409,147,134,13,0,146,1,450,303,97,49
6,BISTRIŢA-NĂSĂUD,"ȘCOALA GENERALĂ CLASELE I - IV NEPOS",138,FELDRU,33248,2,PART,PRCNCT,PRSD,PRSD_SV,"2025-05-19 00:09:10",1555,613,573,40,0,612,1,1674,1061,394,218
6,BISTRIŢA-NĂSĂUD,"CĂMINUL CULTURAL GALAŢII BISTRIŢEI",139,"GALAŢII BISTRIŢEI",33275,1,PART,PRCNCT,PRSD,PRSD_SV,"2025-05-18 21:26:18",531,296,240,56,0,291,5,650,354,123,168
6,BISTRIŢA-NĂSĂUD,"CĂMINUL CULTURAL ALBEŞTII BISTRIŢEI",140,"GALAŢII BISTRIŢEI",33275,1,PART,PRCNCT,PRSD,PRSD_SV,"2025-05-18 21:16:38",143,105,70,35,0,104,1,150,45,55,49
6,BISTRIŢA-NĂSĂUD,"ŞCOALA GENERALĂ DIPŞA CLASELE I - IV",141,"GALAŢII BISTRIŢEI",33275,1,PART,PRCNCT,PRSD,PRSD_SV,"2025-05-18 21:35:32",671,312,273,39,0,312,0,700,388,165,147
6,BISTRIŢA-NĂSĂUD,"ŞCOALA GENERALĂ HERINA CLASELE I - IV",142,"GALAŢII BISTRIŢEI",33275,1,PART,PRCNCT,PRSD,PRSD_SV,"2025-05-18 21:23:33",438,223,189,34,0,223,0,500,277,139,84
6,BISTRIŢA-NĂSĂUD,"CĂMINUL CULTURAL TONCIU",143,"GALAŢII BISTRIŢEI",33275,1,PART,PRCNCT,PRSD,PRSD_SV,"2025-05-18 21:25:29",198,143,96,43,4,140,3,250,107,20,120
6,BISTRIŢA-NĂSĂUD,"PRIMĂRIA COMUNEI ILVA MARE",144,"ILVA MARE",33337,1,PART,PRCNCT,PRSD,PRSD_SV,"2025-05-18 22:09:53",1030,449,417,32,0,443,6,1150,701,308,135
6,BISTRIŢA-NĂSĂUD,"PRIMĂRIA COMUNEI ILVA MARE",145,"ILVA MARE",33337,1,PART,PRCNCT,PRSD,PRSD_SV,"2025-05-18 22:07:42",871,359,336,23,0,355,4,950,591,262,93
6,BISTRIŢA-NĂSĂUD,"ŞCOALA GIMNAZIALĂ NR. 2",146,"ILVA MICĂ",33364,1,PART,PRCNCT,PRSD,PRSD_SV,"2025-05-18 21:32:57",1241,534,486,42,6,531,3,1350,816,272,259
6,BISTRIŢA-NĂSĂUD,"ŞCOALA GIMNAZIALĂ ”DEMIAN NECHITI”",147,"ILVA MICĂ",33364,1,PART,PRCNCT,PRSD,PRSD_SV,"2025-05-18 21:32:19",1390,609,573,31,5,606,3,1500,891,349,257
6,BISTRIŢA-NĂSĂUD,"CĂMIN CULTURAL JOSENII BÂRGĂULUI",148,"JOSENII BÂRGĂULUI",33382,1,PART,PRCNCT,PRSD,PRSD_SV,"2025-05-18 21:39:50",814,449,369,80,0,445,4,884,435,262,183
6,BISTRIŢA-NĂSĂUD,"ȘCOALA GIMNAZIALĂ JOSENII BÎRGĂULUI",149,"JOSENII BÂRGĂULUI",33382,1,PART,PRCNCT,PRSD,PRSD_SV,"2025-05-18 22:53:32",862,433,409,23,1,428,5,950,517,319,109
6,BISTRIŢA-NĂSĂUD,"CENTRU CULTURAL MIJLOCENII BÂRGĂULUI",150,"JOSENII BÂRGĂULUI",33382,1,PART,PRCNCT,PRSD,PRSD_SV,"2025-05-18 22:29:46",1350,644,584,59,1,639,5,1500,856,413,226
6,BISTRIŢA-NĂSĂUD,"CĂMINUL CULTURAL RUSU BÎRGĂULUI",151,"JOSENII BÂRGĂULUI",33382,1,PART,PRCNCT,PRSD,PRSD_SV,"2025-05-18 21:46:00",767,397,359,37,1,389,8,850,453,210,179
6,BISTRIŢA-NĂSĂUD,"ŞCOALA PRIMARĂ STRÎMBA",152,"JOSENII BÂRGĂULUI",33382,1,PART,PRCNCT,PRSD,PRSD_SV,"2025-05-18 21:33:44",394,171,151,20,0,171,0,450,279,145,26
6,BISTRIŢA-NĂSĂUD,"PRIMĂRIA COMUNEI LECHINȚA",153,LECHINŢA,33435,1,PART,PRCNCT,PRSD,PRSD_SV,"2025-05-18 21:47:19",1162,509,440,66,3,508,1,1250,741,261,247
6,BISTRIŢA-NĂSĂUD,"LICEUL TEHNOLOGIC ŞCOALA GENERALĂ",154,LECHINŢA,33435,1,PART,PRCNCT,PRSD,PRSD_SV,"2025-05-18 22:00:44",1191,517,479,37,1,510,7,1250,733,288,222
6,BISTRIŢA-NĂSĂUD,"CĂMINUL CULTURAL CHIRALEŞ",155,LECHINŢA,33435,2,PART,PRCNCT,PRSD,PRSD_SV,"2025-05-19 00:12:26",398,224,169,55,0,222,2,450,226,116,106
6,BISTRIŢA-NĂSĂUD,"CĂMINUL CULTURAL SÎNGEORZU- NOU",156,LECHINŢA,33435,1,PART,PRCNCT,PRSD,PRSD_SV,"2025-05-18 22:14:20",812,336,293,43,0,336,0,900,564,213,123
6,BISTRIŢA-NĂSĂUD,"CĂMINUL CULTURAL SÎNIACOB",157,LECHINŢA,33435,1,PART,PRCNCT,PRSD,PRSD_SV,"2025-05-18 21:29:48",184,124,97,24,3,124,0,200,76,76,48
6,BISTRIŢA-NĂSĂUD,"ŞCOALA PRIMARĂ ŢIGĂU",158,LECHINŢA,33435,1,PART,PRCNCT,PRSD,PRSD_SV,"2025-05-18 22:06:04",349,208,183,22,3,205,3,400,192,49,156
6,BISTRIŢA-NĂSĂUD,"GRĂDINIŢA CU PROGRAM NORMAL",159,LECHINŢA,33435,2,PART,PRCNCT,PRSD,PRSD_SV,"2025-05-18 23:37:29",723,307,261,42,4,301,6,800,493,162,139
6,BISTRIŢA-NĂSĂUD,"ȘCOALA GIMNAZIALĂ NR. 1 - LEȘU",160,LEŞU,33514,1,PART,PRCNCT,PRSD,PRSD_SV,"2025-05-18 21:47:51",1327,535,495,33,7,531,4,1450,915,388,143
6,BISTRIŢA-NĂSĂUD,"ŞCOALA GENERALĂ NR. 2 LUNCA LEŞULUI",161,LEŞU,33514,1,PART,PRCNCT,PRSD,PRSD_SV,"2025-05-18 21:29:01",938,391,371,20,0,388,3,1000,609,310,78
6,BISTRIŢA-NĂSĂUD,"CĂMINUL CULTURAL LIVEZILE",162,LIVEZILE,33541,1,PART,PRCNCT,PRSD,PRSD_SV,"2025-05-18 22:17:45",1202,537,489,47,1,537,0,1300,763,351,186
6,BISTRIŢA-NĂSĂUD,"ŞCOALA GIMNAZIALĂ LIVEZILE",163,LIVEZILE,33541,1,PART,PRCNCT,PRSD,PRSD_SV,"2025-05-18 21:46:52",1273,562,487,74,1,558,4,1400,838,340,218
6,BISTRIŢA-NĂSĂUD,"ŞCOALA PRIMARĂ CUŞMA",164,LIVEZILE,33541,1,PART,PRCNCT,PRSD,PRSD_SV,"2025-05-18 21:36:12",528,230,201,27,2,229,1,600,370,145,84
6,BISTRIŢA-NĂSĂUD,"ŞCOALA GIMNAZIALĂ DOROLEA",165,LIVEZILE,33541,1,PART,PRCNCT,PRSD,PRSD_SV,"2025-05-18 21:46:45",567,242,210,32,0,240,2,600,358,166,74
6,BISTRIŢA-NĂSĂUD,"ŞCOALA PRIMARĂ DUMBRAVA",166,LIVEZILE,33541,1,PART,PRCNCT,PRSD,PRSD_SV,"2025-05-18 21:27:50",375,200,180,20,0,199,1,450,250,161,38
6,BISTRIŢA-NĂSĂUD,"ŞCOALA PRIMARĂ VALEA POENII",167,LIVEZILE,33541,1,PART,PRCNCT,PRSD,PRSD_SV,"2025-05-18 21:43:03",132,67,55,12,0,67,0,150,83,53,14
6,BISTRIŢA-NĂSĂUD,"CĂMINUL CULTURAL LUNCA ILVEI",168,"LUNCA ILVEI",33603,1,PART,PRCNCT,PRSD,PRSD_SV,"2025-05-18 21:51:40",1517,649,627,22,0,644,5,1650,1001,408,236
6,BISTRIŢA-NĂSĂUD,"CĂMINUL CULTURAL LUNCA ILVEI",169,"LUNCA ILVEI",33603,1,PART,PRCNCT,PRSD,PRSD_SV,"2025-05-18 22:07:02",1168,539,493,46,0,535,4,1300,761,355,180
6,BISTRIŢA-NĂSĂUD,"LICEUL TEHNOLOGIC MAIERU",170,MAIERU,33621,1,PART,PRCNCT,PRSD,PRSD_SV,"2025-05-18 21:37:32",1011,491,460,30,1,490,1,1100,609,318,172
6,BISTRIŢA-NĂSĂUD,"LICEUL TEHNOLOGIC MAIERU",171,MAIERU,33621,1,PART,PRCNCT,PRSD,PRSD_SV,"2025-05-18 21:48:00",1277,643,613,30,0,640,3,1400,757,430,210
6,BISTRIŢA-NĂSĂUD,"LICEUL TEHNOLOGIC MAIERU",172,MAIERU,33621,1,PART,PRCNCT,PRSD,PRSD_SV,"2025-05-18 21:54:50",955,412,391,21,0,411,1,1050,638,267,144
6,BISTRIŢA-NĂSĂUD,"CENTRUL CULTURAL CATEHETIC SF. ARHIDIACON STEFAN",173,MAIERU,33621,1,PART,PRCNCT,PRSD,PRSD_SV,"2025-05-18 21:36:18",1560,766,726,40,0,762,4,1700,934,456,306
6,BISTRIŢA-NĂSĂUD,"ŞCOALA GIMNAZIALĂ ANIEŞ",174,MAIERU,33621,1,PART,PRCNCT,PRSD,PRSD_SV,"2025-05-18 22:02:23",1511,718,691,27,0,715,3,1650,932,459,256
6,BISTRIŢA-NĂSĂUD,"ŞCOALA GIMNAZIALĂ MATEI",175,MATEI,33658,1,PART,PRCNCT,PRSD,PRSD_SV,"2025-05-18 21:50:22",572,362,325,35,2,361,1,600,238,59,302
6,BISTRIŢA-NĂSĂUD,"CĂMINUL CULTURAL BIDIU",176,MATEI,33658,1,PART,PRCNCT,PRSD,PRSD_SV,"2025-05-18 21:27:23",129,68,48,20,0,68,0,200,132,25,43
6,BISTRIŢA-NĂSĂUD,"ŞCOALA GIMNAZIALĂ CORVINEŞTI",177,MATEI,33658,1,PART,PRCNCT,PRSD,PRSD_SV,"2025-05-18 21:41:21",496,261,209,52,0,260,1,550,289,140,120
6,BISTRIŢA-NĂSĂUD,"GRĂDINIŢA ENCIU",178,MATEI,33658,1,PART,PRCNCT,PRSD,PRSD_SV,"2025-05-18 21:20:02",132,72,47,25,0,71,1,150,78,48,23
6,BISTRIŢA-NĂSĂUD,"ŞCOALA PRIMARĂ FÎNTÎNELE",179,MATEI,33658,1,PART,PRCNCT,PRSD,PRSD_SV,"2025-05-18 21:47:10",428,249,206,43,0,249,0,450,201,67,182
6,BISTRIŢA-NĂSĂUD,"ŞCOALA PRIMARĂ MORUŢ",180,MATEI,33658,1,PART,PRCNCT,PRSD,PRSD_SV,"2025-05-18 21:29:54",159,81,59,22,0,81,0,200,119,36,45
6,BISTRIŢA-NĂSĂUD,"CĂMINUL CULTURAL MĂGURA ILVEI",181,"MĂGURA ILVEI",33729,1,PART,PRCNCT,PRSD,PRSD_SV,"2025-05-18 21:58:46",1333,563,526,36,1,560,3,1450,887,375,185
6,BISTRIŢA-NĂSĂUD,"CĂMINUL CULTURAL ARŞIŢA",182,"MĂGURA ILVEI",33729,1,PART,PRCNCT,PRSD,PRSD_SV,"2025-05-18 21:15:36",334,150,136,14,0,149,1,400,250,116,33
6,BISTRIŢA-NĂSĂUD,"CĂMINUL CULTURAL BÎRLA",183,MĂRIŞELU,33765,1,PART,PRCNCT,PRSD,PRSD_SV,"2025-05-18 21:54:11",267,136,119,17,0,135,1,300,164,62,73
6,BISTRIŢA-NĂSĂUD,"ŞCOALA PRIMARĂ DOMNEŞTI",184,MĂRIŞELU,33765,1,PART,PRCNCT,PRSD,PRSD_SV,"2025-05-18 22:08:29",757,339,292,47,0,337,2,800,461,222,115
6,BISTRIŢA-NĂSĂUD,"SOCIETATEA AGRICOLĂ",185,MĂRIŞELU,33765,1,PART,PRCNCT,PRSD,PRSD_SV,"2025-05-18 21:32:01",88,110,54,56,0,110,0,120,10,9,101
6,BISTRIŢA-NĂSĂUD,"ŞCOALA GIMNAZIALĂ MĂRIŞELU",186,MĂRIŞELU,33765,1,PART,PRCNCT,PRSD,PRSD_SV,"2025-05-18 22:04:06",491,224,194,30,0,224,0,550,326,123,101
6,BISTRIŢA-NĂSĂUD,"ŞCOALA PRIMARĂ SÎNTIOANA",187,MĂRIŞELU,33765,1,PART,PRCNCT,PRSD,PRSD_SV,"2025-05-18 22:22:12",354,181,156,25,0,180,1,400,219,86,94
6,BISTRIŢA-NĂSĂUD,"CĂMINUL CULTURAL MICEŞTII DE CÎMPIE",188,"MICEŞTII DE CÂMPIE",33845,1,PART,PRCNCT,PRSD,PRSD_SV,"2025-05-18 21:16:14",235,136,106,29,1,136,0,250,114,63,73
6,BISTRIŢA-NĂSĂUD,"ȘCOALA GENERALĂ FÎNTÎNIŢA",189,"MICEŞTII DE CÂMPIE",33845,1,PART,PRCNCT,PRSD,PRSD_SV,"2025-05-18 21:19:05",266,103,86,17,0,102,1,300,197,42,60
6,BISTRIŢA-NĂSĂUD,"CĂMINUL CULTURAL VISUIA",190,"MICEŞTII DE CÂMPIE",33845,1,PART,PRCNCT,PRSD,PRSD_SV,"2025-05-18 21:24:03",293,113,95,18,0,113,0,300,187,54,59
6,BISTRIŢA-NĂSĂUD,"GRADINITA CU PROGRAM NORMAL",191,MILAŞ,33881,1,PART,PRCNCT,PRSD,PRSD_SV,"2025-05-18 21:55:27",578,333,262,66,5,326,7,650,317,151,175
6,BISTRIŢA-NĂSĂUD,"CĂMINUL CULTURAL COMLOD",192,MILAŞ,33881,1,PART,PRCNCT,PRSD,PRSD_SV,"2025-05-18 21:18:05",116,98,65,32,1,97,1,150,52,45,52
6,BISTRIŢA-NĂSĂUD,"CAMINUL CULTURAL OROSFAIA",193,MILAŞ,33881,1,PART,PRCNCT,PRSD,PRSD_SV,"2025-05-18 21:40:47",283,194,158,33,3,191,3,350,156,68,123
6,BISTRIŢA-NĂSĂUD,"CĂMINUL CULTURAL MONOR",194,MONOR,33952,1,PART,PRCNCT,PRSD,PRSD_SV,"2025-05-18 21:45:27",640,394,318,75,1,394,0,700,306,203,191
6,BISTRIŢA-NĂSĂUD,"CĂMINUL CULTURAL GLEDIN",195,MONOR,33952,1,PART,PRCNCT,PRSD,PRSD_SV,"2025-05-18 21:43:06",380,192,162,30,0,190,2,400,208,109,81
6,BISTRIŢA-NĂSĂUD,"ŞCOALA GIMNAZIALĂ NEGRILEŞTI",196,NEGRILEŞTI,179659,1,PART,PRCNCT,PRSD,PRSD_SV,"2025-05-18 22:31:26",991,495,411,84,0,491,4,1100,605,306,185
6,BISTRIŢA-NĂSĂUD,"ŞCOALA GIMNAZIALĂ ”VICTOR MOTOGNA” BREAZA",197,NEGRILEŞTI,179659,1,PART,PRCNCT,PRSD,PRSD_SV,"2025-05-18 21:27:55",791,324,299,25,0,323,1,900,576,205,118
6,BISTRIŢA-NĂSĂUD,"ŞCOALA GENERALĂ PURCĂRETE",198,NEGRILEŞTI,179659,1,PART,PRCNCT,PRSD,PRSD_SV,"2025-05-18 21:26:07",168,82,57,25,0,80,2,200,118,57,23
6,BISTRIŢA-NĂSĂUD,"ŞCOALA GIMNAZIALĂ NIMIGEA DE JOS",199,NIMIGEA,33989,1,PART,PRCNCT,PRSD,PRSD_SV,"2025-05-18 21:44:13",1332,667,594,68,5,663,4,1450,783,338,325
6,BISTRIŢA-NĂSĂUD,"ŞCOALA PRIMARĂ FLOREŞTI",200,NIMIGEA,33989,1,PART,PRCNCT,PRSD,PRSD_SV,"2025-05-18 21:31:47",425,160,138,21,1,158,2,500,340,101,57
6,BISTRIŢA-NĂSĂUD,"ŞCOALA PRIMARĂ MINTIU",201,NIMIGEA,33989,1,PART,PRCNCT,PRSD,PRSD_SV,"2025-05-18 21:14:18",359,162,126,36,0,161,1,400,238,112,49
6,BISTRIŢA-NĂSĂUD,"ŞCOALA GIMNAZIALĂ MITITEI 2",202,NIMIGEA,33989,1,PART,PRCNCT,PRSD,PRSD_SV,"2025-05-18 21:41:37",565,251,227,24,0,251,0,600,349,165,86
6,BISTRIŢA-NĂSĂUD,"CĂMINUL CULTURAL MOCOD",203,NIMIGEA,33989,1,PART,PRCNCT,PRSD,PRSD_SV,"2025-05-18 21:45:41",483,245,215,30,0,243,2,550,305,129,114
6,BISTRIŢA-NĂSĂUD,"ŞCOALA PRIMARĂ MOGOŞENI",204,NIMIGEA,33989,1,PART,PRCNCT,PRSD,PRSD_SV,"2025-05-18 21:35:16",291,156,136,20,0,154,2,350,194,85,69
6,BISTRIŢA-NĂSĂUD,"ŞCOALA PRIMARĂ NIMIGEA DE SUS",205,NIMIGEA,33989,1,PART,PRCNCT,PRSD,PRSD_SV,"2025-05-18 21:27:23",461,244,215,29,0,241,3,500,256,139,102
6,BISTRIŢA-NĂSĂUD,"ŞCOALA PRIMARĂ TĂURE",206,NIMIGEA,33989,2,PART,PRCNCT,PRSD,PRSD_SV,"2025-05-18 23:11:59",331,137,117,20,0,136,1,350,213,81,55
6,BISTRIŢA-NĂSĂUD,"CĂMINUL CULTURAL",207,NUŞENI,34075,1,PART,PRCNCT,PRSD,PRSD_SV,"2025-05-18 21:35:35",709,498,340,78,80,488,10,750,252,211,277
6,BISTRIŢA-NĂSĂUD,"CAMINUL CULTURAL BEUDIU",208,NUŞENI,34075,1,PART,PRCNCT,PRSD,PRSD_SV,"2025-05-18 21:43:40",440,318,243,44,31,317,1,500,182,111,206
6,BISTRIŢA-NĂSĂUD,"CĂMINUL CULTURAL FELEAC",209,NUŞENI,34075,1,PART,PRCNCT,PRSD,PRSD_SV,"2025-05-18 21:24:35",249,162,128,34,0,159,3,300,138,97,62
6,BISTRIŢA-NĂSĂUD,"CĂMINUL CULTURAL",210,NUŞENI,34075,1,PART,PRCNCT,PRSD,PRSD_SV,"2025-05-18 21:55:12",350,245,188,45,12,243,2,400,155,63,180
6,BISTRIŢA-NĂSĂUD,"CAMINUL CULTURAL RUSU DE SUS",211,NUŞENI,34075,1,PART,PRCNCT,PRSD,PRSD_SV,"2025-05-18 21:39:23",217,153,124,27,2,152,1,250,97,77,75
6,BISTRIŢA-NĂSĂUD,"CĂMINUL CULTURAL",212,NUŞENI,34075,2,PART,PRCNCT,PRSD,PRSD_SV,"2025-05-19 00:27:04",293,186,131,37,18,185,1,350,164,33,152
6,BISTRIŢA-NĂSĂUD,"GRĂDINIȚA CU PROGRAM NORMAL PARVA",213,PARVA,34155,1,PART,PRCNCT,PRSD,PRSD_SV,"2025-05-18 22:28:21",994,480,455,25,0,467,13,1100,620,346,121
6,BISTRIŢA-NĂSĂUD,"CENTRUL DE INFORMARE TURISTICA",214,PARVA,34155,1,PART,PRCNCT,PRSD,PRSD_SV,"2025-05-18 22:34:37",983,493,462,28,3,481,12,1094,601,379,102
6,BISTRIŢA-NĂSĂUD,"PRIMĂRIA COMUNEI PETRU RAREŞ",215,"PETRU RAREŞ",34173,1,PART,PRCNCT,PRSD,PRSD_SV,"2025-05-18 23:25:01",1395,651,587,63,1,643,8,1500,849,370,273
6,BISTRIŢA-NĂSĂUD,"ŞCOALA GENERALĂ RETEAG POIENI, CLASELE I - IV",216,"PETRU RAREŞ",34173,1,PART,PRCNCT,PRSD,PRSD_SV,"2025-05-18 22:19:29",748,238,219,19,0,234,4,850,612,187,47
6,BISTRIŢA-NĂSĂUD,"CĂMINUL CULTURAL BAŢA",217,"PETRU RAREŞ",34173,1,PART,PRCNCT,PRSD,PRSD_SV,"2025-05-18 22:33:18",689,375,320,54,1,371,4,750,375,173,198
6,BISTRIŢA-NĂSĂUD,"ŞCOALA GIMNAZIALĂ ”SEVER POP” POIANA ILVEI",218,"POIANA ILVEI",179720,2,PART,PRCNCT,PRSD,PRSD_SV,"2025-05-19 00:31:42",1185,630,564,61,5,628,2,1300,670,360,268
6,BISTRIŢA-NĂSĂUD,"ŞCOALA GENERALĂ PRUNDU BÂRGĂULUI",219,"PRUNDU BÂRGĂULUI",34235,1,PART,PRCNCT,PRSD,PRSD_SV,"2025-05-18 21:51:55",1090,607,540,67,0,597,10,1200,593,314,283
6,BISTRIŢA-NĂSĂUD,"ȘCOALA GENERALĂ PRUNDU BÂRGĂULUI",220,"PRUNDU BÂRGĂULUI",34235,1,PART,PRCNCT,PRSD,PRSD_SV,"2025-05-18 22:23:37",1425,687,633,54,0,679,8,1550,863,370,309
6,BISTRIŢA-NĂSĂUD,"CENTRUL CULTURAL PRUNDU BÂRGĂULUI",221,"PRUNDU BÂRGĂULUI",34235,1,PART,PRCNCT,PRSD,PRSD_SV,"2025-05-18 22:36:32",1551,795,726,69,0,788,7,1700,905,440,348
6,BISTRIŢA-NĂSĂUD,"ŞCOALA PRIMARĂ SUSENII BÎRGĂULUI",222,"PRUNDU BÂRGĂULUI",34235,1,PART,PRCNCT,PRSD,PRSD_SV,"2025-05-18 22:10:51",1131,575,524,42,9,570,5,1200,625,344,226
6,BISTRIŢA-NĂSĂUD,"ȘCOALA GIMNAZIALĂ REBRA CLASELE I-IV",223,REBRA,34262,1,PART,PRCNCT,PRSD,PRSD_SV,"2025-05-18 22:07:47",1036,403,382,18,3,400,3,1100,697,299,101
6,BISTRIŢA-NĂSĂUD,"ȘCOALA GIMNAZIALĂ REBRA CLASELE I-IV",224,REBRA,34262,1,PART,PRCNCT,PRSD,PRSD_SV,"2025-05-18 21:39:36",1074,404,383,19,2,401,3,1156,752,322,79
6,BISTRIŢA-NĂSĂUD,"ŞCOALA GIMNAZIALĂ CLASELE I-IV REBRIŞOARA",225,REBRIŞOARA,34280,1,PART,PRCNCT,PRSD,PRSD_SV,"2025-05-18 21:55:28",1377,694,640,50,4,684,10,1500,806,381,303
6,BISTRIŢA-NĂSĂUD,"ŞCOALA GIMNAZIALĂ CLASELE I-IV REBRIŞOARA",226,REBRIŞOARA,34280,1,PART,PRCNCT,PRSD,PRSD_SV,"2025-05-18 21:57:15",1669,713,683,22,8,700,13,1800,1087,480,220
6,BISTRIŢA-NĂSĂUD,"ŞCOALA GIMNAZIALĂ NR.1 GERSA I",227,REBRIŞOARA,34280,1,PART,PRCNCT,PRSD,PRSD_SV,"2025-05-18 21:32:04",532,243,226,17,0,242,1,600,357,173,69
6,BISTRIŢA-NĂSĂUD,"ŞCOALA PRIMARĂ ”VALEA BABII”",228,REBRIŞOARA,34280,1,PART,PRCNCT,PRSD,PRSD_SV,"2025-05-18 21:24:38",132,42,29,13,0,42,0,150,108,31,11
6,BISTRIŢA-NĂSĂUD,"ŞCOALA GIMNAZIALĂ NR. 2 ”FLORIAN PORCIUS” RODNA",229,RODNA,34333,1,PART,PRCNCT,PRSD,PRSD_SV,"2025-05-18 22:08:27",917,424,409,15,0,420,4,1000,576,272,148
6,BISTRIŢA-NĂSĂUD,"ŞCOALA GIMNAZIALĂ NR. 2 ”FLORIAN PORCIUS” RODNA",230,RODNA,34333,1,PART,PRCNCT,PRSD,PRSD_SV,"2025-05-18 22:48:58",929,437,414,23,0,429,8,1000,563,324,105
6,BISTRIŢA-NĂSĂUD,"PRIMĂRIA COMUNEI RODNA",231,RODNA,34333,1,PART,PRCNCT,PRSD,PRSD_SV,"2025-05-18 21:41:00",1435,752,714,37,1,746,6,1600,848,513,233
6,BISTRIŢA-NĂSĂUD,"CĂMINUL CULTURAL ”GHERASIM DOMIDE” RODNA",232,RODNA,34333,1,PART,PRCNCT,PRSD,PRSD_SV,"2025-05-18 21:51:10",1429,612,586,26,0,609,3,1550,938,397,212
6,BISTRIŢA-NĂSĂUD,"GRĂDINIȚĂ CU PROGRAM NORMAL",233,RODNA,34333,1,PART,PRCNCT,PRSD,PRSD_SV,"2025-05-18 21:20:43",161,92,67,25,0,92,0,200,108,59,33
6,BISTRIŢA-NĂSĂUD,"ŞCOALA GIMNAZIALĂ CLASELE I-VIII, ROMULI",234,ROMULI,34360,1,PART,PRCNCT,PRSD,PRSD_SV,"2025-05-18 21:42:55",1024,467,423,43,1,466,1,1100,633,311,155
6,BISTRIŢA-NĂSĂUD,"GRĂDINIȚA CU PROGRAM NORMAL DEALU ŞTEFĂNIŢEI",235,ROMULI,34360,1,PART,PRCNCT,PRSD,PRSD_SV,"2025-05-18 21:40:18",372,204,184,20,0,203,1,400,196,144,59
6,BISTRIŢA-NĂSĂUD,"PRIMĂRIA COMUNEI RUNCU SALVEI",236,"RUNCU SALVEI",179944,1,PART,PRCNCT,PRSD,PRSD_SV,"2025-05-18 21:49:55",1009,481,444,37,0,477,4,1100,619,278,199
6,BISTRIŢA-NĂSĂUD,"PRIMĂRIA COMUNEI SALVA",237,SALVA,34397,1,PART,PRCNCT,PRSD,PRSD_SV,"2025-05-18 21:41:27",1053,570,510,33,27,563,7,1150,580,260,303
6,BISTRIŢA-NĂSĂUD,"ŞCOALA PROFESIONALĂ ”TIBERIU MORARIU”",238,SALVA,34397,1,PART,PRCNCT,PRSD,PRSD_SV,"2025-05-18 21:47:22",1176,621,555,51,15,617,4,1250,629,290,327
6,BISTRIŢA-NĂSĂUD,"CĂMINUL CULTURAL SÎNMIHAIU DE CÎMPIE",239,"SÂNMIHAIU DE CÂMPIE",34477,1,PART,PRCNCT,PRSD,PRSD_SV,"2025-05-18 21:56:32",551,285,238,41,6,281,4,600,315,160,121
6,BISTRIŢA-NĂSĂUD,"CĂMINUL CULTURAL BRĂTENI",240,"SÂNMIHAIU DE CÂMPIE",34477,1,PART,PRCNCT,PRSD,PRSD_SV,"2025-05-18 21:29:37",57,70,30,40,0,70,0,100,30,29,41
6,BISTRIŢA-NĂSĂUD,"CĂMINUL CULTURAL SĂLCUŢA",241,"SÂNMIHAIU DE CÂMPIE",34477,1,PART,PRCNCT,PRSD,PRSD_SV,"2025-05-18 21:50:04",84,66,38,28,0,65,1,100,34,38,27
6,BISTRIŢA-NĂSĂUD,"CĂMIN CULTURAL",242,"SÂNMIHAIU DE CÂMPIE",34477,1,PART,PRCNCT,PRSD,PRSD_SV,"2025-05-18 21:50:01",145,74,53,21,0,74,0,150,76,34,40
6,BISTRIŢA-NĂSĂUD,"CĂMINUL CULTURAL ZORENI",243,"SÂNMIHAIU DE CÂMPIE",34477,1,PART,PRCNCT,PRSD,PRSD_SV,"2025-05-18 21:43:29",220,122,95,27,0,120,2,250,128,66,54
6,BISTRIŢA-NĂSĂUD,"CĂMINUL CULTURAL",244,"SILIVAŞU DE CÂMPIE",34422,1,PART,PRCNCT,PRSD,PRSD_SV,"2025-05-18 22:13:42",715,379,300,79,0,376,3,800,421,212,164
6,BISTRIŢA-NĂSĂUD,"CĂMINUL CULTURAL SPERMEZEU",245,SPERMEZEU,34547,1,PART,PRCNCT,PRSD,PRSD_SV,"2025-05-18 21:26:42",1402,603,551,44,8,601,2,1500,897,309,292
6,BISTRIŢA-NĂSĂUD,"CĂMINUL CULTURAL DOBRICEL",246,SPERMEZEU,34547,1,PART,PRCNCT,PRSD,PRSD_SV,"2025-05-18 21:35:28",395,188,165,23,0,186,2,450,262,94,92
6,BISTRIŢA-NĂSĂUD,"ŞCOALA GIMNAZIALĂ ”TEODOR COTUŢIU” DUMBRĂVIŢA",247,SPERMEZEU,34547,1,PART,PRCNCT,PRSD,PRSD_SV,"2025-05-18 21:34:44",630,276,241,29,6,274,2,700,424,147,127
6,BISTRIŢA-NĂSĂUD,"ŞCOALA PRIMARĂ HĂLMĂSĂU",248,SPERMEZEU,34547,1,PART,PRCNCT,PRSD,PRSD_SV,"2025-05-18 21:23:55",216,119,104,15,0,118,1,250,131,54,64
6,BISTRIŢA-NĂSĂUD,"ŞCOALA GIMNAZIALĂ SITA",249,SPERMEZEU,34547,1,PART,PRCNCT,PRSD,PRSD_SV,"2025-05-18 21:15:33",248,131,115,14,2,131,0,300,169,63,68
6,BISTRIŢA-NĂSĂUD,"ȘCOALA GIMNAZIALĂ ”ENEA GRAPINI”",250,ŞANŢ,34618,1,PART,PRCNCT,PRSD,PRSD_SV,"2025-05-18 21:55:21",1296,694,668,26,0,689,5,1400,706,460,229
6,BISTRIŢA-NĂSĂUD,"ȘCOALA GIMNAZIALĂ ”ENEA GRAPINI” ŞANŢ",251,ŞANŢ,34618,1,PART,PRCNCT,PRSD,PRSD_SV,"2025-05-18 21:56:17",1102,568,538,30,0,565,3,1200,632,404,161
6,BISTRIŢA-NĂSĂUD,"ŞCOALA PRIMARĂ ”LUCIAN VALEA”",252,ŞANŢ,34618,1,PART,PRCNCT,PRSD,PRSD_SV,"2025-05-18 21:34:04",264,170,147,23,0,170,0,300,130,139,31
6,BISTRIŢA-NĂSĂUD,"PRIMĂRIA COMUNEI ŞIEU",253,ŞIEU,34645,1,PART,PRCNCT,PRSD,PRSD_SV,"2025-05-18 21:37:05",1080,559,513,46,0,558,1,1200,641,259,299
6,BISTRIŢA-NĂSĂUD,"ŞCOALA GENERALĂ ARDAN",254,ŞIEU,34645,1,PART,PRCNCT,PRSD,PRSD_SV,"2025-05-18 21:36:05",571,240,227,13,0,239,1,650,410,160,79
6,BISTRIŢA-NĂSĂUD,"ŞCOALA PRIMARĂ POSMUŞ",255,ŞIEU,34645,1,PART,PRCNCT,PRSD,PRSD_SV,"2025-05-18 21:41:49",537,223,207,16,0,223,0,600,377,140,83
6,BISTRIŢA-NĂSĂUD,"CĂMINUL CULTURAL ŞOIMUŞ",256,ŞIEU,34645,1,PART,PRCNCT,PRSD,PRSD_SV,"2025-05-18 21:39:43",105,79,66,13,0,79,0,150,71,32,47
6,BISTRIŢA-NĂSĂUD,"CĂMINUL CULTURAL ŞIEU-MĂGHERUŞ",257,ŞIEU-MĂGHERUŞ,34690,1,PART,PRCNCT,PRSD,PRSD_SV,"2025-05-18 22:15:25",993,461,396,65,0,456,5,1100,639,282,174
6,BISTRIŢA-NĂSĂUD,"CĂMINUL CULTURAL ARCALIA",258,ŞIEU-MĂGHERUŞ,34690,1,PART,PRCNCT,PRSD,PRSD_SV,"2025-05-18 21:33:35",812,365,316,49,0,365,0,900,535,235,130
6,BISTRIŢA-NĂSĂUD,"CAMIN CULTURAL ”GRIGORE PLETOSU”",259,ŞIEU-MĂGHERUŞ,34690,1,PART,PRCNCT,PRSD,PRSD_SV,"2025-05-18 22:27:40",552,335,275,60,0,334,1,600,265,167,167
6,BISTRIŢA-NĂSĂUD,"CĂMINUL CULTURAL CRAINIMĂT",260,ŞIEU-MĂGHERUŞ,34690,1,PART,PRCNCT,PRSD,PRSD_SV,"2025-05-18 22:02:50",913,457,412,44,1,457,0,1000,543,318,139
6,BISTRIŢA-NĂSĂUD,"CĂMINUL CULTURAL SĂRĂŢEL",261,ŞIEU-MĂGHERUŞ,34690,1,PART,PRCNCT,PRSD,PRSD_SV,"2025-05-18 21:44:27",478,238,188,50,0,236,2,500,262,147,89
6,BISTRIŢA-NĂSĂUD,"PRIMĂRIA COMUNEI ŞIEU-ODORHEI",262,ŞIEU-ODORHEI,34770,1,PART,PRCNCT,PRSD,PRSD_SV,"2025-05-18 22:02:08",594,344,296,48,0,342,2,650,306,148,194
6,BISTRIŢA-NĂSĂUD,"ŞCOALA GENERALĂ AGRIŞU DE JOS",263,ŞIEU-ODORHEI,34770,1,PART,PRCNCT,PRSD,PRSD_SV,"2025-05-18 21:24:08",284,125,107,18,0,123,2,300,175,65,58
6,BISTRIŢA-NĂSĂUD,"CĂMINUL CULTURAL AGRIŞU DE SUS",264,ŞIEU-ODORHEI,34770,1,PART,PRCNCT,PRSD,PRSD_SV,"2025-05-18 21:19:10",122,92,66,26,0,92,0,150,58,48,44
6,BISTRIŢA-NĂSĂUD,"CONTAINERE MODULARE AMPLASATE ÎN CURTEA CĂMINULUI CULTURAL BRETEA",265,ŞIEU-ODORHEI,34770,1,PART,PRCNCT,PRSD,PRSD_SV,"2025-05-18 21:13:40",108,89,52,36,1,87,2,150,61,22,65
6,BISTRIŢA-NĂSĂUD,"CĂMINUL CULTURAL COASTA",266,ŞIEU-ODORHEI,34770,1,PART,PRCNCT,PRSD,PRSD_SV,"2025-05-18 21:19:55",146,119,76,43,0,119,0,200,81,60,59
6,BISTRIŢA-NĂSĂUD,"ŞCOALA GENERALĂ CRISTUR-ŞIEU",267,ŞIEU-ODORHEI,34770,1,PART,PRCNCT,PRSD,PRSD_SV,"2025-05-18 21:34:05",382,226,173,53,0,222,4,400,174,108,114
6,BISTRIŢA-NĂSĂUD,"CĂMINUL CULTURAL ȘIRIOARA",268,ŞIEU-ODORHEI,34770,1,PART,PRCNCT,PRSD,PRSD_SV,"2025-05-18 21:59:06",199,172,109,63,0,171,1,250,78,86,85
6,BISTRIŢA-NĂSĂUD,"PRIMĂRIA COMUNEI ŞIEUŢ",269,ŞIEUŢ,34850,1,PART,PRCNCT,PRSD,PRSD_SV,"2025-05-18 22:08:24",551,328,271,56,1,324,4,600,272,147,177
6,BISTRIŢA-NĂSĂUD,"ŞCOALA PRIMARĂ LUNCA",270,ŞIEUŢ,34850,1,PART,PRCNCT,PRSD,PRSD_SV,"2025-05-18 21:20:08",317,134,117,17,0,134,0,350,216,74,60
6,BISTRIŢA-NĂSĂUD,"ŞCOALA PRIMARĂ RUŞTIOR",271,ŞIEUŢ,34850,1,PART,PRCNCT,PRSD,PRSD_SV,"2025-05-18 21:31:41",475,242,222,19,1,241,1,500,258,148,93
6,BISTRIŢA-NĂSĂUD,"ŞCOALA GIMNAZIALĂ SEBIŞ",272,ŞIEUŢ,34850,1,PART,PRCNCT,PRSD,PRSD_SV,"2025-05-18 21:39:49",665,349,329,20,0,346,3,750,401,190,156
6,BISTRIŢA-NĂSĂUD,"PRIMĂRIA COMUNEI ŞINTEREAG",273,ŞINTEREAG,34903,1,PART,PRCNCT,PRSD,PRSD_SV,"2025-05-18 22:06:24",828,452,391,58,3,448,4,900,448,214,234
6,BISTRIŢA-NĂSĂUD,"CĂMINUL CULTURAL BLĂJENII DE JOS",274,ŞINTEREAG,34903,1,PART,PRCNCT,PRSD,PRSD_SV,"2025-05-18 21:47:25",292,191,142,49,0,191,0,350,159,97,94
6,BISTRIŢA-NĂSĂUD,"ŞCOALA PRIMARĂ ”NICOLAE BĂLAN” BLĂJENII DE SUS",275,ŞINTEREAG,34903,1,PART,PRCNCT,PRSD,PRSD_SV,"2025-05-18 21:38:47",274,180,140,40,0,177,3,300,120,89,88
6,BISTRIŢA-NĂSĂUD,"CĂMINUL CULTURAL",276,ŞINTEREAG,34903,1,PART,PRCNCT,PRSD,PRSD_SV,"2025-05-18 21:33:59",239,136,99,36,1,136,0,250,114,76,60
6,BISTRIŢA-NĂSĂUD,"ŞCOALA GIMNAZIALĂ COCIU",277,ŞINTEREAG,34903,1,PART,PRCNCT,PRSD,PRSD_SV,"2025-05-18 21:50:14",850,456,417,39,0,455,1,900,444,198,257
6,BISTRIŢA-NĂSĂUD,"CĂMINUL CULTURAL ŞIEU-SFÂNTU",278,ŞINTEREAG,34903,1,PART,PRCNCT,PRSD,PRSD_SV,"2025-05-18 21:46:47",383,267,211,55,1,264,3,400,133,101,163
6,BISTRIŢA-NĂSĂUD,"CĂMINUL CULTURAL TÂRLIȘUA",279,TÂRLIŞUA,35152,1,PART,PRCNCT,PRSD,PRSD_SV,"2025-05-18 22:06:32",982,470,437,33,0,463,7,1050,580,247,216
6,BISTRIŢA-NĂSĂUD,"ŞCOALA GENERALĂ AGRIEŞ",280,TÂRLIŞUA,35152,1,PART,PRCNCT,PRSD,PRSD_SV,"2025-05-18 22:12:15",714,356,327,28,1,354,2,800,444,127,227
6,BISTRIŢA-NĂSĂUD,"ŞCOALA GENERALĂ BORLEASA",281,TÂRLIŞUA,35152,1,PART,PRCNCT,PRSD,PRSD_SV,"2025-05-18 21:33:20",292,134,120,14,0,133,1,350,216,88,45
6,BISTRIŢA-NĂSĂUD,"ŞCOALA GENERALĂ LUNCA SĂTEASCĂ",282,TÂRLIŞUA,35152,1,PART,PRCNCT,PRSD,PRSD_SV,"2025-05-18 21:26:24",440,165,151,12,2,160,5,450,285,80,80
6,BISTRIŢA-NĂSĂUD,"CASA DE LOCUIT",283,TÂRLIŞUA,35152,1,PART,PRCNCT,PRSD,PRSD_SV,"2025-05-18 21:25:16",163,104,84,19,1,104,0,200,96,48,56
6,BISTRIŢA-NĂSĂUD,"CĂMINUL CULTURAL TEACA",284,TEACA,34985,1,PART,PRCNCT,PRSD,PRSD_SV,"2025-05-18 22:23:00",851,419,337,52,30,413,6,900,481,198,215
6,BISTRIŢA-NĂSĂUD,"PRIMĂRIA COMUNEI TEACA",285,TEACA,34985,1,PART,PRCNCT,PRSD,PRSD_SV,"2025-05-18 21:36:06",758,390,334,46,10,388,2,850,460,133,255
6,BISTRIŢA-NĂSĂUD,"CĂMINUL CULTURAL ARCHIUD",286,TEACA,34985,1,PART,PRCNCT,PRSD,PRSD_SV,"2025-05-18 21:27:23",417,200,177,23,0,198,2,450,250,93,105
6,BISTRIŢA-NĂSĂUD,"CĂMINUL CULTURAL BUDURLENI",287,TEACA,34985,1,PART,PRCNCT,PRSD,PRSD_SV,"2025-05-18 21:22:49",71,55,32,23,0,55,0,100,45,21,34
6,BISTRIŢA-NĂSĂUD,"CĂMINUL CULTURAL OCNIŢA",288,TEACA,34985,1,PART,PRCNCT,PRSD,PRSD_SV,"2025-05-18 21:49:14",754,318,270,48,0,315,3,800,482,144,171
6,BISTRIŢA-NĂSĂUD,"CĂMINUL CULTURAL PINTICU",289,TEACA,34985,1,PART,PRCNCT,PRSD,PRSD_SV,"2025-05-18 22:04:40",592,254,229,25,0,252,2,650,396,172,80
6,BISTRIŢA-NĂSĂUD,"CĂMINUL CULTURAL VIILE TECII",290,TEACA,34985,1,PART,PRCNCT,PRSD,PRSD_SV,"2025-05-18 21:59:58",885,279,245,33,1,273,6,950,671,213,60
6,BISTRIŢA-NĂSĂUD,"LICEUL TEHNOLOGIC TELCIU",291,TELCIU,35054,2,PART,PRCNCT,PRSD,PRSD_SV,"2025-05-19 00:34:42",1142,478,445,33,0,478,0,1250,772,302,176
6,BISTRIŢA-NĂSĂUD,"CENTRUL DE INFORMARE TURISTICĂ",292,TELCIU,35054,1,PART,PRCNCT,PRSD,PRSD_SV,"2025-05-18 21:42:38",1004,481,449,32,0,476,5,1100,619,253,223
6,BISTRIŢA-NĂSĂUD,"OCOLUL SILVIC TELCIU",293,TELCIU,35054,1,PART,PRCNCT,PRSD,PRSD_SV,"2025-05-18 21:39:31",936,384,359,25,0,383,1,1000,616,213,170
6,BISTRIŢA-NĂSĂUD,"ŞCOALA GIMNAZIALĂ BICHIGIU",294,TELCIU,35054,1,PART,PRCNCT,PRSD,PRSD_SV,"2025-05-18 21:28:12",649,178,162,16,0,177,1,700,522,98,79
6,BISTRIŢA-NĂSĂUD,"CABANA STARSILVA FIAD",295,TELCIU,35054,1,PART,PRCNCT,PRSD,PRSD_SV,"2025-05-18 21:19:58",145,70,50,20,0,69,1,200,130,45,24
6,BISTRIŢA-NĂSĂUD,"ŞCOALA GIMNAZIALĂ TELCIŞOR",296,TELCIU,35054,1,PART,PRCNCT,PRSD,PRSD_SV,"2025-05-18 21:48:30",856,330,310,20,0,329,1,950,620,245,84
6,BISTRIŢA-NĂSĂUD,"ŞCOALA GIMNAZIALĂ TIHA BÎRGĂULUI",297,"TIHA BÂRGĂULUI",35090,1,PART,PRCNCT,PRSD,PRSD_SV,"2025-05-18 22:22:50",1371,690,627,60,3,688,2,1500,810,425,263
6,BISTRIŢA-NĂSĂUD,"ŞCOALA GIMNAZIALĂ MUREŞENII BÎRGĂULUI",298,"TIHA BÂRGĂULUI",35090,1,PART,PRCNCT,PRSD,PRSD_SV,"2025-05-18 22:10:53",1344,659,592,67,0,653,6,1500,841,476,177
6,BISTRIŢA-NĂSĂUD,"ŞCOALA GIMNAZIALĂ PIATRA FÎNTÎNELE",299,"TIHA BÂRGĂULUI",35090,1,PART,PRCNCT,PRSD,PRSD_SV,"2025-05-18 21:30:16",312,168,107,61,0,166,2,350,182,121,45
6,BISTRIŢA-NĂSĂUD,"ȘCOALA GIMNAZIALĂ TUREAC",300,"TIHA BÂRGĂULUI",35090,1,PART,PRCNCT,PRSD,PRSD_SV,"2025-05-18 22:32:06",560,240,205,35,0,239,1,600,360,200,39
6,BISTRIŢA-NĂSĂUD,"ȘCOALA GIMNAZIALĂ TUREAC",301,"TIHA BÂRGĂULUI",35090,1,PART,PRCNCT,PRSD,PRSD_SV,"2025-05-18 21:55:46",1643,728,673,54,1,724,4,1800,1072,578,146
6,BISTRIŢA-NĂSĂUD,"ŞCOALA GENERALĂ URIU",302,URIU,35269,1,PART,PRCNCT,PRSD,PRSD_SV,"2025-05-18 22:05:20",1273,691,592,93,6,686,5,1400,709,331,355
6,BISTRIŢA-NĂSĂUD,"ŞCOALA GENERALĂ CRISTEŞTII CICEULUI",303,URIU,35269,1,PART,PRCNCT,PRSD,PRSD_SV,"2025-05-18 22:00:20",1000,539,459,76,4,531,8,1100,561,281,250
6,BISTRIŢA-NĂSĂUD,"ŞCOALA GENERALĂ HĂŞMAŞU CICEULUI",304,URIU,35269,1,PART,PRCNCT,PRSD,PRSD_SV,"2025-05-18 21:32:01",177,112,80,32,0,112,0,200,88,63,49
6,BISTRIŢA-NĂSĂUD,"ŞCOALA GENERALĂ ILIŞUA",305,URIU,35269,1,PART,PRCNCT,PRSD,PRSD_SV,"2025-05-18 22:01:20",602,313,262,51,0,311,2,650,337,157,154
6,BISTRIŢA-NĂSĂUD,"SALA DE SPORT URMENIŞ",306,URMENIŞ,35312,1,PART,PRCNCT,PRSD,PRSD_SV,"2025-05-18 22:01:28",719,378,310,68,0,371,7,800,422,220,151
6,BISTRIŢA-NĂSĂUD,"ŞCOALA GENERALĂ DELURENI",307,URMENIŞ,35312,1,PART,PRCNCT,PRSD,PRSD_SV,"2025-05-18 23:00:06",246,129,92,37,0,127,2,300,171,73,54
6,BISTRIŢA-NĂSĂUD,"CĂMINUL CULTURAL FÎNAŢE",308,URMENIŞ,35312,1,PART,PRCNCT,PRSD,PRSD_SV,"2025-05-18 22:09:20",148,71,51,20,0,70,1,200,129,37,33
6,BISTRIŢA-NĂSĂUD,"CĂMINUL CULTURAL ŞOPTERIU",309,URMENIŞ,35312,1,PART,PRCNCT,PRSD,PRSD_SV,"2025-05-18 21:40:57",279,130,104,26,0,129,1,300,170,73,56
6,BISTRIŢA-NĂSĂUD,"ŞCOALA GENERALĂ ZAGRA",310,ZAGRA,35429,1,PART,PRCNCT,PRSD,PRSD_SV,"2025-05-18 21:21:15",838,472,422,32,18,470,2,900,428,237,233
6,BISTRIŢA-NĂSĂUD,"ŞCOALA GENERALĂ ALUNIŞUL",311,ZAGRA,35429,1,PART,PRCNCT,PRSD,PRSD_SV,"2025-05-18 21:15:24",165,102,88,10,4,102,0,200,98,59,43
6,BISTRIŢA-NĂSĂUD,"ŞCOALA GENERALĂ PERIŞOR",312,ZAGRA,35429,1,PART,PRCNCT,PRSD,PRSD_SV,"2025-05-18 21:25:55",406,198,177,13,8,196,2,450,252,116,80
6,BISTRIŢA-NĂSĂUD,"ŞCOALA GENERALĂ POIENILE ZAGREI",313,ZAGRA,35429,1,PART,PRCNCT,PRSD,PRSD_SV,"2025-05-18 21:30:29",706,290,252,28,10,288,2,800,510,188,100
6,BISTRIŢA-NĂSĂUD,"ŞCOALA GENERALĂ SUPLAI",314,ZAGRA,35429,1,PART,PRCNCT,PRSD,PRSD_SV,"2025-05-18 21:21:12",532,201,171,21,9,200,1,550,349,126,74
7,BOTOŞANI,"COLEGIUL NAȚIONAL „A.T. LAURIAN”, BOTOȘANI",1,"MUNICIPIUL BOTOŞANI",35731,1,PART,PRCNCT,PRSD,PRSD_SV,"2025-05-18 21:41:59",805,491,351,67,73,481,10,1000,509,172,309
7,BOTOŞANI,"COLEGIUL NAȚIONAL „A.T. LAURIAN”, BOTOȘANI",2,"MUNICIPIUL BOTOŞANI",35731,1,PART,PRCNCT,PRSD,PRSD_SV,"2025-05-18 21:51:22",1204,712,588,48,76,704,8,1600,888,236,468
7,BOTOŞANI,"COLEGIUL NAȚIONAL „A.T. LAURIAN”, BOTOȘANI",3,"MUNICIPIUL BOTOŞANI",35731,2,PART,PRCNCT,PRSD,PRSD_SV,"2025-05-18 23:53:26",1319,718,674,19,25,706,12,1600,882,219,487
7,BOTOŞANI,"GRĂDINIȚA CU PROGRAM NORMAL „FLOARE DE COLȚ”",4,"MUNICIPIUL BOTOŞANI",35731,1,PART,PRCNCT,PRSD,PRSD_SV,"2025-05-18 21:36:25",1430,775,697,78,0,771,4,1500,725,240,531
7,BOTOŞANI,"GRĂDINIȚA CU PROGRAM NORMAL „FLOARE DE COLȚ”",5,"MUNICIPIUL BOTOŞANI",35731,1,PART,PRCNCT,PRSD,PRSD_SV,"2025-05-18 21:35:41",1312,688,625,62,1,681,7,1400,712,251,430
7,BOTOŞANI,"ŞCOALA GIMNAZIALĂ NR. 7",6,"MUNICIPIUL BOTOŞANI",35731,1,PART,PRCNCT,PRSD,PRSD_SV,"2025-05-18 21:29:11",1041,539,487,52,0,532,7,1100,561,209,323
7,BOTOŞANI,"ŞCOALA GIMNAZIALĂ NR. 7",7,"MUNICIPIUL BOTOŞANI",35731,1,PART,PRCNCT,PRSD,PRSD_SV,"2025-05-18 21:30:14",982,487,451,36,0,474,13,1100,613,181,293
7,BOTOŞANI,"ȘCOALA GIMNAZIALĂ NR. 7, BOTOȘANI",8,"MUNICIPIUL BOTOŞANI",35731,1,PART,PRCNCT,PRSD,PRSD_SV,"2025-05-18 21:22:51",913,452,422,29,1,445,7,1000,548,148,297
7,BOTOŞANI,"ȘCOALA GIMNAZIALĂ NR. 7, BOTOȘANI",9,"MUNICIPIUL BOTOŞANI",35731,1,PART,PRCNCT,PRSD,PRSD_SV,"2025-05-18 21:28:07",982,465,428,37,0,451,14,1100,635,197,254
7,BOTOŞANI,"ŞCOALA GIMNAZIALĂ NR. 17",10,"MUNICIPIUL BOTOŞANI",35731,1,PART,PRCNCT,PRSD,PRSD_SV,"2025-05-18 21:47:50",1360,766,699,66,1,753,13,1400,634,267,486
7,BOTOŞANI,"LICEUL TEORETIC „GRIGORE ANTIPA”",11,"MUNICIPIUL BOTOŞANI",35731,1,PART,PRCNCT,PRSD,PRSD_SV,"2025-05-18 21:31:27",1507,769,694,75,0,756,13,1600,831,288,468
7,BOTOŞANI,"LICEUL TEORETIC „GRIGORE ANTIPA”",12,"MUNICIPIUL BOTOŞANI",35731,1,PART,PRCNCT,PRSD,PRSD_SV,"2025-05-18 21:33:17",1288,710,617,82,11,690,20,1400,690,238,452
7,BOTOŞANI,"ŞCOALA GIMNAZIALĂ „SFÂNTA MARIA”",13,"MUNICIPIUL BOTOŞANI",35731,1,PART,PRCNCT,PRSD,PRSD_SV,"2025-05-18 21:28:59",1363,693,630,62,1,687,6,1392,699,276,411
7,BOTOŞANI,"ŞCOALA GIMNAZIALĂ „SFÂNTA MARIA”",14,"MUNICIPIUL BOTOŞANI",35731,1,PART,PRCNCT,PRSD,PRSD_SV,"2025-05-18 21:25:11",1273,567,528,39,0,557,10,1400,833,210,347
7,BOTOŞANI,"ŞCOALA GIMNAZIALĂ „SFÂNTA MARIA”",15,"MUNICIPIUL BOTOŞANI",35731,1,PART,PRCNCT,PRSD,PRSD_SV,"2025-05-18 21:49:03",1204,561,532,29,0,554,7,1300,739,251,303
7,BOTOŞANI,"ŞCOALA GIMNAZIALĂ NR. 13",16,"MUNICIPIUL BOTOŞANI",35731,1,PART,PRCNCT,PRSD,PRSD_SV,"2025-05-18 21:36:15",1229,622,554,68,0,615,7,1300,678,249,366
7,BOTOŞANI,"ŞCOALA GIMNAZIALĂ NR. 13",17,"MUNICIPIUL BOTOŞANI",35731,1,PART,PRCNCT,PRSD,PRSD_SV,"2025-05-18 21:44:17",1376,654,616,38,0,643,11,1500,846,250,393
7,BOTOŞANI,"COLEGIUL NAŢIONAL „MIHAI EMINESCU”",18,"MUNICIPIUL BOTOŞANI",35731,1,PART,PRCNCT,PRSD,PRSD_SV,"2025-05-18 21:46:12",1218,562,522,40,0,555,7,1300,738,193,362
7,BOTOŞANI,"COLEGIUL NAŢIONAL „MIHAI EMINESCU”",19,"MUNICIPIUL BOTOŞANI",35731,1,PART,PRCNCT,PRSD,PRSD_SV,"2025-05-18 21:41:28",1014,524,500,23,1,511,13,1100,576,182,329
7,BOTOŞANI,"COLEGIUL NAŢIONAL „MIHAI EMINESCU”",20,"MUNICIPIUL BOTOŞANI",35731,1,PART,PRCNCT,PRSD,PRSD_SV,"2025-05-18 21:25:57",1412,760,694,66,0,751,9,1600,840,261,490
7,BOTOŞANI,"COLEGIUL NAŢIONAL „MIHAI EMINESCU”",21,"MUNICIPIUL BOTOŞANI",35731,1,PART,PRCNCT,PRSD,PRSD_SV,"2025-05-18 21:28:37",1056,489,465,24,0,485,4,1200,711,164,321
7,BOTOŞANI,"COLEGIUL TEHNIC ”GHEORGHE ASACHI” BOTOȘANI",22,"MUNICIPIUL BOTOŞANI",35731,1,PART,PRCNCT,PRSD,PRSD_SV,"2025-05-18 21:37:25",901,436,390,46,0,424,12,1000,564,199,225
7,BOTOŞANI,"COLEGIUL TEHNIC ”GHEORGHE ASACHI” BOTOȘANI",23,"MUNICIPIUL BOTOŞANI",35731,1,PART,PRCNCT,PRSD,PRSD_SV,"2025-05-18 21:28:15",856,459,353,106,0,452,7,900,441,199,253
7,BOTOŞANI,"COLEGIUL TEHNIC ”GHEORGHE ASACHI” BOTOȘANI",24,"MUNICIPIUL BOTOŞANI",35731,1,PART,PRCNCT,PRSD,PRSD_SV,"2025-05-18 21:44:33",1220,604,567,35,2,596,8,1300,696,250,346
7,BOTOŞANI,"GRĂDINIŢA CU PROGRAM PRELUNGIT NR. 23",25,"MUNICIPIUL BOTOŞANI",35731,1,PART,PRCNCT,PRSD,PRSD_SV,"2025-05-18 21:36:20",1117,555,500,55,0,538,17,1200,645,243,295
7,BOTOŞANI,"COLEGIUL TEHNIC „GHEORGHE ASACHI”",26,"MUNICIPIUL BOTOŞANI",35731,1,PART,PRCNCT,PRSD,PRSD_SV,"2025-05-18 21:30:19",631,368,267,81,20,362,6,800,432,172,190
7,BOTOŞANI,"COLEGIUL TEHNIC „GHEORGHE ASACHI”",27,"MUNICIPIUL BOTOŞANI",35731,1,PART,PRCNCT,PRSD,PRSD_SV,"2025-05-18 21:27:27",926,450,418,30,2,440,10,1000,550,178,262
7,BOTOŞANI,"COLEGIUL TEHNIC „GHEORGHE ASACHI”",28,"MUNICIPIUL BOTOŞANI",35731,1,PART,PRCNCT,PRSD,PRSD_SV,"2025-05-18 21:18:57",1170,515,487,28,0,506,9,1300,785,266,240
7,BOTOŞANI,"COLEGIUL TEHNIC „GHEORGHE ASACHI”",29,"MUNICIPIUL BOTOŞANI",35731,1,PART,PRCNCT,PRSD,PRSD_SV,"2025-05-18 21:17:53",1011,510,460,50,0,500,10,1100,590,276,224
7,BOTOŞANI,"COLEGIUL TEHNIC „GHEORGHE ASACHI”",30,"MUNICIPIUL BOTOŞANI",35731,1,PART,PRCNCT,PRSD,PRSD_SV,"2025-05-18 21:39:22",797,441,402,39,0,437,4,900,459,200,237
7,BOTOŞANI,"LICEUL „ALEXANDRU CEL BUN”",31,"MUNICIPIUL BOTOŞANI",35731,1,PART,PRCNCT,PRSD,PRSD_SV,"2025-05-18 21:47:39",1310,588,550,37,1,577,11,1400,812,285,292
7,BOTOŞANI,"LICEUL „ALEXANDRU CEL BUN”",32,"MUNICIPIUL BOTOŞANI",35731,1,PART,PRCNCT,PRSD,PRSD_SV,"2025-05-18 21:39:14",716,393,346,31,16,387,6,800,407,160,227
7,BOTOŞANI,"LICEUL „ALEXANDRU CEL BUN”",33,"MUNICIPIUL BOTOŞANI",35731,1,PART,PRCNCT,PRSD,PRSD_SV,"2025-05-18 21:29:06",794,545,396,48,101,534,11,1000,455,248,286
7,BOTOŞANI,"ŞCOALA GIMNAZIALĂ „ȘTEFAN CEL MARE”",34,"MUNICIPIUL BOTOŞANI",35731,1,PART,PRCNCT,PRSD,PRSD_SV,"2025-05-18 21:25:15",878,500,428,72,0,493,7,1000,500,205,288
7,BOTOŞANI,"ŞCOALA GIMNAZIALĂ „ȘTEFAN CEL MARE”",35,"MUNICIPIUL BOTOŞANI",35731,1,PART,PRCNCT,PRSD,PRSD_SV,"2025-05-18 21:37:17",1385,750,703,47,0,735,15,1500,750,296,439
7,BOTOŞANI,"ŞCOALA GIMNAZIALĂ „ȘTEFAN CEL MARE”",36,"MUNICIPIUL BOTOŞANI",35731,1,PART,PRCNCT,PRSD,PRSD_SV,"2025-05-18 21:39:31",550,310,276,34,0,304,6,600,290,143,161
7,BOTOŞANI,"ŞCOALA GIMNAZIALĂ „ȘTEFAN CEL MARE”",37,"MUNICIPIUL BOTOŞANI",35731,1,PART,PRCNCT,PRSD,PRSD_SV,"2025-05-18 21:31:16",1018,542,489,53,0,537,5,1200,658,231,306
7,BOTOŞANI,"ŞCOALA GIMNAZIALĂ „ȘTEFAN CEL MARE”",38,"MUNICIPIUL BOTOŞANI",35731,1,PART,PRCNCT,PRSD,PRSD_SV,"2025-05-18 21:46:05",1035,481,452,29,0,472,9,1100,619,186,286
7,BOTOŞANI,"ŞCOALA GIMNAZIALĂ „ȘTEFAN CEL MARE”",39,"MUNICIPIUL BOTOŞANI",35731,1,PART,PRCNCT,PRSD,PRSD_SV,"2025-05-18 22:00:31",1078,500,466,34,0,491,9,1200,700,220,271
7,BOTOŞANI,"GRĂDINIŢA CU PROGRAM PRELUNGIT NR. 22",40,"MUNICIPIUL BOTOŞANI",35731,1,PART,PRCNCT,PRSD,PRSD_SV,"2025-05-18 21:27:52",1127,548,513,35,0,540,8,1200,652,293,247
7,BOTOŞANI,"GRĂDINIŢA CU PROGRAM PRELUNGIT NR. 22",41,"MUNICIPIUL BOTOŞANI",35731,1,PART,PRCNCT,PRSD,PRSD_SV,"2025-05-18 21:24:45",838,457,434,22,1,447,10,900,443,160,287
7,BOTOŞANI,"GRĂDINIŢA CU PROGRAM PRELUNGIT NR. 22",42,"MUNICIPIUL BOTOŞANI",35731,1,PART,PRCNCT,PRSD,PRSD_SV,"2025-05-18 21:35:32",920,415,402,12,1,408,7,1000,585,199,209
7,BOTOŞANI,"GRĂDINIŢA CU PROGRAM PRELUNGIT NR. 22",43,"MUNICIPIUL BOTOŞANI",35731,1,PART,PRCNCT,PRSD,PRSD_SV,"2025-05-18 21:19:58",909,436,417,19,0,430,6,1000,564,218,212
7,BOTOŞANI,"ŞCOALA GIMNAZIALĂ „ELENA RAREȘ”",44,"MUNICIPIUL BOTOŞANI",35731,1,PART,PRCNCT,PRSD,PRSD_SV,"2025-05-18 21:46:52",1190,552,536,16,0,539,13,1400,848,250,289
7,BOTOŞANI,"ŞCOALA GIMNAZIALĂ „ELENA RAREȘ”",45,"MUNICIPIUL BOTOŞANI",35731,1,PART,PRCNCT,PRSD,PRSD_SV,"2025-05-18 21:28:57",1279,612,580,30,2,594,18,1400,788,264,330
7,BOTOŞANI,"ŞCOALA GIMNAZIALĂ „ELENA RAREȘ”",46,"MUNICIPIUL BOTOŞANI",35731,1,PART,PRCNCT,PRSD,PRSD_SV,"2025-05-18 21:28:03",953,434,389,44,1,429,5,1100,666,183,246
7,BOTOŞANI,"ŞCOALA GIMNAZIALĂ „ELENA RAREȘ”",47,"MUNICIPIUL BOTOŞANI",35731,1,PART,PRCNCT,PRSD,PRSD_SV,"2025-05-18 22:02:02",1215,619,542,77,0,604,15,1300,681,279,325
7,BOTOŞANI,"ȘCOALA GIMNAZIALĂ ”ȘTEFAN CEL MARE”, BOTOȘANI",48,"MUNICIPIUL BOTOŞANI",35731,1,PART,PRCNCT,PRSD,PRSD_SV,"2025-05-18 21:25:04",1040,527,498,29,0,519,8,1100,573,188,331
7,BOTOŞANI,"ȘCOALA GIMNAZIALĂ ”ȘTEFAN CEL MARE”, BOTOȘANI",49,"MUNICIPIUL BOTOŞANI",35731,1,PART,PRCNCT,PRSD,PRSD_SV,"2025-05-18 21:28:41",753,404,388,16,0,396,8,800,396,128,268
7,BOTOŞANI,"ȘCOALA GIMNAZIALĂ ”ȘTEFAN CEL MARE”, BOTOȘANI",50,"MUNICIPIUL BOTOŞANI",35731,1,PART,PRCNCT,PRSD,PRSD_SV,"2025-05-18 21:33:04",1117,545,525,19,1,536,9,1200,655,183,353
7,BOTOŞANI,"ŞCOALA GIMNAZIALĂ ”ȘTEFAN CEL MARE”, BOTOȘANI",51,"MUNICIPIUL BOTOŞANI",35731,1,PART,PRCNCT,PRSD,PRSD_SV,"2025-05-18 21:46:57",980,439,425,14,0,435,4,1100,661,192,243
7,BOTOŞANI,"ȘCOALA GIMNAZIALĂ ”ȘTEFAN CEL MARE”, BOTOȘANI",52,"MUNICIPIUL BOTOŞANI",35731,1,PART,PRCNCT,PRSD,PRSD_SV,"2025-05-18 21:28:02",571,283,271,12,0,280,3,700,417,79,201
7,BOTOŞANI,"ȘCOALA GIMNAZIALĂ ”ELENA RAREȘ”, BOTOȘANI",53,"MUNICIPIUL BOTOŞANI",35731,1,PART,PRCNCT,PRSD,PRSD_SV,"2025-05-18 21:26:02",1117,454,420,34,0,448,6,1200,746,285,163
7,BOTOŞANI,"ŞCOALA GIMNAZIALĂ ”ELENA RAREȘ”, BOTOȘANI",54,"MUNICIPIUL BOTOŞANI",35731,1,PART,PRCNCT,PRSD,PRSD_SV,"2025-05-18 22:43:09",1180,557,471,85,1,548,9,1300,743,311,237
7,BOTOŞANI,"ȘCOALA GIMNAZIALĂ ”ELENA RAREȘ”, BOTOȘANI",55,"MUNICIPIUL BOTOŞANI",35731,2,PART,PRCNCT,PRSD,PRSD_SV,"2025-05-18 22:14:49",1220,479,448,31,0,470,9,1300,821,257,213
7,BOTOŞANI,"ŞCOALA GIMNAZIALĂ ”ELENARAREȘ”, BOTOȘANI",56,"MUNICIPIUL BOTOŞANI",35731,1,PART,PRCNCT,PRSD,PRSD_SV,"2025-05-18 21:33:48",558,261,224,37,0,256,5,700,439,132,124
7,BOTOŞANI,"COLEGIUL ECONOMIC „OCTAV ONICESCU”",57,"MUNICIPIUL BOTOŞANI",35731,1,PART,PRCNCT,PRSD,PRSD_SV,"2025-05-18 21:54:19",908,457,396,58,3,446,11,1100,643,186,260
7,BOTOŞANI,"COLEGIUL ECONOMIC „OCTAV ONICESCU”",58,"MUNICIPIUL BOTOŞANI",35731,1,PART,PRCNCT,PRSD,PRSD_SV,"2025-05-18 22:43:11",1517,937,866,71,0,932,5,1600,663,357,575
7,BOTOŞANI,"COLEGIUL ECONOMIC „OCTAV ONICESCU”",59,"MUNICIPIUL BOTOŞANI",35731,1,PART,PRCNCT,PRSD,PRSD_SV,"2025-05-18 21:37:53",1163,627,588,39,0,621,6,1300,673,208,413
7,BOTOŞANI,"GRĂDINIȚA CU PROGRAM PRELUNGIT NR. 20",60,"MUNICIPIUL BOTOŞANI",35731,1,PART,PRCNCT,PRSD,PRSD_SV,"2025-05-18 21:42:08",1748,994,935,58,1,965,29,1800,806,526,439
7,BOTOŞANI,"ŞCOALA GIMNAZIALĂ NR. 10",61,"MUNICIPIUL BOTOŞANI",35731,1,PART,PRCNCT,PRSD,PRSD_SV,"2025-05-18 22:27:10",1239,717,641,76,0,709,8,1300,583,263,446
7,BOTOŞANI,"ŞCOALA GIMNAZIALĂ NR. 10",62,"MUNICIPIUL BOTOŞANI",35731,1,PART,PRCNCT,PRSD,PRSD_SV,"2025-05-18 22:01:13",1294,669,629,39,1,662,7,1400,731,281,381
7,BOTOŞANI,"ŞCOALA GIMNAZIALĂ NR. 10",63,"MUNICIPIUL BOTOŞANI",35731,1,PART,PRCNCT,PRSD,PRSD_SV,"2025-05-18 21:55:41",1301,757,712,45,0,746,11,1500,743,273,473
7,BOTOŞANI,"COLEGIUL NAŢIONAL „A.T. LAURIAN”",64,"MUNICIPIUL BOTOŞANI",35731,1,PART,PRCNCT,PRSD,PRSD_SV,"2025-05-18 21:48:21",1220,778,615,162,1,760,18,1300,522,254,506
7,BOTOŞANI,"COLEGIUL NAŢIONAL „A.T. LAURIAN”",65,"MUNICIPIUL BOTOŞANI",35731,1,PART,PRCNCT,PRSD,PRSD_SV,"2025-05-18 21:53:59",1221,645,562,82,1,635,10,1300,655,271,364
7,BOTOŞANI,"LOCAL CLUBUL PENSIONARILOR",66,"MUNICIPIUL BOTOŞANI",35731,3,PART,PRCNCT,PRSD,PRSD_SV,"2025-05-19 00:22:18",1022,517,456,61,0,509,8,1100,583,288,221
7,BOTOŞANI,"ŞCOALA GIMNAZIALĂ „SFÂNTUL NICOLAE”",67,"MUNICIPIUL BOTOŞANI",35731,1,PART,PRCNCT,PRSD,PRSD_SV,"2025-05-18 21:58:42",1250,639,615,24,0,624,15,1300,661,277,347
7,BOTOŞANI,"ŞCOALA GIMNAZIALĂ „SFÂNTUL NICOLAE”",68,"MUNICIPIUL BOTOŞANI",35731,1,PART,PRCNCT,PRSD,PRSD_SV,"2025-05-18 21:30:59",904,558,406,55,97,549,9,1000,442,271,278
7,BOTOŞANI,"ŞCOALA GIMNAZIALĂ „SFÂNTUL NICOLAE”",69,"MUNICIPIUL BOTOŞANI",35731,1,PART,PRCNCT,PRSD,PRSD_SV,"2025-05-18 21:29:29",1261,640,615,25,0,630,10,1400,760,304,326
7,BOTOŞANI,"LICEUL „DIMITRIE NEGREANU”",70,"MUNICIPIUL BOTOŞANI",35731,1,PART,PRCNCT,PRSD,PRSD_SV,"2025-05-18 22:03:25",1163,576,551,25,0,573,3,1260,684,239,334
7,BOTOŞANI,"LICEUL „DIMITRIE NEGREANU”",71,"MUNICIPIUL BOTOŞANI",35731,1,PART,PRCNCT,PRSD,PRSD_SV,"2025-05-18 21:30:38",1197,651,584,20,47,641,10,1300,649,262,379
7,BOTOŞANI,"LICEUL „DIMITRIE NEGREANU”",72,"MUNICIPIUL BOTOŞANI",35731,1,PART,PRCNCT,PRSD,PRSD_SV,"2025-05-18 21:41:22",1051,528,494,34,0,518,10,1200,672,209,309
7,BOTOŞANI,"ŞCOALA GIMNAZIALĂ „GRIGORE ANTIPA”",73,"MUNICIPIUL BOTOŞANI",35731,1,PART,PRCNCT,PRSD,PRSD_SV,"2025-05-18 21:50:12",884,460,398,62,0,453,7,1000,540,220,233
7,BOTOŞANI,"ŞCOALA GIMNAZIALĂ „GRIGORE ANTIPA”",74,"MUNICIPIUL BOTOŞANI",35731,1,PART,PRCNCT,PRSD,PRSD_SV,"2025-05-18 21:24:37",737,379,343,36,0,376,3,1000,621,151,225
7,BOTOŞANI,"ŞCOALA GIMNAZIALĂ „GRIGORE ANTIPA”",75,"MUNICIPIUL BOTOŞANI",35731,2,PART,PRCNCT,PRSD,PRSD_SV,"2025-05-18 22:32:38",1128,578,545,33,0,567,11,1200,622,254,313
7,BOTOŞANI,"ŞCOALA GIMNAZIALĂ „GRIGORE ANTIPA”",76,"MUNICIPIUL BOTOŞANI",35731,1,PART,PRCNCT,PRSD,PRSD_SV,"2025-05-18 21:31:51",1088,555,516,39,0,549,6,1200,645,223,326
7,BOTOŞANI,"ŞCOALA GIMNAZIALĂ „GRIGORE ANTIPA”",77,"MUNICIPIUL BOTOŞANI",35731,1,PART,PRCNCT,PRSD,PRSD_SV,"2025-05-18 21:28:04",707,394,350,44,0,385,9,800,406,158,227
7,BOTOŞANI,"LICEUL TEHNOLOGIC „PETRU RAREȘ”",78,"MUNICIPIUL BOTOŞANI",35731,1,PART,PRCNCT,PRSD,PRSD_SV,"2025-05-18 21:27:24",1345,628,602,26,0,616,12,1600,972,246,370
7,BOTOŞANI,"LICEUL TEHNOLOGIC „PETRU RAREȘ”",79,"MUNICIPIUL BOTOŞANI",35731,3,PART,PRCNCT,PRSD,PRSD_SV,"2025-05-18 22:58:26",989,690,480,22,188,672,18,1200,510,367,305
7,BOTOŞANI,"LICEUL TEHNOLOGIC „PETRU RAREȘ”",80,"MUNICIPIUL BOTOŞANI",35731,1,PART,PRCNCT,PRSD,PRSD_SV,"2025-05-18 21:37:53",1260,748,557,32,159,727,21,1500,752,388,339
7,BOTOŞANI,"GRĂDINIŢA CU PROGRAM NORMAL NR. 8",81,"MUNICIPIUL BOTOŞANI",35731,1,PART,PRCNCT,PRSD,PRSD_SV,"2025-05-18 21:46:45",1591,815,781,34,0,801,14,1700,885,479,322
7,BOTOŞANI,"GRĂDINIȚA CU PROGRAM NORMAL NR. 16",82,"MUNICIPIUL BOTOŞANI",35731,1,PART,PRCNCT,PRSD,PRSD_SV,"2025-05-18 21:39:26",1007,547,512,35,0,542,5,1200,653,281,261
7,BOTOŞANI,"LICEUL TEHNOLOGIC ”ELIE RADU”, BOTOȘANI",83,"MUNICIPIUL BOTOŞANI",35731,1,PART,PRCNCT,PRSD,PRSD_SV,"2025-05-18 21:29:31",1325,737,665,34,38,729,8,1500,763,332,397
7,BOTOŞANI,"LICEUL TEHNOLOGIC ”ELIE RADU”, BOTOȘANI",84,"MUNICIPIUL BOTOŞANI",35731,1,PART,PRCNCT,PRSD,PRSD_SV,"2025-05-18 22:27:33",1593,762,698,61,3,756,6,1800,1038,374,382
7,BOTOŞANI,"LICEUL TEHNOLOGIC ”ELIE RADU”, BOTOȘANI",85,"MUNICIPIUL BOTOŞANI",35731,1,PART,PRCNCT,PRSD,PRSD_SV,"2025-05-18 21:53:15",1080,767,499,28,240,754,13,1300,533,412,342
7,BOTOŞANI,"COLEGIUL NAȚIONAL ”GRIGORE GHICA” DOROHOI",86,"MUNICIPIUL DOROHOI",36006,1,PART,PRCNCT,PRSD,PRSD_SV,"2025-05-18 21:45:43",1264,586,546,40,0,578,8,1400,814,239,339
7,BOTOŞANI,"COLEGIUL NAȚIONAL”GRIGORE GHICA”DOROHOI",87,"MUNICIPIUL DOROHOI",36006,2,PART,PRCNCT,PRSD,PRSD_SV,"2025-05-19 00:09:20",997,481,434,47,0,468,13,1100,619,175,293
7,BOTOŞANI,"GRĂDINIȚA CU PROGRAM PRELUNGIT NR.6 DOROHOI(PREȘCOLAR)",88,"MUNICIPIUL DOROHOI",36006,1,PART,PRCNCT,PRSD,PRSD_SV,"2025-05-18 21:49:49",1657,805,768,37,0,794,11,1800,995,370,424
7,BOTOŞANI,"ȘCOALA GIMNAZIALĂ ”SPIRU HARET” DOROHOI",89,"MUNICIPIUL DOROHOI",36006,1,PART,PRCNCT,PRSD,PRSD_SV,"2025-05-18 22:04:30",1295,631,579,51,1,627,4,1400,769,285,342
7,BOTOŞANI,"ȘCOALA GIMNAZIALĂ”SPIRU HARET” DOROHOI",90,"MUNICIPIUL DOROHOI",36006,1,PART,PRCNCT,PRSD,PRSD_SV,"2025-05-18 21:39:15",910,464,432,31,1,457,7,1000,536,194,263
7,BOTOŞANI,"ȘCOALA GIMNAZIALĂ NR.1 DOROHOI",91,"MUNICIPIUL DOROHOI",36006,1,PART,PRCNCT,PRSD,PRSD_SV,"2025-05-18 21:50:07",1163,581,479,101,1,573,8,1200,619,268,305
7,BOTOŞANI,"COLEGIUL NAȚIONAL ”GRIGORE GHICA ”DOROHOI-CORP II",92,"MUNICIPIUL DOROHOI",36006,1,PART,PRCNCT,PRSD,PRSD_SV,"2025-05-18 21:53:05",1086,537,465,67,5,534,3,1200,663,256,278
7,BOTOŞANI,"ȘCOALA GIMNAZIALĂ ”ȘTEFAN CEL MARE” DOROHOI",93,"MUNICIPIUL DOROHOI",36006,1,PART,PRCNCT,PRSD,PRSD_SV,"2025-05-18 21:36:35",1010,446,409,36,1,438,8,1100,654,224,214
7,BOTOŞANI,"ȘCOALA GIMNAZIALĂ ” ȘTEFAN CEL MARE” DOROHOI",94,"MUNICIPIUL DOROHOI",36006,1,PART,PRCNCT,PRSD,PRSD_SV,"2025-05-18 21:58:22",959,495,465,27,3,487,8,1000,505,225,262
7,BOTOŞANI,"ȘCOALA GIMNAZIALĂ ”ALEXANDRU IOAN CUZA” DOROHOI",95,"MUNICIPIUL DOROHOI",36006,1,PART,PRCNCT,PRSD,PRSD_SV,"2025-05-18 21:43:12",1037,433,401,32,0,431,2,1100,667,221,210
7,BOTOŞANI,"ȘCOALA GIMNAZIALĂ ”ALEXANDRU IOAN CUZA” DOROHOI",96,"MUNICIPIUL DOROHOI",36006,1,PART,PRCNCT,PRSD,PRSD_SV,"2025-05-18 21:51:51",1328,584,555,29,0,572,12,1400,816,346,226
7,BOTOŞANI,"ȘCOALA GIMNAZIALĂ ”ALEXANDRU IOAN CUZA” DOROHOI",97,"MUNICIPIUL DOROHOI",36006,1,PART,PRCNCT,PRSD,PRSD_SV,"2025-05-18 21:39:13",772,387,344,43,0,376,11,900,513,158,218
7,BOTOŞANI,"LICEUL ”REGINA MARIA” DOROHOI",98,"MUNICIPIUL DOROHOI",36006,1,PART,PRCNCT,PRSD,PRSD_SV,"2025-05-18 21:47:07",1304,595,549,46,0,584,11,1400,805,326,258
7,BOTOŞANI,"LICEUL ”REGINA MARIA” DOROHOI",99,"MUNICIPIUL DOROHOI",36006,1,PART,PRCNCT,PRSD,PRSD_SV,"2025-05-18 21:50:40",1127,524,503,21,0,513,11,1200,676,240,273
7,BOTOŞANI,"ȘCOALA GIMNAZIALĂ ”MIHAIL KOGĂLNICEANU” DOROHOI",100,"MUNICIPIUL DOROHOI",36006,1,PART,PRCNCT,PRSD,PRSD_SV,"2025-05-18 21:43:59",1245,522,502,20,0,517,5,1300,778,222,295
7,BOTOŞANI,"ȘCOALA GIMNAZIALĂ ”MIHAIL KOGĂLNICEANU” DOROHOI",101,"MUNICIPIUL DOROHOI",36006,1,PART,PRCNCT,PRSD,PRSD_SV,"2025-05-18 21:53:48",1106,510,441,67,2,508,2,1200,690,248,260
7,BOTOŞANI,"GRĂDINIȚA CU PROGRAM PRELUNGIT ” ALBA CA ZĂPADA” DOROHOI",102,"MUNICIPIUL DOROHOI",36006,1,PART,PRCNCT,PRSD,PRSD_SV,"2025-05-18 21:38:19",1028,414,388,26,0,405,9,1300,886,207,198
7,BOTOŞANI,"GRĂDINIȚA CU PROGRAM PRELUNGIT”ALBA CA ZĂPADA” DOROHOI",103,"MUNICIPIUL DOROHOI",36006,1,PART,PRCNCT,PRSD,PRSD_SV,"2025-05-18 21:33:50",1285,682,578,36,68,671,11,1500,818,309,362
7,BOTOŞANI,"ȘCOALA GIMNAZIALĂ ” DIMITRIE ROMANESCU” DOROHOI",104,"MUNICIPIUL DOROHOI",36006,1,PART,PRCNCT,PRSD,PRSD_SV,"2025-05-18 21:20:48",919,433,420,13,0,425,8,1000,567,215,210
7,BOTOŞANI,"ȘCOALA GIMNAZIALĂ ”DIMITRIE ROMANESCU” DOROHOI",105,"MUNICIPIUL DOROHOI",36006,1,PART,PRCNCT,PRSD,PRSD_SV,"2025-05-18 21:49:11",1114,501,477,22,2,494,7,1200,699,275,219
7,BOTOŞANI,"CLĂDIRE ȘCOALĂ(GRĂDINIȚĂ) SATU NOU",106,"MUNICIPIUL DOROHOI",36006,1,PART,PRCNCT,PRSD,PRSD_SV,"2025-05-18 21:35:43",690,333,316,17,0,329,4,800,467,195,134
7,BOTOŞANI,"CLĂDIRE ȘCOALĂ LOTURI ENESCU",107,"MUNICIPIUL DOROHOI",36006,1,PART,PRCNCT,PRSD,PRSD_SV,"2025-05-18 21:23:48",348,185,170,15,0,183,2,400,215,134,49
7,BOTOŞANI,"SCOALA NR.1 BUCECEA",108,"ORAŞ BUCECEA",36453,1,PART,PRCNCT,PRSD,PRSD_SV,"2025-05-18 21:41:20",785,369,324,42,3,367,2,900,531,248,119
7,BOTOŞANI,"CENTRUL CULTURAL BUCECEA",109,"ORAŞ BUCECEA",36453,1,PART,PRCNCT,PRSD,PRSD_SV,"2025-05-18 21:28:51",1749,729,663,66,0,712,17,1800,1071,387,325
7,BOTOŞANI,"SCOALA NR.2 BUCECEA",110,"ORAŞ BUCECEA",36453,1,PART,PRCNCT,PRSD,PRSD_SV,"2025-05-18 21:36:31",1785,619,584,33,2,608,11,1800,1181,363,245
7,BOTOŞANI,"SCOALA CALINESTI",111,"ORAŞ BUCECEA",36453,1,PART,PRCNCT,PRSD,PRSD_SV,"2025-05-18 21:25:59",528,224,196,27,1,222,2,600,376,145,77
7,BOTOŞANI,"LICEUL”DIMITRIE CANTEMIR",112,"ORAŞ DARABANI",35946,1,PART,PRCNCT,PRSD,PRSD_SV,"2025-05-18 21:47:09",1523,614,555,59,0,602,12,1600,986,312,290
7,BOTOŞANI,"ŞCOALA GIMNAZIALĂ”LEON DĂNĂILĂ”",113,"ORAŞ DARABANI",35946,1,PART,PRCNCT,PRSD,PRSD_SV,"2025-05-18 21:51:17",1598,591,568,22,1,580,11,1700,1109,305,275
7,BOTOŞANI,"ŞCOALA GIMNAZIALĂ ”LEON DĂNĂILĂ”",114,"ORAŞ DARABANI",35946,1,PART,PRCNCT,PRSD,PRSD_SV,"2025-05-18 21:33:31",1578,578,531,46,1,570,8,1700,1122,258,312
7,BOTOŞANI,"GRĂDINIŢA NR.2",115,"ORAŞ DARABANI",35946,1,PART,PRCNCT,PRSD,PRSD_SV,"2025-05-18 21:48:43",1603,590,547,43,0,584,6,1700,1110,251,333
7,BOTOŞANI,"ȘCOALA GIMNAZIALĂ NR. 2 - DARABANI",116,"ORAŞ DARABANI",35946,1,PART,PRCNCT,PRSD,PRSD_SV,"2025-05-18 21:35:57",968,364,350,13,1,357,7,1100,736,201,156
7,BOTOŞANI,"ŞCOALA TEIOASA",117,"ORAŞ DARABANI",35946,1,PART,PRCNCT,PRSD,PRSD_SV,"2025-05-18 21:52:56",1054,374,355,19,0,368,6,1200,826,212,156
7,BOTOŞANI,"ŞCOALAL BAJURA",118,"ORAŞ DARABANI",35946,1,PART,PRCNCT,PRSD,PRSD_SV,"2025-05-18 21:42:22",1481,560,527,33,0,552,8,1600,1040,275,277
7,BOTOŞANI,"ŞCOALA EŞANCA",119,"ORAŞ DARABANI",35946,1,PART,PRCNCT,PRSD,PRSD_SV,"2025-05-18 21:19:35",262,95,73,22,0,95,0,300,205,59,36
7,BOTOŞANI,"ŞCOALA LIŞMĂNIŢA",120,"ORAŞ DARABANI",35946,1,PART,PRCNCT,PRSD,PRSD_SV,"2025-05-18 21:35:26",521,208,192,16,0,204,4,600,392,119,85
7,BOTOŞANI,"ȘCOALA GIMNAZIALĂ ”MIHAIL STURZA”",121,"ORAŞ FLĂMÂNZI",37280,1,PART,PRCNCT,PRSD,PRSD_SV,"2025-05-18 21:15:44",595,251,231,18,2,250,1,700,449,129,121
7,BOTOŞANI,"ȘCOALA .GIMNAZIALĂ ”MIHAIL STURZA”",122,"ORAŞ FLĂMÂNZI",37280,1,PART,PRCNCT,PRSD,PRSD_SV,"2025-05-18 21:22:44",862,344,320,17,7,337,7,1000,656,182,155
7,BOTOŞANI,"ȘCOALA.GIMNAZIALĂ ”ION BOJOI”",123,"ORAŞ FLĂMÂNZI",37280,1,PART,PRCNCT,PRSD,PRSD_SV,"2025-05-18 21:15:15",1086,463,428,35,0,456,7,1200,737,253,203
7,BOTOŞANI,"CASA DE CULTURA ”NICOLAE SEVEREANU”",124,"ORAŞ FLĂMÂNZI",37280,1,PART,PRCNCT,PRSD,PRSD_SV,"2025-05-18 21:20:42",1132,494,428,65,1,487,7,1200,706,246,241
7,BOTOŞANI,"CENTRUL DE SPRIJINIRE A AFACERILOR FLĂMÂNZI",125,"ORAŞ FLĂMÂNZI",37280,1,PART,PRCNCT,PRSD,PRSD_SV,"2025-05-18 21:25:19",991,471,440,31,0,468,3,1100,629,242,226
7,BOTOŞANI,"LICEUL TEHNOLOGIC ”NICOLAE BĂLCESCU”",126,"ORAŞ FLĂMÂNZI",37280,1,PART,PRCNCT,PRSD,PRSD_SV,"2025-05-18 21:31:28",1010,451,410,41,0,443,8,1200,749,260,183
7,BOTOŞANI,"LICEUL TEHNOLOGIC ”NICOLAE BĂLCESCU”",127,"ORAŞ FLĂMÂNZI",37280,1,PART,PRCNCT,PRSD,PRSD_SV,"2025-05-18 21:22:36",1166,523,481,16,26,514,9,1200,677,271,243
7,BOTOŞANI,"ȘCOALA GIMNAZIALĂ ”CONSTANTIN COMICESCU”",128,"ORAŞ FLĂMÂNZI",37280,1,PART,PRCNCT,PRSD,PRSD_SV,"2025-05-18 21:20:45",1350,575,518,51,6,573,2,1400,825,347,226
7,BOTOŞANI,"ȘCOALA PRIMARĂ ”GHEORGHE PRICOP”",129,"ORAŞ FLĂMÂNZI",37280,1,PART,PRCNCT,PRSD,PRSD_SV,"2025-05-18 21:18:42",457,193,170,21,2,191,2,600,407,121,70
7,BOTOŞANI,"ȘCOALA GIMNAZIALĂ ”PETRU ZAMFIRESCU”",130,"ORAŞ FLĂMÂNZI",37280,1,PART,PRCNCT,PRSD,PRSD_SV,"2025-05-18 21:16:54",480,187,168,19,0,187,0,600,413,122,65
7,BOTOŞANI,"LICEUL TEORETIC DR. M. CIUCA SAVENI",131,"ORAŞ SĂVENI",36060,1,PART,PRCNCT,PRSD,PRSD_SV,"2025-05-18 21:52:37",1143,525,467,58,0,518,7,1200,675,290,228
7,BOTOŞANI,"LICEUL TEORETIC DR. M.CIUCA SAVENI",132,"ORAŞ SĂVENI",36060,1,PART,PRCNCT,PRSD,PRSD_SV,"2025-05-18 21:38:42",898,445,366,47,32,437,8,1000,555,210,227
7,BOTOŞANI,"SCOALA GENERALA NR. 1 SAVENI",133,"ORAŞ SĂVENI",36060,1,PART,PRCNCT,PRSD,PRSD_SV,"2025-05-18 21:48:53",1601,669,612,57,0,655,14,1700,1031,332,323
7,BOTOŞANI,"SCOALA GENERALA NR. 2 SAVENI",134,"ORAŞ SĂVENI",36060,1,PART,PRCNCT,PRSD,PRSD_SV,"2025-05-18 21:32:44",1458,617,583,33,1,607,10,1600,983,305,302
7,BOTOŞANI,"SCOALA GENERALA BODEASA",135,"ORAŞ SĂVENI",36060,1,PART,PRCNCT,PRSD,PRSD_SV,"2025-05-18 21:14:21",317,128,111,17,0,127,1,400,272,84,43
7,BOTOŞANI,"ȘCOALA PRIMARĂ NR. 2 BOZIENI",136,"ORAŞ SĂVENI",36060,1,PART,PRCNCT,PRSD,PRSD_SV,"2025-05-18 21:22:09",220,120,94,26,0,120,0,300,180,82,38
7,BOTOŞANI,"SCOALA GENERALA PETRICANI",137,"ORAŞ SĂVENI",36060,1,PART,PRCNCT,PRSD,PRSD_SV,"2025-05-18 21:55:44",956,370,333,37,0,367,3,1000,630,195,172
7,BOTOŞANI,"LICEUL TEORETIC ”STEFAN D. LUCHIAN” CORP C2",138,"ORAŞ ŞTEFĂNEŞTI",39168,1,PART,PRCNCT,PRSD,PRSD_SV,"2025-05-18 22:01:18",1163,472,421,51,0,466,6,1300,828,262,204
7,BOTOŞANI,"LICEUL TEORETIC ”STEFAN D. LUCHIAN”",139,"ORAŞ ŞTEFĂNEŞTI",39168,1,PART,PRCNCT,PRSD,PRSD_SV,"2025-05-18 21:54:47",943,372,326,46,0,368,4,1000,628,214,154
7,BOTOŞANI,"SCOALA PRIMARA BADIUTI",140,"ORAŞ ŞTEFĂNEŞTI",39168,1,PART,PRCNCT,PRSD,PRSD_SV,"2025-05-18 21:31:51",830,332,301,31,0,329,3,900,568,242,87
7,BOTOŞANI,"SCOALA GIMNAZIALA BOBULESTI",141,"ORAŞ ŞTEFĂNEŞTI",39168,1,PART,PRCNCT,PRSD,PRSD_SV,"2025-05-18 21:37:54",1049,432,372,60,0,429,3,1100,668,206,223
7,BOTOŞANI,"SCOALA PRIMARA STANCA",142,"ORAŞ ŞTEFĂNEŞTI",39168,1,PART,PRCNCT,PRSD,PRSD_SV,"2025-05-18 21:35:12",706,316,251,65,0,312,4,800,484,179,133
7,BOTOŞANI,"ȘCOALA GIMNAZIALĂ NR. 1 ADĂȘENI",143,ADĂŞENI,40035,1,PART,PRCNCT,PRSD,PRSD_SV,"2025-05-18 21:38:58",1448,290,237,34,19,288,2,1600,1310,197,91
7,BOTOŞANI,"SCOALA ZOITANI",144,ADĂŞENI,40035,1,PART,PRCNCT,PRSD,PRSD_SV,"2025-05-18 21:17:03",389,129,96,32,1,129,0,400,271,86,43
7,BOTOŞANI,"CAMIN CULTURAL ALBESTI",145,ALBEŞTI,36131,1,PART,PRCNCT,PRSD,PRSD_SV,"2025-05-18 21:25:34",927,402,375,27,0,398,4,1000,598,218,180
7,BOTOŞANI,"SCOALA PRIMARA NR.1 ALBESTI",146,ALBEŞTI,36131,1,PART,PRCNCT,PRSD,PRSD_SV,"2025-05-18 21:22:19",602,253,234,18,1,250,3,700,447,177,73
7,BOTOŞANI,"ȘCOALA GIMNAZIALĂ NR.1 ALBEȘTI",147,ALBEŞTI,36131,1,PART,PRCNCT,PRSD,PRSD_SV,"2025-05-18 21:15:10",602,227,206,21,0,226,1,700,473,140,86
7,BOTOŞANI,"SCOALA PRIMARA NR.3 COSTIUGENI",148,ALBEŞTI,36131,1,PART,PRCNCT,PRSD,PRSD_SV,"2025-05-18 21:09:47",414,188,163,25,0,186,2,500,312,116,70
7,BOTOŞANI,"SCOALA PRIMARA NR.4 JIJIA",149,ALBEŞTI,36131,1,PART,PRCNCT,PRSD,PRSD_SV,"2025-05-18 21:24:17",480,206,185,21,0,205,1,600,394,143,62
7,BOTOŞANI,"SCOALA PRIMARA NR.5 MASCATENI",150,ALBEŞTI,36131,1,PART,PRCNCT,PRSD,PRSD_SV,"2025-05-18 21:20:14",323,147,129,18,0,143,4,400,253,109,34
7,BOTOŞANI,"SCOALA GIMNAZIALA NR.2 TUDOR VLADIMIRESCU",151,ALBEŞTI,36131,1,PART,PRCNCT,PRSD,PRSD_SV,"2025-05-18 21:24:10",730,268,248,20,0,267,1,800,532,216,51
7,BOTOŞANI,"SCOALA GIMNAZIALA NR.2 TUDOR VLADIMIRESCU",152,ALBEŞTI,36131,1,PART,PRCNCT,PRSD,PRSD_SV,"2025-05-18 21:25:40",782,253,237,16,0,249,4,800,547,210,39
7,BOTOŞANI,"ȘCOALA GIMNAZIALĂ NR.1 AVRĂMENI",153,AVRĂMENI,36202,1,PART,PRCNCT,PRSD,PRSD_SV,"2025-05-18 21:30:41",1267,443,408,34,1,437,6,1300,857,306,131
7,BOTOŞANI,"ȘCOALA PRIMARĂ NR.4 AUREL VLAICU",154,AVRĂMENI,36202,1,PART,PRCNCT,PRSD,PRSD_SV,"2025-05-18 21:33:39",448,190,180,10,0,186,4,500,310,90,96
7,BOTOŞANI,"SCOALA CU CLASELE 1-4 ICHIMENI",155,AVRĂMENI,36202,1,PART,PRCNCT,PRSD,PRSD_SV,"2025-05-18 21:28:37",94,35,22,13,0,35,0,200,165,17,18
7,BOTOŞANI,"SCOALA PRIMARĂ NR.1 TIMUȘ SAT TIMUȘ",156,AVRĂMENI,36202,1,PART,PRCNCT,PRSD,PRSD_SV,"2025-05-18 21:41:48",542,196,183,13,0,194,2,600,404,117,77
7,BOTOŞANI,"ȘCOALA GIMNAZIALĂ NR.3 TUDOR VLADIMIRESCU",157,AVRĂMENI,36202,1,PART,PRCNCT,PRSD,PRSD_SV,"2025-05-18 21:26:23",623,260,229,31,0,256,4,700,440,151,105
7,BOTOŞANI,"SCOALA BALUSENI",158,BĂLUŞENI,36300,1,PART,PRCNCT,PRSD,PRSD_SV,"2025-05-18 21:45:53",1106,454,401,52,1,447,7,1200,746,293,154
7,BOTOŞANI,"SCOALA BALUSENII NOI",159,BĂLUŞENI,36300,1,PART,PRCNCT,PRSD,PRSD_SV,"2025-05-18 21:16:41",251,112,99,13,0,112,0,300,188,99,13
7,BOTOŞANI,"SCOALA BUZENI",160,BĂLUŞENI,36300,1,PART,PRCNCT,PRSD,PRSD_SV,"2025-05-18 21:12:50",546,221,195,22,4,218,3,600,379,137,81
7,BOTOŞANI,"SCOALA DRAXINI",161,BĂLUŞENI,36300,1,PART,PRCNCT,PRSD,PRSD_SV,"2025-05-18 21:48:16",1476,670,573,97,0,666,4,1600,930,382,284
7,BOTOŞANI,"SCOALA ZAICESTI",162,BĂLUŞENI,36300,1,PART,PRCNCT,PRSD,PRSD_SV,"2025-05-18 21:28:32",586,349,295,51,3,347,2,600,251,184,163
7,BOTOŞANI,"SCOALA GIMNAZIALA NR. 1",163,BLÂNDEŞTI,39983,1,PART,PRCNCT,PRSD,PRSD_SV,"2025-05-18 21:34:10",576,253,220,33,0,250,3,600,347,140,110
7,BOTOŞANI,"SCOALA PRIMARA NR.2 CERCHEJENI",164,BLÂNDEŞTI,39983,1,PART,PRCNCT,PRSD,PRSD_SV,"2025-05-18 21:30:29",617,281,238,43,0,276,5,700,419,174,102
7,BOTOŞANI,"SCOLA PRIMARA NR. 3",165,BLÂNDEŞTI,39983,1,PART,PRCNCT,PRSD,PRSD_SV,"2025-05-18 21:26:51",330,181,148,33,0,181,0,400,219,127,54
7,BOTOŞANI,"CĂMIN CULTURAL BRĂEŞTI",166,BRĂEŞTI,36373,1,PART,PRCNCT,PRSD,PRSD_SV,"2025-05-18 21:41:50",1089,567,501,58,8,557,10,1200,633,342,215
7,BOTOŞANI,"SCOALA POIANA 2",167,BRĂEŞTI,36373,1,PART,PRCNCT,PRSD,PRSD_SV,"2025-05-18 21:35:57",341,173,146,27,0,171,2,400,227,126,45
7,BOTOŞANI,"ŞCOALA POPENI",168,BRĂEŞTI,36373,1,PART,PRCNCT,PRSD,PRSD_SV,"2025-05-18 21:21:30",206,111,95,16,0,111,0,300,189,61,50
7,BOTOŞANI,"SCOALA DIMITRIE POMPEIU BROSCAUTI",169,BROSCĂUŢI,36426,1,PART,PRCNCT,PRSD,PRSD_SV,"2025-05-18 22:00:59",1479,716,638,76,2,710,6,1600,884,416,294
7,BOTOŞANI,"ȘCOALA GIMNAZIALĂ ”DIMITRIE POMPEIU”",170,BROSCĂUŢI,36426,1,PART,PRCNCT,PRSD,PRSD_SV,"2025-05-18 21:33:18",1194,476,448,28,0,473,3,1300,824,327,146
7,BOTOŞANI,"CAMIN CULTURAL CALARASI",171,CĂLĂRAŞI,36499,1,PART,PRCNCT,PRSD,PRSD_SV,"2025-05-18 21:54:13",921,436,352,63,21,432,4,1000,564,212,220
7,BOTOŞANI,"SCOALA CALARASI",172,CĂLĂRAŞI,36499,1,PART,PRCNCT,PRSD,PRSD_SV,"2025-05-18 21:38:31",858,403,358,31,14,401,2,900,497,232,169
7,BOTOŞANI,"SCOALA LIBERTATEA",173,CĂLĂRAŞI,36499,1,PART,PRCNCT,PRSD,PRSD_SV,"2025-05-18 21:38:55",337,177,141,34,2,174,3,400,223,75,99
7,BOTOŞANI,"SCOALA PLESANI",174,CĂLĂRAŞI,36499,1,PART,PRCNCT,PRSD,PRSD_SV,"2025-05-18 21:23:17",477,185,153,32,0,185,0,600,415,105,80
7,BOTOŞANI,"ŞCOALA GIMNAZIALÃ, CÂNDEȘTI",175,CÂNDEŞTI,39967,1,PART,PRCNCT,PRSD,PRSD_SV,"2025-05-18 21:23:00",1069,371,320,51,0,365,6,1100,729,215,150
7,BOTOŞANI,"ŞCOALA PRIMARĂ TALPA",176,CÂNDEŞTI,39967,1,PART,PRCNCT,PRSD,PRSD_SV,"2025-05-18 21:25:08",490,221,190,31,0,217,4,600,379,150,67
7,BOTOŞANI,"ŞCOLA PRIMARĂ VIŢCANI",177,CÂNDEŞTI,39967,1,PART,PRCNCT,PRSD,PRSD_SV,"2025-05-18 21:23:08",309,142,121,21,0,139,3,400,258,96,43
7,BOTOŞANI,"ȘCOALA GIMNAZIALĂ NR. 1 CONCEȘTI",178,CONCEŞTI,36532,1,PART,PRCNCT,PRSD,PRSD_SV,"2025-05-18 21:36:17",1393,543,475,66,2,525,18,1500,957,284,241
7,BOTOŞANI,"CAMINUL CULTURAL MOVILENI",179,CONCEŞTI,36532,1,PART,PRCNCT,PRSD,PRSD_SV,"2025-05-18 21:14:53",258,127,102,25,0,124,3,300,173,76,48
7,BOTOŞANI,"ŞCOALA GIMNAZIALĂ NR.1 COPĂLĂU",180,COPĂLĂU,36569,1,PART,PRCNCT,PRSD,PRSD_SV,"2025-05-18 21:24:14",1282,589,561,28,0,579,10,1400,811,376,203
7,BOTOŞANI,"ŞCOALA GIMNAZIALĂ NR. 1 COPĂLĂU",181,COPĂLĂU,36569,1,PART,PRCNCT,PRSD,PRSD_SV,"2025-05-18 21:21:05",949,438,403,34,1,433,5,1000,562,280,153
7,BOTOŞANI,"ŞCOALA PRIMARĂ NR.3 CERBU",182,COPĂLĂU,36569,1,PART,PRCNCT,PRSD,PRSD_SV,"2025-05-18 21:14:56",664,289,263,26,0,287,2,700,411,197,90
7,BOTOŞANI,"ŞCOALA PRIMARĂ NR. 2 COTU",183,COPĂLĂU,36569,1,PART,PRCNCT,PRSD,PRSD_SV,"2025-05-18 21:15:35",493,237,204,33,0,235,2,600,363,126,109
7,BOTOŞANI,"ȘCOALA GIMNAZIALĂ ”MIHAI MUNTEANU” CORDĂRENI",184,CORDĂRENI,36649,1,PART,PRCNCT,PRSD,PRSD_SV,"2025-05-18 21:26:49",690,345,298,38,9,342,3,800,455,178,164
7,BOTOŞANI,"SCOALA GRIVITA",185,CORDĂRENI,36649,1,PART,PRCNCT,PRSD,PRSD_SV,"2025-05-18 21:16:08",369,197,154,38,5,194,3,400,203,123,71
7,BOTOŞANI,"SCOALA SLOBOZIA",186,CORDĂRENI,36649,1,PART,PRCNCT,PRSD,PRSD_SV,"2025-05-18 21:21:42",255,127,92,32,3,122,5,300,173,74,48
7,BOTOŞANI,"PRIMARIA CORLATENI",187,CORLĂTENI,36676,1,PART,PRCNCT,PRSD,PRSD_SV,"2025-05-18 21:36:22",481,208,173,34,1,206,2,600,392,133,73
7,BOTOŞANI,"GRADINITA CARASA",188,CORLĂTENI,36676,1,PART,PRCNCT,PRSD,PRSD_SV,"2025-05-18 21:24:21",402,192,152,40,0,189,3,500,308,106,83
7,BOTOŞANI,"SCOALA PODENI",189,CORLĂTENI,36676,1,PART,PRCNCT,PRSD,PRSD_SV,"2025-05-18 21:36:32",315,173,153,20,0,169,4,400,227,133,36
7,BOTOŞANI,"SCOALA VLADENI",190,CORLĂTENI,36676,2,PART,PRCNCT,PRSD,PRSD_SV,"2025-05-18 23:43:41",332,144,120,23,1,142,2,400,256,94,48
7,BOTOŞANI,"GRĂDINIȚA CU PROGRAM NORMAL NR. 1 CORNI",191,CORNI,36756,1,PART,PRCNCT,PRSD,PRSD_SV,"2025-05-18 21:43:41",1275,516,490,26,0,514,2,1400,884,357,157
7,BOTOŞANI,"SCOALA O. BANCILA",192,CORNI,36756,1,PART,PRCNCT,PRSD,PRSD_SV,"2025-05-18 21:15:49",886,392,341,51,0,389,3,1000,608,282,107
7,BOTOŞANI,"CENTRUL CULTURAL CORNI",193,CORNI,36756,1,PART,PRCNCT,PRSD,PRSD_SV,"2025-05-18 21:31:10",1070,498,453,45,0,490,8,1100,602,327,163
7,BOTOŞANI,"SCOALA CU CL I-IV BALTA ARSA",194,CORNI,36756,1,PART,PRCNCT,PRSD,PRSD_SV,"2025-05-18 21:22:31",344,183,141,42,0,181,2,400,217,134,47
7,BOTOŞANI,"SCOALA CU CL I-IV MESTEACAN",195,CORNI,36756,1,PART,PRCNCT,PRSD,PRSD_SV,"2025-05-18 21:21:49",364,164,147,17,0,164,0,400,236,126,38
7,BOTOŞANI,"SCOALA CU CL I-VIII SARAFINESTI",196,CORNI,36756,1,PART,PRCNCT,PRSD,PRSD_SV,"2025-05-18 21:26:31",1135,506,450,56,0,504,2,1200,694,374,130
7,BOTOŞANI,"GRĂDINIȚA *PRICHINDEL* COȘULA",197,COŞULA,39975,1,PART,PRCNCT,PRSD,PRSD_SV,"2025-05-18 21:35:42",986,463,397,65,1,451,12,1100,637,330,121
7,BOTOŞANI,"ȘCOALA CU CLASELE I-IV BUDA",198,COŞULA,39975,1,PART,PRCNCT,PRSD,PRSD_SV,"2025-05-18 21:19:17",276,113,100,13,0,109,4,300,187,92,17
7,BOTOŞANI,"ȘCOALA CU CLASELE I-IV PĂDURENI",199,COŞULA,39975,1,PART,PRCNCT,PRSD,PRSD_SV,"2025-05-18 21:28:39",491,210,189,21,0,206,4,600,390,164,42
7,BOTOŞANI,"ȘCOALA CU CLASELE I-IV ȘUPITCA",200,COŞULA,39975,1,PART,PRCNCT,PRSD,PRSD_SV,"2025-05-18 21:29:50",656,289,256,33,0,282,7,700,411,220,62
7,BOTOŞANI,"LICEUL TEHNOLOGIC COȚUȘCA CORP A",201,COŢUŞCA,36809,1,PART,PRCNCT,PRSD,PRSD_SV,"2025-05-18 21:30:02",1507,318,284,34,0,314,4,1600,1282,158,156
7,BOTOŞANI,"LICEUL TEHNOLOGIC COȚUȘCA -CORP A",202,COŢUŞCA,36809,1,PART,PRCNCT,PRSD,PRSD_SV,"2025-05-18 21:33:48",904,171,152,19,0,171,0,900,729,62,109
7,BOTOŞANI,"ȘCOALA PRIMARĂ NR.4",203,COŢUŞCA,36809,1,PART,PRCNCT,PRSD,PRSD_SV,"2025-05-18 21:23:40",509,140,115,25,0,138,2,600,460,96,42
7,BOTOŞANI,"GRĂDINIȚA CU PROGRAM NORMAL NR. 2 CRASNALEUCA",204,COŢUŞCA,36809,1,PART,PRCNCT,PRSD,PRSD_SV,"2025-05-18 21:19:34",472,201,175,26,0,198,3,500,299,107,91
7,BOTOŞANI,"ȘCOALA PRIMARĂ NR.2 GHIRENI",205,COŢUŞCA,36809,1,PART,PRCNCT,PRSD,PRSD_SV,"2025-05-18 21:17:37",771,181,162,19,0,181,0,800,619,102,79
7,BOTOŞANI,"GRĂDINIȚA CU PROGRAM NORMAL NR. 3 NICHITENI",206,COŢUŞCA,36809,1,PART,PRCNCT,PRSD,PRSD_SV,"2025-05-18 21:31:50",809,243,220,23,0,239,4,900,657,144,95
7,BOTOŞANI,"ŞCOALA PRIMARĂ NR.5",207,COŢUŞCA,36809,1,PART,PRCNCT,PRSD,PRSD_SV,"2025-05-18 21:25:09",435,153,136,17,0,149,4,500,347,96,53
7,BOTOŞANI,"SCOALA GIMNAZIALA NR. 1 CRISTESTI CORPUL II",208,CRISTEŞTI,36907,1,PART,PRCNCT,PRSD,PRSD_SV,"2025-05-18 21:41:27",1427,630,554,71,5,626,4,1500,870,424,202
7,BOTOŞANI,"SCOALA PRIMARA NR. 1 SAT CRISTESTI , DENUMIRE UZUALA SCOALA DIN GHILANESTI",209,CRISTEŞTI,36907,1,PART,PRCNCT,PRSD,PRSD_SV,"2025-05-18 21:18:55",481,251,205,42,4,251,0,500,249,191,60
7,BOTOŞANI,"SCOALA GIMNAZIALA NR. 2 SAT ONEAGA",210,CRISTEŞTI,36907,1,PART,PRCNCT,PRSD,PRSD_SV,"2025-05-18 21:20:10",1117,458,405,51,2,448,10,1200,742,332,116
7,BOTOŞANI,"ȘCOALA PRIMARĂ NR.3 SCHIT-ORĂȘENI",211,CRISTEŞTI,36907,1,PART,PRCNCT,PRSD,PRSD_SV,"2025-05-18 21:20:01",462,217,187,30,0,214,3,500,283,146,68
7,BOTOŞANI,"SCOALA PRIMARA NR. 4 UNGUROAIA",212,CRISTEŞTI,36907,1,PART,PRCNCT,PRSD,PRSD_SV,"2025-05-18 21:14:51",195,95,77,18,0,95,0,300,205,82,13
7,BOTOŞANI,"GRĂDINIŢA CU PROGRAM NORMAL NR.1 CRISTINEŞTI",213,CRISTINEŞTI,36952,1,PART,PRCNCT,PRSD,PRSD_SV,"2025-05-18 21:49:25",921,451,371,51,29,448,3,1000,549,232,216
7,BOTOŞANI,"SCOALA BARANCA",214,CRISTINEŞTI,36952,1,PART,PRCNCT,PRSD,PRSD_SV,"2025-05-18 21:37:58",547,174,153,21,0,170,4,596,422,114,56
7,BOTOŞANI,"ȘCOALA PRIMARĂ „IOAN ŞI NATALIA CORBU” DĂMILENI",215,CRISTINEŞTI,36952,1,PART,PRCNCT,PRSD,PRSD_SV,"2025-05-18 21:30:55",249,146,110,36,0,144,2,300,154,71,73
7,BOTOŞANI,"SCOALA DRAGALINA",216,CRISTINEŞTI,36952,1,PART,PRCNCT,PRSD,PRSD_SV,"2025-05-18 21:29:33",534,305,240,64,1,303,2,600,295,160,143
7,BOTOŞANI,"SCOALA FUNDU HERTII",217,CRISTINEŞTI,36952,1,PART,PRCNCT,PRSD,PRSD_SV,"2025-05-18 21:41:16",539,314,233,81,0,309,5,600,286,190,119
7,BOTOŞANI,"GRĂDINIȚA CU PROGRAM NORMAL NR. 1 CURTEȘTI",218,CURTEŞTI,35759,1,PART,PRCNCT,PRSD,PRSD_SV,"2025-05-18 21:35:09",1445,795,699,94,2,783,12,1500,705,367,416
7,BOTOŞANI,"ȘCOALA AGAFTON",219,CURTEŞTI,35759,1,PART,PRCNCT,PRSD,PRSD_SV,"2025-05-18 21:25:38",223,136,88,48,0,134,2,300,164,45,89
7,BOTOŞANI,"ȘCOALA GIMNAZIALĂ „NECULAI LEON” BĂICENI",220,CURTEŞTI,35759,1,PART,PRCNCT,PRSD,PRSD_SV,"2025-05-18 21:25:18",741,347,301,46,0,345,2,800,453,241,104
7,BOTOŞANI,"ȘCOALA MĂNĂSTIREA DOAMNEI",221,CURTEŞTI,35759,1,PART,PRCNCT,PRSD,PRSD_SV,"2025-05-18 21:41:07",1371,713,649,63,1,705,8,1400,687,260,445
7,BOTOŞANI,"ȘCOALA GIMNAZIALĂ NR. 1 ORĂȘENI- DEAL, CORP B",222,CURTEŞTI,35759,1,PART,PRCNCT,PRSD,PRSD_SV,"2025-05-18 21:34:00",986,500,444,56,0,493,7,1000,500,263,230
7,BOTOŞANI,"ȘCOALA PRIMARĂ NR. 2 ORĂȘENI-VALE",223,CURTEŞTI,35759,1,PART,PRCNCT,PRSD,PRSD_SV,"2025-05-18 21:38:26",556,277,249,27,1,273,4,600,323,198,75
7,BOTOŞANI,"ȘCOALA GIMNAZIALĂ NR.1 DÂNGENI",224,DÂNGENI,37057,1,PART,PRCNCT,PRSD,PRSD_SV,"2025-05-18 21:39:09",760,235,215,19,1,231,4,800,565,145,86
7,BOTOŞANI,"CĂMINUL CULTURAL HULUB",225,DÂNGENI,37057,1,PART,PRCNCT,PRSD,PRSD_SV,"2025-05-18 21:22:40",450,208,183,21,4,207,1,500,292,120,87
7,BOTOŞANI,"SCOALA GIMNAZIALA NR.2 IACOBENI",226,DÂNGENI,37057,2,PART,PRCNCT,PRSD,PRSD_SV,"2025-05-18 22:41:48",988,333,303,30,0,333,0,1000,667,173,160
7,BOTOŞANI,"SCOALA PRIMARA NR.2 STRAHOTIN",227,DÂNGENI,37057,1,PART,PRCNCT,PRSD,PRSD_SV,"2025-05-18 21:12:01",461,166,148,17,1,161,5,500,334,95,66
7,BOTOŞANI,"CĂMIN CULTURAL DERSCA",228,DERSCA,37011,1,PART,PRCNCT,PRSD,PRSD_SV,"2025-05-18 21:50:23",1303,527,472,53,2,514,13,1400,873,345,169
7,BOTOŞANI,"ȘCOALA GIMNAZIALĂ „NICOLAE IORGA” DERSCA",229,DERSCA,37011,1,PART,PRCNCT,PRSD,PRSD_SV,"2025-05-18 21:47:33",1146,470,426,44,0,464,6,1200,730,302,162
7,BOTOŞANI,PRIMARIA,230,DIMĂCHENI,39959,1,PART,PRCNCT,PRSD,PRSD_SV,"2025-05-18 21:54:09",818,418,339,52,27,411,7,900,482,207,204
7,BOTOŞANI,"CAMIN CULTURAL",231,DIMĂCHENI,39959,1,PART,PRCNCT,PRSD,PRSD_SV,"2025-05-18 21:36:54",167,97,75,15,7,97,0,200,103,57,40
7,BOTOŞANI,"ȘCOALA DOBIRCENI",232,DOBÂRCENI,37100,1,PART,PRCNCT,PRSD,PRSD_SV,"2025-05-18 21:25:24",614,236,211,25,0,233,3,700,464,139,94
7,BOTOŞANI,"SCOALA BIVOLARI",233,DOBÂRCENI,37100,1,PART,PRCNCT,PRSD,PRSD_SV,"2025-05-18 21:18:27",124,57,42,15,0,57,0,200,143,31,26
7,BOTOŞANI,"ȘCOALA BRATENI",234,DOBÂRCENI,37100,1,PART,PRCNCT,PRSD,PRSD_SV,"2025-05-18 21:37:02",459,201,171,30,0,199,2,500,299,119,80
7,BOTOŞANI,"SCOALA CISMANESTI",235,DOBÂRCENI,37100,1,PART,PRCNCT,PRSD,PRSD_SV,"2025-05-18 21:15:31",281,152,117,35,0,149,3,400,248,91,58
7,BOTOŞANI,"SCOALA MURGUTA",236,DOBÂRCENI,37100,1,PART,PRCNCT,PRSD,PRSD_SV,"2025-05-18 21:31:34",393,177,157,20,0,176,1,500,323,119,57
7,BOTOŞANI,"CĂMINUL CULTURAL ”PROF. IOAN COBÂLĂ ” DRĂGUȘENI",237,DRĂGUŞENI,37173,1,PART,PRCNCT,PRSD,PRSD_SV,"2025-05-18 21:26:25",1821,444,411,33,0,437,7,1900,1456,278,159
7,BOTOŞANI,"SCOALA PRIMARĂ NR. 2",238,DRĂGUŞENI,37173,1,PART,PRCNCT,PRSD,PRSD_SV,"2025-05-18 21:16:18",877,148,131,17,0,146,2,1000,852,98,48
7,BOTOŞANI,"SCOALA CU CLASELE I-IV PODRIGA",239,DRĂGUŞENI,37173,1,PART,PRCNCT,PRSD,PRSD_SV,"2025-05-18 21:20:21",1133,176,156,20,0,174,2,1200,1024,87,87
7,BOTOŞANI,"SCOALA CU CLASELE I-IV SARATA",240,DRĂGUŞENI,37173,1,PART,PRCNCT,PRSD,PRSD_SV,"2025-05-18 21:10:05",147,56,41,15,0,54,2,200,144,37,17
7,BOTOŞANI,"CĂMINUL CULTURAL DIN SATUL DURNEȘTI",241,DURNEŞTI,37217,1,PART,PRCNCT,PRSD,PRSD_SV,"2025-05-18 21:28:29",898,372,332,40,0,368,4,1000,628,223,145
7,BOTOŞANI,"GRĂDINIȚA CU PROGRAM NORMAL NR. 3 BĂBICENI",242,DURNEŞTI,37217,1,PART,PRCNCT,PRSD,PRSD_SV,"2025-05-18 21:24:38",541,229,206,23,0,227,2,600,371,136,91
7,BOTOŞANI,"CĂMINUL CULTURAL CUCUTENI",243,DURNEŞTI,37217,1,PART,PRCNCT,PRSD,PRSD_SV,"2025-05-18 21:21:51",643,331,304,27,0,329,2,700,369,198,131
7,BOTOŞANI,"GRĂDINIȚA CU PROGRAM NORMAL NR. 2 GURANDA",244,DURNEŞTI,37217,1,PART,PRCNCT,PRSD,PRSD_SV,"2025-05-18 21:30:19",888,354,307,47,0,348,6,1000,646,234,114
7,BOTOŞANI,"SCOALA GIMNAZIALA NR. 2 FRUMUSICA",245,FRUMUŞICA,37324,1,PART,PRCNCT,PRSD,PRSD_SV,"2025-05-18 21:25:38",640,255,233,21,1,250,5,700,445,152,98
7,BOTOŞANI,"GRĂDINIȚA CU PROGRAM NORMAL NR. 6 BOSCOTENI",246,FRUMUŞICA,37324,1,PART,PRCNCT,PRSD,PRSD_SV,"2025-05-18 21:29:20",493,219,185,34,0,214,5,600,381,160,54
7,BOTOŞANI,"SCOALA GIMNAZIALA NR.3 RADENI",247,FRUMUŞICA,37324,1,PART,PRCNCT,PRSD,PRSD_SV,"2025-05-18 21:35:15",806,320,277,43,0,318,2,900,580,220,98
7,BOTOŞANI,"SCOALA GIMNAZIALA NR.4 STORESTI",248,FRUMUŞICA,37324,1,PART,PRCNCT,PRSD,PRSD_SV,"2025-05-18 21:30:15",862,329,303,26,0,321,8,900,571,226,95
7,BOTOŞANI,"SCOALA GIMNAZIALA NR.5 SENDRENI",249,FRUMUŞICA,37324,1,PART,PRCNCT,PRSD,PRSD_SV,"2025-05-18 21:16:39",581,239,214,25,0,238,1,700,461,177,61
7,BOTOŞANI,"SCOALA GIMNAZIALA NR.1 VLADENI DEAL",250,FRUMUŞICA,37324,1,PART,PRCNCT,PRSD,PRSD_SV,"2025-05-18 21:51:04",1287,505,478,27,0,501,4,1400,895,349,152
7,BOTOŞANI,"SEDIUL PRIMARIEI COMUNEI GEORGE ENESCU",251,"GEORGE ENESCU",37397,1,PART,PRCNCT,PRSD,PRSD_SV,"2025-05-18 21:44:34",531,248,212,36,0,247,1,600,352,136,111
7,BOTOŞANI,"SCOALA GENERALA NR.2 DUMENI",252,"GEORGE ENESCU",37397,1,PART,PRCNCT,PRSD,PRSD_SV,"2025-05-18 21:44:44",829,371,309,62,0,367,4,900,529,217,150
7,BOTOŞANI,"ȘCOALA PRIMARĂ NR. 5 ARBOREA",253,"GEORGE ENESCU",37397,1,PART,PRCNCT,PRSD,PRSD_SV,"2025-05-18 21:27:08",346,144,117,27,0,143,1,400,256,100,43
7,BOTOŞANI,"SCOALA GENERALA POPENI",254,"GEORGE ENESCU",37397,1,PART,PRCNCT,PRSD,PRSD_SV,"2025-05-18 21:40:10",423,206,177,29,0,203,3,500,294,124,79
7,BOTOŞANI,"SCOALA GENERALA STINCA",255,"GEORGE ENESCU",37397,1,PART,PRCNCT,PRSD,PRSD_SV,"2025-05-18 21:16:01",277,144,118,26,0,141,3,400,256,95,46
7,BOTOŞANI,"SCOALA GORBANESTI",256,GORBĂNEŞTI,37459,1,PART,PRCNCT,PRSD,PRSD_SV,"2025-05-18 21:20:43",730,329,296,33,0,326,3,800,471,181,145
7,BOTOŞANI,"ŞCOALA GENERALA BATRANESTI",257,GORBĂNEŞTI,37459,1,PART,PRCNCT,PRSD,PRSD_SV,"2025-05-18 21:09:11",189,86,76,10,0,84,2,300,214,55,29
7,BOTOŞANI,"ŞCOALA GENERALĂ GEORGE COSBUC",258,GORBĂNEŞTI,37459,1,PART,PRCNCT,PRSD,PRSD_SV,"2025-05-18 21:09:43",197,77,66,11,0,76,1,300,223,54,22
7,BOTOŞANI,"SCOALA GENERALA SILISCANI",259,GORBĂNEŞTI,37459,1,PART,PRCNCT,PRSD,PRSD_SV,"2025-05-18 21:17:01",274,127,104,23,0,125,2,300,173,84,41
7,BOTOŞANI,"SCOALA GENERALA SOCRUJENI",260,GORBĂNEŞTI,37459,1,PART,PRCNCT,PRSD,PRSD_SV,"2025-05-18 21:22:55",591,230,200,30,0,229,1,700,470,142,87
7,BOTOŞANI,"GRĂDINIȚA CU PROGRAM NORMAL NR. 2 VÂNĂTORI",261,GORBĂNEŞTI,37459,1,PART,PRCNCT,PRSD,PRSD_SV,"2025-05-18 21:16:41",520,238,216,22,0,237,1,600,362,148,89
7,BOTOŞANI,"ȘCOALA GIMNAZIALĂ ” IOAN CERNAT” HAVÂRNA -CORPUL 2",262,HAVÂRNA,37547,1,PART,PRCNCT,PRSD,PRSD_SV,"2025-05-18 21:42:20",836,329,273,56,0,327,2,900,571,214,113
7,BOTOŞANI,"ȘCOALA GIMNAZIALĂ ” IOAN CERNAT” HAVÂRNA -CORPUL 2",263,HAVÂRNA,37547,1,PART,PRCNCT,PRSD,PRSD_SV,"2025-05-18 21:38:28",927,264,235,29,0,260,4,1000,736,173,87
7,BOTOŞANI,"GRADINITA CU PROGRAM NORMAL NR.2 HAVIRNA(CATUN BASEU)",264,HAVÂRNA,37547,1,PART,PRCNCT,PRSD,PRSD_SV,"2025-05-18 21:39:40",607,193,165,28,0,192,1,700,507,105,87
7,BOTOŞANI,"SCOALA PRIMARA ”DUMITRU POMPAS” BALINTI",265,HAVÂRNA,37547,1,PART,PRCNCT,PRSD,PRSD_SV,"2025-05-18 21:41:04",335,112,81,31,0,111,1,400,288,67,44
7,BOTOŞANI,"SCOALA GIMNAZIALA ” IANCU MUNTEANU” TATARASENI",266,HAVÂRNA,37547,1,PART,PRCNCT,PRSD,PRSD_SV,"2025-05-18 21:21:11",589,239,205,33,1,235,4,700,461,133,102
7,BOTOŞANI,"ȘCOALA GIMNAZIALĂ „TEOFIL VÂLCU” HĂNEȘTI",267,HĂNEŞTI,37618,1,PART,PRCNCT,PRSD,PRSD_SV,"2025-05-18 21:23:06",1042,129,108,21,0,128,1,1200,1071,80,48
7,BOTOŞANI,"ȘCOALA GIMNAZIALĂ „TEOFIL VÂLCU” HĂNEȘTI",268,HĂNEŞTI,37618,1,PART,PRCNCT,PRSD,PRSD_SV,"2025-05-18 21:36:54",1090,249,229,18,2,242,7,1200,951,114,128
7,BOTOŞANI,"SCOALA CU CL I-IV BOROLEA",269,HĂNEŞTI,37618,1,PART,PRCNCT,PRSD,PRSD_SV,"2025-05-18 21:22:02",915,125,113,12,0,123,2,1000,875,80,43
7,BOTOŞANI,"ȘCOALA CU CLASELE I-IV SĂRATA BASARAB",270,HĂNEŞTI,37618,1,PART,PRCNCT,PRSD,PRSD_SV,"2025-05-18 21:18:40",913,158,142,16,0,156,2,1000,842,97,59
7,BOTOŞANI,"SCOALA GIMNAZIALA NR. 1 HILISEU HORIA",271,HILIŞEU-HORIA,37672,1,PART,PRCNCT,PRSD,PRSD_SV,"2025-05-18 21:26:18",566,236,193,43,0,234,2,600,364,111,123
7,BOTOŞANI,"SCOALA PRIMARA NR. 4 HILISEU CLOSCA",272,HILIŞEU-HORIA,37672,1,PART,PRCNCT,PRSD,PRSD_SV,"2025-05-18 21:37:47",508,230,215,15,0,226,4,600,370,142,84
7,BOTOŞANI,"SCOALA GIMNAZIALA NR. 2 HILISEU CRISAN",273,HILIŞEU-HORIA,37672,1,PART,PRCNCT,PRSD,PRSD_SV,"2025-05-18 21:22:36",1101,460,414,43,3,449,11,1200,740,294,155
7,BOTOŞANI,"SCOALA GIMNAZIALA NR. 3 IEZER",274,HILIŞEU-HORIA,37672,1,PART,PRCNCT,PRSD,PRSD_SV,"2025-05-18 21:15:53",475,231,203,28,0,229,2,500,269,126,103
7,BOTOŞANI,"SALA DE SPORT ȘCOLARĂ,COMUNA HLIPICENI,JUDEȚUL BOTOȘANI",275,HLIPICENI,37734,1,PART,PRCNCT,PRSD,PRSD_SV,"2025-05-18 21:45:50",1284,531,439,92,0,524,7,1400,869,285,239
7,BOTOŞANI,"SCOALA CU CL .I-IV DRAGALINA",276,HLIPICENI,37734,1,PART,PRCNCT,PRSD,PRSD_SV,"2025-05-18 21:17:01",289,141,125,16,0,140,1,400,259,88,52
7,BOTOŞANI,"SCOALA CU CL.I-VIII VICTORIA",277,HLIPICENI,37734,1,PART,PRCNCT,PRSD,PRSD_SV,"2025-05-18 21:30:50",1086,446,390,56,0,443,3,1100,654,209,234
7,BOTOŞANI,"CĂMIN CULTURAL",278,HUDEŞTI,37770,1,PART,PRCNCT,PRSD,PRSD_SV,"2025-05-18 21:30:17",873,406,353,52,1,402,4,900,494,223,179
7,BOTOŞANI,GRĂDINIȚA,279,HUDEŞTI,37770,1,PART,PRCNCT,PRSD,PRSD_SV,"2025-05-18 21:32:35",1055,490,453,37,0,489,1,1100,610,302,187
7,BOTOŞANI,"ȘCOALA BARANCA",280,HUDEŞTI,37770,1,PART,PRCNCT,PRSD,PRSD_SV,"2025-05-18 21:27:40",939,330,306,24,0,326,4,1000,670,273,53
7,BOTOŞANI,"ȘCOALĂ BAȘEU",281,HUDEŞTI,37770,1,PART,PRCNCT,PRSD,PRSD_SV,"2025-05-18 21:30:59",378,168,142,26,0,164,4,400,232,110,54
7,BOTOŞANI,"ȘCOALA MLENĂUȚI",282,HUDEŞTI,37770,1,PART,PRCNCT,PRSD,PRSD_SV,"2025-05-18 21:23:10",531,257,229,28,0,255,2,600,343,180,75
7,BOTOŞANI,"CĂMIN CULTURAL",283,HUDEŞTI,37770,1,PART,PRCNCT,PRSD,PRSD_SV,"2025-05-18 21:30:13",822,360,330,29,1,354,6,900,540,212,142
7,BOTOŞANI,"GRADINITA CU 4 GRUPE IBANESTI",284,IBĂNEŞTI,37823,1,PART,PRCNCT,PRSD,PRSD_SV,"2025-05-18 21:27:07",763,364,302,61,1,361,3,800,436,181,180
7,BOTOŞANI,"GRADINITA CU 4 GRUPE IBANESTI",285,IBĂNEŞTI,37823,1,PART,PRCNCT,PRSD,PRSD_SV,"2025-05-18 21:34:13",792,383,340,41,2,380,3,900,517,190,190
7,BOTOŞANI,"SCOALA ”MIHAIL SADOVEANU”, CORP B",286,IBĂNEŞTI,37823,1,PART,PRCNCT,PRSD,PRSD_SV,"2025-05-18 21:34:14",731,380,347,33,0,379,1,800,420,216,163
7,BOTOŞANI,"SCOALA ”MIHAIL SADOVEANU”, CORP B",287,IBĂNEŞTI,37823,1,PART,PRCNCT,PRSD,PRSD_SV,"2025-05-18 21:34:15",709,321,287,33,1,316,5,800,479,179,137
7,BOTOŞANI,"SCOALA GENERALA NR. 1 LEORDA",288,LEORDA,37850,1,PART,PRCNCT,PRSD,PRSD_SV,"2025-05-18 21:34:12",1100,603,512,90,1,593,10,1200,597,378,215
7,BOTOŞANI,"SCOALA GENERALA CU CLASELE I-IV COSTINESTI",289,LEORDA,37850,1,PART,PRCNCT,PRSD,PRSD_SV,"2025-05-18 21:24:34",160,118,81,22,15,108,10,300,182,59,49
7,BOTOŞANI,"ȘCOALA PRIMARĂ NR. 3, DOLINA",290,LEORDA,37850,1,PART,PRCNCT,PRSD,PRSD_SV,"2025-05-18 21:31:46",883,404,351,52,1,401,3,900,496,272,129
7,BOTOŞANI,"CAMIN CULTURAL",291,LOZNA,39942,1,PART,PRCNCT,PRSD,PRSD_SV,"2025-05-18 21:26:38",812,360,328,32,0,357,3,900,540,230,127
7,BOTOŞANI,"CAMIN CULTURAL",292,LOZNA,39942,1,PART,PRCNCT,PRSD,PRSD_SV,"2025-05-18 21:26:41",712,281,264,17,0,275,6,800,519,203,72
7,BOTOŞANI,"CAMINUL CULTURAL LUNCA",293,LUNCA,37912,1,PART,PRCNCT,PRSD,PRSD_SV,"2025-05-18 21:31:17",581,257,210,40,7,255,2,700,443,144,111
7,BOTOŞANI,"CAMINUL CULTURAL BIZNOASA",294,LUNCA,37912,1,PART,PRCNCT,PRSD,PRSD_SV,"2025-05-18 21:24:33",608,256,221,35,0,253,3,700,444,128,125
7,BOTOŞANI,"CAMINUL CULTURAL STROIESTI",295,LUNCA,37912,1,PART,PRCNCT,PRSD,PRSD_SV,"2025-05-18 21:34:23",643,283,253,29,1,280,3,700,417,155,125
7,BOTOŞANI,"CĂMINUL CULTURAL ZLĂTUNOAIA",296,LUNCA,37912,1,PART,PRCNCT,PRSD,PRSD_SV,"2025-05-18 21:38:52",1185,511,443,68,0,500,11,1200,689,295,205
7,BOTOŞANI,"SCOALA GENERALA STANESTI",297,LUNCA,37912,1,PART,PRCNCT,PRSD,PRSD_SV,"2025-05-18 21:26:09",142,90,57,33,0,89,1,200,110,52,37
7,BOTOŞANI,"SCOALA MANOLEASA",298,MANOLEASA,37958,1,PART,PRCNCT,PRSD,PRSD_SV,"2025-05-18 21:28:25",639,176,146,29,1,175,1,700,524,112,63
7,BOTOŞANI,"SCOALA FLONDORA",299,MANOLEASA,37958,2,PART,PRCNCT,PRSD,PRSD_SV,"2025-05-19 00:49:44",722,148,132,16,0,147,1,800,652,106,41
7,BOTOŞANI,"FOST MAGAZIN SATESC",300,MANOLEASA,37958,1,PART,PRCNCT,PRSD,PRSD_SV,"2025-05-18 21:14:41",243,75,43,32,0,75,0,300,225,49,26
7,BOTOŞANI,"SCOALA LIVENI",301,MANOLEASA,37958,1,PART,PRCNCT,PRSD,PRSD_SV,"2025-05-18 21:32:37",650,202,170,32,0,201,1,700,498,118,83
7,BOTOŞANI,"SCOALA LOTURI",302,MANOLEASA,37958,1,PART,PRCNCT,PRSD,PRSD_SV,"2025-05-18 21:18:00",177,72,59,13,0,71,1,200,128,54,17
7,BOTOŞANI,"SCOALA SADOVENI",303,MANOLEASA,37958,1,PART,PRCNCT,PRSD,PRSD_SV,"2025-05-18 21:25:27",394,184,158,26,0,180,4,400,216,139,41
7,BOTOŞANI,"SCOALA ZAHORENI",304,MANOLEASA,37958,1,PART,PRCNCT,PRSD,PRSD_SV,"2025-05-18 21:23:22",553,196,178,18,0,195,1,600,404,132,63
7,BOTOŞANI,"SCOALA IPOTEȘTI",305,"MIHAI EMINESCU",38063,1,PART,PRCNCT,PRSD,PRSD_SV,"2025-05-18 21:54:09",518,298,262,36,0,293,5,600,302,173,120
7,BOTOŞANI,"ȘCOALA CĂTĂMĂREȘTI",306,"MIHAI EMINESCU",38063,1,PART,PRCNCT,PRSD,PRSD_SV,"2025-05-18 21:16:28",517,302,249,53,0,299,3,600,298,189,110
7,BOTOŞANI,"SCOALA CĂTĂMĂREȘTI DEAL",307,"MIHAI EMINESCU",38063,1,PART,PRCNCT,PRSD,PRSD_SV,"2025-05-18 21:55:31",1748,978,860,117,1,959,19,1800,822,537,422
7,BOTOŞANI,"SCOALA CĂTĂMĂREȘTI DEAL",308,"MIHAI EMINESCU",38063,1,PART,PRCNCT,PRSD,PRSD_SV,"2025-05-18 21:39:30",1694,994,882,111,1,979,15,1800,806,512,467
7,BOTOŞANI,"SCOALA CERVICEȘTI",309,"MIHAI EMINESCU",38063,1,PART,PRCNCT,PRSD,PRSD_SV,"2025-05-18 21:28:03",722,421,382,39,0,411,10,800,379,287,124
7,BOTOŞANI,"SCOALA CUCORĂNI",310,"MIHAI EMINESCU",38063,1,PART,PRCNCT,PRSD,PRSD_SV,"2025-05-18 21:18:30",682,385,348,37,0,379,6,700,315,270,109
7,BOTOŞANI,"ȘCOALA STÎNCEȘTI",311,"MIHAI EMINESCU",38063,1,PART,PRCNCT,PRSD,PRSD_SV,"2025-05-18 22:04:44",1436,762,690,72,0,746,16,1500,738,371,375
7,BOTOŞANI,"SCOALA CL I-IV MIHAILENI",312,MIHĂILENI,38161,1,PART,PRCNCT,PRSD,PRSD_SV,"2025-05-18 21:39:22",1222,521,437,73,11,510,11,1300,779,328,182
7,BOTOŞANI,"ŞCOALAGENERALĂ PARAU NEGRU",313,MIHĂILENI,38161,1,PART,PRCNCT,PRSD,PRSD_SV,"2025-05-18 21:19:53",410,171,148,23,0,168,3,500,329,115,53
7,BOTOŞANI,"ŞCOALA GENERALĂ ROGOJESTI",314,MIHĂILENI,38161,1,PART,PRCNCT,PRSD,PRSD_SV,"2025-05-18 21:31:59",421,195,159,33,3,192,3,500,305,122,70
7,BOTOŞANI,"SCOALA MIHALASENI",315,MIHĂLĂŞENI,38241,1,PART,PRCNCT,PRSD,PRSD_SV,"2025-05-18 21:37:15",1640,239,222,17,0,238,1,1700,1461,129,109
7,BOTOŞANI,"SCOALA NASTASE",316,MIHĂLĂŞENI,38241,1,PART,PRCNCT,PRSD,PRSD_SV,"2025-05-18 21:26:53",336,121,98,23,0,120,1,400,279,80,40
7,BOTOŞANI,"SCOALA NEGRESTI",317,MIHĂLĂŞENI,38241,1,PART,PRCNCT,PRSD,PRSD_SV,"2025-05-18 21:28:06",386,135,119,16,0,135,0,400,265,97,38
7,BOTOŞANI,"SCOALA SARATA",318,MIHĂLĂŞENI,38241,1,PART,PRCNCT,PRSD,PRSD_SV,"2025-05-18 21:30:36",416,191,171,20,0,191,0,500,309,134,57
7,BOTOŞANI,"CĂMIN CULTURAL MILEANCA",319,MILEANCA,38321,1,PART,PRCNCT,PRSD,PRSD_SV,"2025-05-18 22:01:17",1211,470,414,51,5,461,9,1300,830,251,210
7,BOTOŞANI,"ȘCOALA PRIMARĂ NR. 2 CODRENI",320,MILEANCA,38321,1,PART,PRCNCT,PRSD,PRSD_SV,"2025-05-18 21:29:14",233,112,92,20,0,111,1,300,188,66,45
7,BOTOŞANI,"GRĂDINIȚA CU PROGRAM NORMAL NR. 3 SCUTARI",321,MILEANCA,38321,1,PART,PRCNCT,PRSD,PRSD_SV,"2025-05-18 21:20:57",223,83,72,11,0,83,0,300,217,59,24
7,BOTOŞANI,"ȘCOALA PRIMARĂ NR. 4 SELIȘTEA",322,MILEANCA,38321,1,PART,PRCNCT,PRSD,PRSD_SV,"2025-05-18 21:25:49",299,122,107,15,0,121,1,400,278,74,47
7,BOTOŞANI,"ŞCOALA GIMNAZIALĂ ”FLORICĂ MURARIU” MITOC",323,MITOC,38376,1,PART,PRCNCT,PRSD,PRSD_SV,"2025-05-18 21:33:39",987,364,328,36,0,359,5,1000,636,250,109
7,BOTOŞANI,"ŞCOALA PRIMARĂ NR. 1 HORIA",324,MITOC,38376,1,PART,PRCNCT,PRSD,PRSD_SV,"2025-05-18 21:29:40",379,145,124,21,0,141,4,400,255,94,47
7,BOTOŞANI,CAMINCULTURALNICŞENI,325,NICŞENI,38456,1,PART,PRCNCT,PRSD,PRSD_SV,"2025-05-18 21:22:16",743,383,329,54,0,381,2,800,417,248,133
7,BOTOŞANI,"ŞCOALA DACIA",326,NICŞENI,38456,1,PART,PRCNCT,PRSD,PRSD_SV,"2025-05-18 21:20:22",132,78,65,13,0,76,2,200,122,53,23
7,BOTOŞANI,"ȘCOALA GIMNAZIALĂ ”MIHAI CONSTANTINEANU” DOROBANȚI",327,NICŞENI,38456,1,PART,PRCNCT,PRSD,PRSD_SV,"2025-05-18 21:32:36",1216,527,475,52,0,515,12,1300,773,335,180
7,BOTOŞANI,"CAMIN CULTURAL PALTINIS",328,PĂLTINIŞ,38492,1,PART,PRCNCT,PRSD,PRSD_SV,"2025-05-18 21:17:36",1927,340,308,31,1,330,10,2000,1660,238,92
7,BOTOŞANI,"ȘCOALA GRIVIȚA",329,PĂLTINIŞ,38492,1,PART,PRCNCT,PRSD,PRSD_SV,"2025-05-18 21:15:08",1326,106,85,21,0,105,1,1400,1294,70,35
7,BOTOŞANI,"CĂMIN CULTURAL IVANCĂUȚI",330,PĂLTINIŞ,38492,1,PART,PRCNCT,PRSD,PRSD_SV,"2025-05-18 21:12:43",771,208,170,37,1,206,2,800,592,136,70
7,BOTOŞANI,"ȘCOALA CUZLĂU",331,PĂLTINIŞ,38492,1,PART,PRCNCT,PRSD,PRSD_SV,"2025-05-18 21:17:28",520,150,123,27,0,148,2,600,450,96,52
7,BOTOŞANI,"ȘCOALA CU CL I-VIII HORODIȘTEA",332,PĂLTINIŞ,38492,1,PART,PRCNCT,PRSD,PRSD_SV,"2025-05-18 21:14:05",911,240,182,58,0,239,1,1000,760,118,121
7,BOTOŞANI,"BAZA SPORTIVĂ MULTIFUNCȚIONALĂ TIP I",333,POMÂRLA,38544,1,PART,PRCNCT,PRSD,PRSD_SV,"2025-05-18 21:40:36",934,574,432,97,45,568,6,1000,426,207,361
7,BOTOŞANI,"GRĂDINIȚA CU PROGRAM NORMAL NR.2 POMÂRLA, SAT POMÂRLA, COMUNA POMÂRLA",334,POMÂRLA,38544,1,PART,PRCNCT,PRSD,PRSD_SV,"2025-05-18 21:31:38",879,525,435,63,27,517,8,1000,475,232,285
7,BOTOŞANI,"SOALA PRIMARA NR. 2 RACOVĂŢ",335,POMÂRLA,38544,1,PART,PRCNCT,PRSD,PRSD_SV,"2025-05-18 21:20:17",243,134,101,26,7,132,2,300,166,68,64
7,BOTOŞANI,"ŞCOALA CU CLASELE I-IV SALA I",336,PRĂJENI,38580,1,PART,PRCNCT,PRSD,PRSD_SV,"2025-05-18 21:35:07",982,369,355,14,0,362,7,1100,731,222,140
7,BOTOŞANI,"ŞCOALA CU CLASELE I-IV",337,PRĂJENI,38580,1,PART,PRCNCT,PRSD,PRSD_SV,"2025-05-18 21:27:03",496,200,175,25,0,199,1,600,400,123,76
7,BOTOŞANI,"ȘCOALA PRIMARĂ NR. 4 LUPĂRIA",338,PRĂJENI,38580,1,PART,PRCNCT,PRSD,PRSD_SV,"2025-05-18 21:33:09",598,230,204,25,1,227,3,700,470,145,82
7,BOTOŞANI,"ŞCOALA GIMNAZIALA NR.2 MILETIN",339,PRĂJENI,38580,1,PART,PRCNCT,PRSD,PRSD_SV,"2025-05-18 21:17:11",495,214,200,14,0,212,2,600,386,162,50
7,BOTOŞANI,"ȘCOALA GIMNAZIALĂ NR.1 RĂCHIȚI",340,RĂCHIŢI,35839,1,PART,PRCNCT,PRSD,PRSD_SV,"2025-05-18 22:12:01",1169,644,565,79,0,633,11,1200,556,397,236
7,BOTOŞANI,"GRĂDINIȚA CU PROGRAM NORMAL NR. 1 CIȘMEA",341,RĂCHIŢI,35839,1,PART,PRCNCT,PRSD,PRSD_SV,"2025-05-18 21:28:46",516,291,256,35,0,281,10,600,309,139,142
7,BOTOŞANI,"ŞCOALA GIMNAZIALĂ ”PETRE ŞUŞTER”",342,RĂCHIŢI,35839,1,PART,PRCNCT,PRSD,PRSD_SV,"2025-05-18 22:35:36",1271,701,629,71,1,695,6,1300,599,489,206
7,BOTOŞANI,"CĂMIN CULTURAL ROŞIORI",343,RĂCHIŢI,35839,1,PART,PRCNCT,PRSD,PRSD_SV,"2025-05-18 22:05:06",1413,678,610,67,1,669,9,1500,822,439,230
7,BOTOŞANI,"CAMIN CULTURAL RADAUTI-PRUT",344,RĂDĂUŢI-PRUT,38633,1,PART,PRCNCT,PRSD,PRSD_SV,"2025-05-18 21:51:54",704,291,224,67,0,289,2,800,509,154,135
7,BOTOŞANI,"CAMINUL CULTURAL SAT MIORCANI",345,RĂDĂUŢI-PRUT,38633,1,PART,PRCNCT,PRSD,PRSD_SV,"2025-05-18 21:40:49",650,242,214,27,1,240,2,700,458,146,94
7,BOTOŞANI,"CAMINUL CULTURAL SAT MIORCANI",346,RĂDĂUŢI-PRUT,38633,1,PART,PRCNCT,PRSD,PRSD_SV,"2025-05-18 21:52:46",612,215,183,32,0,215,0,700,485,144,71
7,BOTOŞANI,"CAMINUL CULTURAL SAT REDIU",347,RĂDĂUŢI-PRUT,38633,1,PART,PRCNCT,PRSD,PRSD_SV,"2025-05-18 21:52:16",675,273,223,44,6,271,2,700,427,166,105
7,BOTOŞANI,"CAMIN CULTURAL RAUSENI",348,RĂUSENI,38679,1,PART,PRCNCT,PRSD,PRSD_SV,"2025-05-18 21:46:28",990,400,343,57,0,397,3,1100,700,225,172
7,BOTOŞANI,"ŞCOALA GENERALA DOINA",349,RĂUSENI,38679,1,PART,PRCNCT,PRSD,PRSD_SV,"2025-05-18 21:35:21",410,174,155,19,0,173,1,500,326,90,83
7,BOTOŞANI,"GRADINITA REDIU",350,RĂUSENI,38679,1,PART,PRCNCT,PRSD,PRSD_SV,"2025-05-18 21:31:58",415,150,125,25,0,149,1,500,350,81,68
7,BOTOŞANI,"ȘCOALA GENERALĂ STOLNICENI",351,RĂUSENI,38679,1,PART,PRCNCT,PRSD,PRSD_SV,"2025-05-18 21:48:40",157,73,52,21,0,73,0,200,127,30,43
7,BOTOŞANI,"CĂMINUL CULTURAL",352,RIPICENI,38731,1,PART,PRCNCT,PRSD,PRSD_SV,"2025-05-18 21:40:54",1212,174,167,7,0,173,1,1300,1126,107,66
7,BOTOŞANI,"CĂMINUL CULTURAL",353,RIPICENI,38731,1,PART,PRCNCT,PRSD,PRSD_SV,"2025-05-18 21:43:38",1053,107,103,4,0,107,0,1200,1093,71,36
7,BOTOŞANI,"GRĂDINIŢA DE COPII",354,RIPICENI,38731,1,PART,PRCNCT,PRSD,PRSD_SV,"2025-05-18 22:20:44",1715,322,283,39,0,319,3,1800,1478,211,108
7,BOTOŞANI,"SCOALA NR. 1 ROMA",355,ROMA,38811,1,PART,PRCNCT,PRSD,PRSD_SV,"2025-05-18 21:49:31",1428,638,556,79,3,628,10,1500,862,423,205
7,BOTOŞANI,"SCOALA NR.2 ROMA",356,ROMA,38811,1,PART,PRCNCT,PRSD,PRSD_SV,"2025-05-18 21:26:53",986,531,450,81,0,527,4,1000,469,338,189
7,BOTOŞANI,"CĂMIN CULTURAL COTÂRGACI",357,ROMA,38811,1,PART,PRCNCT,PRSD,PRSD_SV,"2025-05-18 21:18:24",662,192,159,33,0,191,1,700,508,113,78
7,BOTOŞANI,"CĂMINUL CULTURAL",358,ROMÂNEŞTI,38848,1,PART,PRCNCT,PRSD,PRSD_SV,"2025-05-18 21:33:07",1065,470,408,62,0,465,5,1100,630,260,205
7,BOTOŞANI,"SCOALA PRIMARĂ NR 1",359,ROMÂNEŞTI,38848,1,PART,PRCNCT,PRSD,PRSD_SV,"2025-05-18 21:34:52",478,204,173,31,0,201,3,500,296,135,66
7,BOTOŞANI,"CAMINUL CULTURAL SANTA MARE",360,"SANTA MARE",38893,2,PART,PRCNCT,PRSD,PRSD_SV,"2025-05-18 23:47:28",963,427,366,58,3,424,3,1000,573,232,192
7,BOTOŞANI,"SCOALA GENERALA BERZA",361,"SANTA MARE",38893,1,PART,PRCNCT,PRSD,PRSD_SV,"2025-05-18 21:17:22",158,96,77,19,0,95,1,200,104,66,29
7,BOTOŞANI,"SCOALA GENERALA BOGDANESTI",362,"SANTA MARE",38893,1,PART,PRCNCT,PRSD,PRSD_SV,"2025-05-18 21:20:16",303,144,119,25,0,144,0,400,256,85,59
7,BOTOŞANI,"SCOALA GENERALA ILISENI",363,"SANTA MARE",38893,1,PART,PRCNCT,PRSD,PRSD_SV,"2025-05-18 21:21:10",351,137,118,19,0,136,1,400,263,82,54
7,BOTOŞANI,"SCOALA GENERALA RINGHILESTI",364,"SANTA MARE",38893,1,PART,PRCNCT,PRSD,PRSD_SV,"2025-05-18 21:24:35",299,108,91,17,0,106,2,400,292,58,48
7,BOTOŞANI,"CAMIN CULTURAL",365,STĂUCENI,35884,1,PART,PRCNCT,PRSD,PRSD_SV,"2025-05-18 21:53:12",1124,536,468,68,0,528,8,1200,664,309,219
7,BOTOŞANI,"SCOALA GENERALA CU CLASELE I-IV",366,STĂUCENI,35884,1,PART,PRCNCT,PRSD,PRSD_SV,"2025-05-18 21:21:49",453,248,219,29,0,246,2,500,252,150,96
7,BOTOŞANI,"SCOALA GENERALA CU CLASELE I-VIII PATRIARH TEOCTIST ARAPASU",367,STĂUCENI,35884,1,PART,PRCNCT,PRSD,PRSD_SV,"2025-05-18 21:21:22",871,370,332,38,0,365,5,1000,630,245,120
7,BOTOŞANI,"SCOALA GENERALA CU CLASELE I-IV",368,STĂUCENI,35884,1,PART,PRCNCT,PRSD,PRSD_SV,"2025-05-18 21:34:13",581,286,239,47,0,269,17,600,314,168,101
7,BOTOŞANI,"SCOALA PRIMARA NR. 3 SUHARAU",369,SUHARĂU,38982,1,PART,PRCNCT,PRSD,PRSD_SV,"2025-05-18 21:42:30",928,447,382,52,13,441,6,1000,553,232,209
7,BOTOŞANI,"SCOALA GIMNAZIALA NR. 2 SUHARAU",370,SUHARĂU,38982,1,PART,PRCNCT,PRSD,PRSD_SV,"2025-05-18 21:48:14",534,246,217,29,0,243,3,700,454,148,95
7,BOTOŞANI,"ȘCOALA GIMNAZIALĂ CONSTATIN TINCU LIȘNA",371,SUHARĂU,38982,1,PART,PRCNCT,PRSD,PRSD_SV,"2025-05-18 21:33:56",696,374,317,54,3,369,5,800,426,191,178
7,BOTOŞANI,"SCOALA GENERALA NR. 4 OROFTIANA",372,SUHARĂU,38982,1,PART,PRCNCT,PRSD,PRSD_SV,"2025-05-18 21:37:33",685,340,302,38,0,335,5,800,460,206,129
7,BOTOŞANI,"GRADINITA SMARDAN",373,SUHARĂU,38982,1,PART,PRCNCT,PRSD,PRSD_SV,"2025-05-18 21:39:41",576,285,244,41,0,281,4,600,315,187,94
7,BOTOŞANI,"SCOALA CU CL I-VIII SULITA",374,SULIŢA,39051,1,PART,PRCNCT,PRSD,PRSD_SV,"2025-05-18 22:04:23",1293,608,536,56,16,604,4,1400,792,368,236
7,BOTOŞANI,"SCOALA CU CL. I - VIII DRACSANI",375,SULIŢA,39051,1,PART,PRCNCT,PRSD,PRSD_SV,"2025-05-18 22:00:49",1059,500,453,47,0,497,3,1100,600,274,223
7,BOTOŞANI,"ȘCOALA GIMNAZIALĂ ”ALECU IVAN GHILEA”",376,ŞENDRICENI,39122,1,PART,PRCNCT,PRSD,PRSD_SV,"2025-05-18 21:38:08",1239,551,504,47,0,546,5,1300,749,355,191
7,BOTOŞANI,"ŞCOALA GENERALĂ COBÎLA",377,ŞENDRICENI,39122,1,PART,PRCNCT,PRSD,PRSD_SV,"2025-05-18 21:41:37",769,338,305,33,0,332,6,800,462,225,107
7,BOTOŞANI,"ŞCOALA GENERALĂ",378,ŞENDRICENI,39122,1,PART,PRCNCT,PRSD,PRSD_SV,"2025-05-18 21:29:19",490,212,185,27,0,210,2,600,388,137,73
7,BOTOŞANI,"ŞCOALA PRIMARĂ VICTOR ISĂCEANU,CORP I",379,ŞENDRICENI,39122,1,PART,PRCNCT,PRSD,PRSD_SV,"2025-05-18 21:33:42",822,322,293,29,0,321,1,900,578,207,114
7,BOTOŞANI,"ȘCOALA GIMNAZIALĂ NR. 1 - ȘTIUBIENI",380,ŞTIUBIENI,39220,1,PART,PRCNCT,PRSD,PRSD_SV,"2025-05-18 22:03:50",1535,575,493,57,25,571,4,1600,1025,371,200
7,BOTOŞANI,"CAMINUL CULTURAL NEGRENI",381,ŞTIUBIENI,39220,1,PART,PRCNCT,PRSD,PRSD_SV,"2025-05-18 21:37:17",642,305,269,27,9,304,1,700,395,195,109
7,BOTOŞANI,"CĂMINUL CULTURAL AL COMUNEI TODIRENI",382,TODIRENI,39266,1,PART,PRCNCT,PRSD,PRSD_SV,"2025-05-18 21:54:54",1171,497,430,58,9,493,4,1200,703,259,234
7,BOTOŞANI,"ŞCOALA CU CLASELE I-IV NR.2 TODIRENI",383,TODIRENI,39266,1,PART,PRCNCT,PRSD,PRSD_SV,"2025-05-18 21:22:33",498,207,180,27,0,206,1,600,393,137,69
7,BOTOŞANI,"ŞCOALA CU CLASELE I-VIII CERNEŞTI",384,TODIRENI,39266,1,PART,PRCNCT,PRSD,PRSD_SV,"2025-05-18 21:34:59",635,310,260,49,1,307,3,700,390,176,131
7,BOTOŞANI,"ŞCOALA CU CLASELE I-IV IUREŞTI",385,TODIRENI,39266,1,PART,PRCNCT,PRSD,PRSD_SV,"2025-05-18 21:28:29",419,192,161,30,1,192,0,500,308,126,66
7,BOTOŞANI,"GRĂDINIŢA DE COPII TRUSESTI",386,TRUŞEŞTI,39328,1,PART,PRCNCT,PRSD,PRSD_SV,"2025-05-18 21:44:22",1030,470,421,44,5,464,6,1200,730,235,229
7,BOTOŞANI,"GRĂDINIŢA DE COPII TRUSESTI",387,TRUŞEŞTI,39328,1,PART,PRCNCT,PRSD,PRSD_SV,"2025-05-18 21:33:26",1070,439,401,38,0,430,9,1100,661,221,209
7,BOTOŞANI,"ŞCOALA GENERALĂ NR. 4 BUHĂCENI",388,TRUŞEŞTI,39328,1,PART,PRCNCT,PRSD,PRSD_SV,"2025-05-18 21:21:48",612,294,249,34,11,288,6,700,406,148,140
7,BOTOŞANI,"GRĂDINIŢA DRISLEA",389,TRUŞEŞTI,39328,1,PART,PRCNCT,PRSD,PRSD_SV,"2025-05-18 21:26:24",853,387,331,56,0,383,4,900,513,228,155
7,BOTOŞANI,"ŞCOALA GENERALĂ NR. 2 IONĂŞENI",390,TRUŞEŞTI,39328,1,PART,PRCNCT,PRSD,PRSD_SV,"2025-05-18 21:21:26",714,304,257,47,0,299,5,800,496,169,130
7,BOTOŞANI,"CĂMIN CULTURAL",391,TUDORA,39391,1,PART,PRCNCT,PRSD,PRSD_SV,"2025-05-18 21:46:47",1242,609,524,71,14,602,7,1300,691,336,266
7,BOTOŞANI,"ȘCOALA TIBERIU CRUDU CORP A",392,TUDORA,39391,1,PART,PRCNCT,PRSD,PRSD_SV,"2025-05-18 21:28:25",1592,587,540,42,5,582,5,1600,1013,371,211
7,BOTOŞANI,"SCOALA CU CLASELE I-VIII ARINI",393,TUDORA,39391,1,PART,PRCNCT,PRSD,PRSD_SV,"2025-05-18 21:33:45",1137,467,411,47,9,461,6,1200,733,281,180
7,BOTOŞANI,"ŞCOALA GIMNAZIALĂ NR. 1 UNGURENI",394,UNGURENI,39417,1,PART,PRCNCT,PRSD,PRSD_SV,"2025-05-18 21:48:12",1108,441,381,60,0,438,3,1200,759,274,164
7,BOTOŞANI,"ȘCOALA GIMNAZIALĂ NR. 2 UNGURENI",395,UNGURENI,39417,1,PART,PRCNCT,PRSD,PRSD_SV,"2025-05-18 21:21:48",1042,379,356,23,0,378,1,1100,721,274,104
7,BOTOŞANI,"ŞCOALA GIMNAZIALĂ NR. 3 BORZEŞTI",396,UNGURENI,39417,1,PART,PRCNCT,PRSD,PRSD_SV,"2025-05-18 21:38:20",1122,378,347,31,0,372,6,1200,822,289,83
7,BOTOŞANI,"ŞCOALA PRIMARĂ NR. 9, CĂLUGĂRENII NOI",397,UNGURENI,39417,1,PART,PRCNCT,PRSD,PRSD_SV,"2025-05-18 21:47:45",568,260,221,39,0,259,1,600,340,199,60
7,BOTOŞANI,"ŞCOALA PRIMARĂ NR. 5 MIHAI VITEAZU",398,UNGURENI,39417,1,PART,PRCNCT,PRSD,PRSD_SV,"2025-05-18 21:25:01",372,173,157,16,0,168,5,400,227,113,55
7,BOTOŞANI,"LICEUL TEHNOLOGIC PLOPENII MARI",399,UNGURENI,39417,1,PART,PRCNCT,PRSD,PRSD_SV,"2025-05-18 21:39:54",779,334,300,34,0,329,5,800,466,191,138
7,BOTOŞANI,"ŞCOALA GIMNAZIALĂ NR.1 UNŢENI",400,UNŢENI,39532,1,PART,PRCNCT,PRSD,PRSD_SV,"2025-05-18 21:19:12",955,419,379,40,0,415,4,1000,581,281,134
7,BOTOŞANI,"GRĂDINIȚA CU PROGRAM NORMAL NR. 1 BURLEȘTI",401,UNŢENI,39532,1,PART,PRCNCT,PRSD,PRSD_SV,"2025-05-18 21:25:25",488,254,205,49,0,253,1,600,346,167,86
7,BOTOŞANI,"ŞCOALA PRIMARĂ NR.2 MÂNĂSTIRENI",402,UNŢENI,39532,1,PART,PRCNCT,PRSD,PRSD_SV,"2025-05-18 21:20:13",612,264,229,32,3,259,5,700,436,169,90
7,BOTOŞANI,"SCOALA VACULESTI, CORP A",403,VĂCULEŞTI,39612,1,PART,PRCNCT,PRSD,PRSD_SV,"2025-05-18 21:54:21",847,414,339,58,17,406,8,900,486,265,141
7,BOTOŞANI,"SCOALA GOROVEI",404,VĂCULEŞTI,39612,1,PART,PRCNCT,PRSD,PRSD_SV,"2025-05-18 21:09:49",25,31,13,18,0,31,0,53,22,23,8
7,BOTOŞANI,"BAZA SPORTIVĂ",405,VĂCULEŞTI,39612,1,PART,PRCNCT,PRSD,PRSD_SV,"2025-05-18 21:49:18",817,433,368,50,15,431,2,900,467,294,137
7,BOTOŞANI,"ȘCOALA GIMNAZIALĂ ”GEORGE HAZGAN”",406,"VÂRFU CÂMPULUI",39694,1,PART,PRCNCT,PRSD,PRSD_SV,"2025-05-18 21:14:37",1927,55,23,32,0,55,0,2000,1945,35,20
7,BOTOŞANI,"ȘCOALA GIMNAZIALĂ ”GEORGE HAZGAN”",407,"VÂRFU CÂMPULUI",39694,1,PART,PRCNCT,PRSD,PRSD_SV,"2025-05-18 21:22:29",1993,53,33,20,0,52,1,2100,2047,23,29
7,BOTOŞANI,"ŞC.CU CLASELE I-VIII GEORGE HAZGAN",408,"VÂRFU CÂMPULUI",39694,1,PART,PRCNCT,PRSD,PRSD_SV,"2025-05-18 21:30:23",1782,232,207,23,2,230,2,1900,1668,102,128
7,BOTOŞANI,"ȘC.CU CLASELE I-VIII GEORGE HAZGAN",409,"VÂRFU CÂMPULUI",39694,1,PART,PRCNCT,PRSD,PRSD_SV,"2025-05-18 21:29:57",1786,186,174,12,0,181,5,1900,1714,88,93
7,BOTOŞANI,"ŞC.CU CLASELE I-VIII IONĂŞENI",410,"VÂRFU CÂMPULUI",39694,1,PART,PRCNCT,PRSD,PRSD_SV,"2025-05-18 21:31:43",852,360,320,40,0,356,4,1000,640,183,173
7,BOTOŞANI,"ŞCOALA PRIMARĂ NR. 2 LUNCA",411,"VÂRFU CÂMPULUI",39694,1,PART,PRCNCT,PRSD,PRSD_SV,"2025-05-18 21:34:32",688,308,248,60,0,305,3,800,492,188,117
7,BOTOŞANI,"ŞC.CU CLASELE I-VIII NR.1",412,"VÂRFU CÂMPULUI",39694,1,PART,PRCNCT,PRSD,PRSD_SV,"2025-05-18 21:31:59",846,382,333,49,0,374,8,900,518,167,207
7,BOTOŞANI,"CĂMINUL CULTURAL VIIŞOARA",413,VIIŞOARA,39658,1,PART,PRCNCT,PRSD,PRSD_SV,"2025-05-18 21:36:50",625,251,222,28,1,248,3,700,449,139,109
7,BOTOŞANI,"ŞCOLA CU CLASELE I-IV CUZA VODĂ",414,VIIŞOARA,39658,1,PART,PRCNCT,PRSD,PRSD_SV,"2025-05-18 21:29:49",396,165,138,27,0,162,3,500,335,104,58
7,BOTOŞANI,"ŞCOLA CU CLASELE I-IV VIIŞOARA MICĂ",415,VIIŞOARA,39658,1,PART,PRCNCT,PRSD,PRSD_SV,"2025-05-18 21:29:20",348,142,124,18,0,138,4,400,258,85,53
7,BOTOŞANI,"SCOALA CU CLASELE I-VIII VLADENI(CORP NOU)",416,VLĂDENI,39738,1,PART,PRCNCT,PRSD,PRSD_SV,"2025-05-18 21:47:53",1484,727,607,119,1,717,10,1600,873,429,288
7,BOTOŞANI,"SCOALA CU CLASELE I-VIII BREHUIESTI(CORPUL B)",417,VLĂDENI,39738,1,PART,PRCNCT,PRSD,PRSD_SV,"2025-05-18 21:32:13",1459,591,540,51,0,586,5,1500,909,392,194
7,BOTOŞANI,"SCOALA CU CLASELE I-VIII MANDRESTI",418,VLĂDENI,39738,1,PART,PRCNCT,PRSD,PRSD_SV,"2025-05-18 21:22:04",1059,485,434,51,0,480,5,1100,615,346,134
7,BOTOŞANI,"ȘCOALA PROFESIONALĂ ”GHEORGHE BURAC” VLĂSINEȘTI",419,VLĂSINEŞTI,39792,1,PART,PRCNCT,PRSD,PRSD_SV,"2025-05-18 21:37:47",975,279,235,35,9,275,4,1100,821,163,112
7,BOTOŞANI,"ŞCOALA CU CLASELE I-VIII GHEORGHE BURAC",420,VLĂSINEŞTI,39792,1,PART,PRCNCT,PRSD,PRSD_SV,"2025-05-18 21:36:34",1057,263,219,42,2,257,6,1100,837,155,102
7,BOTOŞANI,"ŞCOALA CU CLASELE I-IV",421,VLĂSINEŞTI,39792,1,PART,PRCNCT,PRSD,PRSD_SV,"2025-05-18 21:21:22",449,154,136,18,0,152,2,500,346,113,39
7,BOTOŞANI,"ŞCOALA CU CLASELE I-IV",422,VLĂSINEŞTI,39792,1,PART,PRCNCT,PRSD,PRSD_SV,"2025-05-18 21:32:08",1235,373,334,35,4,372,1,1300,927,243,129
7,BOTOŞANI,"CĂMINUL CULTURAL VORNICENI",423,VORNICENI,39836,1,PART,PRCNCT,PRSD,PRSD_SV,"2025-05-18 21:32:30",1468,445,396,49,0,445,0,1600,1155,243,202
7,BOTOŞANI,"GRĂDINIȚA NR. 2 VORNICENI",424,VORNICENI,39836,1,PART,PRCNCT,PRSD,PRSD_SV,"2025-05-18 21:39:26",1022,300,282,18,0,297,3,1100,800,199,98
7,BOTOŞANI,"ȘCOALA GIMNAZIALĂ NR.1 VORNICENI",425,VORNICENI,39836,1,PART,PRCNCT,PRSD,PRSD_SV,"2025-05-18 21:42:13",1016,260,232,28,0,255,5,1100,840,163,92
7,BOTOŞANI,"ȘCOALA PRIMARĂ NR. 2 DEALU CRUCII",426,VORNICENI,39836,1,PART,PRCNCT,PRSD,PRSD_SV,"2025-05-18 21:18:03",274,106,86,20,0,106,0,300,194,80,26
7,BOTOŞANI,"ŞCOALA GIMNAZIALĂ ” AL. I. CUZA” VORONA",427,VORONA,39872,2,PART,PRCNCT,PRSD,PRSD_SV,"2025-05-18 23:17:41",804,303,274,29,0,300,3,900,597,190,110
7,BOTOŞANI,"LICEUL TEHNOLOGIC STEFAN CEL MARE VORONA",428,VORONA,39872,1,PART,PRCNCT,PRSD,PRSD_SV,"2025-05-18 21:41:34",807,465,344,119,2,462,3,900,435,248,214
7,BOTOŞANI,"SCOALA CU CLASELE I-VIII IONITA PANCUL VORONA",429,VORONA,39872,1,PART,PRCNCT,PRSD,PRSD_SV,"2025-05-18 21:30:40",474,199,155,44,0,198,1,600,401,129,69
7,BOTOŞANI,"GRADINITA NUMARUL 2 ICUSENI",430,VORONA,39872,1,PART,PRCNCT,PRSD,PRSD_SV,"2025-05-18 21:12:02",226,125,99,26,0,125,0,400,275,73,52
7,BOTOŞANI,"SCOALA CU CLASELE I-VIII ALEXANDRU CEL BUN ICUSENI",431,VORONA,39872,1,PART,PRCNCT,PRSD,PRSD_SV,"2025-05-18 21:25:43",773,329,291,38,0,324,5,900,571,192,132
7,BOTOŞANI,"SCOALA CU CLASELE I-VIII RALUCA IURASCU JOLDESTI",432,VORONA,39872,2,PART,PRCNCT,PRSD,PRSD_SV,"2025-05-18 22:53:43",1016,446,403,43,0,441,5,1100,654,280,161
7,BOTOŞANI,"SCOALA CU CLASELE I-VIII NICOLAE IORGA POIANA",433,VORONA,39872,1,PART,PRCNCT,PRSD,PRSD_SV,"2025-05-18 21:36:37",938,389,346,43,0,382,7,1100,711,230,152
7,BOTOŞANI,"SCOALA CU CLASELE I-VIII LUCA ARBORE VORONA MARE",434,VORONA,39872,1,PART,PRCNCT,PRSD,PRSD_SV,"2025-05-18 21:24:07",993,397,350,45,2,393,4,1100,703,243,150
8,BRAŞOV,"SEMINARUL TEOLOGIC LICEAL ORTODOX ”DUMITRU STĂNILOAIE”",1,"MUNICIPIUL BRAŞOV",40198,1,PART,PRCNCT,PRSD,PRSD_SV,"2025-05-18 21:59:32",1764,899,820,78,1,883,16,1900,1001,249,634
8,BRAŞOV,"SEMINARUL TEOLOGIC LICEAL ORTODOX ”DUMITRU STĂNILOAIE”",2,"MUNICIPIUL BRAŞOV",40198,2,PART,PRCNCT,PRSD,PRSD_SV,"2025-05-19 01:00:43",1143,691,629,60,2,683,8,1200,509,182,501
8,BRAŞOV,"GRĂDINIŢA CU PROGRAM PRELUNGIT NR. 2",3,"MUNICIPIUL BRAŞOV",40198,1,PART,PRCNCT,PRSD,PRSD_SV,"2025-05-18 22:14:38",903,642,519,122,1,639,3,1000,358,176,463
8,BRAŞOV,"GRĂDINIŢA CU PROGRAM PRELUNGIT NR. 2",4,"MUNICIPIUL BRAŞOV",40198,1,PART,PRCNCT,PRSD,PRSD_SV,"2025-05-18 22:17:44",1183,822,689,131,2,812,10,1300,478,173,639
8,BRAŞOV,"COLEGIUL NAȚIONAL ”ANDREI MUREŞANU”",5,"MUNICIPIUL BRAŞOV",40198,1,PART,PRCNCT,PRSD,PRSD_SV,"2025-05-18 22:23:12",1295,1000,724,221,55,978,22,1400,400,245,733
8,BRAŞOV,"COLEGIUL NAȚIONAL ”ANDREI MUREŞANU”",6,"MUNICIPIUL BRAŞOV",40198,1,PART,PRCNCT,PRSD,PRSD_SV,"2025-05-18 22:20:59",1336,905,664,194,47,892,13,1700,795,214,678
8,BRAŞOV,"COLEGIUL TEHNIC ”MARIA BAIULESCU”",7,"MUNICIPIUL BRAŞOV",40198,1,PART,PRCNCT,PRSD,PRSD_SV,"2025-05-18 22:22:36",1124,740,539,198,3,728,11,1200,460,176,552
8,BRAŞOV,"COLEGIUL TEHNIC ”MARIA BAIULESCU”",8,"MUNICIPIUL BRAŞOV",40198,2,PART,PRCNCT,PRSD,PRSD_SV,"2025-05-19 00:27:57",1257,698,585,112,1,686,12,1301,603,184,502
8,BRAŞOV,"COLEGIUL NAŢIONAL ”APRILY LAJOS”",9,"MUNICIPIUL BRAŞOV",40198,1,PART,PRCNCT,PRSD,PRSD_SV,"2025-05-18 22:09:10",814,618,402,216,0,613,5,900,282,166,447
8,BRAŞOV,"COLEGIUL NAŢIONAL ”APRILY LAJOS”",10,"MUNICIPIUL BRAŞOV",40198,1,PART,PRCNCT,PRSD,PRSD_SV,"2025-05-18 21:39:45",875,690,461,225,4,680,10,1000,310,144,536
8,BRAŞOV,"COLEGIUL NAŢIONAL ”APRILY LAJOS”",11,"MUNICIPIUL BRAŞOV",40198,1,PART,PRCNCT,PRSD,PRSD_SV,"2025-05-18 21:52:56",645,545,330,215,0,540,5,700,155,136,404
8,BRAŞOV,"COLEGIUL NAŢIONAL ”UNIREA”",12,"MUNICIPIUL BRAŞOV",40198,1,PART,PRCNCT,PRSD,PRSD_SV,"2025-05-18 22:13:13",779,979,424,555,0,969,10,1200,221,237,732
8,BRAŞOV,"COLEGIUL NAŢIONAL ”UNIREA”",13,"MUNICIPIUL BRAŞOV",40198,1,PART,PRCNCT,PRSD,PRSD_SV,"2025-05-18 22:18:20",1171,973,575,397,1,960,13,1600,627,221,739
8,BRAŞOV,"ŞCOALA GIMNAZIALĂ NR. 8",14,"MUNICIPIUL BRAŞOV",40198,1,PART,PRCNCT,PRSD,PRSD_SV,"2025-05-18 21:40:04",860,627,499,128,0,620,7,900,273,140,480
8,BRAŞOV,"ŞCOALA GIMNAZIALĂ NR. 8",15,"MUNICIPIUL BRAŞOV",40198,1,PART,PRCNCT,PRSD,PRSD_SV,"2025-05-18 22:08:46",892,729,436,253,40,724,5,1000,271,175,549
8,BRAŞOV,"ŞCOALA GIMNAZIALĂ NR. 8",16,"MUNICIPIUL BRAŞOV",40198,1,PART,PRCNCT,PRSD,PRSD_SV,"2025-05-18 21:34:27",1083,692,619,68,5,686,6,1200,508,175,511
8,BRAŞOV,"ŞCOALA GIMNAZIALĂ NR. 8",17,"MUNICIPIUL BRAŞOV",40198,1,PART,PRCNCT,PRSD,PRSD_SV,"2025-05-18 22:33:59",1559,915,866,49,0,902,13,1600,685,209,693
8,BRAŞOV,"ŞCOALA GIMNAZIALĂ NR.5",18,"MUNICIPIUL BRAŞOV",40198,1,PART,PRCNCT,PRSD,PRSD_SV,"2025-05-18 23:10:49",1378,1016,735,272,9,1008,8,1500,484,221,787
8,BRAŞOV,"ŞCOALA GIMNAZIALĂ NR.5",19,"MUNICIPIUL BRAŞOV",40198,1,PART,PRCNCT,PRSD,PRSD_SV,"2025-05-18 21:54:05",1382,958,696,215,47,932,26,1500,542,231,701
8,BRAŞOV,"ŞCOALA GIMNAZIALĂ NR. 15",20,"MUNICIPIUL BRAŞOV",40198,1,PART,PRCNCT,PRSD,PRSD_SV,"2025-05-18 22:03:59",1568,1294,909,385,0,1280,14,1800,506,308,972
8,BRAŞOV,"ŞCOALA GIMNAZIALĂ NR. 15",21,"MUNICIPIUL BRAŞOV",40198,1,PART,PRCNCT,PRSD,PRSD_SV,"2025-05-18 22:28:23",1376,1070,734,319,17,1052,18,1600,530,252,800
8,BRAŞOV,"ŞCOALA GIMNAZIALĂ NR. 15",22,"MUNICIPIUL BRAŞOV",40198,1,PART,PRCNCT,PRSD,PRSD_SV,"2025-05-18 22:07:05",1330,1115,782,333,0,1108,7,1608,493,237,871
8,BRAŞOV,"ŞCOALA GIMNAZIALĂ NR. 15",23,"MUNICIPIUL BRAŞOV",40198,1,PART,PRCNCT,PRSD,PRSD_SV,"2025-05-18 22:01:38",1358,841,773,66,2,831,10,1500,659,168,663
8,BRAŞOV,"ŞCOALA GIMNAZIALĂ NR. 15",24,"MUNICIPIUL BRAŞOV",40198,1,PART,PRCNCT,PRSD,PRSD_SV,"2025-05-18 22:40:07",1160,689,616,72,1,673,16,1300,611,182,491
8,BRAŞOV,"ŞCOALA GIMNAZIALĂ NR. 15",25,"MUNICIPIUL BRAŞOV",40198,1,PART,PRCNCT,PRSD,PRSD_SV,"2025-05-18 22:04:25",1123,618,580,38,0,617,1,1200,582,193,424
8,BRAŞOV,"ŞCOALA GIMNAZIALĂ NR. 15",26,"MUNICIPIUL BRAŞOV",40198,1,PART,PRCNCT,PRSD,PRSD_SV,"2025-05-18 22:28:39",1146,965,675,289,1,952,13,1400,435,216,736
8,BRAŞOV,"LICEUL DE MUZICĂ ”TUDOR CIORTEA”",27,"MUNICIPIUL BRAŞOV",40198,1,PART,PRCNCT,PRSD,PRSD_SV,"2025-05-18 22:19:57",1216,1020,672,290,58,1003,17,1300,280,252,751
8,BRAŞOV,"ŞCOALA GIMNAZIALĂ NR. 12",28,"MUNICIPIUL BRAŞOV",40198,1,PART,PRCNCT,PRSD,PRSD_SV,"2025-05-18 22:04:24",1491,981,808,171,2,973,8,1600,619,239,734
8,BRAŞOV,"ŞCOALA GIMNAZIALĂ NR. 12",29,"MUNICIPIUL BRAŞOV",40198,1,PART,PRCNCT,PRSD,PRSD_SV,"2025-05-18 22:11:56",1380,940,732,208,0,930,10,1500,560,240,690
8,BRAŞOV,"GRĂDINIŢA CU PROGRAM PRELUNGIT ”CASUTA BUCURIEI” NR. 11",30,"MUNICIPIUL BRAŞOV",40198,1,PART,PRCNCT,PRSD,PRSD_SV,"2025-05-18 21:58:27",843,545,462,83,0,537,8,900,355,145,392
8,BRAŞOV,"GRĂDINIŢA CU PROGRAM PRELUNGIT ”CASUTA BUCURIEI” NR. 11",31,"MUNICIPIUL BRAŞOV",40198,1,PART,PRCNCT,PRSD,PRSD_SV,"2025-05-18 22:08:08",802,554,480,73,1,544,10,899,345,122,422
8,BRAŞOV,"COLEGIUL DE ȘTIINȚE ALE NATURII ”EMIL RACOVIŢĂ”",32,"MUNICIPIUL BRAŞOV",40198,1,PART,PRCNCT,PRSD,PRSD_SV,"2025-05-18 22:00:41",1007,660,566,92,2,649,11,1100,440,190,459
8,BRAŞOV,"COLEGIUL DE ȘTIINȚE ALE NATURII ”EMIL RACOVIŢĂ”",33,"MUNICIPIUL BRAŞOV",40198,2,PART,PRCNCT,PRSD,PRSD_SV,"2025-05-18 22:58:46",1239,787,687,99,1,781,6,1300,513,184,597
8,BRAŞOV,"COLEGIUL DE ȘTIINȚE ALE NATURII ”EMIL RACOVIŢĂ”",34,"MUNICIPIUL BRAŞOV",40198,1,PART,PRCNCT,PRSD,PRSD_SV,"2025-05-18 22:06:33",1226,763,661,100,2,753,10,1300,537,173,580
8,BRAŞOV,"COLEGIUL DE ȘTIINȚE ALE NATURII ”EMIL RACOVIŢĂ”",35,"MUNICIPIUL BRAŞOV",40198,1,PART,PRCNCT,PRSD,PRSD_SV,"2025-05-18 21:54:41",1207,810,702,108,0,799,11,1300,490,190,609
8,BRAŞOV,"COLEGIUL NAŢIONAL ”DR. I. MEŞOTĂ”",36,"MUNICIPIUL BRAŞOV",40198,1,PART,PRCNCT,PRSD,PRSD_SV,"2025-05-18 21:59:19",1238,898,722,169,7,888,10,1400,502,162,726
8,BRAŞOV,"COLEGIUL NAŢIONAL ”DR. I. MEŞOTĂ”",37,"MUNICIPIUL BRAŞOV",40198,1,PART,PRCNCT,PRSD,PRSD_SV,"2025-05-18 22:23:27",1148,930,668,260,2,923,7,1300,370,193,730
8,BRAŞOV,"COLEGIUL NAŢIONAL ”DR. I. MEŞOTĂ”",38,"MUNICIPIUL BRAŞOV",40198,1,PART,PRCNCT,PRSD,PRSD_SV,"2025-05-18 22:36:12",1389,992,775,217,0,983,9,1500,508,201,782
8,BRAŞOV,"ŞCOALA GIMNAZIALĂ NR. 19",39,"MUNICIPIUL BRAŞOV",40198,2,PART,PRCNCT,PRSD,PRSD_SV,"2025-05-19 00:43:52",1053,725,587,136,2,718,7,1100,375,156,562
8,BRAŞOV,"ŞCOALA GIMNAZIALĂ NR. 19",40,"MUNICIPIUL BRAŞOV",40198,1,PART,PRCNCT,PRSD,PRSD_SV,"2025-05-18 21:43:14",1282,919,743,176,0,906,13,1400,481,248,658
8,BRAŞOV,"ŞCOALA GIMNAZIALĂ NR. 19",41,"MUNICIPIUL BRAŞOV",40198,1,PART,PRCNCT,PRSD,PRSD_SV,"2025-05-18 22:12:38",896,679,494,184,1,674,5,1000,321,188,486
8,BRAŞOV,"ŞCOALA GIMNAZIALĂ NR. 19",42,"MUNICIPIUL BRAŞOV",40198,1,PART,PRCNCT,PRSD,PRSD_SV,"2025-05-18 22:04:58",1450,937,795,141,1,923,14,1500,563,217,706
8,BRAŞOV,"ŞCOALA GIMNAZIALĂ NR. 19",43,"MUNICIPIUL BRAŞOV",40198,2,PART,PRCNCT,PRSD,PRSD_SV,"2025-05-19 00:46:10",1373,932,802,129,1,918,14,1500,568,217,701
8,BRAŞOV,"VILA ORIZONT",44,"MUNICIPIUL BRAŞOV",40198,1,PART,PRCNCT,PRSD,PRSD_SV,"2025-05-18 22:06:14",345,618,175,442,1,611,7,1100,482,251,360
8,BRAŞOV,"ŞCOALA GIMNAZIALĂ NR. 27 ”ANATOL GHERMANSCHI”",45,"MUNICIPIUL BRAŞOV",40198,1,PART,PRCNCT,PRSD,PRSD_SV,"2025-05-18 22:18:40",1374,910,763,146,1,898,12,1500,590,214,684
8,BRAŞOV,"ŞCOALA GIMNAZIALĂ NR. 27 ”ANATOL GHERMANSCHI”",46,"MUNICIPIUL BRAŞOV",40198,1,PART,PRCNCT,PRSD,PRSD_SV,"2025-05-18 21:54:37",1316,854,739,115,0,836,18,1400,546,219,617
8,BRAŞOV,"ŞCOALA GIMNAZIALĂ NR. 27 ”ANATOL GHERMANSCHI”",47,"MUNICIPIUL BRAŞOV",40198,1,PART,PRCNCT,PRSD,PRSD_SV,"2025-05-18 23:17:09",898,660,515,145,0,651,9,1000,340,161,490
8,BRAŞOV,"ŞCOALA GIMNAZIALĂ NR. 27 ”ANATOL GHERMANSCHI”",48,"MUNICIPIUL BRAŞOV",40198,1,PART,PRCNCT,PRSD,PRSD_SV,"2025-05-18 21:57:36",1176,775,663,111,1,763,12,1300,525,225,538
8,BRAŞOV,"ŞCOALA GIMNAZIALĂ NR. 27 ”ANATOL GHERMANSCHI”",49,"MUNICIPIUL BRAŞOV",40198,2,PART,PRCNCT,PRSD,PRSD_SV,"2025-05-18 22:31:32",1308,818,697,121,0,804,14,1400,582,254,550
8,BRAŞOV,"ŞCOALA GIMNAZIALĂ NR. 27 ”ANATOL GHERMANSCHI”",50,"MUNICIPIUL BRAŞOV",40198,1,PART,PRCNCT,PRSD,PRSD_SV,"2025-05-18 21:51:54",1405,903,794,109,0,887,16,1500,597,208,679
8,BRAŞOV,"ŞCOALA GIMNAZIALĂ NR. 27 ”ANATOL GHERMANSCHI”",51,"MUNICIPIUL BRAŞOV",40198,1,PART,PRCNCT,PRSD,PRSD_SV,"2025-05-18 21:51:10",1403,876,787,87,2,862,14,1500,624,230,632
8,BRAŞOV,"ŞCOALA GIMNAZIALĂ NR. 11 „ST.O.IOSIF”",52,"MUNICIPIUL BRAŞOV",40198,1,PART,PRCNCT,PRSD,PRSD_SV,"2025-05-18 22:08:58",1131,769,658,110,1,758,11,1200,431,206,552
8,BRAŞOV,"ŞCOALA GIMNAZIALĂ NR. 11 „ST.O.IOSIF”",53,"MUNICIPIUL BRAŞOV",40198,1,PART,PRCNCT,PRSD,PRSD_SV,"2025-05-18 21:53:44",1365,832,755,77,0,817,15,1500,668,248,569
8,BRAŞOV,"ŞCOALA GIMNAZIALĂ NR. 11 „ST.O.IOSIF”",54,"MUNICIPIUL BRAŞOV",40198,1,PART,PRCNCT,PRSD,PRSD_SV,"2025-05-18 22:06:00",992,559,494,65,0,554,5,1100,541,174,380
8,BRAŞOV,"ŞCOALA GIMNAZIALĂ NR. 11 „ST.O.IOSIF”",55,"MUNICIPIUL BRAŞOV",40198,1,PART,PRCNCT,PRSD,PRSD_SV,"2025-05-18 21:55:23",809,426,355,71,0,421,5,900,474,165,256
8,BRAŞOV,"ŞCOALA GIMNAZIALĂ NR. 11 „ST.O.IOSIF”",56,"MUNICIPIUL BRAŞOV",40198,1,PART,PRCNCT,PRSD,PRSD_SV,"2025-05-18 21:55:16",1299,670,602,67,1,651,19,1400,730,210,441
8,BRAŞOV,"ŞCOALA GIMNAZIALĂ NR. 11 „ST.O.IOSIF”",57,"MUNICIPIUL BRAŞOV",40198,1,PART,PRCNCT,PRSD,PRSD_SV,"2025-05-18 22:06:36",1276,702,661,40,1,691,11,1400,698,218,473
8,BRAŞOV,"ȘCOALA GIMNAZIALĂ NR. 11 ”ST.O.IOSIF”",58,"MUNICIPIUL BRAŞOV",40198,1,PART,PRCNCT,PRSD,PRSD_SV,"2025-05-18 21:54:43",1250,688,642,46,0,671,17,1300,612,191,480
8,BRAŞOV,"ȘCOALA GIMNAZIALĂ NR. 11 ”ST.O.IOSIF”",59,"MUNICIPIUL BRAŞOV",40198,1,PART,PRCNCT,PRSD,PRSD_SV,"2025-05-18 21:48:08",1071,640,597,42,1,631,9,1200,560,150,481
8,BRAŞOV,"ȘCOALA GIMNAZIALĂ NR. 11 ”ST.O.IOSIF”",60,"MUNICIPIUL BRAŞOV",40198,1,PART,PRCNCT,PRSD,PRSD_SV,"2025-05-18 22:10:13",1094,708,592,116,0,700,8,1200,492,163,537
8,BRAŞOV,"ȘCOALA GIMNAZIALĂ NR. 11 ”ST.O.IOSIF”",61,"MUNICIPIUL BRAŞOV",40198,1,PART,PRCNCT,PRSD,PRSD_SV,"2025-05-18 21:32:00",1214,751,658,93,0,737,14,1300,549,196,541
8,BRAŞOV,"ȘCOALA GIMNAZIALĂ NR. 11 ”ST.O.IOSIF”",62,"MUNICIPIUL BRAŞOV",40198,2,PART,PRCNCT,PRSD,PRSD_SV,"2025-05-19 00:41:31",1087,609,558,51,0,604,5,1200,591,191,413
8,BRAŞOV,"ȘCOALA GIMNAZIALĂ NR. 11 ”ST.O.IOSIF”",63,"MUNICIPIUL BRAŞOV",40198,1,PART,PRCNCT,PRSD,PRSD_SV,"2025-05-18 21:35:05",1163,649,602,47,0,639,10,1300,651,196,443
8,BRAŞOV,"ȘCOALA GIMNAZIALĂ NR. 11 ”ST.O.IOSIF”",64,"MUNICIPIUL BRAŞOV",40198,1,PART,PRCNCT,PRSD,PRSD_SV,"2025-05-18 22:19:06",1433,813,773,40,0,798,15,1500,687,289,509
8,BRAŞOV,"ȘCOALA GIMNAZIALĂ NR. 11 ”ST.O.IOSIF”",65,"MUNICIPIUL BRAŞOV",40198,1,PART,PRCNCT,PRSD,PRSD_SV,"2025-05-18 21:57:49",1448,798,760,37,1,787,11,1500,702,258,529
8,BRAŞOV,"ŞCOALA GIMNAZIALĂ NR. 25",66,"MUNICIPIUL BRAŞOV",40198,1,PART,PRCNCT,PRSD,PRSD_SV,"2025-05-18 21:40:45",1366,915,763,150,2,901,14,1500,585,247,654
8,BRAŞOV,"ŞCOALA GIMNAZIALĂ NR. 25",67,"MUNICIPIUL BRAŞOV",40198,1,PART,PRCNCT,PRSD,PRSD_SV,"2025-05-18 21:48:26",1702,1025,911,114,0,1012,13,1800,775,261,751
8,BRAŞOV,"ŞCOALA GIMNAZIALĂ NR. 25",68,"MUNICIPIUL BRAŞOV",40198,1,PART,PRCNCT,PRSD,PRSD_SV,"2025-05-18 21:59:04",783,569,441,128,0,558,11,900,331,170,388
8,BRAŞOV,"ŞCOALA GIMNAZIALĂ NR. 25",69,"MUNICIPIUL BRAŞOV",40198,1,PART,PRCNCT,PRSD,PRSD_SV,"2025-05-18 21:52:50",1480,898,786,112,0,884,14,1800,902,230,654
8,BRAŞOV,"LICEUL DE ARTE PLASTICE „HANS MATTIS-TEUTSCH”",70,"MUNICIPIUL BRAŞOV",40198,1,PART,PRCNCT,PRSD,PRSD_SV,"2025-05-18 21:30:27",1216,808,667,140,1,799,9,1300,492,172,627
8,BRAŞOV,"LICEUL DE ARTE PLASTICE „HANS MATTIS-TEUTSCH”",71,"MUNICIPIUL BRAŞOV",40198,1,PART,PRCNCT,PRSD,PRSD_SV,"2025-05-18 22:18:07",1521,966,825,138,3,953,13,1600,634,240,713
8,BRAŞOV,"LICEUL DE ARTE PLASTICE „HANS MATTIS-TEUTSCH”",72,"MUNICIPIUL BRAŞOV",40198,2,PART,PRCNCT,PRSD,PRSD_SV,"2025-05-18 22:56:36",1400,851,750,101,0,841,10,1500,649,217,624
8,BRAŞOV,"ȘCOALA GIMNAZIALĂ NR. 4",73,"MUNICIPIUL BRAŞOV",40198,1,PART,PRCNCT,PRSD,PRSD_SV,"2025-05-18 22:39:48",1267,721,666,53,2,709,12,1400,679,191,518
8,BRAŞOV,"ȘCOALA GIMNAZIALĂ NR. 4",74,"MUNICIPIUL BRAŞOV",40198,1,PART,PRCNCT,PRSD,PRSD_SV,"2025-05-18 21:59:07",1089,634,568,65,1,628,6,1200,566,145,483
8,BRAŞOV,"ȘCOALA GIMNAZIALĂ NR. 4",75,"MUNICIPIUL BRAŞOV",40198,1,PART,PRCNCT,PRSD,PRSD_SV,"2025-05-18 22:03:28",1184,752,667,85,0,734,18,1300,548,166,568
8,BRAŞOV,"ȘCOALA GIMNAZIALĂ NR. 4",76,"MUNICIPIUL BRAŞOV",40198,1,PART,PRCNCT,PRSD,PRSD_SV,"2025-05-18 22:55:33",1255,761,640,121,0,748,13,1300,539,186,562
8,BRAŞOV,"ȘCOALA GIMNAZIALĂ NR. 4",77,"MUNICIPIUL BRAŞOV",40198,1,PART,PRCNCT,PRSD,PRSD_SV,"2025-05-18 22:23:52",1475,896,831,65,0,891,5,1600,704,201,690
8,BRAŞOV,"ȘCOALA GIMNAZIALĂ NR. 4",78,"MUNICIPIUL BRAŞOV",40198,1,PART,PRCNCT,PRSD,PRSD_SV,"2025-05-18 21:58:27",1157,720,632,87,1,710,10,1300,580,187,523
8,BRAŞOV,"ŞCOALA GIMNAZIALĂ NR. 9 ”NICOLAE ORGHIDAN”",79,"MUNICIPIUL BRAŞOV",40198,1,PART,PRCNCT,PRSD,PRSD_SV,"2025-05-18 21:57:52",1456,771,719,50,2,762,9,1600,829,295,467
8,BRAŞOV,"ŞCOALA GIMNAZIALĂ NR. 9 ”NICOLAE ORGHIDAN”",80,"MUNICIPIUL BRAŞOV",40198,1,PART,PRCNCT,PRSD,PRSD_SV,"2025-05-18 22:26:18",1467,815,686,98,31,795,20,1600,785,358,437
8,BRAŞOV,"ŞCOALA GIMNAZIALĂ NR. 9 ”NICOLAE ORGHIDAN”",81,"MUNICIPIUL BRAŞOV",40198,1,PART,PRCNCT,PRSD,PRSD_SV,"2025-05-18 22:10:36",1330,792,684,103,5,783,9,1400,608,317,466
8,BRAŞOV,"ŞCOALA GIMNAZIALĂ NR. 9 ”NICOLAE ORGHIDAN”",82,"MUNICIPIUL BRAŞOV",40198,1,PART,PRCNCT,PRSD,PRSD_SV,"2025-05-18 22:11:20",1372,940,698,241,1,917,23,1500,560,364,553
8,BRAŞOV,"ŞCOALA GIMNAZIALĂ NR. 9 ”NICOLAE ORGHIDAN”",83,"MUNICIPIUL BRAŞOV",40198,1,PART,PRCNCT,PRSD,PRSD_SV,"2025-05-18 22:03:42",1329,816,712,104,0,804,12,1400,584,286,518
8,BRAŞOV,"ŞCOALA GIMNAZIALĂ NR. 9 ”NICOLAE ORGHIDAN”",84,"MUNICIPIUL BRAŞOV",40198,1,PART,PRCNCT,PRSD,PRSD_SV,"2025-05-18 21:55:05",1058,590,537,53,0,578,12,1200,610,208,370
8,BRAŞOV,"ŞCOALA GIMNAZIALĂ NR. 9 ”NICOLAE ORGHIDAN”",85,"MUNICIPIUL BRAŞOV",40198,1,PART,PRCNCT,PRSD,PRSD_SV,"2025-05-18 21:39:04",1334,731,628,102,1,719,12,1400,669,266,453
8,BRAŞOV,"ŞCOALA GIMNAZIALĂ NR. 9 ”NICOLAE ORGHIDAN”",86,"MUNICIPIUL BRAŞOV",40198,1,PART,PRCNCT,PRSD,PRSD_SV,"2025-05-18 22:08:47",1477,855,778,77,0,849,6,1600,745,330,519
8,BRAŞOV,"ŞCOALA GIMNAZIALĂ NR. 9 ”NICOLAE ORGHIDAN”",87,"MUNICIPIUL BRAŞOV",40198,1,PART,PRCNCT,PRSD,PRSD_SV,"2025-05-18 21:52:34",1583,921,877,38,6,916,5,1700,779,229,687
8,BRAŞOV,"ŞCOALA GIMNAZIALĂ NR. 9 ”NICOLAE ORGHIDAN”",88,"MUNICIPIUL BRAŞOV",40198,1,PART,PRCNCT,PRSD,PRSD_SV,"2025-05-18 22:05:34",1325,700,666,33,1,693,7,1500,800,269,424
8,BRAŞOV,"ŞCOALA GIMNAZIALĂ NR. 9 ”NICOLAE ORGHIDAN”",89,"MUNICIPIUL BRAŞOV",40198,1,PART,PRCNCT,PRSD,PRSD_SV,"2025-05-18 22:01:59",1360,681,647,34,0,664,17,1500,819,246,418
8,BRAŞOV,"ŞCOALA GIMNAZIALĂ NR. 3 ”GHEORGHE LAZĂR”",90,"MUNICIPIUL BRAŞOV",40198,1,PART,PRCNCT,PRSD,PRSD_SV,"2025-05-18 22:11:37",1432,1023,812,211,0,1011,12,1500,477,302,709
8,BRAŞOV,"ŞCOALA GIMNAZIALĂ NR. 3 ”GHEORGHE LAZĂR”",91,"MUNICIPIUL BRAŞOV",40198,1,PART,PRCNCT,PRSD,PRSD_SV,"2025-05-18 22:14:36",1459,1000,800,198,2,990,10,1600,600,243,747
8,BRAŞOV,"ŞCOALA GIMNAZIALĂ NR. 3 ”GHEORGHE LAZĂR”",92,"MUNICIPIUL BRAŞOV",40198,1,PART,PRCNCT,PRSD,PRSD_SV,"2025-05-18 23:26:24",1591,1027,881,146,0,1011,16,1700,673,310,701
8,BRAŞOV,"ŞCOALA GIMNAZIALĂ NR. 3 ”GHEORGHE LAZĂR”",93,"MUNICIPIUL BRAŞOV",40198,1,PART,PRCNCT,PRSD,PRSD_SV,"2025-05-18 22:02:52",1179,758,662,96,0,747,11,1300,542,202,545
8,BRAŞOV,"ŞCOALA GIMNAZIALĂ NR. 3 ”GHEORGHE LAZĂR”",94,"MUNICIPIUL BRAŞOV",40198,1,PART,PRCNCT,PRSD,PRSD_SV,"2025-05-18 21:39:47",1445,808,769,39,0,796,12,1500,692,175,621
8,BRAŞOV,"ŞCOALA GIMNAZIALĂ NR. 3 ”GHEORGHE LAZĂR”",95,"MUNICIPIUL BRAŞOV",40198,1,PART,PRCNCT,PRSD,PRSD_SV,"2025-05-18 21:46:37",1347,845,770,75,0,832,13,1500,655,195,637
8,BRAŞOV,"ŞCOALA GIMNAZIALĂ NR. 3 ”GHEORGHE LAZĂR”",96,"MUNICIPIUL BRAŞOV",40198,1,PART,PRCNCT,PRSD,PRSD_SV,"2025-05-18 21:51:10",1546,892,838,53,1,886,6,1700,808,211,675
8,BRAŞOV,"LICEUL TEHNOLOGIC SILVIC ”DOCTOR NICOLAE RUCĂREANU”",97,"MUNICIPIUL BRAŞOV",40198,1,PART,PRCNCT,PRSD,PRSD_SV,"2025-05-18 21:37:01",994,629,526,101,2,620,9,1100,471,161,459
8,BRAŞOV,"LICEUL TEHNOLOGIC SILVIC ”DOCTOR NICOLAE RUCĂREANU”",98,"MUNICIPIUL BRAŞOV",40198,1,PART,PRCNCT,PRSD,PRSD_SV,"2025-05-18 21:48:26",1246,781,693,88,0,772,9,1408,627,228,544
8,BRAŞOV,"LICEUL TEHNOLOGIC SILVIC ”DOCTOR NICOLAE RUCĂREANU”",99,"MUNICIPIUL BRAŞOV",40198,1,PART,PRCNCT,PRSD,PRSD_SV,"2025-05-18 21:31:41",840,531,440,91,0,519,12,900,369,127,392
8,BRAŞOV,"LICEUL TEHNOLOGIC SILVIC ”DOCTOR NICOLAE RUCĂREANU”",100,"MUNICIPIUL BRAŞOV",40198,1,PART,PRCNCT,PRSD,PRSD_SV,"2025-05-18 22:20:32",1342,796,689,100,7,779,17,1500,704,213,566
8,BRAŞOV,"ŞCOALA GIMNAZIALĂ NR. 2 ”DIACONU CORESI”",101,"MUNICIPIUL BRAŞOV",40198,1,PART,PRCNCT,PRSD,PRSD_SV,"2025-05-18 22:11:39",1395,762,717,44,1,747,15,1500,738,205,542
8,BRAŞOV,"ŞCOALA GIMNAZIALĂ NR. 2 ”DIACONU CORESI”",102,"MUNICIPIUL BRAŞOV",40198,1,PART,PRCNCT,PRSD,PRSD_SV,"2025-05-18 21:42:52",1369,834,760,72,2,826,8,1500,666,202,624
8,BRAŞOV,"ŞCOALA GIMNAZIALĂ NR. 2 ”DIACONU CORESI”",103,"MUNICIPIUL BRAŞOV",40198,1,PART,PRCNCT,PRSD,PRSD_SV,"2025-05-18 21:43:26",1317,853,705,145,3,841,12,1500,647,223,618
8,BRAŞOV,"ŞCOALA GIMNAZIALĂ NR. 2 ”DIACONU CORESI”",104,"MUNICIPIUL BRAŞOV",40198,1,PART,PRCNCT,PRSD,PRSD_SV,"2025-05-18 21:56:40",1409,873,723,149,1,861,12,1500,627,253,608
8,BRAŞOV,"ŞCOALA GIMNAZIALĂ NR. 2 ”DIACONU CORESI”",105,"MUNICIPIUL BRAŞOV",40198,1,PART,PRCNCT,PRSD,PRSD_SV,"2025-05-18 21:55:46",1309,768,666,101,1,761,7,1400,632,186,575
8,BRAŞOV,"ŞCOALA GIMNAZIALĂ NR. 2 ”DIACONU CORESI”",106,"MUNICIPIUL BRAŞOV",40198,1,PART,PRCNCT,PRSD,PRSD_SV,"2025-05-18 21:56:33",1678,1014,923,90,1,1001,13,1800,786,331,670
8,BRAŞOV,"COLEGIUL DE ŞTIINŢE ”GRIGORE ANTIPA”",107,"MUNICIPIUL BRAŞOV",40198,1,PART,PRCNCT,PRSD,PRSD_SV,"2025-05-18 22:54:04",1315,1006,749,201,56,992,14,1500,494,247,745
8,BRAŞOV,"COLEGIUL DE ŞTIINŢE ”GRIGORE ANTIPA”",108,"MUNICIPIUL BRAŞOV",40198,1,PART,PRCNCT,PRSD,PRSD_SV,"2025-05-18 22:18:32",1384,968,784,130,54,954,14,1500,532,257,697
8,BRAŞOV,"COLEGIUL DE ŞTIINŢE ”GRIGORE ANTIPA”",109,"MUNICIPIUL BRAŞOV",40198,1,PART,PRCNCT,PRSD,PRSD_SV,"2025-05-18 22:10:07",1317,908,716,141,51,893,15,1500,592,239,654
8,BRAŞOV,"COLEGIUL DE ŞTIINŢE ”GRIGORE ANTIPA”",110,"MUNICIPIUL BRAŞOV",40198,1,PART,PRCNCT,PRSD,PRSD_SV,"2025-05-18 22:14:25",1102,800,628,121,51,784,16,1200,400,213,571
8,BRAŞOV,"COLEGIUL NAŢIONAL DE INFORMATICĂ ”GRIGORE MOISIL”",111,"MUNICIPIUL BRAŞOV",40198,1,PART,PRCNCT,PRSD,PRSD_SV,"2025-05-18 21:46:33",1085,766,583,183,0,754,12,1200,434,221,533
8,BRAŞOV,"COLEGIUL NAŢIONAL DE INFORMATICĂ ”GRIGORE MOISIL”",112,"MUNICIPIUL BRAŞOV",40198,1,PART,PRCNCT,PRSD,PRSD_SV,"2025-05-18 22:38:51",1265,854,683,171,0,845,9,1400,546,229,616
8,BRAŞOV,"COLEGIUL NAŢIONAL DE INFORMATICĂ ”GRIGORE MOISIL”",113,"MUNICIPIUL BRAŞOV",40198,1,PART,PRCNCT,PRSD,PRSD_SV,"2025-05-18 22:35:59",1362,720,627,93,0,712,8,1500,780,243,469
8,BRAŞOV,"COLEGIUL NAŢIONAL DE INFORMATICĂ ”GRIGORE MOISIL”",114,"MUNICIPIUL BRAŞOV",40198,1,PART,PRCNCT,PRSD,PRSD_SV,"2025-05-18 22:09:27",1256,740,678,62,0,728,12,1400,660,189,539
8,BRAŞOV,"COLEGIUL NAŢIONAL DE INFORMATICĂ ”GRIGORE MOISIL”",115,"MUNICIPIUL BRAŞOV",40198,2,PART,PRCNCT,PRSD,PRSD_SV,"2025-05-19 01:12:00",1470,973,818,154,1,953,20,1600,627,238,715
8,BRAŞOV,"COLEGIUL NAŢIONAL DE INFORMATICĂ ”GRIGORE MOISIL”",116,"MUNICIPIUL BRAŞOV",40198,1,PART,PRCNCT,PRSD,PRSD_SV,"2025-05-18 22:00:51",873,574,438,136,0,571,3,1000,426,175,396
8,BRAŞOV,"COLEGIUL NAŢIONAL DE INFORMATICĂ ”GRIGORE MOISIL”",117,"MUNICIPIUL BRAŞOV",40198,1,PART,PRCNCT,PRSD,PRSD_SV,"2025-05-18 22:05:10",1200,751,641,110,0,742,9,1300,549,186,556
8,BRAŞOV,"COLEGIUL NAŢIONAL DE INFORMATICĂ ”GRIGORE MOISIL”",118,"MUNICIPIUL BRAŞOV",40198,2,PART,PRCNCT,PRSD,PRSD_SV,"2025-05-19 01:14:06",1768,1082,994,86,2,1071,11,1900,818,271,800
8,BRAŞOV,"ŞCOALA GIMNAZIALĂ NR. 1, CORP B",119,"MUNICIPIUL BRAŞOV",40198,1,PART,PRCNCT,PRSD,PRSD_SV,"2025-05-18 21:42:53",1401,853,787,66,0,843,10,1500,647,223,620
8,BRAŞOV,"ŞCOALA GIMNAZIALĂ NR. 1, CORP B",120,"MUNICIPIUL BRAŞOV",40198,1,PART,PRCNCT,PRSD,PRSD_SV,"2025-05-18 22:02:39",979,626,522,104,0,613,13,1100,474,147,466
8,BRAŞOV,"ŞCOALA GIMNAZIALĂ NR. 1, CORP B",121,"MUNICIPIUL BRAŞOV",40198,1,PART,PRCNCT,PRSD,PRSD_SV,"2025-05-18 22:07:18",1150,775,641,134,0,764,11,1300,525,213,551
8,BRAŞOV,"ŞCOALA GIMNAZIALĂ NR. 1, CORP B",122,"MUNICIPIUL BRAŞOV",40198,1,PART,PRCNCT,PRSD,PRSD_SV,"2025-05-18 21:58:48",1314,814,728,85,1,802,12,1400,586,222,580
8,BRAŞOV,"ŞCOALA GIMNAZIALĂ NR. 1, CORP B",123,"MUNICIPIUL BRAŞOV",40198,2,PART,PRCNCT,PRSD,PRSD_SV,"2025-05-18 23:52:30",1289,748,686,61,1,737,11,1400,652,200,537
8,BRAŞOV,"ŞCOALA GIMNAZIALĂ NR. 1",124,"MUNICIPIUL BRAŞOV",40198,1,PART,PRCNCT,PRSD,PRSD_SV,"2025-05-18 21:48:50",1339,803,732,71,0,793,10,1400,597,218,575
8,BRAŞOV,"ŞCOALA GIMNAZIALĂ NR. 1",125,"MUNICIPIUL BRAŞOV",40198,1,PART,PRCNCT,PRSD,PRSD_SV,"2025-05-18 22:16:31",1260,757,677,79,1,745,12,1400,643,215,530
8,BRAŞOV,"ŞCOALA GIMNAZIALĂ NR. 1",126,"MUNICIPIUL BRAŞOV",40198,1,PART,PRCNCT,PRSD,PRSD_SV,"2025-05-18 21:37:50",1208,820,656,164,0,806,14,1300,480,219,587
8,BRAŞOV,"ŞCOALA GIMNAZIALĂ NR. 1",127,"MUNICIPIUL BRAŞOV",40198,1,PART,PRCNCT,PRSD,PRSD_SV,"2025-05-18 21:51:12",1529,955,819,136,0,946,9,1600,645,219,727
8,BRAŞOV,"ŞCOALA GIMNAZIALĂ NR. 1",128,"MUNICIPIUL BRAŞOV",40198,2,PART,PRCNCT,PRSD,PRSD_SV,"2025-05-18 23:20:10",1332,729,679,50,0,713,16,1400,671,219,494
8,BRAŞOV,"ŞCOALA GIMNAZIALĂ NR. 1",129,"MUNICIPIUL BRAŞOV",40198,1,PART,PRCNCT,PRSD,PRSD_SV,"2025-05-18 21:55:12",890,533,489,44,0,525,8,1000,467,137,388
8,BRAŞOV,"ŞCOALA GIMNAZIALĂ NR. 1",130,"MUNICIPIUL BRAŞOV",40198,1,PART,PRCNCT,PRSD,PRSD_SV,"2025-05-18 21:59:17",952,555,482,72,1,538,17,1100,545,180,358
8,BRAŞOV,"ŞCOALA GIMNAZIALĂ NR. 1",131,"MUNICIPIUL BRAŞOV",40198,1,PART,PRCNCT,PRSD,PRSD_SV,"2025-05-18 21:46:06",1386,821,750,70,1,810,11,1500,679,241,569
8,BRAŞOV,"CENTRUL REGIONAL DE FORMARE PROFESIONALĂ BRAŞOV",132,"MUNICIPIUL BRAŞOV",40198,1,PART,PRCNCT,PRSD,PRSD_SV,"2025-05-18 22:12:02",1061,682,495,187,0,673,9,1200,518,237,436
8,BRAŞOV,"CENTRUL REGIONAL DE FORMARE PROFESIONALĂ BRAŞOV",133,"MUNICIPIUL BRAŞOV",40198,1,PART,PRCNCT,PRSD,PRSD_SV,"2025-05-18 22:51:05",1681,1141,979,159,3,1128,13,1800,659,268,860
8,BRAŞOV,"CANTINA STUDENŢEASCĂ",134,"MUNICIPIUL BRAŞOV",40198,1,PART,PRCNCT,PRSD,PRSD_SV,"2025-05-18 22:43:38",1495,1815,827,985,3,1795,20,2100,285,348,1447
8,BRAŞOV,"COLEGIUL NAŢIONAL ECONOMIC ”ANDREI BÂRSEANU”",135,"MUNICIPIUL BRAŞOV",40198,1,PART,PRCNCT,PRSD,PRSD_SV,"2025-05-18 22:00:33",903,575,492,83,0,569,6,1000,425,127,442
8,BRAŞOV,"COLEGIUL NAŢIONAL ECONOMIC ”ANDREI BÂRSEANU”",136,"MUNICIPIUL BRAŞOV",40198,1,PART,PRCNCT,PRSD,PRSD_SV,"2025-05-18 22:06:42",1089,689,586,102,1,679,10,1200,511,181,498
8,BRAŞOV,"COLEGIUL NAŢIONAL ECONOMIC ”ANDREI BÂRSEANU”",137,"MUNICIPIUL BRAŞOV",40198,1,PART,PRCNCT,PRSD,PRSD_SV,"2025-05-18 22:35:22",1101,812,647,120,45,803,9,1200,388,213,590
8,BRAŞOV,"COLEGIUL NAŢIONAL ECONOMIC ”ANDREI BÂRSEANU”",138,"MUNICIPIUL BRAŞOV",40198,1,PART,PRCNCT,PRSD,PRSD_SV,"2025-05-18 22:37:29",1252,703,627,76,0,695,8,1300,597,244,451
8,BRAŞOV,"COLEGIUL NAŢIONAL ECONOMIC ”ANDREI BÂRSEANU”",139,"MUNICIPIUL BRAŞOV",40198,1,PART,PRCNCT,PRSD,PRSD_SV,"2025-05-18 22:11:45",1345,702,655,47,0,691,11,1500,798,297,394
8,BRAŞOV,"ŞCOALA GIMNAZIALĂ NR. 14",140,"MUNICIPIUL BRAŞOV",40198,1,PART,PRCNCT,PRSD,PRSD_SV,"2025-05-18 21:52:17",1322,801,674,127,0,795,6,1400,599,224,571
8,BRAŞOV,"ŞCOALA GIMNAZIALĂ NR. 14",141,"MUNICIPIUL BRAŞOV",40198,1,PART,PRCNCT,PRSD,PRSD_SV,"2025-05-18 22:14:36",1419,872,721,150,1,865,7,1500,628,312,553
8,BRAŞOV,"ŞCOALA GIMNAZIALĂ NR. 14",142,"MUNICIPIUL BRAŞOV",40198,1,PART,PRCNCT,PRSD,PRSD_SV,"2025-05-18 22:09:45",1471,978,792,186,0,963,15,1600,622,330,633
8,BRAŞOV,"ŞCOALA GIMNAZIALĂ NR. 14",143,"MUNICIPIUL BRAŞOV",40198,1,PART,PRCNCT,PRSD,PRSD_SV,"2025-05-18 22:36:27",1376,813,672,141,0,805,8,1500,687,285,520
8,BRAŞOV,"ŞCOALA GIMNAZIALĂ NR. 14",144,"MUNICIPIUL BRAŞOV",40198,1,PART,PRCNCT,PRSD,PRSD_SV,"2025-05-18 21:50:21",1294,886,685,200,1,870,16,1400,514,290,580
8,BRAŞOV,"ŞCOALA GIMNAZIALĂ NR. 14",145,"MUNICIPIUL BRAŞOV",40198,1,PART,PRCNCT,PRSD,PRSD_SV,"2025-05-18 21:45:33",1362,844,732,112,0,835,9,1500,656,268,567
8,BRAŞOV,"ŞCOALA GIMNAZIALĂ NR. 14",146,"MUNICIPIUL BRAŞOV",40198,1,PART,PRCNCT,PRSD,PRSD_SV,"2025-05-18 21:43:15",1144,671,580,91,0,661,10,1200,529,223,438
8,BRAŞOV,"ŞCOALA GIMNAZIALĂ NR. 14",147,"MUNICIPIUL BRAŞOV",40198,1,PART,PRCNCT,PRSD,PRSD_SV,"2025-05-18 21:57:45",1254,801,651,147,3,795,6,1300,499,292,503
8,BRAŞOV,"ŞCOALA GIMNAZIALĂ NR. 14",148,"MUNICIPIUL BRAŞOV",40198,1,PART,PRCNCT,PRSD,PRSD_SV,"2025-05-18 21:50:52",1161,738,602,136,0,725,13,1300,562,274,451
8,BRAŞOV,"ŞCOALA GIMNAZIALĂ NR. 14",149,"MUNICIPIUL BRAŞOV",40198,1,PART,PRCNCT,PRSD,PRSD_SV,"2025-05-18 22:16:22",1781,1269,1162,107,0,1252,17,1900,631,333,919
8,BRAŞOV,"ŞCOALA GIMNAZIALĂ NR. 14",150,"MUNICIPIUL BRAŞOV",40198,1,PART,PRCNCT,PRSD,PRSD_SV,"2025-05-18 21:51:19",1452,905,846,59,0,893,12,1500,595,305,588
8,BRAŞOV,"ȘCOALA GIMNAZIALĂ NR. 14",151,"MUNICIPIUL BRAŞOV",40198,1,PART,PRCNCT,PRSD,PRSD_SV,"2025-05-18 22:18:59",1555,1210,1072,136,2,1198,12,1700,490,341,857
8,BRAŞOV,"CATTIA (CENTRUL DE AFACERI, TRANSFER TEHNOLOGIC ȘI INCUBATOR DE AFACERI)",152,"MUNICIPIUL BRAŞOV",40198,1,PART,PRCNCT,PRSD,PRSD_SV,"2025-05-18 23:05:23",1836,1347,1003,342,2,1334,13,2100,753,353,981
8,BRAŞOV,"CATTIA (CENTRUL DE AFACERI, TRANSFER TEHNOLOGIC ȘI INCUBATOR DE AFACERI)",153,"MUNICIPIUL BRAŞOV",40198,1,PART,PRCNCT,PRSD,PRSD_SV,"2025-05-18 22:47:48",1818,1246,994,252,0,1231,15,2100,854,304,927
8,BRAŞOV,"CATTIA (CENTRUL DE AFACERI, TRANSFER TEHNOLOGIC ȘI INCUBATOR DE AFACERI)",154,"MUNICIPIUL BRAŞOV",40198,1,PART,PRCNCT,PRSD,PRSD_SV,"2025-05-18 22:27:35",1764,1181,942,239,0,1174,7,2000,819,290,884
8,BRAŞOV,"ŞCOALA GIMNAZIALĂ NR. 30",155,"MUNICIPIUL BRAŞOV",40198,1,PART,PRCNCT,PRSD,PRSD_SV,"2025-05-18 21:54:48",1571,1112,940,170,2,1095,17,1700,588,291,804
8,BRAŞOV,"ŞCOALA GIMNAZIALĂ NR. 30",156,"MUNICIPIUL BRAŞOV",40198,1,PART,PRCNCT,PRSD,PRSD_SV,"2025-05-18 21:59:24",1809,1243,1111,132,0,1226,17,1900,657,330,896
8,BRAŞOV,"ŞCOALA GIMNAZIALĂ NR. 30",157,"MUNICIPIUL BRAŞOV",40198,1,PART,PRCNCT,PRSD,PRSD_SV,"2025-05-18 22:08:27",1528,1015,851,164,0,999,16,1600,585,273,726
8,BRAŞOV,"ŞCOALA GIMNAZIALĂ NR. 30",158,"MUNICIPIUL BRAŞOV",40198,1,PART,PRCNCT,PRSD,PRSD_SV,"2025-05-18 23:09:40",1475,934,842,92,0,919,15,1600,665,278,641
8,BRAŞOV,"ŞCOALA GIMNAZIALĂ NR. 30",159,"MUNICIPIUL BRAŞOV",40198,1,PART,PRCNCT,PRSD,PRSD_SV,"2025-05-18 21:38:14",1305,891,795,96,0,884,7,1400,509,201,683
8,BRAŞOV,"ŞCOALA GIMNAZIALĂ NR. 30",160,"MUNICIPIUL BRAŞOV",40198,1,PART,PRCNCT,PRSD,PRSD_SV,"2025-05-18 21:59:19",1448,970,856,114,0,963,7,1500,530,222,741
8,BRAŞOV,"ŞCOALA GIMNAZIALĂ NR. 30 EXTINDERE",161,"MUNICIPIUL BRAŞOV",40198,1,PART,PRCNCT,PRSD,PRSD_SV,"2025-05-18 22:20:51",1661,1173,1025,148,0,1160,13,1800,627,288,872
8,BRAŞOV,"ŞCOALA GIMNAZIALĂ NR. 30 EXTINDERE",162,"MUNICIPIUL BRAŞOV",40198,1,PART,PRCNCT,PRSD,PRSD_SV,"2025-05-18 22:18:56",1752,1096,1007,89,0,1087,9,1800,704,252,835
8,BRAŞOV,"ŞCOALA GIMNAZIALĂ NR. 13",163,"MUNICIPIUL BRAŞOV",40198,2,PART,PRCNCT,PRSD,PRSD_SV,"2025-05-19 01:22:24",1856,1145,1001,138,6,1130,15,2000,855,258,872
8,BRAŞOV,"ŞCOALA GIMNAZIALĂ NR. 13",164,"MUNICIPIUL BRAŞOV",40198,1,PART,PRCNCT,PRSD,PRSD_SV,"2025-05-18 23:23:45",1811,1260,1048,174,38,1244,16,1900,640,311,933
8,BRAŞOV,"ŞCOALA GIMNAZIALĂ NR. 13",165,"MUNICIPIUL BRAŞOV",40198,1,PART,PRCNCT,PRSD,PRSD_SV,"2025-05-18 22:11:15",1419,975,792,182,1,968,7,1600,625,284,684
8,BRAŞOV,"ŞCOALA GIMNAZIALĂ NR. 13",166,"MUNICIPIUL BRAŞOV",40198,1,PART,PRCNCT,PRSD,PRSD_SV,"2025-05-18 23:10:13",1425,892,794,97,1,881,11,1600,708,248,633
8,BRAŞOV,"ŞCOALA GIMNAZIALĂ NR. 13",167,"MUNICIPIUL BRAŞOV",40198,1,PART,PRCNCT,PRSD,PRSD_SV,"2025-05-18 22:26:35",1431,882,769,113,0,872,10,1600,718,235,637
8,BRAŞOV,"COLEGIUL ”NICOLAE TITULESCU”",168,"MUNICIPIUL BRAŞOV",40198,1,PART,PRCNCT,PRSD,PRSD_SV,"2025-05-18 22:45:58",1336,1138,576,562,0,1126,12,1600,462,454,672
8,BRAŞOV,"COLEGIUL ”NICOLAE TITULESCU”",169,"MUNICIPIUL BRAŞOV",40198,1,PART,PRCNCT,PRSD,PRSD_SV,"2025-05-18 23:01:11",1267,1058,637,421,0,1042,16,1500,442,352,690
8,BRAŞOV,"COLEGIUL ”NICOLAE TITULESCU”",170,"MUNICIPIUL BRAŞOV",40198,1,PART,PRCNCT,PRSD,PRSD_SV,"2025-05-18 22:00:42",1210,1165,622,543,0,1148,17,1400,235,360,788
8,BRAŞOV,"COLEGIUL ”NICOLAE TITULESCU”",171,"MUNICIPIUL BRAŞOV",40198,1,PART,PRCNCT,PRSD,PRSD_SV,"2025-05-18 22:19:43",1203,1035,582,453,0,1017,18,1400,365,296,721
8,BRAŞOV,"COLEGIUL ”NICOLAE TITULESCU”",172,"MUNICIPIUL BRAŞOV",40198,2,PART,PRCNCT,PRSD,PRSD_SV,"2025-05-19 01:10:22",1460,1283,744,539,0,1258,25,1700,417,391,867
8,BRAŞOV,"COLEGIUL ”NICOLAE TITULESCU”",173,"MUNICIPIUL BRAŞOV",40198,1,PART,PRCNCT,PRSD,PRSD_SV,"2025-05-18 22:49:27",1244,935,570,365,0,928,7,1500,565,325,603
8,BRAŞOV,"ŞCOALA PROFESIONALĂ GERMANĂ „KRONSTADT”",174,"MUNICIPIUL BRAŞOV",40198,1,PART,PRCNCT,PRSD,PRSD_SV,"2025-05-18 21:58:32",1627,1200,1008,192,0,1192,8,1900,700,265,927
8,BRAŞOV,"ŞCOALA PROFESIONALĂ GERMANĂ „KRONSTADT”",175,"MUNICIPIUL BRAŞOV",40198,1,PART,PRCNCT,PRSD,PRSD_SV,"2025-05-18 22:45:35",1272,984,807,177,0,972,12,1500,516,260,712
8,BRAŞOV,"ŞCOALA PROFESIONALĂ GERMANĂ „KRONSTADT”",176,"MUNICIPIUL BRAŞOV",40198,1,PART,PRCNCT,PRSD,PRSD_SV,"2025-05-18 22:24:06",1574,1363,1067,296,0,1353,9,1800,437,290,1063
8,BRAŞOV,"ŞCOALA PROFESIONALĂ GERMANĂ „KRONSTADT”",177,"MUNICIPIUL BRAŞOV",40198,1,PART,PRCNCT,PRSD,PRSD_SV,"2025-05-18 22:01:37",1705,1461,1044,417,0,1438,23,2000,539,376,1062
8,BRAŞOV,"COLEGIUL TEHNIC DE TRANSPORTURI",178,"MUNICIPIUL BRAŞOV",40198,1,PART,PRCNCT,PRSD,PRSD_SV,"2025-05-18 22:25:28",1062,655,545,110,0,641,14,1200,545,270,371
8,BRAŞOV,"COLEGIUL TEHNIC DE TRANSPORTURI",179,"MUNICIPIUL BRAŞOV",40198,1,PART,PRCNCT,PRSD,PRSD_SV,"2025-05-18 22:00:50",1165,709,615,94,0,697,12,1300,591,297,400
8,BRAŞOV,"COLEGIUL TEHNIC DE TRANSPORTURI",180,"MUNICIPIUL BRAŞOV",40198,1,PART,PRCNCT,PRSD,PRSD_SV,"2025-05-18 21:52:23",1026,595,510,85,0,588,7,1100,505,266,322
8,BRAŞOV,"ŞCOALA GIMNAZIALĂ NR. 31",181,"MUNICIPIUL BRAŞOV",40198,1,PART,PRCNCT,PRSD,PRSD_SV,"2025-05-18 21:51:30",1260,741,663,78,0,724,17,1400,659,252,472
8,BRAŞOV,"ŞCOALA GIMNAZIALĂ NR. 31",182,"MUNICIPIUL BRAŞOV",40198,1,PART,PRCNCT,PRSD,PRSD_SV,"2025-05-18 21:43:55",1290,782,686,96,0,771,11,1400,618,260,511
8,BRAŞOV,"ŞCOALA GIMNAZIALĂ NR. 31",183,"MUNICIPIUL BRAŞOV",40198,1,PART,PRCNCT,PRSD,PRSD_SV,"2025-05-18 22:15:43",1099,638,579,59,0,629,9,1200,562,205,424
8,BRAŞOV,"COLEGIUL TEHNIC ”REMUS RĂDULEŢ”",184,"MUNICIPIUL BRAŞOV",40198,1,PART,PRCNCT,PRSD,PRSD_SV,"2025-05-18 21:34:22",495,277,261,16,0,273,4,500,223,88,185
8,BRAŞOV,"COLEGIUL TEHNIC ”REMUS RĂDULEŢ”",185,"MUNICIPIUL BRAŞOV",40198,1,PART,PRCNCT,PRSD,PRSD_SV,"2025-05-18 21:34:50",919,511,451,60,0,503,8,1000,489,221,282
8,BRAŞOV,"COLEGIUL TEHNIC ”REMUS RĂDULEŢ”",186,"MUNICIPIUL BRAŞOV",40198,1,PART,PRCNCT,PRSD,PRSD_SV,"2025-05-18 22:05:10",1012,537,456,80,1,531,6,1100,563,264,267
8,BRAŞOV,"COLEGIUL TEHNIC ”REMUS RĂDULEŢ”",187,"MUNICIPIUL BRAŞOV",40198,1,PART,PRCNCT,PRSD,PRSD_SV,"2025-05-18 22:27:17",981,506,479,25,2,497,9,1100,594,266,231
8,BRAŞOV,"COLEGIUL TEHNIC ”REMUS RĂDULEŢ”",188,"MUNICIPIUL BRAŞOV",40198,1,PART,PRCNCT,PRSD,PRSD_SV,"2025-05-18 22:16:27",910,505,455,49,1,498,7,1000,495,194,304
8,BRAŞOV,"COLEGIUL TEHNIC SIMION MEHEDINŢI",189,"MUNICIPIUL CODLEA",40241,1,PART,PRCNCT,PRSD,PRSD_SV,"2025-05-18 21:43:12",949,530,440,90,0,526,4,1000,470,265,261
8,BRAŞOV,"COLEGIUL TEHNIC SIMION MEHEDINŢI",190,"MUNICIPIUL CODLEA",40241,1,PART,PRCNCT,PRSD,PRSD_SV,"2025-05-18 21:51:04",1105,556,521,34,1,546,10,1200,644,218,328
8,BRAŞOV,"COLEGIUL TEHNIC SIMION MEHEDINŢI",191,"MUNICIPIUL CODLEA",40241,1,PART,PRCNCT,PRSD,PRSD_SV,"2025-05-18 22:03:03",1064,559,535,24,0,548,11,1200,641,235,313
8,BRAŞOV,"COLEGIUL TEHNIC SIMION MEHEDINTI",192,"MUNICIPIUL CODLEA",40241,1,PART,PRCNCT,PRSD,PRSD_SV,"2025-05-18 21:29:00",1179,662,612,50,0,654,8,1300,638,340,314
8,BRAŞOV,"ŞCOALA GENERALA NR.2",193,"MUNICIPIUL CODLEA",40241,1,PART,PRCNCT,PRSD,PRSD_SV,"2025-05-18 21:59:15",1108,656,586,68,2,647,9,1200,544,281,366
8,BRAŞOV,"GRADINITA NR.1",194,"MUNICIPIUL CODLEA",40241,1,PART,PRCNCT,PRSD,PRSD_SV,"2025-05-18 21:45:42",1252,894,662,49,183,873,21,1550,656,404,469
8,BRAŞOV,"GRADINITA NR.1",195,"MUNICIPIUL CODLEA",40241,1,PART,PRCNCT,PRSD,PRSD_SV,"2025-05-18 21:36:16",1364,904,694,38,172,879,25,1650,746,440,439
8,BRAŞOV,"GRUP SCOLAR FORESTIER",196,"MUNICIPIUL CODLEA",40241,1,PART,PRCNCT,PRSD,PRSD_SV,"2025-05-18 22:27:01",1583,1104,832,132,140,1091,13,1858,754,521,570
8,BRAŞOV,"ŞCOALA GIMNAZIALA NR. 3",197,"MUNICIPIUL CODLEA",40241,1,PART,PRCNCT,PRSD,PRSD_SV,"2025-05-18 21:33:26",1233,639,585,37,17,624,15,1400,761,266,358
8,BRAŞOV,"GRADINITA NR.4",198,"MUNICIPIUL CODLEA",40241,1,PART,PRCNCT,PRSD,PRSD_SV,"2025-05-18 21:59:04",1193,560,476,84,0,548,12,1300,740,274,274
8,BRAŞOV,"GRADINITA NR.4",199,"MUNICIPIUL CODLEA",40241,1,PART,PRCNCT,PRSD,PRSD_SV,"2025-05-18 22:07:12",1764,949,936,13,0,931,18,1900,951,348,583
8,BRAŞOV,"ŞCOALA GENERALA NR. 3",200,"MUNICIPIUL CODLEA",40241,1,PART,PRCNCT,PRSD,PRSD_SV,"2025-05-18 22:11:52",898,487,428,59,0,473,14,1000,513,195,278
8,BRAŞOV,"ŞCOALA GENERALA NR. 3",201,"MUNICIPIUL CODLEA",40241,1,PART,PRCNCT,PRSD,PRSD_SV,"2025-05-18 21:51:46",1283,657,623,34,0,649,8,1400,743,254,395
8,BRAŞOV,"ŞCOALA GENERALA NR. 3",202,"MUNICIPIUL CODLEA",40241,1,PART,PRCNCT,PRSD,PRSD_SV,"2025-05-18 22:00:16",940,499,476,23,0,488,11,1000,501,207,281
8,BRAŞOV,"LICEUL TEORETIC",203,"MUNICIPIUL CODLEA",40241,1,PART,PRCNCT,PRSD,PRSD_SV,"2025-05-18 21:54:13",1257,738,672,63,3,722,16,1400,662,327,395
8,BRAŞOV,"ŞCOALA DE ARTE SI MESERII",204,"MUNICIPIUL CODLEA",40241,1,PART,PRCNCT,PRSD,PRSD_SV,"2025-05-18 22:08:43",1052,599,567,32,0,587,12,1200,601,271,316
8,BRAŞOV,"ŞCOALA DE ARTE SI MESERII",205,"MUNICIPIUL CODLEA",40241,1,PART,PRCNCT,PRSD,PRSD_SV,"2025-05-18 21:49:49",1531,592,568,24,0,573,19,1700,1108,397,176
8,BRAŞOV,"DIRECȚIA DE ASISTENȚĂ SOCIALĂ",206,"MUNICIPIUL FĂGĂRAŞ",40278,1,PART,PRCNCT,PRSD,PRSD_SV,"2025-05-18 21:36:38",1464,582,522,60,0,573,9,1600,1018,273,300
8,BRAŞOV,"GRADINȚA CU PROGRAM PRELUNGIT „VOINICELUL”",207,"MUNICIPIUL FĂGĂRAŞ",40278,1,PART,PRCNCT,PRSD,PRSD_SV,"2025-05-18 22:14:23",1579,684,613,71,0,676,8,1700,1016,338,338
8,BRAŞOV,"ȘCOALA GIMNAZIALĂ ”OVID DENSUȘIANU”",208,"MUNICIPIUL FĂGĂRAŞ",40278,1,PART,PRCNCT,PRSD,PRSD_SV,"2025-05-18 21:56:09",1574,790,712,61,17,784,6,1700,910,302,482
8,BRAŞOV,"ȘCOALA GIMNAZIALĂ ”OVID DENSUȘIANU”",209,"MUNICIPIUL FĂGĂRAŞ",40278,1,PART,PRCNCT,PRSD,PRSD_SV,"2025-05-18 22:05:45",1172,536,469,67,0,529,7,1300,764,172,357
8,BRAŞOV,"ŞCOALA GIMNAZIALĂ ”OVID DENSUŞIANU”",210,"MUNICIPIUL FĂGĂRAŞ",40278,1,PART,PRCNCT,PRSD,PRSD_SV,"2025-05-18 21:44:19",1017,481,435,46,0,479,2,1100,619,128,351
8,BRAŞOV,"ŞCOALA GIMNAZIALĂ NR. 4 - ȘCOALA GIMNAZIALĂ ”OVID DENSUŞIANU”",211,"MUNICIPIUL FĂGĂRAŞ",40278,1,PART,PRCNCT,PRSD,PRSD_SV,"2025-05-18 22:16:20",1199,722,586,134,2,717,5,1300,578,335,382
8,BRAŞOV,"COLEGIUL NAȚIONAL ”DOAMNA STANCA”",212,"MUNICIPIUL FĂGĂRAŞ",40278,1,PART,PRCNCT,PRSD,PRSD_SV,"2025-05-18 22:18:20",910,503,409,91,3,495,8,1400,897,171,324
8,BRAŞOV,"COLEGIUL NAŢIONAL ”DOAMNA STANCA”",213,"MUNICIPIUL FĂGĂRAŞ",40278,1,PART,PRCNCT,PRSD,PRSD_SV,"2025-05-18 22:34:59",1333,624,571,49,4,615,9,1500,876,215,400
8,BRAŞOV,"COLEGIUL NAŢIONAL ”DOAMNA STANCA”",214,"MUNICIPIUL FĂGĂRAŞ",40278,1,PART,PRCNCT,PRSD,PRSD_SV,"2025-05-18 22:38:25",1257,629,592,37,0,623,6,1400,771,220,403
8,BRAŞOV,"ȘCOALA GIMNAZIALA NR. 1 - COLEGIUL NAŢIONAL ”RADU NEGRU”",215,"MUNICIPIUL FĂGĂRAŞ",40278,3,PART,PRCNCT,PRSD,PRSD_SV,"2025-05-19 02:29:59",1056,532,457,75,0,527,5,1200,668,162,365
8,BRAŞOV,"ȘCOALA GIMNAZIALĂ NR. 1 - COLEGIUL NAŢIONAL ”RADU NEGRU”",216,"MUNICIPIUL FĂGĂRAŞ",40278,1,PART,PRCNCT,PRSD,PRSD_SV,"2025-05-18 21:46:54",1260,659,540,87,32,648,11,1400,741,224,424
8,BRAŞOV,"COLEGIUL NAŢIONAL „RADU NEGRU”",217,"MUNICIPIUL FĂGĂRAŞ",40278,1,PART,PRCNCT,PRSD,PRSD_SV,"2025-05-18 22:20:30",1095,565,443,122,0,557,8,1200,635,186,371
8,BRAŞOV,"COLEGIUL NAŢIONAL „RADU NEGRU”",218,"MUNICIPIUL FĂGĂRAŞ",40278,1,PART,PRCNCT,PRSD,PRSD_SV,"2025-05-18 22:26:52",1261,597,503,94,0,591,6,1400,803,226,365
8,BRAŞOV,"COLEGIUL NAȚIONAL ”RADU NEGRU”",219,"MUNICIPIUL FĂGĂRAŞ",40278,1,PART,PRCNCT,PRSD,PRSD_SV,"2025-05-18 22:16:25",1343,496,447,49,0,490,6,1500,1004,239,251
8,BRAŞOV,"COLEGIUL NAȚIONAL ”RADU NEGRU”",220,"MUNICIPIUL FĂGĂRAŞ",40278,1,PART,PRCNCT,PRSD,PRSD_SV,"2025-05-18 21:55:37",1495,576,505,71,0,571,5,1600,1024,267,304
8,BRAŞOV,"COLEGIUL NAȚIONAL ”RADU NEGRU”",221,"MUNICIPIUL FĂGĂRAŞ",40278,1,PART,PRCNCT,PRSD,PRSD_SV,"2025-05-18 21:40:26",1532,638,613,25,0,628,10,1700,1062,238,390
8,BRAŞOV,"LICEUL TEHNOLOGIC „AUREL VIJOLI”",222,"MUNICIPIUL FĂGĂRAŞ",40278,1,PART,PRCNCT,PRSD,PRSD_SV,"2025-05-18 22:13:26",1337,503,464,39,0,498,5,1500,997,327,171
8,BRAŞOV,"LICEUL TEHNOLOGIC „AUREL VIJOLI”",223,"MUNICIPIUL FĂGĂRAŞ",40278,1,PART,PRCNCT,PRSD,PRSD_SV,"2025-05-18 21:40:44",1092,420,391,29,0,417,3,1200,780,314,103
8,BRAŞOV,"LICEUL TEOLOGIC ORTODOX ”SF. CONSTANTIN BRÂNCOVEANU”",224,"MUNICIPIUL FĂGĂRAŞ",40278,1,PART,PRCNCT,PRSD,PRSD_SV,"2025-05-18 21:56:26",1759,803,726,77,0,798,5,1900,1097,303,495
8,BRAŞOV,"LICEUL TEOLOGIC ORTODOX ”SF. CONSTANTIN BRÂNCOVEANU”",225,"MUNICIPIUL FĂGĂRAŞ",40278,1,PART,PRCNCT,PRSD,PRSD_SV,"2025-05-18 22:07:54",1562,604,555,49,0,599,5,1700,1096,299,300
8,BRAŞOV,"GRĂDINIȚA CU PROGRAM PRELUNGIT ALBINUȚA",226,"MUNICIPIUL FĂGĂRAŞ",40278,1,PART,PRCNCT,PRSD,PRSD_SV,"2025-05-18 22:04:48",1071,564,523,41,0,558,6,1200,636,221,337
8,BRAŞOV,"GRĂDINIȚA CU PROGRAM PRELUNGIT ALBINUȚA",227,"MUNICIPIUL FĂGĂRAŞ",40278,1,PART,PRCNCT,PRSD,PRSD_SV,"2025-05-18 21:44:32",1074,495,454,41,0,488,7,1200,705,177,311
8,BRAŞOV,"GRĂDINIȚA CU PROGRAM PRELUNGIT ”PINOCHIO”",228,"MUNICIPIUL FĂGĂRAŞ",40278,1,PART,PRCNCT,PRSD,PRSD_SV,"2025-05-18 22:04:51",1050,514,460,53,1,510,4,1200,686,196,314
8,BRAŞOV,"ŞCOALA GIMNAZIALĂ NR. 1, CORPUL A (LÂNGĂ GRĂDINIŢĂ)",229,"MUNICIPIUL SĂCELE",40438,1,PART,PRCNCT,PRSD,PRSD_SV,"2025-05-18 22:00:12",1306,892,753,139,0,882,10,1400,508,206,676
8,BRAŞOV,"ŞCOALA GIMNAZIALĂ NR. 1 CORPUL B",230,"MUNICIPIUL SĂCELE",40438,1,PART,PRCNCT,PRSD,PRSD_SV,"2025-05-18 21:57:19",1327,688,599,88,1,676,12,1500,812,320,356
8,BRAŞOV,"ȘCOALA GIMNAZIALĂ NR. 1 CORPUL B",231,"MUNICIPIUL SĂCELE",40438,1,PART,PRCNCT,PRSD,PRSD_SV,"2025-05-18 21:48:32",1237,748,674,73,1,741,7,1400,652,279,462
8,BRAŞOV,"ŞCOALA GIMNAZIALĂ NR. 1 CORPUL F",232,"MUNICIPIUL SĂCELE",40438,1,PART,PRCNCT,PRSD,PRSD_SV,"2025-05-18 22:35:32",1839,1023,939,84,0,1010,13,2000,977,354,656
8,BRAŞOV,"LICEU ZAJZONI RAB ISTVAN",233,"MUNICIPIUL SĂCELE",40438,1,PART,PRCNCT,PRSD,PRSD_SV,"2025-05-18 22:34:03",1627,923,823,98,2,907,16,1800,877,232,675
8,BRAŞOV,"LICEUL GEORGE MOROIANU CORPUL C",234,"MUNICIPIUL SĂCELE",40438,1,PART,PRCNCT,PRSD,PRSD_SV,"2025-05-18 21:46:12",1585,1032,924,107,1,1019,13,1700,668,248,771
8,BRAŞOV,"LICEUL GEORGE MOROIANU CORPUL C",235,"MUNICIPIUL SĂCELE",40438,1,PART,PRCNCT,PRSD,PRSD_SV,"2025-05-18 22:34:01",1447,875,801,74,0,864,11,1600,725,285,579
8,BRAŞOV,"SALA DE SPORT",236,"MUNICIPIUL SĂCELE",40438,1,PART,PRCNCT,PRSD,PRSD_SV,"2025-05-18 21:58:49",1444,767,727,40,0,757,10,1600,833,249,508
8,BRAŞOV,"SALA DE SPORT",237,"MUNICIPIUL SĂCELE",40438,1,PART,PRCNCT,PRSD,PRSD_SV,"2025-05-18 21:59:40",1381,789,737,52,0,781,8,1500,711,323,458
8,BRAŞOV,"LICEUL GEORGE MOROIANU",238,"MUNICIPIUL SĂCELE",40438,2,PART,PRCNCT,PRSD,PRSD_SV,"2025-05-19 00:58:25",1755,1050,952,97,1,1028,22,1900,850,251,777
8,BRAŞOV,"ŞCOALA GIMNAZIALĂ NR.4 FRAŢII POPEEA",239,"MUNICIPIUL SĂCELE",40438,1,PART,PRCNCT,PRSD,PRSD_SV,"2025-05-18 22:26:06",1676,1101,964,119,18,1082,19,1900,799,342,740
8,BRAŞOV,"ŞCOALA GIMNAZIALĂ NR.4 FRAŢII POPEEA",240,"MUNICIPIUL SĂCELE",40438,1,PART,PRCNCT,PRSD,PRSD_SV,"2025-05-18 21:41:47",1292,670,636,34,0,661,9,1400,730,282,379
8,BRAŞOV,"ŞCOALA GIMNAZIALĂ NR.4 FRAŢII POPEEA",241,"MUNICIPIUL SĂCELE",40438,1,PART,PRCNCT,PRSD,PRSD_SV,"2025-05-18 21:29:29",1037,525,474,51,0,512,13,1100,575,186,326
8,BRAŞOV,"ŞCOALA GIMNAZIALĂ NR.4 FRAŢII POPEEA",242,"MUNICIPIUL SĂCELE",40438,1,PART,PRCNCT,PRSD,PRSD_SV,"2025-05-18 21:36:16",1369,652,624,27,1,641,11,1500,848,290,351
8,BRAŞOV,"GRUP ŞCOLAR INDUSTRIAL VICTOR JINGA",243,"MUNICIPIUL SĂCELE",40438,1,PART,PRCNCT,PRSD,PRSD_SV,"2025-05-18 21:23:33",1011,495,465,29,1,490,5,1100,605,254,236
8,BRAŞOV,"GRUP ŞCOLAR INDUSTRIAL VICTOR JINGA",244,"MUNICIPIUL SĂCELE",40438,1,PART,PRCNCT,PRSD,PRSD_SV,"2025-05-18 21:41:50",1053,523,494,25,4,520,3,1200,677,210,310
8,BRAŞOV,"ŞCOALA GIMNAZIALĂ NR.5 CORPUL B",245,"MUNICIPIUL SĂCELE",40438,1,PART,PRCNCT,PRSD,PRSD_SV,"2025-05-18 21:31:42",1091,540,517,23,0,527,13,1200,660,221,306
8,BRAŞOV,"ŞCOALA GIMNAZIALĂ NR.5 CORPUL B",246,"MUNICIPIUL SĂCELE",40438,1,PART,PRCNCT,PRSD,PRSD_SV,"2025-05-18 21:49:44",1440,576,553,23,0,566,10,1600,1024,466,100
8,BRAŞOV,"ŞCOALA GIMNAZIALĂ NR.5 CORPUL A",247,"MUNICIPIUL SĂCELE",40438,1,PART,PRCNCT,PRSD,PRSD_SV,"2025-05-18 21:38:26",1248,522,483,39,0,508,14,1400,878,437,71
8,BRAŞOV,"ŞCOALA GIMNAZIALĂ NR.5 CORPUL A",248,"MUNICIPIUL SĂCELE",40438,1,PART,PRCNCT,PRSD,PRSD_SV,"2025-05-18 21:46:45",1506,670,649,21,0,656,14,1700,1030,609,47
8,BRAŞOV,"PRIMĂRIA GHIMBAV",249,"ORAŞ GHIMBAV",40214,1,PART,PRCNCT,PRSD,PRSD_SV,"2025-05-18 21:47:40",1476,849,741,108,0,828,21,1600,751,325,503
8,BRAŞOV,"ŞCOALA GENERALĂ GHIMBAV CLASELE V-VIII",250,"ORAŞ GHIMBAV",40214,1,PART,PRCNCT,PRSD,PRSD_SV,"2025-05-18 21:56:48",1786,1172,1000,169,3,1161,11,2000,828,490,671
8,BRAŞOV,"ŞCOALA GENERALĂ GHIMBAV CLASELE I-IV",251,"ORAŞ GHIMBAV",40214,1,PART,PRCNCT,PRSD,PRSD_SV,"2025-05-18 22:09:17",1533,892,765,127,0,879,13,1698,806,378,501
8,BRAŞOV,"SALA DE SPORT",252,"ORAŞ GHIMBAV",40214,1,PART,PRCNCT,PRSD,PRSD_SV,"2025-05-18 21:59:28",1137,1056,749,307,0,1047,9,1200,144,299,748
8,BRAŞOV,"SALA DE SPORT",253,"ORAŞ GHIMBAV",40214,1,PART,PRCNCT,PRSD,PRSD_SV,"2025-05-18 22:02:55",1060,940,763,177,0,931,9,1200,260,295,636
8,BRAŞOV,"COMPANIA NAȚIONALĂ POȘTA ROMÂNĂ",254,"ORAŞ PREDEAL",40303,1,PART,PRCNCT,PRSD,PRSD_SV,"2025-05-18 22:46:49",1116,1016,492,524,0,998,18,1400,384,447,551
8,BRAŞOV,"LICEUL TEORETIC MIHAIL SAULESCU",255,"ORAŞ PREDEAL",40303,1,PART,PRCNCT,PRSD,PRSD_SV,"2025-05-18 22:12:04",877,577,413,164,0,565,12,1200,623,251,314
8,BRAŞOV,"LICEUL TEORETIC MIHAIL SĂULESCU",256,"ORAŞ PREDEAL",40303,1,PART,PRCNCT,PRSD,PRSD_SV,"2025-05-18 22:20:21",1138,811,559,252,0,798,13,1500,689,416,382
8,BRAŞOV,"VILA M7",257,"ORAŞ PREDEAL",40303,1,PART,PRCNCT,PRSD,PRSD_SV,"2025-05-18 21:32:00",180,161,103,58,0,159,2,200,39,70,89
8,BRAŞOV,"GRADINITA CU PROGRAM NORMAL TIMISUL DE JOS",258,"ORAŞ PREDEAL",40303,1,PART,PRCNCT,PRSD,PRSD_SV,"2025-05-18 21:58:41",309,172,129,43,0,171,1,301,129,99,72
8,BRAŞOV,"AGENȚIA POȘTALĂ",259,"ORAŞ PREDEAL",40303,1,PART,PRCNCT,PRSD,PRSD_SV,"2025-05-18 21:31:53",275,143,113,30,0,143,0,300,157,82,61
8,BRAŞOV,"ȘCOALA GENERALĂ NR. 1 RÂȘNOV",260,"ORAŞ RÂŞNOV",40367,1,PART,PRCNCT,PRSD,PRSD_SV,"2025-05-18 22:23:04",1481,929,825,99,5,918,11,1600,671,349,569
8,BRAŞOV,"ȘCOALA GENERALĂ NR. 1 RÂȘNOV",261,"ORAŞ RÂŞNOV",40367,1,PART,PRCNCT,PRSD,PRSD_SV,"2025-05-18 22:01:39",1435,768,689,79,0,752,16,1500,732,488,264
8,BRAŞOV,"ȘCOALA GENERALĂ NR. 3 RÂȘNOV",262,"ORAŞ RÂŞNOV",40367,1,PART,PRCNCT,PRSD,PRSD_SV,"2025-05-18 21:56:16",1666,1007,960,46,1,992,15,1800,793,339,653
8,BRAŞOV,"ȘCOALA GENERALĂ NR. 3 RÂȘNOV",263,"ORAŞ RÂŞNOV",40367,1,PART,PRCNCT,PRSD,PRSD_SV,"2025-05-18 21:49:28",1306,821,744,77,0,804,17,1400,579,321,483
8,BRAŞOV,"ȘCOALA GENERALĂ NR. 3 RÂȘNOV",264,"ORAŞ RÂŞNOV",40367,1,PART,PRCNCT,PRSD,PRSD_SV,"2025-05-18 21:39:18",831,486,367,119,0,476,10,900,414,204,272
8,BRAŞOV,"ȘCOALA GENERALĂ NR. 2 RÂȘNOV",265,"ORAŞ RÂŞNOV",40367,1,PART,PRCNCT,PRSD,PRSD_SV,"2025-05-18 22:20:02",1644,979,851,128,0,960,19,1700,721,351,609
8,BRAŞOV,"ȘCOALA GENERALĂ NR. 2 RÂȘNOV",266,"ORAŞ RÂŞNOV",40367,1,PART,PRCNCT,PRSD,PRSD_SV,"2025-05-18 22:15:10",1377,850,707,141,2,842,8,1500,650,303,539
8,BRAŞOV,"ȘCOALA GENERALĂ NR. 2 RÂȘNOV",267,"ORAŞ RÂŞNOV",40367,1,PART,PRCNCT,PRSD,PRSD_SV,"2025-05-18 22:08:11",1157,719,623,95,1,711,8,1300,581,295,416
8,BRAŞOV,"GRUP ȘCOLAR INDUSTRIAL RÂȘNOV",268,"ORAŞ RÂŞNOV",40367,2,PART,PRCNCT,PRSD,PRSD_SV,"2025-05-19 01:58:16",1900,1231,1130,100,1,1214,17,2000,769,427,787
8,BRAŞOV,"GRUP ȘCOLAR INDUSTRIAL RÂȘNOV",269,"ORAŞ RÂŞNOV",40367,1,PART,PRCNCT,PRSD,PRSD_SV,"2025-05-18 22:10:30",1387,881,683,198,0,865,16,1500,619,398,467
8,BRAŞOV,"GRUP ȘCOLAR INDUSTRIAL RÂȘNOV",270,"ORAŞ RÂŞNOV",40367,1,PART,PRCNCT,PRSD,PRSD_SV,"2025-05-18 22:27:02",1174,878,678,200,0,865,13,1299,421,347,518
8,BRAŞOV,"ŞCOALA GENERALA I",271,"ORAŞ RUPEA",40394,1,PART,PRCNCT,PRSD,PRSD_SV,"2025-05-18 21:55:08",1069,452,396,56,0,443,9,1400,948,172,271
8,BRAŞOV,"CASA ORASENEASCA DE CULTURA",272,"ORAŞ RUPEA",40394,1,PART,PRCNCT,PRSD,PRSD_SV,"2025-05-18 22:13:32",1136,536,438,81,17,529,7,1300,764,219,310
8,BRAŞOV,"SCOALA GENERALA II",273,"ORAŞ RUPEA",40394,1,PART,PRCNCT,PRSD,PRSD_SV,"2025-05-18 21:48:16",1515,676,609,65,2,672,4,1600,924,279,393
8,BRAŞOV,"CLUB MUNCITORESC BRAFOR GARA RUPEA",274,"ORAŞ RUPEA",40394,1,PART,PRCNCT,PRSD,PRSD_SV,"2025-05-18 22:13:34",513,253,227,26,0,247,6,600,347,79,168
8,BRAŞOV,"SCOALA PRIMARA FISER",275,"ORAŞ RUPEA",40394,2,PART,PRCNCT,PRSD,PRSD_SV,"2025-05-19 01:29:49",386,168,127,27,14,163,5,400,232,91,72
8,BRAŞOV,"PRIMARIA VICTORIA",276,"ORAŞ VICTORIA",40465,1,PART,PRCNCT,PRSD,PRSD_SV,"2025-05-18 22:10:10",1219,567,485,82,0,562,5,1308,741,257,305
8,BRAŞOV,"LICEUL TEORETIC I.C. DRĂGUȘANU",277,"ORAŞ VICTORIA",40465,1,PART,PRCNCT,PRSD,PRSD_SV,"2025-05-18 22:05:33",1529,657,571,86,0,647,10,1600,943,343,304
8,BRAŞOV,"ŞCOALA GIMNAZIALA VICTORIA",278,"ORAŞ VICTORIA",40465,1,PART,PRCNCT,PRSD,PRSD_SV,"2025-05-18 22:10:04",1542,677,615,61,1,669,8,1600,923,355,314
8,BRAŞOV,"LICEUL TEHNOLOGIC DR. ALEXANDRU BĂRBAT",279,"ORAŞ VICTORIA",40465,1,PART,PRCNCT,PRSD,PRSD_SV,"2025-05-18 21:39:52",1032,508,416,59,33,501,7,1100,592,184,317
8,BRAŞOV,"GRĂDINIŢA NR. 1",280,"ORAŞ VICTORIA",40465,1,PART,PRCNCT,PRSD,PRSD_SV,"2025-05-18 21:44:09",1352,537,481,51,5,535,2,1400,863,267,268
8,BRAŞOV,"GRĂDINIŢA BOBOCEL",281,"ORAŞ ZĂRNEŞTI",40492,2,PART,PRCNCT,PRSD,PRSD_SV,"2025-05-18 23:54:27",1310,764,705,59,0,745,19,1400,636,357,388
8,BRAŞOV,"SALA DE SPORT A LICEULUI TEORETIC MITROPOLIT IOAN MEŢIANU",282,"ORAŞ ZĂRNEŞTI",40492,1,PART,PRCNCT,PRSD,PRSD_SV,"2025-05-18 21:36:16",1357,852,758,94,0,836,16,1400,548,406,430
8,BRAŞOV,"LICEUL TEORETIC M.I.MEŢIANU - CORP B",283,"ORAŞ ZĂRNEŞTI",40492,1,PART,PRCNCT,PRSD,PRSD_SV,"2025-05-18 21:33:34",1362,892,787,104,1,884,8,1400,508,413,471
8,BRAŞOV,"LICEUL TEORETIC M.I.MEŢIANU - CORP B",284,"ORAŞ ZĂRNEŞTI",40492,2,PART,PRCNCT,PRSD,PRSD_SV,"2025-05-18 23:49:57",1582,926,841,85,0,915,11,1700,774,516,399
8,BRAŞOV,"CASA DE CULTURĂ",285,"ORAŞ ZĂRNEŞTI",40492,1,PART,PRCNCT,PRSD,PRSD_SV,"2025-05-18 21:53:13",1294,826,742,83,1,819,7,1400,574,385,434
8,BRAŞOV,"GRĂDINIŢA VOINICELUL NR. 2",286,"ORAŞ ZĂRNEŞTI",40492,1,PART,PRCNCT,PRSD,PRSD_SV,"2025-05-18 21:54:42",1077,641,543,98,0,621,20,1200,559,246,375
8,BRAŞOV,"CLUBUL PENSIONARILOR - CARAIMAN",287,"ORAŞ ZĂRNEŞTI",40492,1,PART,PRCNCT,PRSD,PRSD_SV,"2025-05-18 21:39:03",1311,719,678,41,0,704,15,1400,681,322,382
8,BRAŞOV,"CLUBUL PENSIONARILOR",288,"ORAŞ ZĂRNEŞTI",40492,1,PART,PRCNCT,PRSD,PRSD_SV,"2025-05-18 21:24:53",1145,698,641,57,0,691,7,1200,502,254,437
8,BRAŞOV,"ŞCOALA GIMNAZIALĂ NR. 3 POMPILIU DAN-CORP A",289,"ORAŞ ZĂRNEŞTI",40492,1,PART,PRCNCT,PRSD,PRSD_SV,"2025-05-18 21:48:42",1099,751,631,120,0,735,16,1200,449,313,422
8,BRAŞOV,"ŞCOALA GIMNAZIALĂ NR. 1 GHEORGHE CRĂCIUN",290,"ORAŞ ZĂRNEŞTI",40492,1,PART,PRCNCT,PRSD,PRSD_SV,"2025-05-18 21:37:31",1201,713,628,60,25,693,20,1300,587,265,428
8,BRAŞOV,"ŞCOALA GIMNAZIALĂ NR. 1 GHEORGHE CRĂCIUN",291,"ORAŞ ZĂRNEŞTI",40492,1,PART,PRCNCT,PRSD,PRSD_SV,"2025-05-18 21:37:39",1380,782,740,42,0,760,22,1500,718,343,417
8,BRAŞOV,"ȘCOALA GIMNAZIALĂ NR. 1 GHEORGHE CRĂCIUN",292,"ORAŞ ZĂRNEŞTI",40492,1,PART,PRCNCT,PRSD,PRSD_SV,"2025-05-18 22:01:59",1376,805,749,28,28,795,10,1500,695,350,445
8,BRAŞOV,"LICEUL TEHNOLOGIC MALAXA",293,"ORAŞ ZĂRNEŞTI",40492,1,PART,PRCNCT,PRSD,PRSD_SV,"2025-05-18 21:36:19",997,493,492,0,1,487,6,1100,607,296,191
8,BRAŞOV,"SCOALA GIMNAZIALA NR. 2",294,"ORAŞ ZĂRNEŞTI",40492,1,PART,PRCNCT,PRSD,PRSD_SV,"2025-05-18 21:45:20",1697,510,463,47,0,493,17,1800,1290,412,81
8,BRAŞOV,"CAMINUL CULTURAL TOHANUL VECHI",295,"ORAŞ ZĂRNEŞTI",40492,1,PART,PRCNCT,PRSD,PRSD_SV,"2025-05-18 22:07:17",1763,1035,934,101,0,1013,22,1900,865,494,519
8,BRAŞOV,"CĂMINUL CULTURAL TOHANUL NOU",296,"ORAŞ ZĂRNEŞTI",40492,1,PART,PRCNCT,PRSD,PRSD_SV,"2025-05-18 22:11:33",1201,892,759,133,0,879,13,1300,408,302,577
8,BRAŞOV,"CĂMINUL CULTURAL APAȚA",297,APAŢA,40526,1,PART,PRCNCT,PRSD,PRSD_SV,"2025-05-18 21:49:52",1308,559,512,47,0,557,2,1400,841,335,222
8,BRAŞOV,"CĂMINUL CULTURAL APAȚA",298,APAŢA,40526,1,PART,PRCNCT,PRSD,PRSD_SV,"2025-05-18 21:35:16",1186,519,486,32,1,514,5,1300,781,232,282
8,BRAŞOV,"GRĂDINIȚA DE COPII",299,AUGUSTIN,42498,2,PART,PRCNCT,PRSD,PRSD_SV,"2025-05-19 01:08:35",1460,479,430,49,0,475,4,1600,1121,392,83
8,BRAŞOV,"CAMIN CULTURAL BECLEAN",300,BECLEAN,40544,1,PART,PRCNCT,PRSD,PRSD_SV,"2025-05-18 21:50:11",727,336,269,65,2,333,3,800,464,143,190
8,BRAŞOV,"CAMIN CULTURAL BOHOLT",301,BECLEAN,40544,1,PART,PRCNCT,PRSD,PRSD_SV,"2025-05-18 21:26:01",171,118,92,26,0,117,1,199,81,68,49
8,BRAŞOV,"CAMIN CULTURAL CALBOR",302,BECLEAN,40544,1,PART,PRCNCT,PRSD,PRSD_SV,"2025-05-18 21:27:15",214,130,90,40,0,125,5,220,90,60,65
8,BRAŞOV,"CLADIRE FOST SEDIU PRIMARIE",303,BECLEAN,40544,1,PART,PRCNCT,PRSD,PRSD_SV,"2025-05-18 21:40:03",390,268,205,63,0,264,4,400,132,106,158
8,BRAŞOV,"CAMIN CULTURAL LUTA",304,BECLEAN,40544,1,PART,PRCNCT,PRSD,PRSD_SV,"2025-05-18 21:30:52",68,55,33,22,0,54,1,80,25,28,26
8,BRAŞOV,"ȘCOALA GIMNAZIALĂ BOD SAT",305,BOD,40606,1,PART,PRCNCT,PRSD,PRSD_SV,"2025-05-18 22:24:00",1674,1133,896,235,2,1118,15,1800,667,475,643
8,BRAŞOV,"CĂMINUL CULTURAL",306,BOD,40606,1,PART,PRCNCT,PRSD,PRSD_SV,"2025-05-18 22:34:07",1267,777,660,116,1,766,11,1400,623,349,417
8,BRAŞOV,"PAVILION ADMINISTRATIV FABRICA DE ZAHAR BOD",307,BOD,40606,1,PART,PRCNCT,PRSD,PRSD_SV,"2025-05-18 21:49:15",863,488,395,93,0,487,1,900,412,211,276
8,BRAŞOV,"PAVILION ADMINISTRATIV FABRICA DE ZAHAR BOD",308,BOD,40606,1,PART,PRCNCT,PRSD,PRSD_SV,"2025-05-18 21:59:29",969,605,502,102,1,602,3,1100,495,264,338
8,BRAŞOV,"PRIMĂRIA COMUNEI BRAN",309,BRAN,40633,1,PART,PRCNCT,PRSD,PRSD_SV,"2025-05-18 22:35:53",741,860,372,488,0,848,12,1000,140,294,554
8,BRAŞOV,"CĂMINUL CULTURAL POARTA",310,BRAN,40633,1,PART,PRCNCT,PRSD,PRSD_SV,"2025-05-18 21:48:01",872,618,436,182,0,611,7,1200,582,227,384
8,BRAŞOV,"SCENA SATULUI",311,BRAN,40633,1,PART,PRCNCT,PRSD,PRSD_SV,"2025-05-18 21:59:43",908,800,522,278,0,791,9,1200,400,312,479
8,BRAŞOV,"ȘCOALA GENERALĂ SOHODOL",312,BRAN,40633,1,PART,PRCNCT,PRSD,PRSD_SV,"2025-05-18 21:44:32",913,536,434,102,0,521,15,1200,664,259,262
8,BRAŞOV,"CĂMINUL CULTURAL ŞIMON",313,BRAN,40633,1,PART,PRCNCT,PRSD,PRSD_SV,"2025-05-18 21:52:47",1034,798,576,222,0,785,13,1300,502,389,396
8,BRAŞOV,"GRĂDINIȚA BUDILA",314,BUDILA,40688,1,PART,PRCNCT,PRSD,PRSD_SV,"2025-05-18 22:12:28",1356,861,838,23,0,851,10,1500,639,739,112
8,BRAŞOV,"ȘCOALA GIMNAZIALĂ BUDILA",315,BUDILA,40688,1,PART,PRCNCT,PRSD,PRSD_SV,"2025-05-18 21:56:36",1052,559,508,51,0,547,12,1100,541,277,270
8,BRAŞOV,"PRIMĂRIA COMUNEI BUDILA",316,BUDILA,40688,1,PART,PRCNCT,PRSD,PRSD_SV,"2025-05-18 21:55:43",999,589,553,35,1,577,12,1100,511,447,130
8,BRAŞOV,"PRIMĂRIA BUNEŞTI",317,BUNEŞTI,40704,1,PART,PRCNCT,PRSD,PRSD_SV,"2025-05-18 21:25:31",640,266,217,49,0,261,5,700,434,169,92
8,BRAŞOV,"ŞCOALA PRIMARĂ CRIȚ",318,BUNEŞTI,40704,1,PART,PRCNCT,PRSD,PRSD_SV,"2025-05-18 21:37:27",575,235,179,56,0,233,2,600,365,144,89
8,BRAŞOV,"CĂMINUL CULTURAL MEŞENDORF",319,BUNEŞTI,40704,1,PART,PRCNCT,PRSD,PRSD_SV,"2025-05-18 21:38:14",298,123,95,28,0,122,1,300,177,78,44
8,BRAŞOV,"ŞCOALA PRIMARĂ ROADEŞ",320,BUNEŞTI,40704,1,PART,PRCNCT,PRSD,PRSD_SV,"2025-05-18 21:39:22",277,128,105,23,0,126,2,300,172,101,25
8,BRAŞOV,"ŞCOALA PRIMARĂ VISCRI",321,BUNEŞTI,40704,1,PART,PRCNCT,PRSD,PRSD_SV,"2025-05-18 21:39:54",380,229,136,93,0,228,1,400,171,97,131
8,BRAŞOV,"CĂMINUL CULTURAL CAŢA",322,CAŢA,40768,1,PART,PRCNCT,PRSD,PRSD_SV,"2025-05-18 21:41:24",1035,453,408,45,0,451,2,1100,647,210,241
8,BRAŞOV,"CĂMIN CULTURAL BEIA",323,CAŢA,40768,1,PART,PRCNCT,PRSD,PRSD_SV,"2025-05-18 21:31:17",321,201,164,37,0,196,5,350,149,156,40
8,BRAŞOV,"CĂMIN CULTURAL DRĂUȘENI",324,CAŢA,40768,1,PART,PRCNCT,PRSD,PRSD_SV,"2025-05-18 21:19:22",409,215,199,16,0,214,1,500,285,69,145
8,BRAŞOV,"CĂMINUL CULTURAL IONEŞTI",325,CAŢA,40768,1,PART,PRCNCT,PRSD,PRSD_SV,"2025-05-18 21:31:06",96,74,53,21,0,74,0,100,26,9,65
8,BRAŞOV,"ŞCOALA GENERALĂ PALOŞ",326,CAŢA,40768,1,PART,PRCNCT,PRSD,PRSD_SV,"2025-05-18 21:38:15",178,107,71,36,0,105,2,200,93,49,56
8,BRAŞOV,"GRĂDINIȚA CU PROGRAM PRELUNGIT CINCU",327,CINCU,40820,1,PART,PRCNCT,PRSD,PRSD_SV,"2025-05-18 22:07:54",1255,948,539,405,4,936,12,1600,652,633,303
8,BRAŞOV,"ȘCOALA GENERALĂ TOARCLA",328,CINCU,40820,1,PART,PRCNCT,PRSD,PRSD_SV,"2025-05-18 21:45:12",277,135,111,24,0,134,1,350,215,107,27
8,BRAŞOV,"CĂMINUL CULTURAL COMĂNA DE JOS",329,COMANA,40857,1,PART,PRCNCT,PRSD,PRSD_SV,"2025-05-18 22:02:02",861,389,342,47,0,384,5,1000,611,244,140
8,BRAŞOV,"CĂMINUL CULTURAL COMĂNA DE SUS",330,COMANA,40857,1,PART,PRCNCT,PRSD,PRSD_SV,"2025-05-18 21:24:09",309,168,113,55,0,165,3,300,132,104,61
8,BRAŞOV,"CĂMINUL CULTURAL CRIHALMA",331,COMANA,40857,1,PART,PRCNCT,PRSD,PRSD_SV,"2025-05-18 21:45:15",606,225,192,32,1,224,1,700,475,145,79
8,BRAŞOV,"CĂMINUL CULTURAL TICUŞU NOU",332,COMANA,40857,1,PART,PRCNCT,PRSD,PRSD_SV,"2025-05-18 21:34:28",501,229,199,30,0,225,4,600,371,148,77
8,BRAŞOV,"GRADINITA DE COPII CRISTIAN",333,CRISTIAN,40900,1,PART,PRCNCT,PRSD,PRSD_SV,"2025-05-18 22:15:35",1384,1020,804,216,0,1003,17,1500,480,314,689
8,BRAŞOV,"GRADINIȚA DE COPII CRISTIAN",334,CRISTIAN,40900,1,PART,PRCNCT,PRSD,PRSD_SV,"2025-05-18 22:36:40",1324,897,697,200,0,886,11,1400,503,288,598
8,BRAŞOV,"SCOALA GENERALA, CORP B",335,CRISTIAN,40900,1,PART,PRCNCT,PRSD,PRSD_SV,"2025-05-18 23:07:35",2038,1454,1195,257,2,1435,19,2100,646,468,967
8,BRAŞOV,"GRĂDINIȚA DE COPII, CRISTIAN",336,CRISTIAN,40900,1,PART,PRCNCT,PRSD,PRSD_SV,"2025-05-18 23:05:18",1431,1117,902,214,1,1108,9,1500,383,321,787
8,BRAŞOV,"CĂMINUL CULTURAL",337,CRIZBAV,42456,1,PART,PRCNCT,PRSD,PRSD_SV,"2025-05-18 22:25:05",1481,702,613,88,1,692,10,1600,898,412,280
8,BRAŞOV,"ŞCOALA PRIMARĂ CUTUŞ",338,CRIZBAV,42456,1,PART,PRCNCT,PRSD,PRSD_SV,"2025-05-18 21:32:30",682,314,297,17,0,308,6,800,486,273,35
8,BRAŞOV,"PRIMĂRIA DRĂGUŞ",339,DRĂGUŞ,42480,1,PART,PRCNCT,PRSD,PRSD_SV,"2025-05-18 21:58:43",907,632,483,142,7,625,7,1000,368,320,305
8,BRAŞOV,"PRIMĂRIA COMUNEI DUMBRĂVIŢA",340,DUMBRĂVIŢA,40928,1,PART,PRCNCT,PRSD,PRSD_SV,"2025-05-18 22:33:19",1610,802,719,83,0,788,14,1700,898,426,362
8,BRAŞOV,"GRĂDINIŢA CU PROGRAM NORMAL DUMBRĂVIŢA",341,DUMBRĂVIŢA,40928,1,PART,PRCNCT,PRSD,PRSD_SV,"2025-05-18 22:54:26",1787,926,866,60,0,911,15,1900,974,524,387
8,BRAŞOV,"ŞCOALA GENERALĂ SAT VLĂDENI",342,DUMBRĂVIŢA,40928,1,PART,PRCNCT,PRSD,PRSD_SV,"2025-05-18 22:36:04",758,450,322,126,2,442,8,800,350,222,220
8,BRAŞOV,"CĂMINUL CULTURAL FELDIOARA",343,FELDIOARA,40955,1,PART,PRCNCT,PRSD,PRSD_SV,"2025-05-18 21:51:56",1721,845,769,76,0,829,16,1800,955,536,293
8,BRAŞOV,"LICEUL TEORETIC PETRU RAREȘ FELDIOARA",344,FELDIOARA,40955,1,PART,PRCNCT,PRSD,PRSD_SV,"2025-05-18 21:42:57",1382,806,742,62,2,793,13,1500,694,396,397
8,BRAŞOV,"LICEUL TEORETIC PETRU RAREȘ FELDIOARA",345,FELDIOARA,40955,1,PART,PRCNCT,PRSD,PRSD_SV,"2025-05-18 21:32:04",1204,512,479,33,0,505,7,1300,788,304,201
8,BRAŞOV,"CĂMINUL CULTURAL RECONSTRUCŢIA",346,FELDIOARA,40955,1,PART,PRCNCT,PRSD,PRSD_SV,"2025-05-18 21:30:19",614,329,304,24,1,322,7,700,371,220,102
8,BRAŞOV,"CĂMINUL CULTURAL ROTBAV",347,FELDIOARA,40955,1,PART,PRCNCT,PRSD,PRSD_SV,"2025-05-18 21:47:59",1151,706,575,130,1,691,15,1300,594,386,305
8,BRAŞOV,"ŞCOALA GENERALĂ FUNDATA",348,FUNDATA,40991,1,PART,PRCNCT,PRSD,PRSD_SV,"2025-05-18 21:37:54",407,420,217,203,0,410,10,550,130,175,235
8,BRAŞOV,"ŞCOALA GENERALĂ ŞIRNEA",349,FUNDATA,40991,1,PART,PRCNCT,PRSD,PRSD_SV,"2025-05-18 21:40:03",171,196,75,121,0,193,3,300,104,92,101
8,BRAŞOV,"CĂMINUL CULTURAL",350,HĂLCHIU,41033,1,PART,PRCNCT,PRSD,PRSD_SV,"2025-05-18 22:10:31",1634,983,878,105,0,977,6,1700,717,450,527
8,BRAŞOV,"LOCAȚIA KREDENT",351,HĂLCHIU,41033,1,PART,PRCNCT,PRSD,PRSD_SV,"2025-05-18 23:58:02",1636,1083,874,206,3,1068,15,1700,617,432,636
8,BRAŞOV,"CAMIN CULTURAL",352,HĂLCHIU,41033,1,PART,PRCNCT,PRSD,PRSD_SV,"2025-05-18 22:00:39",1048,546,468,78,0,536,10,1100,554,226,310
8,BRAŞOV,"SCOALA GIMNAZIALA HARMAN",353,HĂRMAN,41088,1,PART,PRCNCT,PRSD,PRSD_SV,"2025-05-18 22:49:12",2036,1360,1086,273,1,1345,15,2100,740,465,880
8,BRAŞOV,"SCOALA GIMNAZIALA HARMAN",354,HĂRMAN,41088,2,PART,PRCNCT,PRSD,PRSD_SV,"2025-05-19 00:52:28",1936,1254,1010,243,1,1241,13,2000,746,491,750
8,BRAŞOV,"SCOALA GIMNAZIALA HARMAN",355,HĂRMAN,41088,1,PART,PRCNCT,PRSD,PRSD_SV,"2025-05-18 22:21:15",1773,1151,982,166,3,1137,14,1900,749,398,739
8,BRAŞOV,"CĂMINUL CULTURAL",356,HĂRMAN,41088,1,PART,PRCNCT,PRSD,PRSD_SV,"2025-05-18 22:36:41",758,658,449,209,0,647,11,800,142,272,375
8,BRAŞOV,"CĂMINUL CULTURAL HÂRSENI",357,HÂRSENI,41113,1,PART,PRCNCT,PRSD,PRSD_SV,"2025-05-18 21:43:57",468,263,223,40,0,260,3,500,237,159,101
8,BRAŞOV,"CĂMINUL CULTURAL COPĂCEL",358,HÂRSENI,41113,1,PART,PRCNCT,PRSD,PRSD_SV,"2025-05-18 21:40:32",537,336,286,50,0,331,5,600,264,163,168
8,BRAŞOV,"CĂMINUL CULTURAL MĂRGINENI",359,HÂRSENI,41113,1,PART,PRCNCT,PRSD,PRSD_SV,"2025-05-18 21:36:16",253,191,125,65,1,190,1,300,109,96,94
8,BRAŞOV,"CĂMINUL CULTURAL SEBEȘ",360,HÂRSENI,41113,1,PART,PRCNCT,PRSD,PRSD_SV,"2025-05-18 21:49:11",682,335,282,52,1,322,13,800,465,154,168
8,BRAŞOV,"CĂMINUL CULTURAL HOGHIZ",361,HOGHIZ,41177,1,PART,PRCNCT,PRSD,PRSD_SV,"2025-05-18 21:46:34",989,462,422,39,1,459,3,1100,638,152,307
8,BRAŞOV,"CĂMINUL CULTURAL HOGHIZ",362,HOGHIZ,41177,1,PART,PRCNCT,PRSD,PRSD_SV,"2025-05-18 21:43:07",751,313,293,20,0,309,4,800,487,124,185
8,BRAŞOV,"CĂMINUL CULTURAL BOGATA",363,HOGHIZ,41177,1,PART,PRCNCT,PRSD,PRSD_SV,"2025-05-18 21:49:13",360,171,143,28,0,171,0,400,229,99,72
8,BRAŞOV,"CĂMINUL CULTURAL CUCIULATA",364,HOGHIZ,41177,1,PART,PRCNCT,PRSD,PRSD_SV,"2025-05-18 22:05:07",1165,494,438,56,0,485,9,1300,806,359,126
8,BRAŞOV,"CĂMINUL CULTURAL DOPCA",365,HOGHIZ,41177,1,PART,PRCNCT,PRSD,PRSD_SV,"2025-05-18 21:41:05",386,183,168,15,0,183,0,400,217,40,143
8,BRAŞOV,"CĂMUNUL CULTURAL FÂNTÂNA",366,HOGHIZ,41177,1,PART,PRCNCT,PRSD,PRSD_SV,"2025-05-18 21:41:19",215,158,130,28,0,156,2,200,42,62,94
8,BRAŞOV,"CĂMINUL CULTURAL LUPŞA",367,HOGHIZ,41177,1,PART,PRCNCT,PRSD,PRSD_SV,"2025-05-18 21:22:36",76,55,42,13,0,55,0,100,45,37,18
8,BRAŞOV,"CĂMINUL CULTURAL HOLBAV",368,HOLBAV,42472,1,PART,PRCNCT,PRSD,PRSD_SV,"2025-05-18 21:54:50",1022,544,504,40,0,536,8,1100,556,392,144
8,BRAŞOV,"CAMIN CULTURAL HOMOROD",369,HOMOROD,41248,1,PART,PRCNCT,PRSD,PRSD_SV,"2025-05-18 22:00:32",1206,463,404,59,0,460,3,1300,837,285,175
8,BRAŞOV,"CAMIN CULTURAL JIMBOR",370,HOMOROD,41248,1,PART,PRCNCT,PRSD,PRSD_SV,"2025-05-18 21:36:48",377,208,173,35,0,206,2,400,192,40,166
8,BRAŞOV,"CAMIN CULTURAL MERCHEASA",371,HOMOROD,41248,2,PART,PRCNCT,PRSD,PRSD_SV,"2025-05-19 01:03:51",436,229,184,45,0,224,5,500,271,169,55
8,BRAŞOV,"ŞCOALA GENERALĂ JIBERT",372,JIBERT,41284,1,PART,PRCNCT,PRSD,PRSD_SV,"2025-05-18 21:30:03",602,190,162,28,0,188,2,700,510,106,82
8,BRAŞOV,"ŞCOALA GENERALĂ DACIA",373,JIBERT,41284,1,PART,PRCNCT,PRSD,PRSD_SV,"2025-05-18 21:43:30",615,269,231,38,0,266,3,700,431,194,72
8,BRAŞOV,"ŞCOALA GENERALĂ GRÎNARI",374,JIBERT,41284,1,PART,PRCNCT,PRSD,PRSD_SV,"2025-05-18 21:19:24",287,152,129,23,0,152,0,300,148,21,131
8,BRAŞOV,"CĂMINUL CULTURAL LOVNIC",375,JIBERT,41284,1,PART,PRCNCT,PRSD,PRSD_SV,"2025-05-18 21:28:24",484,166,139,27,0,164,2,500,334,73,91
8,BRAŞOV,"ŞCOALA GENERALĂ VĂLENI",376,JIBERT,41284,1,PART,PRCNCT,PRSD,PRSD_SV,"2025-05-18 21:24:21",132,80,56,24,0,80,0,100,20,42,38
8,BRAŞOV,"CĂMINUL CULTURAL LISA",377,LISA,41346,1,PART,PRCNCT,PRSD,PRSD_SV,"2025-05-18 21:37:01",937,488,401,87,0,483,5,1000,512,303,180
8,BRAŞOV,"CĂMINUL CULTURAL BREAZA",378,LISA,41346,1,PART,PRCNCT,PRSD,PRSD_SV,"2025-05-18 21:36:42",547,427,300,127,0,422,5,600,173,225,197
8,BRAŞOV,"CAMINUL CULTURAL MAIERUS",379,MĂIERUŞ,41382,1,PART,PRCNCT,PRSD,PRSD_SV,"2025-05-18 21:55:25",1495,759,692,63,4,751,8,1600,841,487,264
8,BRAŞOV,"CAMINUL CULTURAL ARINI",380,MĂIERUŞ,41382,1,PART,PRCNCT,PRSD,PRSD_SV,"2025-05-18 21:35:33",879,355,299,56,0,348,7,1000,645,278,70
8,BRAŞOV,"AȘEZĂMÎNT CULTURAL MÂNDRA",381,MÂNDRA,41417,1,PART,PRCNCT,PRSD,PRSD_SV,"2025-05-18 21:49:48",1005,561,459,102,0,558,3,1100,539,295,263
8,BRAŞOV,"AŞEZAMÂNT CULTURAL",382,MÂNDRA,41417,1,PART,PRCNCT,PRSD,PRSD_SV,"2025-05-18 22:23:33",683,414,311,103,0,403,11,700,286,156,247
8,BRAŞOV,"AŞEZAMÂNT CULTURAL",383,MÂNDRA,41417,1,PART,PRCNCT,PRSD,PRSD_SV,"2025-05-18 22:04:43",461,303,230,73,0,302,1,500,197,130,172
8,BRAŞOV,"AŞEZAMÂNT CULTURAL",384,MÂNDRA,41417,1,PART,PRCNCT,PRSD,PRSD_SV,"2025-05-18 21:38:14",193,166,90,76,0,165,1,200,34,79,86
8,BRAŞOV,"AŞEZAMÂNT CULTURAL",385,MÂNDRA,41417,1,PART,PRCNCT,PRSD,PRSD_SV,"2025-05-18 21:28:41",232,187,108,79,0,182,5,250,63,96,86
8,BRAŞOV,"PRIMĂRIA COMUNEI MOIECIU",386,MOIECIU,41471,1,PART,PRCNCT,PRSD,PRSD_SV,"2025-05-18 22:24:13",1068,890,588,302,0,880,10,1400,510,389,491
8,BRAŞOV,"PRIMĂRIA COMUNEI MOIECIU",387,MOIECIU,41471,1,PART,PRCNCT,PRSD,PRSD_SV,"2025-05-18 22:13:00",1225,1016,720,296,0,1008,8,1300,284,416,592
8,BRAŞOV,"ŞCOALA GIMNAZIALĂ MĂGURA",388,MOIECIU,41471,1,PART,PRCNCT,PRSD,PRSD_SV,"2025-05-18 21:32:00",394,257,192,65,0,255,2,400,143,133,122
8,BRAŞOV,"ŞCOALA GIMNAZIALĂ MOIECIU DE SUS",389,MOIECIU,41471,1,PART,PRCNCT,PRSD,PRSD_SV,"2025-05-18 22:41:53",783,915,432,483,0,907,8,1100,185,316,591
8,BRAŞOV,"ŞCOALA GIMNAZIALĂ PEȘTERA",390,MOIECIU,41471,1,PART,PRCNCT,PRSD,PRSD_SV,"2025-05-18 21:25:21",326,247,141,106,0,241,6,400,153,132,109
8,BRAŞOV,"DISPENSAR MEDICAL ORMENIŞ",391,ORMENIŞ,41541,1,PART,PRCNCT,PRSD,PRSD_SV,"2025-05-18 22:11:23",1598,854,732,69,53,840,14,1700,846,270,570
8,BRAŞOV,"CĂMINUL CULTURAL PĂRĂU",392,PĂRĂU,41578,1,PART,PRCNCT,PRSD,PRSD_SV,"2025-05-18 21:31:20",516,271,200,70,1,268,3,600,329,151,117
8,BRAŞOV,"CAMIN CULTURAL GRID",393,PĂRĂU,41578,1,PART,PRCNCT,PRSD,PRSD_SV,"2025-05-18 21:26:24",234,193,104,89,0,192,1,300,107,97,95
8,BRAŞOV,"CAMIN CULTURAL VENETIA DE JOS",394,PĂRĂU,41578,1,PART,PRCNCT,PRSD,PRSD_SV,"2025-05-18 21:38:09",567,331,246,85,0,330,1,600,269,174,156
8,BRAŞOV,"CĂMINUL CULTURAL VENEȚIA DE SUS",395,PĂRĂU,41578,1,PART,PRCNCT,PRSD,PRSD_SV,"2025-05-18 21:30:04",389,205,167,38,0,205,0,400,195,148,57
8,BRAŞOV,"ȘCOALA GIMNAZIALĂ NR.1 CORP A2",396,"POIANA MĂRULUI",41621,1,PART,PRCNCT,PRSD,PRSD_SV,"2025-05-18 21:47:15",1226,780,708,72,0,769,11,1300,520,445,324
8,BRAŞOV,"ȘCOALĂ GIMNAZIALĂ NR.1 CORP B",397,"POIANA MĂRULUI",41621,1,PART,PRCNCT,PRSD,PRSD_SV,"2025-05-18 21:33:32",962,569,484,85,0,564,5,1100,531,385,179
8,BRAŞOV,"ȘCOALĂ GIMNAZIALĂ NR. 2 ÎNTRE-VAI",398,"POIANA MĂRULUI",41621,1,PART,PRCNCT,PRSD,PRSD_SV,"2025-05-18 21:20:26",373,163,135,28,0,159,4,400,237,105,54
8,BRAŞOV,"ȘCOALA GIMNAZIALĂ PREJMER, STR.ȘCOLII, NR.1, CORP A, PARTER",399,PREJMER,41667,1,PART,PRCNCT,PRSD,PRSD_SV,"2025-05-18 22:25:21",1751,1054,907,147,0,1042,12,1800,746,430,612
8,BRAŞOV,"ȘCOALA GIMNAZIALĂ PREJMER, STR.ȘCOLII, NR.1, CORP A, PARTER",400,PREJMER,41667,1,PART,PRCNCT,PRSD,PRSD_SV,"2025-05-18 22:27:43",1861,980,875,101,4,967,13,1900,920,469,498
8,BRAŞOV,"ȘCOALA GIMNAZIALĂ PREJMER, STR.ȘCOLII, NR.1, CORP A, PARTER",401,PREJMER,41667,1,PART,PRCNCT,PRSD,PRSD_SV,"2025-05-18 21:43:13",1776,1096,963,133,0,1086,10,1900,804,454,632
8,BRAŞOV,"SCOALA GIMNAZIALA LUNCA CALNICULUI SAT",402,PREJMER,41667,1,PART,PRCNCT,PRSD,PRSD_SV,"2025-05-18 22:26:02",1366,868,757,110,1,864,4,1500,632,450,414
8,BRAŞOV,"SCOALA GIMNAZIALA LUNCA CALNICULUI COLONIE",403,PREJMER,41667,1,PART,PRCNCT,PRSD,PRSD_SV,"2025-05-18 21:55:48",1268,775,637,138,0,762,13,1400,625,389,373
8,BRAŞOV,"SCOALA GENERALA „BETHLEN SAMUEL”",404,RACOŞ,41701,2,PART,PRCNCT,PRSD,PRSD_SV,"2025-05-19 01:35:16",1118,357,325,32,0,353,4,1200,843,216,137
8,BRAŞOV,"GRĂDINIȚA CU PROGRAM NORMAL RACOȘ",405,RACOŞ,41701,1,PART,PRCNCT,PRSD,PRSD_SV,"2025-05-18 21:50:20",1063,500,450,50,0,489,11,1100,600,158,331
8,BRAŞOV,"ȘCOALA PRIMARĂ ”IOAN IOSIF” MATEIAȘ",406,RACOŞ,41701,1,PART,PRCNCT,PRSD,PRSD_SV,"2025-05-18 22:44:59",403,209,153,56,0,207,2,400,191,129,78
8,BRAŞOV,"CĂMINUL CULTURAL RECEA",407,RECEA,41738,1,PART,PRCNCT,PRSD,PRSD_SV,"2025-05-18 22:19:43",1647,941,703,238,0,933,8,1800,859,605,328
8,BRAŞOV,"CĂMINUL CULTURAL BERIVOI",408,RECEA,41738,1,PART,PRCNCT,PRSD,PRSD_SV,"2025-05-18 21:41:17",507,316,230,85,1,315,1,600,284,155,160
8,BRAŞOV,"CĂMINUL CULTURAL SĂVĂSTRENI",409,RECEA,41738,1,PART,PRCNCT,PRSD,PRSD_SV,"2025-05-18 22:08:05",592,353,274,79,0,353,0,700,347,172,181
8,BRAŞOV,"SCOALA GENERALA",410,"SÂMBĂTA DE SUS",42464,1,PART,PRCNCT,PRSD,PRSD_SV,"2025-05-18 21:56:15",1321,854,675,175,4,842,12,1700,846,458,384
8,BRAŞOV,"ŞCOALA GIMNAZIALĂ SÂNPETRU",411,SÂNPETRU,41925,1,PART,PRCNCT,PRSD,PRSD_SV,"2025-05-18 22:26:18",1561,1089,954,135,0,1078,11,1600,511,287,791
8,BRAŞOV,"ȘCOALA GIMNAZIALĂ SÂNPETRU",412,SÂNPETRU,41925,1,PART,PRCNCT,PRSD,PRSD_SV,"2025-05-18 22:04:22",1599,925,790,135,0,913,12,1700,775,251,662
8,BRAŞOV,"ŞCOALA GIMNAZIALĂ SÂNPETRU",413,SÂNPETRU,41925,1,PART,PRCNCT,PRSD,PRSD_SV,"2025-05-18 21:58:21",1540,1048,902,146,0,1036,12,1600,552,306,730
8,BRAŞOV,"GRĂDINIȚA CU PROGRAM NORMAL 4 ORE SÂNPETRU",414,SÂNPETRU,41925,1,PART,PRCNCT,PRSD,PRSD_SV,"2025-05-18 22:45:38",1614,1304,927,358,19,1295,9,1700,396,374,921
8,BRAŞOV,"CĂMINUL CULTURAL AL BISERICII ORTODOXE",415,SÂNPETRU,41925,1,PART,PRCNCT,PRSD,PRSD_SV,"2025-05-18 22:08:43",1568,1048,862,159,27,1023,25,1600,552,489,534
8,BRAŞOV,"GRĂDINIȚA CU PROGRAM NORMAL 8 ORE",416,SÂNPETRU,41925,1,PART,PRCNCT,PRSD,PRSD_SV,"2025-05-18 22:39:29",1497,1312,886,426,0,1294,18,1600,288,451,843
8,BRAŞOV,"GRĂDINIȚA CU PROGRAM NORMAL 8 ORE",417,SÂNPETRU,41925,1,PART,PRCNCT,PRSD,PRSD_SV,"2025-05-18 22:19:48",1597,1280,1038,242,0,1266,14,1700,420,323,943
8,BRAŞOV,"CĂMIN CULTURAL ŞERCAIA",418,ŞERCAIA,41818,1,PART,PRCNCT,PRSD,PRSD_SV,"2025-05-18 22:09:22",1449,707,579,108,20,693,14,1500,793,362,331
8,BRAŞOV,"ȘCOALA PRIMARĂ HĂLMEAG",419,ŞERCAIA,41818,1,PART,PRCNCT,PRSD,PRSD_SV,"2025-05-18 21:34:42",427,217,170,40,7,214,3,500,283,92,122
8,BRAŞOV,"CĂMIN CULTURAL VAD",420,ŞERCAIA,41818,1,PART,PRCNCT,PRSD,PRSD_SV,"2025-05-18 21:48:33",453,317,211,105,1,311,6,500,183,118,193
8,BRAŞOV,PRIMĂRIE,421,ŞINCA,41854,1,PART,PRCNCT,PRSD,PRSD_SV,"2025-05-18 21:41:28",731,465,349,116,0,463,2,800,335,227,236
8,BRAŞOV,"CĂMINUL CULTURAL",422,ŞINCA,41854,1,PART,PRCNCT,PRSD,PRSD_SV,"2025-05-18 21:40:00",238,180,107,73,0,178,2,300,120,92,86
8,BRAŞOV,"CĂMINUL CULTURAL",423,ŞINCA,41854,1,PART,PRCNCT,PRSD,PRSD_SV,"2025-05-18 21:27:23",267,171,106,65,0,171,0,300,129,65,106
8,BRAŞOV,"CĂMINUL CULTURAL",424,ŞINCA,41854,1,PART,PRCNCT,PRSD,PRSD_SV,"2025-05-18 21:54:52",925,550,436,114,0,546,4,1000,450,364,182
8,BRAŞOV,"CĂMINUL CULTURAL",425,ŞINCA,41854,1,PART,PRCNCT,PRSD,PRSD_SV,"2025-05-18 21:38:44",599,349,243,105,1,344,5,700,351,147,197
8,BRAŞOV,"ȘCOALĂ GENERALĂ",426,ŞINCA,41854,1,PART,PRCNCT,PRSD,PRSD_SV,"2025-05-18 21:25:04",192,113,94,19,0,110,3,200,87,92,18
8,BRAŞOV,"CĂMINUL CULTURAL",427,"ŞINCA NOUĂ",42449,1,PART,PRCNCT,PRSD,PRSD_SV,"2025-05-18 21:46:26",923,651,539,108,4,647,4,1000,349,326,321
8,BRAŞOV,"ȘCOALĂ GENERALĂ",428,"ŞINCA NOUĂ",42449,1,PART,PRCNCT,PRSD,PRSD_SV,"2025-05-18 21:40:10",217,128,97,31,0,123,5,215,87,94,29
8,BRAŞOV,"ȘCOALA PRIMARĂ PALTIN",429,"ŞINCA NOUĂ",42449,1,PART,PRCNCT,PRSD,PRSD_SV,"2025-05-18 22:25:57",153,175,84,91,0,172,3,200,25,117,55
8,BRAŞOV,"PRIMĂRIA COMUNEI ȘOARȘ",430,ŞOARŞ,41943,1,PART,PRCNCT,PRSD,PRSD_SV,"2025-05-18 21:33:27",491,205,185,20,0,205,0,500,295,127,78
8,BRAŞOV,"ȘCOALA GENERALĂ BĂRCUT",431,ŞOARŞ,41943,1,PART,PRCNCT,PRSD,PRSD_SV,"2025-05-18 21:35:13",336,180,144,36,0,180,0,400,220,107,73
8,BRAŞOV,"CĂMIN CULTURAL FELMER",432,ŞOARŞ,41943,1,PART,PRCNCT,PRSD,PRSD_SV,"2025-05-18 21:53:06",383,196,151,45,0,193,3,400,204,114,79
8,BRAŞOV,"ȘCOALA GENERALĂ RODBAV",433,ŞOARŞ,41943,1,PART,PRCNCT,PRSD,PRSD_SV,"2025-05-18 21:51:30",263,143,117,26,0,141,2,300,157,94,47
8,BRAŞOV,"GRĂDINIȚA CU PROGRAM NORMAL SELIȘTAT",434,ŞOARŞ,41943,1,PART,PRCNCT,PRSD,PRSD_SV,"2025-05-18 21:27:40",161,95,67,28,0,94,1,200,105,46,48
8,BRAŞOV,"CAMIN CULTURAL",435,TĂRLUNGENI,42003,1,PART,PRCNCT,PRSD,PRSD_SV,"2025-05-18 21:51:55",1795,937,831,106,0,926,11,1900,963,543,383
8,BRAŞOV,"GRADINITA PROGRAM PRELUNGIT",436,TĂRLUNGENI,42003,1,PART,PRCNCT,PRSD,PRSD_SV,"2025-05-18 22:22:33",1780,1149,1023,125,1,1135,14,1900,751,427,708
8,BRAŞOV,"ȘCOALA PRIMARĂ CĂRPINIȘ",437,TĂRLUNGENI,42003,1,PART,PRCNCT,PRSD,PRSD_SV,"2025-05-18 22:09:20",1612,1290,987,302,1,1277,13,1700,410,388,889
8,BRAŞOV,"SCOALA GENERALA CARPINIS",438,TĂRLUNGENI,42003,1,PART,PRCNCT,PRSD,PRSD_SV,"2025-05-18 22:11:46",1451,1017,854,163,0,1015,2,1500,483,340,675
8,BRAŞOV,"SCOALA GENERALA PURCARENI",439,TĂRLUNGENI,42003,1,PART,PRCNCT,PRSD,PRSD_SV,"2025-05-18 21:46:40",1207,791,684,107,0,781,10,1300,509,284,497
8,BRAŞOV,"SCOALA GENERALA ZIZIN",440,TĂRLUNGENI,42003,1,PART,PRCNCT,PRSD,PRSD_SV,"2025-05-18 22:30:30",1152,750,705,45,0,743,7,1200,450,500,243
8,BRAŞOV,"SCOALA GENERALA ZIZIN",441,TĂRLUNGENI,42003,1,PART,PRCNCT,PRSD,PRSD_SV,"2025-05-18 21:44:50",1239,826,779,47,0,816,10,1300,474,607,209
8,BRAŞOV,"ȘCOALĂ GENERALĂ TELIU",442,TELIU,42058,1,PART,PRCNCT,PRSD,PRSD_SV,"2025-05-18 21:54:46",1555,710,663,47,0,697,13,1600,890,557,140
8,BRAŞOV,"CĂMINUL CULTURAL TELIU",443,TELIU,42058,1,PART,PRCNCT,PRSD,PRSD_SV,"2025-05-18 21:53:02",1001,549,480,69,0,546,3,1100,551,211,335
8,BRAŞOV,"ȘCOALĂ GENERALĂ TELIU VALE",444,TELIU,42058,1,PART,PRCNCT,PRSD,PRSD_SV,"2025-05-18 22:03:32",810,509,442,67,0,508,1,900,391,227,281
8,BRAŞOV,"CĂMINUL CULTURAL TICUŞU VECHI",445,TICUŞU,42076,1,PART,PRCNCT,PRSD,PRSD_SV,"2025-05-18 21:40:37",615,204,183,21,0,201,3,700,496,105,96
8,BRAŞOV,"ŞCOALA PRIMARĂ COBOR",446,TICUŞU,42076,1,PART,PRCNCT,PRSD,PRSD_SV,"2025-05-18 21:17:38",182,94,61,32,1,94,0,200,106,46,48
8,BRAŞOV,"SEDIUL PRIMARIEI COMUNEI UCEA",447,UCEA,42101,1,PART,PRCNCT,PRSD,PRSD_SV,"2025-05-18 21:37:33",689,391,310,79,2,387,4,800,409,241,146
8,BRAŞOV,"CAMINUL CULTURAL CORBI",448,UCEA,42101,1,PART,PRCNCT,PRSD,PRSD_SV,"2025-05-18 21:34:06",172,138,90,47,1,138,0,200,62,47,91
8,BRAŞOV,"CAMINUL CULTURAL FELDIOARA",449,UCEA,42101,1,PART,PRCNCT,PRSD,PRSD_SV,"2025-05-18 21:27:06",180,143,102,41,0,139,4,200,57,101,38
8,BRAŞOV,"CAMINUL CULTURAL UCEA DE SUS",450,UCEA,42101,1,PART,PRCNCT,PRSD,PRSD_SV,"2025-05-18 22:14:29",812,490,424,63,3,484,6,900,410,306,178
8,BRAŞOV,"ŞCOALA GENERALĂ UNGRA",451,UNGRA,42156,1,PART,PRCNCT,PRSD,PRSD_SV,"2025-05-18 22:52:27",1156,420,404,15,1,415,5,1200,780,349,66
8,BRAŞOV,"GRĂDINIŢA DĂIŞOARA",452,UNGRA,42156,1,PART,PRCNCT,PRSD,PRSD_SV,"2025-05-18 22:13:04",594,292,266,26,0,286,6,700,408,184,102
8,BRAŞOV,"CĂMIN CULTURAL VAMA BUZĂULUI",453,"VAMA BUZĂULUI",42183,1,PART,PRCNCT,PRSD,PRSD_SV,"2025-05-18 22:12:03",1372,775,675,95,5,762,13,1500,725,402,360
8,BRAŞOV,"CĂMIN CULTURAL ACRIȘ",454,"VAMA BUZĂULUI",42183,1,PART,PRCNCT,PRSD,PRSD_SV,"2025-05-18 21:40:43",1056,543,498,45,0,537,6,1100,557,354,183
8,BRAŞOV,"ŞCOALA PRIMARĂ BUZĂIEL",455,"VAMA BUZĂULUI",42183,1,PART,PRCNCT,PRSD,PRSD_SV,"2025-05-18 21:39:44",484,237,209,28,0,234,3,500,263,186,48
8,BRAŞOV,"CĂMINUL CULTURAL VIȘTEA DE JOS",456,VIŞTEA,42236,1,PART,PRCNCT,PRSD,PRSD_SV,"2025-05-18 21:42:30",655,337,255,82,0,333,4,700,363,159,174
8,BRAŞOV,"ŞCOALA GENERALĂ OLTEŢ",457,VIŞTEA,42236,1,PART,PRCNCT,PRSD,PRSD_SV,"2025-05-18 21:20:36",310,202,116,86,0,199,3,300,98,106,93
8,BRAŞOV,"CAMIN CULTURAL RUCAR",458,VIŞTEA,42236,1,PART,PRCNCT,PRSD,PRSD_SV,"2025-05-18 21:22:16",328,212,149,63,0,211,1,400,188,102,109
8,BRAŞOV,"CAMIN CULTURAL VISTEA DE SUS",459,VIŞTEA,42236,1,PART,PRCNCT,PRSD,PRSD_SV,"2025-05-18 21:31:13",525,359,281,77,1,358,1,600,241,172,186
8,BRAŞOV,"CĂMINUL CULTURAL VOILA",460,VOILA,42307,1,PART,PRCNCT,PRSD,PRSD_SV,"2025-05-18 21:39:27",599,342,276,63,3,338,4,700,358,215,123
8,BRAŞOV,"CAMINUL CULTURAL CINCSOR",461,VOILA,42307,1,PART,PRCNCT,PRSD,PRSD_SV,"2025-05-18 21:40:15",635,347,264,82,1,343,4,700,353,226,117
8,BRAŞOV,"CAMINUL CULTURAL DRIDIF",462,VOILA,42307,1,PART,PRCNCT,PRSD,PRSD_SV,"2025-05-18 21:39:18",390,251,183,67,1,247,4,400,149,142,105
8,BRAŞOV,"CAMINUL CULTURAL LUDISOR",463,VOILA,42307,1,PART,PRCNCT,PRSD,PRSD_SV,"2025-05-18 21:33:43",164,154,91,63,0,151,3,200,46,88,63
8,BRAŞOV,"CAMINUL CULTURAL SAMBATA DE JOS",464,VOILA,42307,1,PART,PRCNCT,PRSD,PRSD_SV,"2025-05-18 21:53:27",427,271,181,88,2,269,2,500,229,149,120
8,BRAŞOV,"CAMINUL CULTURAL VOIVODENII MARI",465,VOILA,42307,1,PART,PRCNCT,PRSD,PRSD_SV,"2025-05-18 21:42:48",363,283,200,81,2,279,4,400,117,156,123
8,BRAŞOV,"CAMINUL CULTURAL VULCAN",466,VULCAN,42398,1,PART,PRCNCT,PRSD,PRSD_SV,"2025-05-18 21:54:58",1700,1080,925,154,1,1071,9,1800,720,551,520
8,BRAŞOV,"CAMINUL CULTURAL VULCAN",467,VULCAN,42398,1,PART,PRCNCT,PRSD,PRSD_SV,"2025-05-18 21:45:56",1824,918,841,77,0,913,5,1900,982,528,385
8,BRAŞOV,"CLĂDIRE ȘCOALA COLONIA 1 MAI",468,VULCAN,42398,1,PART,PRCNCT,PRSD,PRSD_SV,"2025-05-18 21:45:09",735,465,396,49,20,458,7,800,335,338,120
9,BRĂILA,"ŞCOALA GIMNAZIALĂ NR. 31 „MIHAI VITEAZUL”",1,"MUNICIPIUL BRĂILA",42682,2,PART,PRCNCT,PRSD,PRSD_SV,"2025-05-18 22:21:08",1617,639,605,34,0,632,7,1600,961,370,262
9,BRĂILA,"ŞCOALA GIMNAZIALĂ NR. 31 „MIHAI VITEAZUL”",2,"MUNICIPIUL BRĂILA",42682,1,PART,PRCNCT,PRSD,PRSD_SV,"2025-05-18 21:34:34",1081,573,541,32,0,565,8,1200,627,260,305
9,BRĂILA,"ŞCOALA GIMNAZIALĂ NR. 31 „MIHAI VITEAZUL”",3,"MUNICIPIUL BRĂILA",42682,1,PART,PRCNCT,PRSD,PRSD_SV,"2025-05-18 21:19:30",921,496,468,26,2,488,8,1000,504,231,257
9,BRĂILA,"ŞCOALA GIMNAZIALĂ NR. 31 „MIHAI VITEAZUL”",4,"MUNICIPIUL BRĂILA",42682,1,PART,PRCNCT,PRSD,PRSD_SV,"2025-05-18 21:16:48",1056,574,543,31,0,569,5,1200,626,286,283
9,BRĂILA,"GRĂDINIŢA NR. 61 „BOBOCEL”",5,"MUNICIPIUL BRĂILA",42682,1,PART,PRCNCT,PRSD,PRSD_SV,"2025-05-18 21:30:59",1049,576,539,37,0,565,11,1200,624,242,323
9,BRĂILA,"GRĂDINIŢA NR. 61 „BOBOCEL”",6,"MUNICIPIUL BRĂILA",42682,1,PART,PRCNCT,PRSD,PRSD_SV,"2025-05-18 21:24:22",1115,613,590,23,0,599,14,1200,587,268,331
9,BRĂILA,"ȘCOALA GIMNAZIALĂ NR. 1 „VLAICU VODĂ”",7,"MUNICIPIUL BRĂILA",42682,1,PART,PRCNCT,PRSD,PRSD_SV,"2025-05-18 21:38:33",1256,721,693,28,0,705,16,1400,679,323,382
9,BRĂILA,"ȘCOALA GIMNAZIALĂ NR. 1 „VLAICU VODĂ”",8,"MUNICIPIUL BRĂILA",42682,1,PART,PRCNCT,PRSD,PRSD_SV,"2025-05-18 21:58:20",1348,755,700,55,0,745,10,1600,845,353,392
9,BRĂILA,"ȘCOALA GIMNAZIALĂ „VLAICU VODĂ”",9,"MUNICIPIUL BRĂILA",42682,1,PART,PRCNCT,PRSD,PRSD_SV,"2025-05-18 21:57:14",1568,848,805,43,0,845,3,1600,752,393,452
9,BRĂILA,"ȘCOALA GIMNAZIALĂ „VLAICU VODĂ”",10,"MUNICIPIUL BRĂILA",42682,1,PART,PRCNCT,PRSD,PRSD_SV,"2025-05-18 21:34:03",1499,816,786,30,0,800,16,1600,784,359,441
9,BRĂILA,"ȘCOALA GIMNAZIALĂ NR. 27 „AUREL VLAICU”",11,"MUNICIPIUL BRĂILA",42682,1,PART,PRCNCT,PRSD,PRSD_SV,"2025-05-18 21:21:45",1270,753,697,55,1,750,3,1400,647,353,397
9,BRĂILA,"ȘCOALA GIMNAZIALĂ NR. 27 „AUREL VLAICU”",12,"MUNICIPIUL BRĂILA",42682,1,PART,PRCNCT,PRSD,PRSD_SV,"2025-05-18 21:54:46",1398,701,691,10,0,698,3,1400,699,415,283
9,BRĂILA,"ŞCOALA GIMNAZIALĂ NR. 27 „AUREL VLAICU”",13,"MUNICIPIUL BRĂILA",42682,1,PART,PRCNCT,PRSD,PRSD_SV,"2025-05-18 21:48:57",1170,656,618,38,0,648,8,1200,544,307,341
9,BRĂILA,"ŞCOALA GIMNAZIALĂ NR. 27 „AUREL VLAICU”",14,"MUNICIPIUL BRĂILA",42682,1,PART,PRCNCT,PRSD,PRSD_SV,"2025-05-18 21:54:42",1265,658,636,22,0,649,9,1400,742,317,332
9,BRĂILA,"ȘCOALA GIMNAZIALĂ NR. 2 „FĂNUȘ NEAGU”",15,"MUNICIPIUL BRĂILA",42682,1,PART,PRCNCT,PRSD,PRSD_SV,"2025-05-18 21:34:36",825,560,400,79,81,550,10,990,430,290,260
9,BRĂILA,"ȘCOALA GIMNAZIALĂ NR. 2 „FĂNUȘ NEAGU”",16,"MUNICIPIUL BRĂILA",42682,1,PART,PRCNCT,PRSD,PRSD_SV,"2025-05-18 21:26:46",939,550,457,36,57,539,11,1000,450,246,293
9,BRĂILA,"ŞCOALA GIMNAZIALĂ NR. 2 „FĂNUŞ NEAGU”",17,"MUNICIPIUL BRĂILA",42682,1,PART,PRCNCT,PRSD,PRSD_SV,"2025-05-18 21:46:55",1008,585,558,27,0,576,9,1200,615,246,330
9,BRĂILA,"ŞCOALA GIMNAZIALĂ NR. 2 „FĂNUŞ NEAGU”",18,"MUNICIPIUL BRĂILA",42682,1,PART,PRCNCT,PRSD,PRSD_SV,"2025-05-18 21:33:21",1375,811,771,40,0,803,8,1600,789,308,495
9,BRĂILA,"ŞCOALA GIMNAZIALĂ NR. 2 „FĂNUŞ NEAGU”",19,"MUNICIPIUL BRĂILA",42682,1,PART,PRCNCT,PRSD,PRSD_SV,"2025-05-18 21:38:13",1029,576,551,25,0,566,10,1200,624,237,329
9,BRĂILA,"GRĂDINIŢA NR. 39 „CĂSUȚA FERMECATĂ”",20,"MUNICIPIUL BRĂILA",42682,1,PART,PRCNCT,PRSD,PRSD_SV,"2025-05-18 21:26:10",1124,595,575,20,0,586,9,1200,605,271,315
9,BRĂILA,"GRĂDINIŢA NR. 39 „CĂSUȚA FERMECATĂ”",21,"MUNICIPIUL BRĂILA",42682,1,PART,PRCNCT,PRSD,PRSD_SV,"2025-05-18 21:36:27",1010,512,478,34,0,500,12,1200,688,247,253
9,BRĂILA,"GRĂDINIŢA NR. 39 „CĂSUȚA FERMECATĂ”",22,"MUNICIPIUL BRĂILA",42682,1,PART,PRCNCT,PRSD,PRSD_SV,"2025-05-18 21:45:50",994,494,473,21,0,485,9,1200,706,233,252
9,BRĂILA,"GRĂDINIŢA NR. 39 „CĂSUȚA FERMECATĂ”",23,"MUNICIPIUL BRĂILA",42682,1,PART,PRCNCT,PRSD,PRSD_SV,"2025-05-18 21:29:26",981,481,465,16,0,470,11,1000,519,234,236
9,BRĂILA,"ȘCOALA GIMNAZIALĂ NR. 28 „VASILE ALECSANDRI”",24,"MUNICIPIUL BRĂILA",42682,1,PART,PRCNCT,PRSD,PRSD_SV,"2025-05-18 21:28:29",936,532,475,57,0,527,5,1000,468,223,304
9,BRĂILA,"ȘCOALA GIMNAZIALĂ NR. 28 „VASILE ALECSANDRI”",25,"MUNICIPIUL BRĂILA",42682,1,PART,PRCNCT,PRSD,PRSD_SV,"2025-05-18 21:17:04",878,395,374,21,0,392,3,1000,605,214,178
9,BRĂILA,"ȘCOALA GIMNAZIALĂ NR. 28 „VASILE ALECSANDRI”",26,"MUNICIPIUL BRĂILA",42682,1,PART,PRCNCT,PRSD,PRSD_SV,"2025-05-18 21:27:27",909,400,390,10,0,397,3,1000,600,193,204
9,BRĂILA,"ŞCOALA GIMNAZIALĂ NR. 28 „VASILE ALECSANDRI”",27,"MUNICIPIUL BRĂILA",42682,1,PART,PRCNCT,PRSD,PRSD_SV,"2025-05-18 21:18:12",1152,590,554,34,2,585,5,1200,610,232,353
9,BRĂILA,"ŞCOALA GIMNAZIALĂ NR. 28 „VASILE ALECSANDRI”",28,"MUNICIPIUL BRĂILA",42682,1,PART,PRCNCT,PRSD,PRSD_SV,"2025-05-18 21:23:08",788,366,358,8,0,365,1,800,434,180,185
9,BRĂILA,"GRĂDINIŢA NR. 38 „IZVORAȘUL”",29,"MUNICIPIUL BRĂILA",42682,1,PART,PRCNCT,PRSD,PRSD_SV,"2025-05-18 21:46:56",1251,707,668,39,0,695,12,1400,693,326,369
9,BRĂILA,"ŞCOALA GIMNAZIALĂ NR. 29 „MIHAIL SADOVEANU”",30,"MUNICIPIUL BRĂILA",42682,1,PART,PRCNCT,PRSD,PRSD_SV,"2025-05-18 21:34:34",635,345,309,36,0,344,1,800,455,142,202
9,BRĂILA,"ȘCOALA GIMNAZIALĂ NR. 29 „MIHAIL SADOVEANU”",31,"MUNICIPIUL BRĂILA",42682,1,PART,PRCNCT,PRSD,PRSD_SV,"2025-05-18 21:36:23",1107,558,521,37,0,547,11,1200,642,288,259
9,BRĂILA,"ȘCOALA GIMNAZIALĂ NR. 29 „MIHAIL SADOVEANU”",32,"MUNICIPIUL BRĂILA",42682,1,PART,PRCNCT,PRSD,PRSD_SV,"2025-05-18 21:33:32",1229,625,604,21,0,615,10,1400,775,296,319
9,BRĂILA,"GRĂDINIŢA NR. 11 „BRÂNDUȘA”",33,"MUNICIPIUL BRĂILA",42682,1,PART,PRCNCT,PRSD,PRSD_SV,"2025-05-18 21:43:49",1367,666,636,30,0,654,12,1600,934,327,327
9,BRĂILA,"COLEGIUL NAȚIONAL „ANA ASLAN”",34,"MUNICIPIUL BRĂILA",42682,1,PART,PRCNCT,PRSD,PRSD_SV,"2025-05-18 21:40:32",786,362,319,43,0,355,7,1000,638,200,155
9,BRĂILA,"COLEGIUL NAȚIONAL „ANA ASLAN”",35,"MUNICIPIUL BRĂILA",42682,1,PART,PRCNCT,PRSD,PRSD_SV,"2025-05-18 21:35:21",1176,585,548,37,0,578,7,1400,815,243,335
9,BRĂILA,"COLEGIUL NAȚIONAL „ANA ASLAN”",36,"MUNICIPIUL BRĂILA",42682,1,PART,PRCNCT,PRSD,PRSD_SV,"2025-05-18 21:36:31",988,533,501,32,0,531,2,1200,667,237,294
9,BRĂILA,"COLEGIUL NAȚIONAL „ANA ASLAN”",37,"MUNICIPIUL BRĂILA",42682,1,PART,PRCNCT,PRSD,PRSD_SV,"2025-05-18 21:42:08",1305,726,697,29,0,719,7,1400,674,319,400
9,BRĂILA,"COLEGIUL NAȚIONAL „ANA ASLAN”",38,"MUNICIPIUL BRĂILA",42682,1,PART,PRCNCT,PRSD,PRSD_SV,"2025-05-18 21:37:50",1316,574,538,36,0,560,14,1400,826,334,226
9,BRĂILA,"LICEUL TEHNOLOGIC „EDMOND NICOLAU”",39,"MUNICIPIUL BRĂILA",42682,1,PART,PRCNCT,PRSD,PRSD_SV,"2025-05-18 21:53:35",1342,679,630,31,18,673,6,1400,721,313,360
9,BRĂILA,"LICEUL TEHNOLOGIC „EDMOND NICOLAU”",40,"MUNICIPIUL BRĂILA",42682,1,PART,PRCNCT,PRSD,PRSD_SV,"2025-05-18 21:43:49",1267,709,682,25,2,704,5,1400,691,298,406
9,BRĂILA,"LICEUL TEHNOLOGIC „EDMOND NICOLAU”",41,"MUNICIPIUL BRĂILA",42682,1,PART,PRCNCT,PRSD,PRSD_SV,"2025-05-18 21:45:03",1017,548,529,18,1,537,11,1200,652,197,340
9,BRĂILA,"LICEUL TEHNOLOGIC „EDMOND NICOLAU”",42,"MUNICIPIUL BRĂILA",42682,1,PART,PRCNCT,PRSD,PRSD_SV,"2025-05-18 21:43:34",1166,604,556,48,0,596,8,1400,796,229,367
9,BRĂILA,"LICEUL TEHNOLOGIC „EDMOND NICOLAU”",43,"MUNICIPIUL BRĂILA",42682,1,PART,PRCNCT,PRSD,PRSD_SV,"2025-05-18 21:50:25",1013,571,549,22,0,564,7,1200,629,176,388
9,BRĂILA,"COMPANIA DE UTILITĂȚI PUBLICE „DUNĂREA” SA BRĂILA",44,"MUNICIPIUL BRĂILA",42682,1,PART,PRCNCT,PRSD,PRSD_SV,"2025-05-18 22:48:49",1369,750,706,44,0,739,11,1400,650,340,399
9,BRĂILA,"GRĂDINIȚA CU PROGRAM NORMAL WALDORF",45,"MUNICIPIUL BRĂILA",42682,1,PART,PRCNCT,PRSD,PRSD_SV,"2025-05-18 21:40:14",1223,742,678,63,1,726,16,1400,658,279,447
9,BRĂILA,"GRĂDINIȚA CU PROGRAM NORMAL WALDORF",46,"MUNICIPIUL BRĂILA",42682,1,PART,PRCNCT,PRSD,PRSD_SV,"2025-05-18 21:36:55",742,535,419,78,38,529,6,800,265,196,333
9,BRĂILA,"ŞCOALA GIMNAZIALĂ NR. 8 „ION BĂNCILĂ”",47,"MUNICIPIUL BRĂILA",42682,1,PART,PRCNCT,PRSD,PRSD_SV,"2025-05-18 21:26:07",1280,658,630,27,1,652,6,1400,742,289,363
9,BRĂILA,"ŞCOALA GIMNAZIALĂ NR. 8 „ION BĂNCILĂ”",48,"MUNICIPIUL BRĂILA",42682,2,PART,PRCNCT,PRSD,PRSD_SV,"2025-05-18 23:32:44",1027,589,544,44,1,579,10,1200,611,223,356
9,BRĂILA,"ŞCOALA GIMNAZIALĂ NR. 8 „ION BĂNCILĂ”",49,"MUNICIPIUL BRĂILA",42682,1,PART,PRCNCT,PRSD,PRSD_SV,"2025-05-18 21:44:00",674,398,356,42,0,391,7,800,402,165,226
9,BRĂILA,"ŞCOALA GIMNAZIALĂ NR. 8 „ION BĂNCILĂ”",50,"MUNICIPIUL BRĂILA",42682,1,PART,PRCNCT,PRSD,PRSD_SV,"2025-05-18 21:34:55",608,327,307,19,1,320,7,800,473,120,200
9,BRĂILA,"ŞCOALA GIMNAZIALĂ NR. 8 „ION BĂNCILĂ”",51,"MUNICIPIUL BRĂILA",42682,1,PART,PRCNCT,PRSD,PRSD_SV,"2025-05-18 21:19:38",640,344,330,14,0,339,5,800,456,133,206
9,BRĂILA,"LICEUL TEORETIC „PANAIT CERNA”",52,"MUNICIPIUL BRĂILA",42682,1,PART,PRCNCT,PRSD,PRSD_SV,"2025-05-18 22:46:32",1398,726,678,48,0,716,10,1600,874,320,396
9,BRĂILA,"LICEUL TEORETIC „PANAIT CERNA”",53,"MUNICIPIUL BRĂILA",42682,1,PART,PRCNCT,PRSD,PRSD_SV,"2025-05-18 21:36:57",1225,675,627,47,1,664,11,1400,725,269,395
9,BRĂILA,"LICEUL TEORETIC „PANAIT CERNA”",54,"MUNICIPIUL BRĂILA",42682,1,PART,PRCNCT,PRSD,PRSD_SV,"2025-05-18 21:40:35",1167,627,562,65,0,622,5,1200,573,312,310
9,BRĂILA,"LICEUL TEORETIC „PANAIT CERNA”",55,"MUNICIPIUL BRĂILA",42682,1,PART,PRCNCT,PRSD,PRSD_SV,"2025-05-18 21:40:14",883,510,439,71,0,503,7,1000,490,209,294
9,BRĂILA,"COLEGIUL NAȚIONAL „GHEORGHE MUNTEANU MURGOCI”",56,"MUNICIPIUL BRĂILA",42682,1,PART,PRCNCT,PRSD,PRSD_SV,"2025-05-18 21:22:16",1078,636,572,64,0,625,11,1200,564,202,423
9,BRĂILA,"COLEGIUL NAȚIONAL „GHEORGHE MUNTEANU MURGOCI”",57,"MUNICIPIUL BRĂILA",42682,1,PART,PRCNCT,PRSD,PRSD_SV,"2025-05-18 21:36:02",1141,644,584,60,0,633,11,1200,556,220,413
9,BRĂILA,"ŞCOALA GIMNAZIALĂ NR. 7 „ION CREANGĂ”",58,"MUNICIPIUL BRĂILA",42682,1,PART,PRCNCT,PRSD,PRSD_SV,"2025-05-18 21:25:54",1039,557,520,36,1,553,4,1200,643,187,366
9,BRĂILA,"ȘCOALA GIMNAZIALĂ NR. 7 „ION CREANGĂ”",59,"MUNICIPIUL BRĂILA",42682,1,PART,PRCNCT,PRSD,PRSD_SV,"2025-05-18 21:38:51",884,491,463,28,0,488,3,1000,509,170,318
9,BRĂILA,"ȘCOALA GIMNAZIALĂ NR. 7 „ION CREANGĂ”",60,"MUNICIPIUL BRĂILA",42682,1,PART,PRCNCT,PRSD,PRSD_SV,"2025-05-18 21:38:16",820,517,444,28,45,510,7,1000,483,185,325
9,BRĂILA,"LICEUL TEORETIC „NICOLAE IORGA”",61,"MUNICIPIUL BRĂILA",42682,1,PART,PRCNCT,PRSD,PRSD_SV,"2025-05-18 21:26:00",724,402,322,62,18,394,8,800,398,203,191
9,BRĂILA,"ŞCOALA GIMNAZIALĂ NR. 5 „NIKOS KAZANTZAKIS”",62,"MUNICIPIUL BRĂILA",42682,1,PART,PRCNCT,PRSD,PRSD_SV,"2025-05-18 21:54:59",923,523,435,86,2,515,8,1000,477,280,235
9,BRĂILA,"COLEGIUL NAŢIONAL „NICOLAE BĂLCESCU”",63,"MUNICIPIUL BRĂILA",42682,1,PART,PRCNCT,PRSD,PRSD_SV,"2025-05-18 21:28:05",1213,653,588,65,0,650,3,1400,747,299,351
9,BRĂILA,"LICEUL DE ARTĂ „HARICLEA DARCLEE”",64,"MUNICIPIUL BRĂILA",42682,1,PART,PRCNCT,PRSD,PRSD_SV,"2025-05-18 22:00:00",1299,679,634,45,0,671,8,1400,721,312,359
9,BRĂILA,"LICEUL DE ARTĂ „HARICLEA DARCLEE”",65,"MUNICIPIUL BRĂILA",42682,1,PART,PRCNCT,PRSD,PRSD_SV,"2025-05-18 21:29:32",1248,721,646,53,22,718,3,1400,679,326,392
9,BRĂILA,"LICEUL TEHNOLOGIC „GRIGORE MOISIL”",66,"MUNICIPIUL BRĂILA",42682,1,PART,PRCNCT,PRSD,PRSD_SV,"2025-05-18 21:27:33",1382,813,673,36,104,800,13,1400,587,508,292
9,BRĂILA,"ȘCOALA GIMNAZIALĂ NR. 17 „ECATERINA TEODOROIU”",67,"MUNICIPIUL BRĂILA",42682,1,PART,PRCNCT,PRSD,PRSD_SV,"2025-05-18 21:46:26",1188,716,583,28,105,702,14,1200,484,321,381
9,BRĂILA,"ȘCOALA GIMNAZIALĂ NR. 17 „ECATERINA TEODOROIU”",68,"MUNICIPIUL BRĂILA",42682,1,PART,PRCNCT,PRSD,PRSD_SV,"2025-05-18 21:38:43",1369,836,716,26,94,823,13,1400,564,377,446
9,BRĂILA,"COLEGIUL TEHNIC „PANAIT ISTRATI”",69,"MUNICIPIUL BRĂILA",42682,1,PART,PRCNCT,PRSD,PRSD_SV,"2025-05-18 21:35:04",1228,694,650,44,0,685,9,1400,706,272,413
9,BRĂILA,"COLEGIUL TEHNIC „PANAIT ISTRATI”",70,"MUNICIPIUL BRĂILA",42682,1,PART,PRCNCT,PRSD,PRSD_SV,"2025-05-18 21:56:42",765,411,396,15,0,405,6,800,389,176,229
9,BRĂILA,"COLEGIUL TEHNIC „PANAIT ISTRATI”",71,"MUNICIPIUL BRĂILA",42682,1,PART,PRCNCT,PRSD,PRSD_SV,"2025-05-18 21:44:48",1175,622,595,27,0,609,13,1200,578,312,297
9,BRĂILA,"ŞCOALA GIMNAZIALĂ NR. 18 „MIHU DRAGOMIR”",72,"MUNICIPIUL BRĂILA",42682,1,PART,PRCNCT,PRSD,PRSD_SV,"2025-05-18 21:59:41",959,618,459,58,101,610,8,1000,382,348,262
9,BRĂILA,"ȘCOALA GIMNAZIALĂ NR. 18 „MIHU DRAGOMIR”",73,"MUNICIPIUL BRĂILA",42682,2,PART,PRCNCT,PRSD,PRSD_SV,"2025-05-18 23:00:48",1119,584,555,28,1,572,12,1200,616,281,291
9,BRĂILA,"GRĂDINIŢA NR. 21 „PESCĂRUȘUL”",74,"MUNICIPIUL BRĂILA",42682,1,PART,PRCNCT,PRSD,PRSD_SV,"2025-05-18 21:36:57",1189,639,604,35,0,629,10,1200,561,296,333
9,BRĂILA,"GRĂDINIŢA NR. 21 „PESCĂRUȘUL”",75,"MUNICIPIUL BRĂILA",42682,1,PART,PRCNCT,PRSD,PRSD_SV,"2025-05-18 21:32:47",914,475,435,40,0,470,5,1000,525,265,205
9,BRĂILA,"GRĂDINIŢA NR. 21 „PESCĂRUȘUL”",76,"MUNICIPIUL BRĂILA",42682,1,PART,PRCNCT,PRSD,PRSD_SV,"2025-05-18 21:50:04",1224,564,546,18,0,554,10,1400,836,306,248
9,BRĂILA,"ŞCOALA GIMNAZIALĂ NR. 6 „CONSTANTIN SANDU ALDEA”",77,"MUNICIPIUL BRĂILA",42682,1,PART,PRCNCT,PRSD,PRSD_SV,"2025-05-18 21:33:27",1204,682,647,34,1,674,8,1400,718,267,407
9,BRĂILA,"ŞCOALA GIMNAZIALĂ NR. 6 „CONSTANTIN SANDU ALDEA”",78,"MUNICIPIUL BRĂILA",42682,1,PART,PRCNCT,PRSD,PRSD_SV,"2025-05-18 21:32:01",1120,627,585,42,0,621,6,1200,573,281,340
9,BRĂILA,"ŞCOALA GIMNAZIALĂ NR. 6 „CONSTANTIN SANDU ALDEA”",79,"MUNICIPIUL BRĂILA",42682,1,PART,PRCNCT,PRSD,PRSD_SV,"2025-05-18 21:28:24",1090,635,590,44,1,631,4,1200,565,278,353
9,BRĂILA,"ŞCOALA GIMNAZIALĂ NR. 6 „CONSTANTIN SANDU ALDEA”",80,"MUNICIPIUL BRĂILA",42682,1,PART,PRCNCT,PRSD,PRSD_SV,"2025-05-18 21:31:23",1105,615,601,13,1,602,13,1200,585,207,395
9,BRĂILA,"LICEUL TEHNOLOGIC „ANGHEL SALIGNY”",81,"MUNICIPIUL BRĂILA",42682,1,PART,PRCNCT,PRSD,PRSD_SV,"2025-05-18 21:45:05",1089,657,604,52,1,642,15,1200,543,242,400
9,BRĂILA,"LICEUL TEHNOLOGIC „ANGHEL SALIGNY”",82,"MUNICIPIUL BRĂILA",42682,1,PART,PRCNCT,PRSD,PRSD_SV,"2025-05-18 22:05:42",960,544,504,40,0,537,7,1000,456,251,286
9,BRĂILA,"LICEUL TEHNOLOGIC „ANGHEL SALIGNY”",83,"MUNICIPIUL BRĂILA",42682,1,PART,PRCNCT,PRSD,PRSD_SV,"2025-05-18 21:22:25",1136,659,631,27,1,651,8,1200,541,281,370
9,BRĂILA,"COLEGIUL ECONOMIC „ION GHICA”",84,"MUNICIPIUL BRĂILA",42682,1,PART,PRCNCT,PRSD,PRSD_SV,"2025-05-18 21:29:05",1054,592,554,37,1,580,12,1200,608,191,389
9,BRĂILA,"COLEGIUL ECONOMIC „ION GHICA”",85,"MUNICIPIUL BRĂILA",42682,1,PART,PRCNCT,PRSD,PRSD_SV,"2025-05-18 21:59:47",1274,713,679,34,0,699,14,1400,687,363,336
9,BRĂILA,"CASA CORPULUI DIDACTIC",86,"MUNICIPIUL BRĂILA",42682,1,PART,PRCNCT,PRSD,PRSD_SV,"2025-05-18 21:54:07",1081,598,569,28,1,585,13,1200,602,254,331
9,BRĂILA,"ŞCOALA GIMNAZIALĂ NR. 32 „DIMITRIE CANTEMIR”",87,"MUNICIPIUL BRĂILA",42682,1,PART,PRCNCT,PRSD,PRSD_SV,"2025-05-18 22:12:14",1045,526,485,39,2,518,8,1200,674,261,257
9,BRĂILA,"ŞCOALA GIMNAZIALĂ NR. 32 „DIMITRIE CANTEMIR”",88,"MUNICIPIUL BRĂILA",42682,1,PART,PRCNCT,PRSD,PRSD_SV,"2025-05-18 21:58:25",1277,653,630,23,0,644,9,1400,747,293,351
9,BRĂILA,"ȘCOALA GIMNAZIALĂ NR. 32 „DIMITRIE CANTEMIR”",89,"MUNICIPIUL BRĂILA",42682,1,PART,PRCNCT,PRSD,PRSD_SV,"2025-05-18 21:46:46",770,382,369,13,0,373,9,800,418,193,180
9,BRĂILA,"ȘCOALA GIMNAZIALĂ NR. 32 „DIMITRIE CANTEMIR”",90,"MUNICIPIUL BRĂILA",42682,1,PART,PRCNCT,PRSD,PRSD_SV,"2025-05-18 22:26:15",1124,549,534,15,0,539,10,1200,651,242,297
9,BRĂILA,"ȘCOALA GIMNAZIALĂ NR. 32 „DIMITRIE CANTEMIR”",91,"MUNICIPIUL BRĂILA",42682,2,PART,PRCNCT,PRSD,PRSD_SV,"2025-05-18 23:59:20",1233,658,638,20,0,650,8,1400,742,259,391
9,BRĂILA,"GRĂDINIŢA NR. 36 „FURNICUŢA”",92,"MUNICIPIUL BRĂILA",42682,1,PART,PRCNCT,PRSD,PRSD_SV,"2025-05-18 21:41:56",1219,654,625,29,0,641,13,1400,746,275,366
9,BRĂILA,"COLEGIUL NAȚIONAL PEDAGOGIC „DUMITRU PANAITESCU PERPESSICIUS”",93,"MUNICIPIUL BRĂILA",42682,1,PART,PRCNCT,PRSD,PRSD_SV,"2025-05-18 21:37:54",1086,580,568,12,0,571,9,1200,620,211,360
9,BRĂILA,"COLEGIUL NAȚIONAL PEDAGOGIC „DUMITRU PANAITESCU PERPESSICIUS”",94,"MUNICIPIUL BRĂILA",42682,1,PART,PRCNCT,PRSD,PRSD_SV,"2025-05-18 21:33:54",1068,541,517,22,2,533,8,1200,659,238,295
9,BRĂILA,"COLEGIUL NAȚIONAL PEDAGOGIC „DUMITRU PANAITESCU PERPESSICIUS”",95,"MUNICIPIUL BRĂILA",42682,1,PART,PRCNCT,PRSD,PRSD_SV,"2025-05-18 21:22:37",968,542,515,26,1,536,6,1000,458,238,298
9,BRĂILA,"COLEGIUL NAȚIONAL PEDAGOGIC „DUMITRU PANAITESCU PERPESSICIUS”",96,"MUNICIPIUL BRĂILA",42682,1,PART,PRCNCT,PRSD,PRSD_SV,"2025-05-18 21:52:37",1310,730,700,30,0,719,11,1400,670,244,475
9,BRĂILA,"COLEGIUL NAȚIONAL PEDAGOGIC „DUMITRU PANAITESCU PERPESSICIUS”",97,"MUNICIPIUL BRĂILA",42682,1,PART,PRCNCT,PRSD,PRSD_SV,"2025-05-18 22:18:36",1287,717,679,38,0,711,6,1400,683,270,441
9,BRĂILA,"GRĂDINIŢA NR. 37 „DUMBRAVA MINUNATĂ”",98,"MUNICIPIUL BRĂILA",42682,1,PART,PRCNCT,PRSD,PRSD_SV,"2025-05-18 21:48:35",1026,634,521,45,68,626,8,1200,566,268,358
9,BRĂILA,"GRĂDINIŢA NR. 37 „DUMBRAVA MINUNATĂ”",99,"MUNICIPIUL BRĂILA",42682,1,PART,PRCNCT,PRSD,PRSD_SV,"2025-05-18 21:32:18",1515,837,792,45,0,825,12,1600,763,311,514
9,BRĂILA,"GRĂDINIŢA NR. 37 „DUMBRAVA MINUNATĂ”",100,"MUNICIPIUL BRĂILA",42682,1,PART,PRCNCT,PRSD,PRSD_SV,"2025-05-18 22:19:49",1096,685,595,24,66,675,10,1200,515,248,427
9,BRĂILA,"ȘCOALA GIMNAZIALĂ NR. 23 „MIHAI EMINESCU”",101,"MUNICIPIUL BRĂILA",42682,1,PART,PRCNCT,PRSD,PRSD_SV,"2025-05-18 21:52:40",870,419,382,36,1,412,7,1000,581,228,184
9,BRĂILA,"ȘCOALA GIMNAZIALĂ NR. 23 „MIHAI EMINESCU”",102,"MUNICIPIUL BRĂILA",42682,1,PART,PRCNCT,PRSD,PRSD_SV,"2025-05-18 22:11:01",1051,522,453,67,2,513,9,1200,678,294,219
9,BRĂILA,"ȘCOALA GIMNAZIALĂ NR. 23 „MIHAI EMINESCU”",103,"MUNICIPIUL BRĂILA",42682,1,PART,PRCNCT,PRSD,PRSD_SV,"2025-05-18 21:33:55",1045,566,544,22,0,555,11,1200,634,247,308
9,BRĂILA,"ŞCOALA GIMNAZIALĂ NR. 9 „ANTON PANN”",104,"MUNICIPIUL BRĂILA",42682,1,PART,PRCNCT,PRSD,PRSD_SV,"2025-05-18 21:40:46",1188,529,488,41,0,521,8,1200,671,370,151
9,BRĂILA,"ŞCOALA GIMNAZIALĂ NR. 9 „ANTON PANN”",105,"MUNICIPIUL BRĂILA",42682,1,PART,PRCNCT,PRSD,PRSD_SV,"2025-05-18 21:40:14",1198,513,498,15,0,499,14,1200,687,346,153
9,BRĂILA,"ŞCOALA GIMNAZIALĂ NR. 9 „ANTON PANN”",106,"MUNICIPIUL BRĂILA",42682,1,PART,PRCNCT,PRSD,PRSD_SV,"2025-05-18 21:55:16",1287,615,604,11,0,606,9,1400,785,436,170
9,BRĂILA,"ŞCOALA GIMNAZIALĂ NR. 9 „ANTON PANN”",107,"MUNICIPIUL BRĂILA",42682,1,PART,PRCNCT,PRSD,PRSD_SV,"2025-05-18 22:06:15",1308,711,692,19,0,701,10,1400,689,394,307
9,BRĂILA,"ŞCOALA GIMNAZIALĂ NR. 13 „NEDELCU CHERCEA”",108,"MUNICIPIUL BRĂILA",42682,2,PART,PRCNCT,PRSD,PRSD_SV,"2025-05-18 23:17:16",1198,647,610,30,7,640,7,1400,753,360,280
9,BRĂILA,"ŞCOALA GIMNAZIALĂ NR. 13 „NEDELCU CHERCEA”",109,"MUNICIPIUL BRĂILA",42682,1,PART,PRCNCT,PRSD,PRSD_SV,"2025-05-18 21:59:50",1192,589,564,25,0,582,7,1200,611,306,276
9,BRĂILA,"ȘCOALA GIMNAZIALĂ NR. 22 „RADU TUDORAN”",110,"MUNICIPIUL BRĂILA",42682,1,PART,PRCNCT,PRSD,PRSD_SV,"2025-05-18 21:27:13",1232,636,582,54,0,628,8,1400,764,356,272
9,BRĂILA,"ȘCOALA GIMNAZIALĂ NR. 22 „RADU TUDORAN”",111,"MUNICIPIUL BRĂILA",42682,1,PART,PRCNCT,PRSD,PRSD_SV,"2025-05-18 21:32:55",1329,650,634,16,0,643,7,1400,750,396,247
9,BRĂILA,"ȘCOALA GIMNAZIALĂ NR. 22 „RADU TUDORAN”",112,"MUNICIPIUL BRĂILA",42682,1,PART,PRCNCT,PRSD,PRSD_SV,"2025-05-18 21:23:35",1140,600,573,27,0,592,8,1200,600,336,256
9,BRĂILA,"ȘCOALA GIMNAZIALĂ NR. 22 „RADU TUDORAN”",113,"MUNICIPIUL BRĂILA",42682,1,PART,PRCNCT,PRSD,PRSD_SV,"2025-05-18 21:35:58",1090,577,553,24,0,564,13,1200,623,315,249
9,BRĂILA,"ȘCOALA GIMNAZIALĂ NR. 22 „RADU TUDORAN”",114,"MUNICIPIUL BRĂILA",42682,1,PART,PRCNCT,PRSD,PRSD_SV,"2025-05-18 21:22:04",1045,521,503,18,0,518,3,1100,579,271,247
9,BRĂILA,"ȘCOALA GIMNAZIALĂ „RADU TUDORAN”",115,"MUNICIPIUL BRĂILA",42682,1,PART,PRCNCT,PRSD,PRSD_SV,"2025-05-18 21:37:41",1336,632,614,18,0,626,6,1400,768,377,249
9,BRĂILA,"ȘCOALA GIMNAZIALĂ NR. 24 „GHEORGHE NAUM”",116,"MUNICIPIUL BRĂILA",42682,1,PART,PRCNCT,PRSD,PRSD_SV,"2025-05-18 21:38:08",1299,641,608,31,2,638,3,1400,759,385,253
9,BRĂILA,"ȘCOALA GIMNAZIALĂ NR. 24 „GHEORGHE NAUM”",117,"MUNICIPIUL BRĂILA",42682,1,PART,PRCNCT,PRSD,PRSD_SV,"2025-05-18 21:37:15",1394,712,680,32,0,700,12,1600,888,418,282
9,BRĂILA,"ȘCOALA GIMNAZIALĂ NR. 24 „GHEORGHE NAUM”",118,"MUNICIPIUL BRĂILA",42682,1,PART,PRCNCT,PRSD,PRSD_SV,"2025-05-18 21:42:34",1233,650,633,17,0,640,10,1400,750,384,256
9,BRĂILA,"ȘCOALA GIMNAZIALĂ NR. 24 „GHEORGHE NAUM”",119,"MUNICIPIUL BRĂILA",42682,2,PART,PRCNCT,PRSD,PRSD_SV,"2025-05-18 22:55:22",1411,647,626,15,6,635,12,1600,953,422,213
9,BRĂILA,"ȘCOALA GIMNAZIALĂ „GEORGE COȘBUC”",120,"MUNICIPIUL BRĂILA",42682,1,PART,PRCNCT,PRSD,PRSD_SV,"2025-05-18 21:24:41",1077,542,526,15,1,538,4,1200,658,242,296
9,BRĂILA,"ȘCOALA GIMNAZIALĂ „GEORGE COȘBUC”",121,"MUNICIPIUL BRĂILA",42682,1,PART,PRCNCT,PRSD,PRSD_SV,"2025-05-18 21:37:46",1112,566,551,15,0,551,15,1200,634,251,300
9,BRĂILA,"ŞCOALA GIMNAZIALĂ „GEORGE COŞBUC”",122,"MUNICIPIUL BRĂILA",42682,1,PART,PRCNCT,PRSD,PRSD_SV,"2025-05-18 21:26:55",1236,614,588,25,1,609,5,1400,786,271,338
9,BRĂILA,"ŞCOALA GIMNAZIALĂ „GEORGE COŞBUC”",123,"MUNICIPIUL BRĂILA",42682,1,PART,PRCNCT,PRSD,PRSD_SV,"2025-05-18 21:29:57",1048,574,533,41,0,563,11,1200,626,274,289
9,BRĂILA,"ŞCOALA GIMNAZIALĂ „GEORGE COŞBUC”",124,"MUNICIPIUL BRĂILA",42682,1,PART,PRCNCT,PRSD,PRSD_SV,"2025-05-18 21:31:15",1195,641,625,16,0,632,9,1400,759,310,322
9,BRĂILA,"ȘCOALA GIMNAZIALĂ „ALEXANDR SERGHEEVICI PUȘKIN”",125,"MUNICIPIUL BRĂILA",42682,1,PART,PRCNCT,PRSD,PRSD_SV,"2025-05-18 21:21:17",1063,491,471,20,0,485,6,1200,709,228,257
9,BRĂILA,"ȘCOALA GIMNAZIALĂ „ALEXANDR SERGHEEVICI PUȘKIN”",126,"MUNICIPIUL BRĂILA",42682,1,PART,PRCNCT,PRSD,PRSD_SV,"2025-05-18 21:26:50",1185,580,556,24,0,577,3,1200,620,283,294
9,BRĂILA,"ȘCOALA GIMNAZIALĂ „ALEXANDR SERGHEEVICI PUȘKIN”",127,"MUNICIPIUL BRĂILA",42682,1,PART,PRCNCT,PRSD,PRSD_SV,"2025-05-18 21:31:38",1171,532,508,24,0,521,11,1200,668,345,176
9,BRĂILA,"ȘCOALA GIMNAZIALĂ „ALEXANDR SERGHEEVICI PUȘKIN”",128,"MUNICIPIUL BRĂILA",42682,1,PART,PRCNCT,PRSD,PRSD_SV,"2025-05-18 21:31:47",1220,577,555,22,0,569,8,1300,723,346,223
9,BRĂILA,"ȘCOALA GIMNAZIALĂ NR. 19 „MIHAIL KOGĂLNICEANU”",129,"MUNICIPIUL BRĂILA",42682,1,PART,PRCNCT,PRSD,PRSD_SV,"2025-05-18 21:24:39",1276,683,654,29,0,674,9,1400,717,367,307
9,BRĂILA,"ȘCOALA GIMNAZIALĂ NR. 19 „MIHAIL KOGĂLNICEANU”",130,"MUNICIPIUL BRĂILA",42682,1,PART,PRCNCT,PRSD,PRSD_SV,"2025-05-18 21:33:05",1157,612,602,10,0,610,2,1200,588,366,244
9,BRĂILA,"ȘCOALA GIMNAZIALĂ NR. 19 „MIHAIL KOGĂLNICEANU”",131,"MUNICIPIUL BRĂILA",42682,1,PART,PRCNCT,PRSD,PRSD_SV,"2025-05-18 21:25:05",1257,642,614,27,1,641,1,1400,758,355,286
9,BRĂILA,"ȘCOALA GIMNAZIALĂ NR. 19 „MIHAIL KOGĂLNICEANU”",132,"MUNICIPIUL BRĂILA",42682,1,PART,PRCNCT,PRSD,PRSD_SV,"2025-05-18 21:47:50",1751,947,912,35,0,937,10,1800,853,568,369
9,BRĂILA,"LICEUL TEHNOLOGIC „CONSTANTIN BRÂNCOVEANU”",133,"MUNICIPIUL BRĂILA",42682,2,PART,PRCNCT,PRSD,PRSD_SV,"2025-05-18 22:37:59",963,511,482,29,0,506,5,1000,489,232,274
9,BRĂILA,"LICEUL TEHNOLOGIC „CONSTANTIN BRÂNCOVEANU”",134,"MUNICIPIUL BRĂILA",42682,1,PART,PRCNCT,PRSD,PRSD_SV,"2025-05-18 21:47:56",1474,656,616,40,0,648,8,1600,944,355,293
9,BRĂILA,"LICEUL TEHNOLOGIC „CONSTANTIN BRÂNCOVEANU”",135,"MUNICIPIUL BRĂILA",42682,1,PART,PRCNCT,PRSD,PRSD_SV,"2025-05-18 22:06:25",1267,663,643,20,0,656,7,1400,737,317,339
9,BRĂILA,"LICEUL TEHNOLOGIC „CONSTANTIN BRÂNCOVEANU”",136,"MUNICIPIUL BRĂILA",42682,1,PART,PRCNCT,PRSD,PRSD_SV,"2025-05-18 21:33:40",1068,556,536,20,0,551,5,1100,544,252,299
9,BRĂILA,"LICEUL TEHNOLOGIC „CONSTANTIN BRÂNCOVEANU”",137,"MUNICIPIUL BRĂILA",42682,1,PART,PRCNCT,PRSD,PRSD_SV,"2025-05-18 21:18:49",1060,462,447,15,0,455,7,1100,638,249,206
9,BRĂILA,"ȘCOALA GIMNAZIALĂ NR. 33 „SFÂNTUL ANDREI”",138,"MUNICIPIUL BRĂILA",42682,1,PART,PRCNCT,PRSD,PRSD_SV,"2025-05-18 21:23:30",1008,516,488,28,0,508,8,1100,584,281,227
9,BRĂILA,"ȘCOALA GIMNAZIALĂ NR. 33 „SFÂNTUL ANDREI”",139,"MUNICIPIUL BRĂILA",42682,1,PART,PRCNCT,PRSD,PRSD_SV,"2025-05-18 21:34:09",1374,711,688,22,1,704,7,1400,689,405,299
9,BRĂILA,"ȘCOALA GIMNAZIALĂ NR. 33 „SFÂNTUL ANDREI”",140,"MUNICIPIUL BRĂILA",42682,1,PART,PRCNCT,PRSD,PRSD_SV,"2025-05-18 21:28:57",982,496,474,22,0,488,8,1000,504,263,225
9,BRĂILA,"CASA DE CULTURĂ FĂUREI, SALA MICĂ",141,"ORAŞ FĂUREI",42753,1,PART,PRCNCT,PRSD,PRSD_SV,"2025-05-18 22:20:12",1335,738,643,94,1,725,13,1402,664,395,330
9,BRĂILA,"ŞCOALA GIMNAZIALĂ CU CLASELE I-IV FĂUREI, SALA NR.2",142,"ORAŞ FĂUREI",42753,1,PART,PRCNCT,PRSD,PRSD_SV,"2025-05-18 22:46:46",1207,675,596,70,9,667,8,1399,724,322,345
9,BRĂILA,"FOSTA ŞCOALA GENERALĂ NR.2 FĂUREI, SALA NR.1",143,"ORAŞ FĂUREI",42753,1,PART,PRCNCT,PRSD,PRSD_SV,"2025-05-18 21:59:06",512,282,245,37,0,277,5,600,318,149,128
9,BRĂILA,"ȘCOALA GIMNAZIALĂ IANCA",144,"ORAŞ IANCA",43331,1,PART,PRCNCT,PRSD,PRSD_SV,"2025-05-18 21:21:42",967,504,455,49,0,496,8,1000,496,299,197
9,BRĂILA,"ȘCOALA GIMNAZIALĂ IANCA",145,"ORAŞ IANCA",43331,1,PART,PRCNCT,PRSD,PRSD_SV,"2025-05-18 21:22:40",1088,513,482,31,0,509,4,1100,587,297,212
9,BRĂILA,"CASA DE CULTURĂ ”ION THEODORESCU SION”",146,"ORAŞ IANCA",43331,1,PART,PRCNCT,PRSD,PRSD_SV,"2025-05-18 21:28:44",1123,577,484,93,0,573,4,1200,623,329,244
9,BRĂILA,"LICEUL TEORETIC ”CONSTANTIN ANGELESCU”",147,"ORAŞ IANCA",43331,1,PART,PRCNCT,PRSD,PRSD_SV,"2025-05-18 21:38:07",1054,512,457,55,0,503,9,1100,588,328,175
9,BRĂILA,"LICEUL TEORETIC ”CONSTANTIN ANGELESCU”",148,"ORAŞ IANCA",43331,1,PART,PRCNCT,PRSD,PRSD_SV,"2025-05-18 21:34:37",1028,500,430,57,13,495,5,1100,600,332,163
9,BRĂILA,"ȘCOALA PRIMARĂ BERLEȘTI",149,"ORAŞ IANCA",43331,1,PART,PRCNCT,PRSD,PRSD_SV,"2025-05-18 21:07:00",235,132,107,25,0,132,0,300,168,90,42
9,BRĂILA,"ȘCOALA PRIMARĂ OPRIȘENEȘTI",150,"ORAŞ IANCA",43331,1,PART,PRCNCT,PRSD,PRSD_SV,"2025-05-18 21:24:27",577,332,300,32,0,328,4,600,268,221,107
9,BRĂILA,"ȘCOALA GIMNAZIALĂ PERIȘORU",151,"ORAŞ IANCA",43331,2,PART,PRCNCT,PRSD,PRSD_SV,"2025-05-18 23:38:54",830,363,333,30,0,361,2,1000,637,261,100
9,BRĂILA,"ȘCOALA GIMNAZIALĂ PLOPU",152,"ORAŞ IANCA",43331,1,PART,PRCNCT,PRSD,PRSD_SV,"2025-05-18 21:33:43",1222,632,573,59,0,623,9,1400,768,432,191
9,BRĂILA,"ȘCOALA PRIMARĂ TÎRLELE FILIU",153,"ORAŞ IANCA",43331,1,PART,PRCNCT,PRSD,PRSD_SV,"2025-05-18 21:21:34",392,220,176,44,0,219,1,400,180,139,80
9,BRĂILA,"ȘCOALA GIMNAZIALĂ ”SPIRU HARET” ÎNSURĂȚEI - LOCAȚIA 1",154,"ORAŞ ÎNSURĂŢEI",43411,2,PART,PRCNCT,PRSD,PRSD_SV,"2025-05-19 00:04:29",1035,406,384,22,0,401,5,1100,694,298,103
9,BRĂILA,"ȘCOALA GIMNAZIALĂ ”SPIRU HARET” ÎNSURĂȚEI - LOCAȚIA 1",155,"ORAŞ ÎNSURĂŢEI",43411,1,PART,PRCNCT,PRSD,PRSD_SV,"2025-05-18 21:31:39",1049,493,443,50,0,484,9,1100,607,348,136
9,BRĂILA,"LICEUL TEHNOLOGIC ” NICOLAE TITULESCU ” ÎNSURĂȚEI - ȘCOALA ANEXĂ",156,"ORAŞ ÎNSURĂŢEI",43411,1,PART,PRCNCT,PRSD,PRSD_SV,"2025-05-18 21:52:55",972,467,411,56,0,460,7,998,531,313,147
9,BRĂILA,"LICEUL TEHNOLOGIC ” NICOLAE TITULESCU ” ÎNSURĂȚEI - ȘCOALA ANEXĂ",157,"ORAŞ ÎNSURĂŢEI",43411,1,PART,PRCNCT,PRSD,PRSD_SV,"2025-05-18 21:38:07",851,366,332,34,0,356,10,1000,634,246,110
9,BRĂILA,"ȘCOALA GIMNAZIALĂ ” SPIRU HARET ” ÎNSURĂȚEI - LOCAȚIA 2",158,"ORAŞ ÎNSURĂŢEI",43411,1,PART,PRCNCT,PRSD,PRSD_SV,"2025-05-18 21:32:14",1228,543,509,34,0,540,3,1400,857,393,147
9,BRĂILA,"GRADINITA CU PROGRAM NORMAL",159,"ORAŞ ÎNSURĂŢEI",43411,1,PART,PRCNCT,PRSD,PRSD_SV,"2025-05-18 21:19:05",349,154,131,23,0,153,1,400,246,94,59
9,BRĂILA,"ŞCOALA CU CLASELE I - VIII BĂRĂGANUL",160,BĂRĂGANUL,42824,1,PART,PRCNCT,PRSD,PRSD_SV,"2025-05-18 21:55:01",1142,534,457,77,0,527,7,1200,666,340,187
9,BRĂILA,"SCOALA CU CLS. I - VIII BĂRĂGANUL - SALA DE CLASĂ NR. 1",161,BĂRĂGANUL,42824,1,PART,PRCNCT,PRSD,PRSD_SV,"2025-05-18 22:08:01",1203,614,510,104,0,610,4,1400,786,360,250
9,BRĂILA,"CĂMINUL CULTURAL BERTEȘTII DE JOS",162,"BERTEŞTII DE JOS",42842,1,PART,PRCNCT,PRSD,PRSD_SV,"2025-05-18 21:37:11",665,281,248,33,0,281,0,800,519,219,62
9,BRĂILA,"CĂMINUL CULTURAL BERTEȘTII DE SUS",163,"BERTEŞTII DE JOS",42842,1,PART,PRCNCT,PRSD,PRSD_SV,"2025-05-18 21:30:53",251,144,115,29,0,142,2,298,154,95,47
9,BRĂILA,"CĂMIN CULTURAL",164,"BERTEŞTII DE JOS",42842,1,PART,PRCNCT,PRSD,PRSD_SV,"2025-05-18 21:33:47",233,163,127,36,0,163,0,300,137,125,38
9,BRĂILA,"CĂMINUL CULTURAL SPIRU HARET",165,"BERTEŞTII DE JOS",42842,1,PART,PRCNCT,PRSD,PRSD_SV,"2025-05-18 22:23:08",1176,487,430,57,0,484,3,1200,713,360,124
9,BRĂILA,"CLĂDIRE SALA SPORT BORDEI VERDE",166,"BORDEI VERDE",42913,1,PART,PRCNCT,PRSD,PRSD_SV,"2025-05-18 21:27:10",1064,546,465,79,2,540,6,1100,554,308,232
9,BRĂILA,"CĂMIN CULTURAL CONSTANTIN GABRIELESCU",167,"BORDEI VERDE",42913,2,PART,PRCNCT,PRSD,PRSD_SV,"2025-05-18 23:56:01",493,270,228,42,0,267,3,600,330,181,86
9,BRĂILA,"CĂMINUL CULTURAL LIȘCOTEANCA",168,"BORDEI VERDE",42913,1,PART,PRCNCT,PRSD,PRSD_SV,"2025-05-18 21:36:55",421,213,179,34,0,209,4,500,287,144,65
9,BRĂILA,"CORP ANEXA PARTER",169,CAZASU,44560,1,PART,PRCNCT,PRSD,PRSD_SV,"2025-05-18 22:13:22",1531,921,824,97,0,913,8,1600,679,497,416
9,BRĂILA,"ȘCOALA GIMNAZIALĂ CAZASU",170,CAZASU,44560,1,PART,PRCNCT,PRSD,PRSD_SV,"2025-05-18 21:57:03",1965,1160,1029,130,1,1143,17,2000,840,658,485
9,BRĂILA,"CĂMINUL CULTURAL II",171,CHISCANI,42708,1,PART,PRCNCT,PRSD,PRSD_SV,"2025-05-18 22:05:43",1722,902,819,83,0,897,5,1799,897,502,395
9,BRĂILA,"SCOALA GIMNAZIALA- CHISCANI - CARTIER",172,CHISCANI,42708,1,PART,PRCNCT,PRSD,PRSD_SV,"2025-05-18 22:02:42",1638,747,674,73,0,727,20,1800,1053,463,264
9,BRĂILA,"CĂMINUL CULTURAL SAT LACU SĂRAT",173,CHISCANI,42708,1,PART,PRCNCT,PRSD,PRSD_SV,"2025-05-18 21:45:56",1074,652,576,76,0,638,14,1200,548,356,282
9,BRĂILA,"CENTRU DE INFORMARE",174,CHISCANI,42708,1,PART,PRCNCT,PRSD,PRSD_SV,"2025-05-18 22:23:36",1010,679,465,213,1,671,8,1200,521,333,338
9,BRĂILA,"ȘCOALA CU CLASELE I-VIII NR.1",175,CIOCILE,42968,1,PART,PRCNCT,PRSD,PRSD_SV,"2025-05-18 21:34:57",679,278,235,43,0,275,3,800,522,151,124
9,BRĂILA,"ȘCOALA CU CLASELE I-VIII NR.2 „ALEXANDRU TURTOI”",176,CIOCILE,42968,1,PART,PRCNCT,PRSD,PRSD_SV,"2025-05-18 21:51:57",720,318,280,37,1,318,0,800,482,144,174
9,BRĂILA,"ȘCOALA PRIMARA PRI CHICHINEȚU",177,CIOCILE,42968,1,PART,PRCNCT,PRSD,PRSD_SV,"2025-05-18 21:34:54",389,162,124,38,0,159,3,400,238,73,86
9,BRĂILA,"ȘCOALA CU CLASELE I-VIII CIREȘU",178,CIREŞU,43019,1,PART,PRCNCT,PRSD,PRSD_SV,"2025-05-18 21:37:46",670,337,285,52,0,332,5,800,463,161,171
9,BRĂILA,"ȘCOALA CU CLASELE I-VIII BATOGU",179,CIREŞU,43019,1,PART,PRCNCT,PRSD,PRSD_SV,"2025-05-18 21:36:45",459,209,180,29,0,209,0,500,291,125,84
9,BRĂILA,"ȘCOALA CU CLASELE I-VIII SCĂRLĂTEȘTI",180,CIREŞU,43019,1,PART,PRCNCT,PRSD,PRSD_SV,"2025-05-18 21:32:42",601,314,280,34,0,313,1,800,486,148,165
9,BRĂILA,"ȘCOALA CU CLASELE I-VIII VULTURENI",181,CIREŞU,43019,1,PART,PRCNCT,PRSD,PRSD_SV,"2025-05-18 21:38:15",412,214,184,30,0,210,4,500,286,116,94
9,BRĂILA,"ȘCOALA GIMNAZIALĂ DUDEȘTI",182,DUDEŞTI,43073,1,PART,PRCNCT,PRSD,PRSD_SV,"2025-05-18 21:50:04",1281,555,516,39,0,547,8,1400,845,351,196
9,BRĂILA,"CĂMINUL CULTURAL TĂTARU",183,DUDEŞTI,43073,1,PART,PRCNCT,PRSD,PRSD_SV,"2025-05-18 21:57:54",1035,458,418,40,0,453,5,1200,742,293,160
9,BRĂILA,"ŞCOALA CU CLASELE I-IV TATARU",184,DUDEŞTI,43073,1,PART,PRCNCT,PRSD,PRSD_SV,"2025-05-18 21:28:21",414,210,161,49,0,205,5,500,290,145,60
9,BRĂILA,"ȘCOALA CU CLASELE I-VIII FRECĂȚEI",185,FRECĂŢEI,43117,1,PART,PRCNCT,PRSD,PRSD_SV,"2025-05-18 21:26:14",281,270,124,146,0,264,6,400,130,190,74
9,BRĂILA,"ȘCOALA PRIMARĂ AGAUA",186,FRECĂŢEI,43117,1,PART,PRCNCT,PRSD,PRSD_SV,"2025-05-18 21:38:58",397,165,146,19,0,165,0,400,235,136,29
9,BRĂILA,"ȘCOALA CU CLASELE I-IV TITCOV",187,FRECĂŢEI,43117,1,PART,PRCNCT,PRSD,PRSD_SV,"2025-05-18 21:29:45",375,204,170,34,0,204,0,400,196,149,55
9,BRĂILA,"ȘCOALA GIMNAZIALA ”TOMA TAMPEANU” GALBENU",188,GALBENU,43180,1,PART,PRCNCT,PRSD,PRSD_SV,"2025-05-18 21:36:26",715,336,287,34,15,332,4,800,464,155,177
9,BRĂILA,"ȘCOALA GIMNAZIALĂ DROGU",189,GALBENU,43180,1,PART,PRCNCT,PRSD,PRSD_SV,"2025-05-18 21:31:43",636,321,264,45,12,319,2,800,479,152,167
9,BRĂILA,"ȘCOALA GIMNAZIALĂ PÂNTECANI",190,GALBENU,43180,1,PART,PRCNCT,PRSD,PRSD_SV,"2025-05-18 21:31:47",129,70,53,17,0,69,1,198,128,37,32
9,BRĂILA,"ȘCOALA GIMNAZIALĂ SĂTUC",191,GALBENU,43180,1,PART,PRCNCT,PRSD,PRSD_SV,"2025-05-18 21:24:45",567,279,237,42,0,278,1,600,321,183,95
9,BRĂILA,"ȘCOALA GIMNAZIALĂ ZAMFIREȘTI",192,GALBENU,43180,1,PART,PRCNCT,PRSD,PRSD_SV,"2025-05-18 21:38:10",282,162,134,28,0,160,2,300,138,84,76
9,BRĂILA,"ȘCOALA GIMNAZIALĂ CU CLASELE I-VIII",193,GEMENELE,43242,1,PART,PRCNCT,PRSD,PRSD_SV,"2025-05-18 21:49:08",1336,643,571,72,0,637,6,1400,757,430,207
9,BRĂILA,"CAMIN CULTURAL GRADISTEA",194,GRĂDIŞTEA,43279,1,PART,PRCNCT,PRSD,PRSD_SV,"2025-05-18 22:17:54",956,599,464,104,31,590,9,1000,401,245,345
9,BRĂILA,"CĂMIN CULTURAL SAT IBRIANU",195,GRĂDIŞTEA,43279,1,PART,PRCNCT,PRSD,PRSD_SV,"2025-05-18 21:49:39",478,303,243,46,14,300,3,500,197,122,178
9,BRĂILA,"CĂMIN CULTURAL SAT MARALOIU",196,GRĂDIŞTEA,43279,1,PART,PRCNCT,PRSD,PRSD_SV,"2025-05-18 21:38:12",205,137,108,29,0,137,0,300,163,75,62
9,BRĂILA,"CĂMIN CULTURAL",197,GROPENI,43313,1,PART,PRCNCT,PRSD,PRSD_SV,"2025-05-18 22:10:23",1391,764,695,69,0,757,7,1600,836,579,178
9,BRĂILA,"ȘCOALA GIMNAZIALĂ GROPENI",198,GROPENI,43313,1,PART,PRCNCT,PRSD,PRSD_SV,"2025-05-18 22:27:23",1253,654,594,59,1,641,13,1400,746,454,187
9,BRĂILA,"ŞCOALA GIMNAZIALĂ NR.2",199,JIRLĂU,43466,1,PART,PRCNCT,PRSD,PRSD_SV,"2025-05-18 22:21:20",1350,537,457,55,25,532,5,1400,863,339,193
9,BRĂILA,"CENTRU SOCIAL MULTIFUNCTIONAL",200,JIRLĂU,43466,1,PART,PRCNCT,PRSD,PRSD_SV,"2025-05-18 21:51:27",1049,526,411,104,11,522,4,1200,674,291,231
9,BRĂILA,"CĂMINUL CULTURAL MĂRAȘU",201,MĂRAŞU,43493,1,PART,PRCNCT,PRSD,PRSD_SV,"2025-05-18 21:35:30",706,314,274,40,0,309,5,800,486,243,66
9,BRĂILA,"ȘCOALA PRIMARA BĂNDOIU",202,MĂRAŞU,43493,1,PART,PRCNCT,PRSD,PRSD_SV,"2025-05-18 21:34:31",303,150,135,15,0,149,1,400,250,94,55
9,BRĂILA,"CĂMINUL CULTURAL MĂGURENI",203,MĂRAŞU,43493,1,PART,PRCNCT,PRSD,PRSD_SV,"2025-05-18 21:25:57",393,184,160,24,0,183,1,400,216,141,42
9,BRĂILA,"ȘCOALA PRIMARA PLOPI",204,MĂRAŞU,43493,2,PART,PRCNCT,PRSD,PRSD_SV,"2025-05-19 00:40:32",125,52,42,10,0,50,2,200,148,44,6
9,BRĂILA,"ȘCOALA GIMNAZIALĂ ȚĂCĂU",205,MĂRAŞU,43493,1,PART,PRCNCT,PRSD,PRSD_SV,"2025-05-18 22:08:46",485,231,211,20,0,227,4,500,269,158,69
9,BRĂILA,"ȘCOALA GENERALĂ CU CLASELE I-VIII MĂXINENI",206,MĂXINENI,43563,1,PART,PRCNCT,PRSD,PRSD_SV,"2025-05-18 21:45:37",1127,571,504,65,2,563,8,1200,629,342,221
9,BRĂILA,"CĂMINUL CULTURAL CORBU NOU",207,MĂXINENI,43563,1,PART,PRCNCT,PRSD,PRSD_SV,"2025-05-18 21:36:25",690,330,285,45,0,327,3,800,470,214,113
9,BRĂILA,"CĂMINUL CULTURAL CORBU VECHI",208,MĂXINENI,43563,1,PART,PRCNCT,PRSD,PRSD_SV,"2025-05-18 21:15:51",204,114,102,12,0,114,0,300,186,67,47
9,BRĂILA,"CAMIN CULTURAL LATINU",209,MĂXINENI,43563,1,PART,PRCNCT,PRSD,PRSD_SV,"2025-05-18 22:04:42",567,273,238,35,0,269,4,588,315,203,66
9,BRĂILA,"SCOALA GIMNAZIALA MIRCEA VODA, JUDEȚUL BRAILA",210,"MIRCEA VODĂ",43625,1,PART,PRCNCT,PRSD,PRSD_SV,"2025-05-18 21:42:46",873,435,355,79,1,425,10,1000,565,254,171
9,BRĂILA,"SCOALA GIMNAZIALA MIRCEA VODA, JUDETUL BRAILA",211,"MIRCEA VODĂ",43625,1,PART,PRCNCT,PRSD,PRSD_SV,"2025-05-18 21:39:41",965,440,389,50,1,436,4,1000,560,262,174
9,BRĂILA,"SCOALA GIMNAZIALA SAT DEDULESTI",212,"MIRCEA VODĂ",43625,1,PART,PRCNCT,PRSD,PRSD_SV,"2025-05-18 21:58:58",612,302,260,41,1,300,2,800,498,190,110
9,BRĂILA,"SCOALA VECHE",213,"MOVILA MIRESII",43652,1,PART,PRCNCT,PRSD,PRSD_SV,"2025-05-18 21:27:45",1051,450,408,42,0,441,9,1100,650,316,125
9,BRĂILA,"CAMIN CULTURAL M.MIRESII",214,"MOVILA MIRESII",43652,1,PART,PRCNCT,PRSD,PRSD_SV,"2025-05-18 21:41:19",1145,533,488,45,0,516,17,1200,667,356,160
9,BRĂILA,"SCOALA ESNA",215,"MOVILA MIRESII",43652,1,PART,PRCNCT,PRSD,PRSD_SV,"2025-05-18 21:30:27",252,131,108,23,0,126,5,300,169,99,27
9,BRĂILA,"SCOALA TEPES VODA",216,"MOVILA MIRESII",43652,1,PART,PRCNCT,PRSD,PRSD_SV,"2025-05-18 21:27:09",742,374,341,33,0,362,12,800,426,282,80
9,BRĂILA,"ȘCOALA GIMNAZIALĂ RACOVIȚA",217,RACOVIŢA,43698,1,PART,PRCNCT,PRSD,PRSD_SV,"2025-05-18 21:39:29",688,340,289,51,0,336,4,700,360,194,142
9,BRĂILA,"SALĂ FESTIVITĂȚI CORBENI ( FOST CAMIN CULTURAL SAT CORBENI)",218,RACOVIŢA,43698,1,PART,PRCNCT,PRSD,PRSD_SV,"2025-05-18 21:45:49",97,65,41,23,1,65,0,100,35,48,17
9,BRĂILA,"ȘCOALA GIMNAZIALĂ RÎMNICELU",219,RÂMNICELU,43732,1,PART,PRCNCT,PRSD,PRSD_SV,"2025-05-18 21:52:28",1056,467,392,75,0,464,3,1100,633,302,162
9,BRĂILA,"ȘCOALA PRIMARĂ CONSTANTINEȘTI",220,RÂMNICELU,43732,1,PART,PRCNCT,PRSD,PRSD_SV,"2025-05-18 21:35:15",259,138,104,34,0,136,2,300,162,86,50
9,BRĂILA,"ȘCOALA PRIMARĂ MIHAIL KOGĂLNICEANU",221,RÂMNICELU,43732,1,PART,PRCNCT,PRSD,PRSD_SV,"2025-05-18 21:27:24",189,97,77,20,0,97,0,200,103,72,25
9,BRĂILA,"ȘCOALA GIMNAZIALA ROMANU",222,ROMANU,43787,1,PART,PRCNCT,PRSD,PRSD_SV,"2025-05-18 21:53:00",1113,542,466,73,3,537,5,1200,658,337,200
9,BRĂILA,"SALON FESTIVITATI",223,ROMANU,43787,1,PART,PRCNCT,PRSD,PRSD_SV,"2025-05-18 21:25:59",330,167,138,29,0,167,0,400,233,125,42
9,BRĂILA,"CASA DE CULTURĂ ROȘIORI",224,ROŞIORI,43812,2,PART,PRCNCT,PRSD,PRSD_SV,"2025-05-19 00:49:59",1148,504,431,73,0,498,6,1200,696,296,202
9,BRĂILA,"ȘCOALA CU CLASELE I-VIII COLȚEA",225,ROŞIORI,43812,1,PART,PRCNCT,PRSD,PRSD_SV,"2025-05-18 21:58:06",775,348,303,45,0,345,3,800,452,244,101
9,BRĂILA,"CĂMINUL CULTURAL SALCIA TUDOR",226,"SALCIA TUDOR",43867,1,PART,PRCNCT,PRSD,PRSD_SV,"2025-05-18 21:32:17",535,277,252,25,0,276,1,600,323,184,92
9,BRĂILA,"CĂMINUL CULTURAL ARICIU",227,"SALCIA TUDOR",43867,1,PART,PRCNCT,PRSD,PRSD_SV,"2025-05-18 21:18:15",126,79,52,27,0,79,0,199,120,49,30
9,BRĂILA,"ȘCOALA GIMNAZIALĂ CUZA VODĂ",228,"SALCIA TUDOR",43867,1,PART,PRCNCT,PRSD,PRSD_SV,"2025-05-18 21:34:38",622,266,233,33,0,266,0,800,534,159,107
9,BRĂILA,"GRĂDINIŢA CU PROGRAM NORMAL GULIANCA",229,"SALCIA TUDOR",43867,1,PART,PRCNCT,PRSD,PRSD_SV,"2025-05-18 21:28:25",304,161,128,33,0,160,1,400,239,133,27
9,BRĂILA,"CĂMINUL CULTURAL OLĂNEASCA",230,"SALCIA TUDOR",43867,1,PART,PRCNCT,PRSD,PRSD_SV,"2025-05-18 21:23:44",296,153,128,25,0,152,1,400,247,108,44
9,BRĂILA,"ȘCOALA GIMNAZIALĂ SCORȚARU NOU",231,"SCORŢARU NOU",43929,1,PART,PRCNCT,PRSD,PRSD_SV,"2025-05-18 21:35:57",629,299,247,52,0,293,6,800,501,185,108
9,BRĂILA,"GRĂDINIȚA CU PROGRAM NORMAL SIHLEANU",232,"SCORŢARU NOU",43929,2,PART,PRCNCT,PRSD,PRSD_SV,"2025-05-18 23:11:59",367,212,173,38,1,210,2,400,188,147,63
9,BRĂILA,"SPATIU EVENIMENTE COMEMORATIVE",233,SILIŞTEA,43992,1,PART,PRCNCT,PRSD,PRSD_SV,"2025-05-18 21:37:12",143,86,66,20,0,83,3,205,119,45,38
9,BRĂILA,"CĂMINUL CULTURAL SILIȘTEA",234,SILIŞTEA,43992,1,PART,PRCNCT,PRSD,PRSD_SV,"2025-05-18 21:35:54",590,300,256,44,0,295,5,600,300,186,109
9,BRĂILA,"GRĂDINIŢA CU PROGRAM NORMAL COTU-LUNG",235,SILIŞTEA,43992,1,PART,PRCNCT,PRSD,PRSD_SV,"2025-05-18 21:25:53",276,167,122,45,0,166,1,300,133,111,55
9,BRĂILA,"SALĂ FESTIVITĂȚI",236,SILIŞTEA,43992,1,PART,PRCNCT,PRSD,PRSD_SV,"2025-05-18 21:16:12",132,102,60,42,0,101,1,200,98,63,38
9,BRĂILA,"ȘCOALA PRIMARĂ MUCHEA",237,SILIŞTEA,43992,1,PART,PRCNCT,PRSD,PRSD_SV,"2025-05-18 21:30:23",361,248,207,41,0,243,5,400,152,159,84
9,BRĂILA,"ȘCOALA GIMNAZIALA STĂNCUȚA",238,STĂNCUŢA,44060,1,PART,PRCNCT,PRSD,PRSD_SV,"2025-05-18 21:38:29",1146,560,517,43,0,558,2,1200,640,395,163
9,BRĂILA,"ȘCOALA GIMNAZIALĂ CUZA - VODĂ",239,STĂNCUŢA,44060,1,PART,PRCNCT,PRSD,PRSD_SV,"2025-05-18 21:23:56",1165,577,545,32,0,572,5,1200,623,452,120
9,BRĂILA,"ȘCOALA STANCA",240,STĂNCUŢA,44060,1,PART,PRCNCT,PRSD,PRSD_SV,"2025-05-18 21:22:03",327,206,156,50,0,205,1,400,194,139,66
9,BRĂILA,"ȘCOALA GIMNAZIALĂ SURDILA GĂISEANCA",241,SURDILA-GĂISEANCA,44113,1,PART,PRCNCT,PRSD,PRSD_SV,"2025-05-18 21:47:29",1234,662,602,60,0,654,8,1300,638,400,254
9,BRĂILA,"FOSTA ȘCOALA GIMNAZIALA FILIPESTI",242,SURDILA-GĂISEANCA,44113,1,PART,PRCNCT,PRSD,PRSD_SV,"2025-05-18 21:43:06",610,364,278,86,0,360,4,800,436,243,117
9,BRĂILA,"ȘCOALA CU CLASELE I-VIII SURDILA GRECI",243,SURDILA-GRECI,42771,1,PART,PRCNCT,PRSD,PRSD_SV,"2025-05-18 21:34:31",546,297,251,45,1,295,2,600,303,160,135
9,BRĂILA,"ȘCOALA CU CLASELE I-IV FĂUREI - SAT",244,SURDILA-GRECI,42771,1,PART,PRCNCT,PRSD,PRSD_SV,"2025-05-18 21:37:36",276,184,145,39,0,184,0,300,116,131,53
9,BRĂILA,"ȘCOALA CU CLASELE I-IV HORIA",245,SURDILA-GRECI,42771,1,PART,PRCNCT,PRSD,PRSD_SV,"2025-05-18 21:44:37",313,209,180,24,5,208,1,400,191,118,90
9,BRĂILA,"CĂMINUL CULTURAL ŞUŢEŞTI",246,ŞUŢEŞTI,44140,1,PART,PRCNCT,PRSD,PRSD_SV,"2025-05-18 21:29:14",1045,508,440,68,0,499,9,1100,592,327,172
9,BRĂILA,"ŞCOALA GIMNAZIALĂ ŞUŢEŞTI (ŞCOALA DE ARTE ŞI MESERII)",247,ŞUŢEŞTI,44140,1,PART,PRCNCT,PRSD,PRSD_SV,"2025-05-18 21:36:49",1193,569,507,62,0,561,8,1400,831,390,171
9,BRĂILA,"ŞCOALA GIMNAZIALĂ ŞUŢEŞTI (ŞCOALA DE ARTE ŞI MESERII)",248,ŞUŢEŞTI,44140,1,PART,PRCNCT,PRSD,PRSD_SV,"2025-05-18 21:30:30",907,354,332,22,0,347,7,1000,646,237,110
9,BRĂILA,"GRĂDINIȚA 25 LOCURI",249,ŞUŢEŞTI,44140,1,PART,PRCNCT,PRSD,PRSD_SV,"2025-05-18 22:03:44",285,146,117,29,0,146,0,300,154,91,55
9,BRĂILA,"SCOALA GIMNAZIALA TICHILESTI",250,TICHILEŞTI,44177,1,PART,PRCNCT,PRSD,PRSD_SV,"2025-05-18 21:37:34",1350,733,602,61,70,718,15,1400,667,500,218
9,BRĂILA,"SCOALA GIMNAZIALA TICHILESTI",251,TICHILEŞTI,44177,1,PART,PRCNCT,PRSD,PRSD_SV,"2025-05-18 21:58:37",1330,636,568,68,0,631,5,1400,764,431,200
9,BRĂILA,"SCOALA PRIMARA ALBINA",252,TICHILEŞTI,44177,1,PART,PRCNCT,PRSD,PRSD_SV,"2025-05-18 21:36:55",267,202,142,60,0,202,0,300,98,137,65
9,BRĂILA,"ȘCOALA CU CLASELE I-VIII TRAIAN",253,TRAIAN,44202,1,PART,PRCNCT,PRSD,PRSD_SV,"2025-05-18 21:40:56",899,408,357,51,0,406,2,1000,592,249,157
9,BRĂILA,"CĂMINUL CULTURAL SAT CĂLDĂRUȘA",254,TRAIAN,44202,1,PART,PRCNCT,PRSD,PRSD_SV,"2025-05-18 21:19:07",147,75,58,17,0,73,2,200,125,40,33
9,BRĂILA,"GRĂDINIȚA SILISTRARU",255,TRAIAN,44202,1,PART,PRCNCT,PRSD,PRSD_SV,"2025-05-18 21:44:01",609,326,272,54,0,319,7,800,474,205,114
9,BRĂILA,"GRĂDINIȚA URLEASCA",256,TRAIAN,44202,1,PART,PRCNCT,PRSD,PRSD_SV,"2025-05-18 21:52:14",959,431,400,30,1,425,6,1000,569,304,121
9,BRĂILA,"ȘCOALA GIMNAZIALĂ TUDOR VLADIMIRESCU",257,"TUDOR VLADIMIRESCU",44257,1,PART,PRCNCT,PRSD,PRSD_SV,"2025-05-18 22:00:15",759,467,336,131,0,457,10,800,333,311,146
9,BRĂILA,"CĂMINUL CULTURAL COMĂNEASCA",258,"TUDOR VLADIMIRESCU",44257,1,PART,PRCNCT,PRSD,PRSD_SV,"2025-05-18 21:18:00",169,104,74,30,0,103,1,200,96,57,46
9,BRĂILA,"CĂMINUL CULTURAL SCORȚARU VECHI",259,"TUDOR VLADIMIRESCU",44257,1,PART,PRCNCT,PRSD,PRSD_SV,"2025-05-18 22:31:39",723,422,337,84,1,413,9,800,378,285,128
9,BRĂILA,"SCOALA PETRE CARP TUFESTI",260,TUFEŞTI,44300,1,PART,PRCNCT,PRSD,PRSD_SV,"2025-05-18 21:54:56",865,408,371,37,0,405,3,1000,592,258,147
9,BRĂILA,"CAMIN CULTURAL DIN FOSTUL SAT TIBANESTI",261,TUFEŞTI,44300,1,PART,PRCNCT,PRSD,PRSD_SV,"2025-05-18 21:41:29",1013,469,432,37,0,464,5,1200,731,245,219
9,BRĂILA,"CĂMINUI CULTURAL NR. 2",262,TUFEŞTI,44300,1,PART,PRCNCT,PRSD,PRSD_SV,"2025-05-18 21:24:36",829,449,405,44,0,443,6,1000,551,281,162
9,BRĂILA,"SCOALA PETRE CARP DIN FOSTUL SAT TIBANESTI",263,TUFEŞTI,44300,1,PART,PRCNCT,PRSD,PRSD_SV,"2025-05-18 21:57:45",1260,663,603,60,0,657,6,1400,737,407,250
9,BRĂILA,"CAMINUL CULTURAL ULMU",264,ULMU,44328,1,PART,PRCNCT,PRSD,PRSD_SV,"2025-05-18 21:49:42",1114,632,525,107,0,627,5,1200,568,376,251
9,BRĂILA,"GRĂDINIȚA MOHREANU",265,ULMU,44328,1,PART,PRCNCT,PRSD,PRSD_SV,"2025-05-18 21:25:01",902,425,374,51,0,421,4,1000,575,287,134
9,BRĂILA,"CAMINUL CULTURAL JUGUREANU",266,ULMU,44328,1,PART,PRCNCT,PRSD,PRSD_SV,"2025-05-18 21:33:32",714,354,291,63,0,347,7,800,446,220,127
9,BRĂILA,"CĂMIN CULTURAL",267,UNIREA,44355,1,PART,PRCNCT,PRSD,PRSD_SV,"2025-05-18 21:32:00",821,447,375,72,0,442,5,900,453,250,192
9,BRĂILA,"CĂMIN CULTURAL",268,UNIREA,44355,1,PART,PRCNCT,PRSD,PRSD_SV,"2025-05-18 22:00:33",1036,546,460,85,1,541,5,1100,554,344,197
9,BRĂILA,"SCOALA GIMNAZIALA CU CLASELE I-VIII VADENI -SALA A",269,VĂDENI,44391,1,PART,PRCNCT,PRSD,PRSD_SV,"2025-05-18 21:36:18",884,464,398,66,0,460,4,1000,536,321,139
9,BRĂILA,"SCOALA GIMNAZIALA CU CLASELE I-VIII-VADENI-SALA B",270,VĂDENI,44391,1,PART,PRCNCT,PRSD,PRSD_SV,"2025-05-18 21:40:22",937,443,400,43,0,441,2,1000,557,303,138
9,BRĂILA,"SCOALA GIMNAZIALA CU CLASELE I-VIII BALDOVINESTI",271,VĂDENI,44391,1,PART,PRCNCT,PRSD,PRSD_SV,"2025-05-18 21:32:29",973,517,455,52,10,507,10,1000,483,306,201
9,BRĂILA,"SCOALA CU CLASELE I-IV PIETROIU",272,VĂDENI,44391,1,PART,PRCNCT,PRSD,PRSD_SV,"2025-05-18 21:52:47",436,234,206,28,0,230,4,500,266,156,74
9,BRĂILA,"SCOALA GIMNAZIALA VICTORIA",273,VICTORIA,44435,1,PART,PRCNCT,PRSD,PRSD_SV,"2025-05-18 21:46:10",842,348,320,28,0,345,3,900,552,233,112
9,BRĂILA,"SCOALA GIMNAZIALA VICTORIA",274,VICTORIA,44435,1,PART,PRCNCT,PRSD,PRSD_SV,"2025-05-18 21:44:24",792,339,318,21,0,336,3,800,461,257,79
9,BRĂILA,"SCOALA GIMNAZIALA VICTORIA STRUCTURA SCOLARA GIMNAZIALA MIHAI BRAVU",275,VICTORIA,44435,1,PART,PRCNCT,PRSD,PRSD_SV,"2025-05-18 21:37:14",1135,474,433,41,0,469,5,1200,726,345,124
9,BRĂILA,"ȘCOALA GIMNAZIALĂ VIȘANI",276,VIŞANI,44462,1,PART,PRCNCT,PRSD,PRSD_SV,"2025-05-18 22:06:41",1313,624,552,72,0,613,11,1400,776,385,228
9,BRĂILA,"ȘCOALA PRIMARĂ CÂINENI-BĂI",277,VIŞANI,44462,1,PART,PRCNCT,PRSD,PRSD_SV,"2025-05-18 21:34:14",457,207,164,43,0,203,4,500,293,98,105
9,BRĂILA,"SCOALA CU CLASELE I-VIII VIZIRU",278,VIZIRU,44505,1,PART,PRCNCT,PRSD,PRSD_SV,"2025-05-18 22:12:28",1403,719,603,116,0,712,7,1500,781,473,239
9,BRĂILA,"CENTRU EDUCATIONAL VIZIRU",279,VIZIRU,44505,1,PART,PRCNCT,PRSD,PRSD_SV,"2025-05-18 21:41:37",1642,771,685,86,0,758,13,1700,929,545,213
9,BRĂILA,"ȘCOALA LANURILE",280,VIZIRU,44505,2,PART,PRCNCT,PRSD,PRSD_SV,"2025-05-19 00:14:46",874,422,393,29,0,412,10,900,478,343,69
9,BRĂILA,"ȘCOALA LANURILE",281,VIZIRU,44505,1,PART,PRCNCT,PRSD,PRSD_SV,"2025-05-18 22:02:24",893,417,369,48,0,410,7,995,578,325,85
9,BRĂILA,"CAMIN CULTURAL ZAVOAIA",282,ZĂVOAIA,44532,1,PART,PRCNCT,PRSD,PRSD_SV,"2025-05-18 21:59:19",929,414,383,30,1,409,5,996,582,294,115
9,BRĂILA,"CĂMINUL CULTURAL ZĂVOAIA",283,ZĂVOAIA,44532,1,PART,PRCNCT,PRSD,PRSD_SV,"2025-05-18 21:49:13",858,424,391,33,0,415,9,900,476,294,121
9,BRĂILA,"ȘCOALA DUDESCU",284,ZĂVOAIA,44532,1,PART,PRCNCT,PRSD,PRSD_SV,"2025-05-18 21:56:54",579,292,239,53,0,290,2,600,308,184,106
10,BUZĂU,"ȘCOALA GIMNAZIALĂ ”EPISCOP DIONISIE ROMANO”",1,"MUNICIPIUL BUZĂU",44818,1,PART,PRCNCT,PRSD,PRSD_SV,"2025-05-18 21:40:46",1491,927,775,152,0,912,15,1600,673,340,572
10,BUZĂU,"ŞCOALA GIMNAZIALĂ ”EPISCOP DIONISIE ROMANO”",2,"MUNICIPIUL BUZĂU",44818,1,PART,PRCNCT,PRSD,PRSD_SV,"2025-05-18 21:54:22",1370,816,727,87,2,810,6,1500,684,222,588
10,BUZĂU,"ŞCOALA GIMNAZIALĂ NR.11",3,"MUNICIPIUL BUZĂU",44818,1,PART,PRCNCT,PRSD,PRSD_SV,"2025-05-18 21:43:57",1184,750,579,170,1,742,8,1300,550,273,469
10,BUZĂU,"ŞCOALA GIMNAZIALĂ NR.11",4,"MUNICIPIUL BUZĂU",44818,1,PART,PRCNCT,PRSD,PRSD_SV,"2025-05-18 22:11:03",1465,845,802,42,1,843,2,1600,755,272,571
10,BUZĂU,"ŞCOALA GIMNAZIALĂ NR.11",5,"MUNICIPIUL BUZĂU",44818,1,PART,PRCNCT,PRSD,PRSD_SV,"2025-05-18 21:52:02",1477,858,774,59,25,845,13,1600,742,276,569
10,BUZĂU,"ŞCOALA GIMNAZIALĂ NR.11",6,"MUNICIPIUL BUZĂU",44818,1,PART,PRCNCT,PRSD,PRSD_SV,"2025-05-18 21:57:52",1279,739,661,78,0,726,13,1400,661,234,492
10,BUZĂU,"LICEUL TEHNOLOGIC ”GRIGORE C. MOISIL”– SALĂ DE SPORT",7,"MUNICIPIUL BUZĂU",44818,1,PART,PRCNCT,PRSD,PRSD_SV,"2025-05-18 21:27:18",955,537,506,31,0,529,8,1050,513,205,324
10,BUZĂU,"LICEUL TEHNOLOGIC ”GRIGORE C. MOISIL”– SALĂ DE SPORT",8,"MUNICIPIUL BUZĂU",44818,1,PART,PRCNCT,PRSD,PRSD_SV,"2025-05-18 21:53:29",1063,571,524,46,1,564,7,1150,579,206,358
10,BUZĂU,"LICEUL TEHNOLOGIC ”GRIGORE C. MOISIL”",9,"MUNICIPIUL BUZĂU",44818,1,PART,PRCNCT,PRSD,PRSD_SV,"2025-05-18 21:48:05",1505,818,724,94,0,806,12,1650,832,297,509
10,BUZĂU,"LICEUL TEHNOLOGIC ”GRIGORE C. MOISIL”",10,"MUNICIPIUL BUZĂU",44818,1,PART,PRCNCT,PRSD,PRSD_SV,"2025-05-18 22:05:20",1322,709,666,43,0,695,14,1450,741,252,443
10,BUZĂU,"LICEUL TEHNOLOGIC ”GRIGORE C. MOISIL”",11,"MUNICIPIUL BUZĂU",44818,1,PART,PRCNCT,PRSD,PRSD_SV,"2025-05-18 22:26:48",1159,595,573,22,0,583,12,1250,655,265,318
10,BUZĂU,"LICEUL TEHNOLOGIC ”GRIGORE C. MOISIL”",12,"MUNICIPIUL BUZĂU",44818,1,PART,PRCNCT,PRSD,PRSD_SV,"2025-05-18 22:11:10",1299,634,600,34,0,621,13,1400,766,242,379
10,BUZĂU,"COLEGIUL UNIVERSITAR ECONOMIC",13,"MUNICIPIUL BUZĂU",44818,1,PART,PRCNCT,PRSD,PRSD_SV,"2025-05-18 21:52:47",1572,908,789,117,2,890,18,1700,792,331,559
10,BUZĂU,"ŞCOALA GIMNAZIALĂ NR. 7",14,"MUNICIPIUL BUZĂU",44818,1,PART,PRCNCT,PRSD,PRSD_SV,"2025-05-18 22:22:45",1650,872,817,55,0,860,12,1800,928,350,510
10,BUZĂU,"ŞCOALA GIMNAZIALĂ NR. 7",15,"MUNICIPIUL BUZĂU",44818,1,PART,PRCNCT,PRSD,PRSD_SV,"2025-05-18 22:26:35",1581,891,814,77,0,881,10,1700,809,346,535
10,BUZĂU,"ŞCOALA GIMNAZIALĂ ”GENERAL GRIGORE BAŞTAN”",16,"MUNICIPIUL BUZĂU",44818,1,PART,PRCNCT,PRSD,PRSD_SV,"2025-05-18 21:42:48",1013,537,484,53,0,533,4,1100,563,192,341
10,BUZĂU,"ŞCOALA GIMNAZIALĂ ”GENERAL GRIGORE BAŞTAN”",17,"MUNICIPIUL BUZĂU",44818,1,PART,PRCNCT,PRSD,PRSD_SV,"2025-05-18 21:49:15",1108,621,573,48,0,610,11,1200,579,243,367
10,BUZĂU,"ŞCOALA GIMNAZIALĂ ”GENERAL GRIGORE BAŞTAN”",18,"MUNICIPIUL BUZĂU",44818,1,PART,PRCNCT,PRSD,PRSD_SV,"2025-05-18 22:11:29",1141,595,574,21,0,590,5,1250,655,221,369
10,BUZĂU,"ŞCOALA GIMNAZIALĂ ”GENERAL GRIGORE BAŞTAN”",19,"MUNICIPIUL BUZĂU",44818,1,PART,PRCNCT,PRSD,PRSD_SV,"2025-05-18 21:50:25",1133,609,585,24,0,599,10,1250,641,238,361
10,BUZĂU,"LICEUL TEORETIC DE INFORMATICĂ ”ALEXANDRU MARGHILOMAN”",20,"MUNICIPIUL BUZĂU",44818,1,PART,PRCNCT,PRSD,PRSD_SV,"2025-05-18 21:44:02",1231,695,650,45,0,688,7,1350,655,295,393
10,BUZĂU,"LICEUL TEORETIC DE INFORMATICĂ ”ALEXANDRU MARGHILOMAN”",21,"MUNICIPIUL BUZĂU",44818,1,PART,PRCNCT,PRSD,PRSD_SV,"2025-05-18 21:59:31",1211,683,605,77,1,674,9,1300,617,304,370
10,BUZĂU,"LICEUL TEORETIC DE INFORMATICĂ ”ALEXANDRU MARGHILOMAN”",22,"MUNICIPIUL BUZĂU",44818,1,PART,PRCNCT,PRSD,PRSD_SV,"2025-05-18 22:21:17",1290,725,674,51,0,716,9,1400,675,282,434
10,BUZĂU,"LICEUL TEHNOLOGIC ”HENRI COANDĂ”",23,"MUNICIPIUL BUZĂU",44818,1,PART,PRCNCT,PRSD,PRSD_SV,"2025-05-18 22:02:45",1337,660,608,52,0,653,7,1450,790,377,276
10,BUZĂU,"LICEUL TEHNOLOGIC ”HENRI COANDĂ”",24,"MUNICIPIUL BUZĂU",44818,1,PART,PRCNCT,PRSD,PRSD_SV,"2025-05-18 22:01:27",1231,489,434,55,0,486,3,1358,869,354,132
10,BUZĂU,"LICEUL TEHNOLOGIC ”HENRI COANDĂ”",25,"MUNICIPIUL BUZĂU",44818,2,PART,PRCNCT,PRSD,PRSD_SV,"2025-05-18 23:20:15",1086,631,581,37,13,615,16,1200,569,301,314
10,BUZĂU,"LICEUL TEHNOLOGIC ”HENRI COANDĂ”",26,"MUNICIPIUL BUZĂU",44818,1,PART,PRCNCT,PRSD,PRSD_SV,"2025-05-18 21:49:22",1241,597,562,35,0,590,7,1350,753,196,394
10,BUZĂU,"ŞCOALA GIMNAZIALĂ ”ION CREANGĂ”",27,"MUNICIPIUL BUZĂU",44818,1,PART,PRCNCT,PRSD,PRSD_SV,"2025-05-18 22:07:24",1453,767,734,33,0,756,11,1600,833,304,452
10,BUZĂU,"ŞCOALA GIMNAZIALĂ ”ION CREANGĂ”",28,"MUNICIPIUL BUZĂU",44818,1,PART,PRCNCT,PRSD,PRSD_SV,"2025-05-18 21:57:35",1283,725,665,60,0,712,13,1400,675,277,435
10,BUZĂU,"ŞCOALA GIMNAZIALĂ ”ION CREANGĂ”",29,"MUNICIPIUL BUZĂU",44818,1,PART,PRCNCT,PRSD,PRSD_SV,"2025-05-18 22:35:40",1493,798,761,37,0,788,10,1600,802,310,478
10,BUZĂU,"ŞCOALA GIMNAZIALĂ ”ION CREANGĂ”",30,"MUNICIPIUL BUZĂU",44818,1,PART,PRCNCT,PRSD,PRSD_SV,"2025-05-18 21:30:55",1250,721,698,23,0,709,12,1350,629,284,425
10,BUZĂU,"LICEUL TEHNOLOGIC „ALEXANDRU IOAN CUZA”",31,"MUNICIPIUL BUZĂU",44818,1,PART,PRCNCT,PRSD,PRSD_SV,"2025-05-18 21:24:02",778,471,407,35,29,460,11,850,379,163,297
10,BUZĂU,"LICEUL TEHNOLOGIC „ALEXANDRU IOAN CUZA”",32,"MUNICIPIUL BUZĂU",44818,1,PART,PRCNCT,PRSD,PRSD_SV,"2025-05-18 21:22:40",798,435,389,45,1,431,4,850,415,179,252
10,BUZĂU,"LICEUL DE ARTE ”MARGARETA STERIAN”",33,"MUNICIPIUL BUZĂU",44818,1,PART,PRCNCT,PRSD,PRSD_SV,"2025-05-18 21:52:21",1372,840,773,67,0,828,12,1500,660,317,511
10,BUZĂU,"COLEGIUL NAȚIONAL ”B. P. HASDEU”",34,"MUNICIPIUL BUZĂU",44818,1,PART,PRCNCT,PRSD,PRSD_SV,"2025-05-18 21:43:44",1321,883,722,116,45,874,9,1450,567,291,583
10,BUZĂU,"ŞCOALA GIMNAZIALĂ ”P.H. ZANGOPOL”",35,"MUNICIPIUL BUZĂU",44818,1,PART,PRCNCT,PRSD,PRSD_SV,"2025-05-18 21:33:06",889,450,402,48,0,442,8,950,500,231,211
10,BUZĂU,"ŞCOALA GIMNAZIALĂ ”P.H. ZANGOPOL”",36,"MUNICIPIUL BUZĂU",44818,1,PART,PRCNCT,PRSD,PRSD_SV,"2025-05-18 22:12:24",1128,619,588,31,0,612,7,1250,631,261,351
10,BUZĂU,"ŞCOALA GIMNAZIALĂ ”P.H. ZANGOPOL”",37,"MUNICIPIUL BUZĂU",44818,1,PART,PRCNCT,PRSD,PRSD_SV,"2025-05-18 21:31:38",1425,782,740,41,1,773,9,1550,768,395,378
10,BUZĂU,"LICEUL TEHNOLOGIC ”DIMITRIE FILIPESCU”",38,"MUNICIPIUL BUZĂU",44818,1,PART,PRCNCT,PRSD,PRSD_SV,"2025-05-18 21:46:40",1318,807,709,98,0,794,13,1450,643,349,445
10,BUZĂU,"LICEUL TEHNOLOGIC ”DIMITRIE FILIPESCU”",39,"MUNICIPIUL BUZĂU",44818,1,PART,PRCNCT,PRSD,PRSD_SV,"2025-05-18 21:49:01",1366,612,552,60,0,607,5,1500,888,321,286
10,BUZĂU,"LICEUL AGRICOL ”DR. CONSTANTIN ANGELESCU”",40,"MUNICIPIUL BUZĂU",44818,1,PART,PRCNCT,PRSD,PRSD_SV,"2025-05-18 22:07:51",1232,777,711,66,0,767,10,1350,573,260,507
10,BUZĂU,"ȘCOALA GIMNAZIALĂ ”NICU CONSTANTINESCU”",41,"MUNICIPIUL BUZĂU",44818,1,PART,PRCNCT,PRSD,PRSD_SV,"2025-05-18 22:01:03",1013,577,528,49,0,571,6,1100,523,178,393
10,BUZĂU,"ȘCOALA GIMNAZIALĂ ”NICU CONSTANTINESCU”",42,"MUNICIPIUL BUZĂU",44818,1,PART,PRCNCT,PRSD,PRSD_SV,"2025-05-18 21:41:58",899,589,475,114,0,586,3,1000,411,240,346
10,BUZĂU,"ȘCOALA GIMNAZIALĂ ”NICU CONSTANTINESCU”",43,"MUNICIPIUL BUZĂU",44818,1,PART,PRCNCT,PRSD,PRSD_SV,"2025-05-18 21:49:46",1573,866,828,38,0,858,8,1700,834,366,492
10,BUZĂU,"GRADINIȚA CU PROGRAM PRELUNGIT NR.8",44,"MUNICIPIUL BUZĂU",44818,1,PART,PRCNCT,PRSD,PRSD_SV,"2025-05-18 22:00:15",943,564,512,52,0,555,9,1050,486,192,363
10,BUZĂU,"GRADINIȚA CU PROGRAM PRELUNGIT NR.8",45,"MUNICIPIUL BUZĂU",44818,1,PART,PRCNCT,PRSD,PRSD_SV,"2025-05-18 22:25:46",744,470,395,75,0,465,5,800,330,141,324
10,BUZĂU,"GRADINIȚA CU PROGRAM PRELUNGIT NR.8",46,"MUNICIPIUL BUZĂU",44818,1,PART,PRCNCT,PRSD,PRSD_SV,"2025-05-18 22:20:15",1525,812,763,47,2,799,13,1650,838,260,539
10,BUZĂU,"COLEGIUL NAȚIONAL PEDAGOGIC ”SPIRU HARET”",47,"MUNICIPIUL BUZĂU",44818,1,PART,PRCNCT,PRSD,PRSD_SV,"2025-05-18 21:39:37",1500,844,745,98,1,832,12,1650,806,256,576
10,BUZĂU,"COLEGIUL NAȚIONAL PEDAGOGIC ”SPIRU HARET”",48,"MUNICIPIUL BUZĂU",44818,1,PART,PRCNCT,PRSD,PRSD_SV,"2025-05-18 22:08:00",1091,653,569,81,3,644,9,1200,547,176,468
10,BUZĂU,"COLEGIUL NAȚIONAL PEDAGOGIC ”SPIRU HARET”",49,"MUNICIPIUL BUZĂU",44818,1,PART,PRCNCT,PRSD,PRSD_SV,"2025-05-18 21:43:06",1533,864,761,103,0,851,13,1700,836,280,571
10,BUZĂU,"COLEGIUL NAȚIONAL PEDAGOGIC ”SPIRU HARET”",50,"MUNICIPIUL BUZĂU",44818,1,PART,PRCNCT,PRSD,PRSD_SV,"2025-05-18 22:25:19",1211,673,591,81,1,670,3,1300,627,228,442
10,BUZĂU,"GRĂDINIŢA CU PROGRAM PRELUNGIT NR. 1",51,"MUNICIPIUL BUZĂU",44818,1,PART,PRCNCT,PRSD,PRSD_SV,"2025-05-18 21:39:05",1466,1159,932,223,4,1146,13,1600,441,286,860
10,BUZĂU,"ȘCOALA GIMNAZIALĂ ”GEORGE EMIL PALADE”",52,"MUNICIPIUL BUZĂU",44818,1,PART,PRCNCT,PRSD,PRSD_SV,"2025-05-18 21:40:23",1235,756,646,110,0,742,14,1350,594,224,518
10,BUZĂU,"ȘCOALA GIMNAZIALĂ ”GEORGE EMIL PALADE”",53,"MUNICIPIUL BUZĂU",44818,1,PART,PRCNCT,PRSD,PRSD_SV,"2025-05-18 22:20:03",1376,802,730,72,0,788,14,1500,698,235,553
10,BUZĂU,"ȘCOALA GIMNAZIALĂ ”GEORGE EMIL PALADE”",54,"MUNICIPIUL BUZĂU",44818,1,PART,PRCNCT,PRSD,PRSD_SV,"2025-05-18 22:16:59",1071,624,566,57,1,610,14,1200,576,194,416
10,BUZĂU,"ȘCOALA GIMNAZIALĂ ”GEORGE EMIL PALADE”",55,"MUNICIPIUL BUZĂU",44818,1,PART,PRCNCT,PRSD,PRSD_SV,"2025-05-18 22:05:29",1391,745,701,44,0,735,10,1500,755,248,487
10,BUZĂU,"ȘCOALA GIMNAZIALĂ ”GEORGE EMIL PALADE”",56,"MUNICIPIUL BUZĂU",44818,1,PART,PRCNCT,PRSD,PRSD_SV,"2025-05-18 21:51:46",1097,563,521,42,0,554,9,1200,637,168,386
10,BUZĂU,"COLEGIUL ECONOMIC ”REGELE MIHAI I”",57,"MUNICIPIUL BUZĂU",44818,1,PART,PRCNCT,PRSD,PRSD_SV,"2025-05-18 21:32:28",1038,619,544,74,1,613,6,1100,481,211,402
10,BUZĂU,"ȘCOALA GIMNAZIALĂ ”CĂPITAN AVIATOR MIRCEA T. BĂDULESCU”",58,"MUNICIPIUL BUZĂU",44818,1,PART,PRCNCT,PRSD,PRSD_SV,"2025-05-18 21:52:14",1245,830,735,94,1,811,19,1350,520,263,548
10,BUZĂU,"ȘCOALA GIMNAZIALĂ ”CĂPITAN AVIATOR MIRCEA T. BĂDULESCU”",59,"MUNICIPIUL BUZĂU",44818,2,PART,PRCNCT,PRSD,PRSD_SV,"2025-05-18 23:50:57",1307,799,697,101,1,778,21,1400,601,264,514
10,BUZĂU,"ȘCOALA GIMNAZIALĂ ”CAPITAN AVIATOR MIRCEA T. BĂDULESCU”",60,"MUNICIPIUL BUZĂU",44818,1,PART,PRCNCT,PRSD,PRSD_SV,"2025-05-18 21:26:23",1201,642,592,50,0,636,6,1300,658,190,446
10,BUZĂU,"ȘCOALA GIMNAZIALĂ ”CAPITAN AVIATOR MIRCEA T. BĂDULESCU”",61,"MUNICIPIUL BUZĂU",44818,2,PART,PRCNCT,PRSD,PRSD_SV,"2025-05-18 23:35:06",1089,665,599,64,2,650,15,1200,535,165,485
10,BUZĂU,"GRADINIȚA CU PROGRAM PRELUNGIT NR.4",62,"MUNICIPIUL BUZĂU",44818,1,PART,PRCNCT,PRSD,PRSD_SV,"2025-05-18 21:43:36",1189,681,620,61,0,667,14,1300,619,224,443
10,BUZĂU,"ȘCOALA GIMNAZIALĂ ”NICOLAE TITULESCU„",63,"MUNICIPIUL BUZĂU",44818,1,PART,PRCNCT,PRSD,PRSD_SV,"2025-05-18 21:43:48",1244,714,651,62,1,707,7,1350,636,206,501
10,BUZĂU,"ȘCOALA GIMNAZIALĂ ”NICOLAE TITULESCU„",64,"MUNICIPIUL BUZĂU",44818,1,PART,PRCNCT,PRSD,PRSD_SV,"2025-05-18 21:56:19",1344,764,711,52,1,751,13,1500,736,258,493
10,BUZĂU,"ȘCOALA GIMNAZIALĂ ”SFÂNTUL APOSTOL ANDREI”",65,"MUNICIPIUL BUZĂU",44818,1,PART,PRCNCT,PRSD,PRSD_SV,"2025-05-18 22:21:15",1157,647,566,81,0,637,10,1250,603,260,377
10,BUZĂU,"ȘCOALA GIMNAZIALĂ ”SFÂNTUL APOSTOL ANDREI”",66,"MUNICIPIUL BUZĂU",44818,1,PART,PRCNCT,PRSD,PRSD_SV,"2025-05-18 21:49:18",1305,828,665,124,39,818,10,1400,572,390,428
10,BUZĂU,"ȘCOALA GIMNAZIALĂ ”SFÂNTUL APOSTOL ANDREI”",67,"MUNICIPIUL BUZĂU",44818,1,PART,PRCNCT,PRSD,PRSD_SV,"2025-05-18 22:31:49",1369,797,666,83,48,787,10,1500,703,315,472
10,BUZĂU,"ȘCOALA GIMNAZIALĂ ”SFÂNTUL APOSTOL ANDREI”",68,"MUNICIPIUL BUZĂU",44818,1,PART,PRCNCT,PRSD,PRSD_SV,"2025-05-18 21:53:20",1565,868,815,53,0,855,13,1700,832,299,556
10,BUZĂU,"LICEUL CU PROGRAM SPORTIV ”IOLANDA BALAŞ SÖTER”",69,"MUNICIPIUL BUZĂU",44818,1,PART,PRCNCT,PRSD,PRSD_SV,"2025-05-18 22:05:56",797,430,376,54,0,423,7,850,420,170,253
10,BUZĂU,"LICEUL CU PROGRAM SPORTIV ”IOLANDA BALAŞ SÖTER”",70,"MUNICIPIUL BUZĂU",44818,1,PART,PRCNCT,PRSD,PRSD_SV,"2025-05-18 21:38:05",1176,665,628,37,0,654,11,1300,635,269,385
10,BUZĂU,"LICEUL CU PROGRAM SPORTIV ”IOLANDA BALAŞ SÖTER”",71,"MUNICIPIUL BUZĂU",44818,1,PART,PRCNCT,PRSD,PRSD_SV,"2025-05-18 21:39:23",999,492,468,23,1,487,5,1100,608,203,284
10,BUZĂU,"GRĂDINIŢA CU PROGRAM PRELUNGIT ”BOBOCEII DIN MICRO III”",72,"MUNICIPIUL BUZĂU",44818,1,PART,PRCNCT,PRSD,PRSD_SV,"2025-05-18 22:15:53",1296,860,673,186,1,847,13,1400,540,300,547
10,BUZĂU,"SEMINARUL TEOLOGIC ORTODOX ”CHESARIE EPISCOPUL”",73,"MUNICIPIUL BUZĂU",44818,1,PART,PRCNCT,PRSD,PRSD_SV,"2025-05-18 21:46:39",1316,830,742,87,1,820,10,1450,620,234,586
10,BUZĂU,"SEMINARUL TEOLOGIC ORTODOX ”CHESARIE EPISCOPUL”",74,"MUNICIPIUL BUZĂU",44818,1,PART,PRCNCT,PRSD,PRSD_SV,"2025-05-18 22:48:03",1569,811,731,78,2,803,8,1700,889,339,464
10,BUZĂU,"COLEGIUL NAȚIONAL ”MIHAI EMINESCU”",75,"MUNICIPIUL BUZĂU",44818,1,PART,PRCNCT,PRSD,PRSD_SV,"2025-05-18 21:46:18",1720,766,686,80,0,756,10,1900,1134,476,280
10,BUZĂU,"LICEUL TEHNOLOGIC MESERII ŞI SERVICII",76,"MUNICIPIUL BUZĂU",44818,1,PART,PRCNCT,PRSD,PRSD_SV,"2025-05-18 21:20:58",942,388,346,42,0,385,3,1050,662,220,165
10,BUZĂU,"LICEUL TEHNOLOGIC MESERII ŞI SERVICII",77,"MUNICIPIUL BUZĂU",44818,1,PART,PRCNCT,PRSD,PRSD_SV,"2025-05-18 21:46:17",1441,635,582,53,0,629,6,1600,965,374,255
10,BUZĂU,"ȘCOALA GIMNAZIALA ”MIHAI L KOGĂLNICEANU”",78,"MUNICIPIUL BUZĂU",44818,1,PART,PRCNCT,PRSD,PRSD_SV,"2025-05-18 21:38:59",1532,747,706,41,0,738,9,1700,953,406,332
10,BUZĂU,"ȘCOALA GIMNAZIALA ”MIHAI L KOGĂLNICEANU”",79,"MUNICIPIUL BUZĂU",44818,1,PART,PRCNCT,PRSD,PRSD_SV,"2025-05-18 21:48:27",1631,635,599,36,0,625,10,1800,1165,414,211
10,BUZĂU,"ȘCOALA GIMNAZIALA ”MIHAI L KOGĂLNICEANU”",80,"MUNICIPIUL BUZĂU",44818,1,PART,PRCNCT,PRSD,PRSD_SV,"2025-05-18 22:09:32",1648,567,531,36,0,554,13,1800,1233,412,142
10,BUZĂU,"CENTRUL DE RECUPERARE PENTRU COPII CU DIZABILITĂŢI",81,"MUNICIPIUL RÂMNICU SĂRAT",44845,1,PART,PRCNCT,PRSD,PRSD_SV,"2025-05-18 21:46:47",1903,895,852,43,0,874,21,2100,1205,487,387
10,BUZĂU,"ȘCOALA GIMNAZIALĂ DR. ILIE PAVEL",82,"MUNICIPIUL RÂMNICU SĂRAT",44845,1,PART,PRCNCT,PRSD,PRSD_SV,"2025-05-18 21:44:52",1827,706,681,25,0,700,6,2000,1294,636,64
10,BUZĂU,"ŞCOALA GIMNAZIALĂ ”VASILE CRISTOFOREANU”",83,"MUNICIPIUL RÂMNICU SĂRAT",44845,1,PART,PRCNCT,PRSD,PRSD_SV,"2025-05-18 22:47:42",1519,789,724,61,4,775,14,1650,861,434,341
10,BUZĂU,"ŞCOALA GIMNAZIALĂ ”VASILE CRISTOFOREANU”",84,"MUNICIPIUL RÂMNICU SĂRAT",44845,1,PART,PRCNCT,PRSD,PRSD_SV,"2025-05-18 21:40:49",1422,728,643,84,1,716,12,1550,822,347,369
10,BUZĂU,"ŞCOALA GIMNAZIALĂ ”VASILE CRISTOFOREANU”",85,"MUNICIPIUL RÂMNICU SĂRAT",44845,1,PART,PRCNCT,PRSD,PRSD_SV,"2025-05-18 22:11:53",1614,923,859,64,0,915,8,1750,827,397,518
10,BUZĂU,"GRĂDINIŢA CU PROGRAM NORMAL ”ORIZONT”",86,"MUNICIPIUL RÂMNICU SĂRAT",44845,1,PART,PRCNCT,PRSD,PRSD_SV,"2025-05-18 22:14:32",1380,698,632,66,0,686,12,1500,802,367,319
10,BUZĂU,"LICEUL TEHNOLOGIC ”VICTOR FRUNZĂ”",87,"MUNICIPIUL RÂMNICU SĂRAT",44845,1,PART,PRCNCT,PRSD,PRSD_SV,"2025-05-18 21:50:22",1633,708,629,79,0,699,9,1800,1092,415,284
10,BUZĂU,"LICEUL TEHNOLOGIC ”VICTOR FRUNZĂ”",88,"MUNICIPIUL RÂMNICU SĂRAT",44845,1,PART,PRCNCT,PRSD,PRSD_SV,"2025-05-18 22:05:51",1285,773,654,39,80,763,10,1400,627,379,384
10,BUZĂU,"COLEGIUL NAŢIONAL ”ALEXANDRU VLAHUŢĂ”",89,"MUNICIPIUL RÂMNICU SĂRAT",44845,1,PART,PRCNCT,PRSD,PRSD_SV,"2025-05-18 21:42:08",1017,531,459,70,2,524,7,1100,569,255,269
10,BUZĂU,"COLEGIUL NAŢIONAL ”ALEXANDRU VLAHUŢĂ”",90,"MUNICIPIUL RÂMNICU SĂRAT",44845,1,PART,PRCNCT,PRSD,PRSD_SV,"2025-05-18 21:52:16",1178,657,586,70,1,649,8,1300,643,299,350
10,BUZĂU,"GRĂDINIŢA CU PROGRAM PRELUNGIT ”MUGURAŞII”",91,"MUNICIPIUL RÂMNICU SĂRAT",44845,1,PART,PRCNCT,PRSD,PRSD_SV,"2025-05-18 21:46:52",1322,633,573,59,1,612,21,1450,817,359,253
10,BUZĂU,"GRĂDINIŢA CU PROGRAM PRELUNGIT ”LUMEA COPILĂRIEI”",92,"MUNICIPIUL RÂMNICU SĂRAT",44845,1,PART,PRCNCT,PRSD,PRSD_SV,"2025-05-18 22:27:38",1535,764,729,34,1,752,12,1700,936,403,349
10,BUZĂU,"GRĂDINIŢA CU PROGRAM PRELUNGIT ”LUMEA COPILĂRIEI”",93,"MUNICIPIUL RÂMNICU SĂRAT",44845,1,PART,PRCNCT,PRSD,PRSD_SV,"2025-05-18 22:04:11",1593,796,758,38,0,780,16,1750,954,398,382
10,BUZĂU,"ŞCOALA GIMNAZIALĂ NR. 6",94,"MUNICIPIUL RÂMNICU SĂRAT",44845,1,PART,PRCNCT,PRSD,PRSD_SV,"2025-05-18 22:19:11",1792,987,912,75,0,969,18,1950,963,574,395
10,BUZĂU,"LICEUL TEORETIC ”ŞTEFAN CEL MARE”",95,"MUNICIPIUL RÂMNICU SĂRAT",44845,1,PART,PRCNCT,PRSD,PRSD_SV,"2025-05-18 22:12:53",1205,668,619,48,1,658,10,1300,632,280,378
10,BUZĂU,"CANTINA DE AJUTOR SOCIAL",96,"MUNICIPIUL RÂMNICU SĂRAT",44845,1,PART,PRCNCT,PRSD,PRSD_SV,"2025-05-18 21:34:56",1171,595,554,40,1,581,14,1300,705,283,298
10,BUZĂU,"ŞCOALA GIMNAZIALĂ NR. 1",97,"MUNICIPIUL RÂMNICU SĂRAT",44845,1,PART,PRCNCT,PRSD,PRSD_SV,"2025-05-18 22:00:42",1093,603,536,55,12,598,5,1200,597,313,285
10,BUZĂU,"ŞCOALA GIMNAZIALĂ NR. 2",98,"MUNICIPIUL RÂMNICU SĂRAT",44845,1,PART,PRCNCT,PRSD,PRSD_SV,"2025-05-18 22:06:33",1719,841,783,41,17,831,10,1900,1059,483,348
10,BUZĂU,"S.C. RAFINĂRIA VENUS OILREG S.A.",99,"MUNICIPIUL RÂMNICU SĂRAT",44845,1,PART,PRCNCT,PRSD,PRSD_SV,"2025-05-18 22:38:31",1877,984,924,60,0,961,23,2050,1066,652,309
10,BUZĂU,"GRĂDINIŢA CU PROGRAM PRELUNGIT NR.2",100,"MUNICIPIUL RÂMNICU SĂRAT",44845,1,PART,PRCNCT,PRSD,PRSD_SV,"2025-05-18 22:19:00",1372,710,673,36,1,701,9,1500,790,312,389
10,BUZĂU,"LICEUL ECONOMIC ”ELINA MATEI BASARAB”",101,"MUNICIPIUL RÂMNICU SĂRAT",44845,1,PART,PRCNCT,PRSD,PRSD_SV,"2025-05-18 22:08:45",1347,693,639,54,0,680,13,1500,807,333,347
10,BUZĂU,"CASA DE CULTURĂ GEORGE BĂICULESCU NEHOIU",102,"ORAŞ NEHOIU",47916,1,PART,PRCNCT,PRSD,PRSD_SV,"2025-05-18 22:29:35",1045,677,524,150,3,663,14,1142,465,277,386
10,BUZĂU,"GRUP SCOLAR TEHNIC NEHOIU STR. SCOLII",103,"ORAŞ NEHOIU",47916,1,PART,PRCNCT,PRSD,PRSD_SV,"2025-05-18 21:54:54",910,557,468,66,23,547,10,1000,443,196,351
10,BUZĂU,"COMPLEX SPORTIV NEHOIU",104,"ORAŞ NEHOIU",47916,1,PART,PRCNCT,PRSD,PRSD_SV,"2025-05-18 21:44:18",650,394,359,35,0,389,5,700,306,180,209
10,BUZĂU,"CĂMIN CULTURAL BĂDÂRLEGI",105,"ORAŞ NEHOIU",47916,1,PART,PRCNCT,PRSD,PRSD_SV,"2025-05-18 21:16:21",91,65,51,12,2,65,0,100,35,28,37
10,BUZĂU,"CLĂDIREA FOSTA SECŢIE CONFECŢIONAT ÎNCĂLŢĂMINTE DÂMBOVIŢA (LÂNGĂ BISERICA ORTODOXĂ) STR. VALEA NEHOIULUI",106,"ORAŞ NEHOIU",47916,1,PART,PRCNCT,PRSD,PRSD_SV,"2025-05-18 21:15:19",514,309,268,40,1,309,0,550,241,129,180
10,BUZĂU,"CĂMIN CULTURAL VALEA NEHOIULUI",107,"ORAŞ NEHOIU",47916,1,PART,PRCNCT,PRSD,PRSD_SV,"2025-05-18 21:33:01",766,434,395,39,0,423,11,850,416,242,181
10,BUZĂU,"ŞCOALA PRIMARĂ NEHOIAŞU",108,"ORAŞ NEHOIU",47916,1,PART,PRCNCT,PRSD,PRSD_SV,"2025-05-18 21:27:27",315,199,176,22,1,196,3,350,151,101,95
10,BUZĂU,"CĂMIN CULTURAL BÎSCA ROZILEI",109,"ORAŞ NEHOIU",47916,1,PART,PRCNCT,PRSD,PRSD_SV,"2025-05-18 21:58:55",524,295,272,23,0,290,5,600,305,160,130
10,BUZĂU,"GRĂDINITA POD VINETIS - VECHE",110,"ORAŞ NEHOIU",47916,1,PART,PRCNCT,PRSD,PRSD_SV,"2025-05-18 21:38:51",511,328,306,22,0,322,6,600,272,188,134
10,BUZĂU,"CENTRU CULTURAL CHIRLEȘTI",111,"ORAŞ NEHOIU",47916,1,PART,PRCNCT,PRSD,PRSD_SV,"2025-05-18 21:28:38",663,412,376,36,0,410,2,750,338,234,176
10,BUZĂU,"CĂMIN CULTURAL CURMĂTURA",112,"ORAŞ NEHOIU",47916,1,PART,PRCNCT,PRSD,PRSD_SV,"2025-05-18 21:28:06",107,66,53,12,1,66,0,150,84,25,41
10,BUZĂU,"CENTRU CULTURAL LUNCA PRIPORULUI",113,"ORAŞ NEHOIU",47916,1,PART,PRCNCT,PRSD,PRSD_SV,"2025-05-18 21:33:26",559,368,343,25,0,359,9,610,242,202,157
10,BUZĂU,"SCOALA CU CLASELE I-IV PRUND",114,"ORAŞ NEHOIU",47916,1,PART,PRCNCT,PRSD,PRSD_SV,"2025-05-18 21:32:32",370,240,218,21,1,239,1,400,160,133,106
10,BUZĂU,"CĂMIN CULTURAL MLĂJET",115,"ORAŞ NEHOIU",47916,1,PART,PRCNCT,PRSD,PRSD_SV,"2025-05-18 21:41:20",673,440,386,51,3,437,3,750,310,246,191
10,BUZĂU,"CĂMIN CULTURAL PĂLTINENI",116,"ORAŞ NEHOIU",47916,1,PART,PRCNCT,PRSD,PRSD_SV,"2025-05-18 22:19:51",624,414,362,52,0,407,7,700,286,182,225
10,BUZĂU,"CĂMIN CULTURAL VINETIS",117,"ORAŞ NEHOIU",47916,1,PART,PRCNCT,PRSD,PRSD_SV,"2025-05-18 21:16:53",114,97,83,14,0,96,1,150,53,50,46
10,BUZĂU,"LICEUL TEHNOLOGIC PĂTÂRLAGELE",118,"ORAŞ PĂTÂRLAGELE",48325,1,PART,PRCNCT,PRSD,PRSD_SV,"2025-05-18 21:47:00",883,470,418,50,2,465,5,1000,530,196,269
10,BUZĂU,"LICEUL TEHNOLOGIC PĂTÂRLAGELE",119,"ORAŞ PĂTÂRLAGELE",48325,1,PART,PRCNCT,PRSD,PRSD_SV,"2025-05-18 22:10:27",1033,559,503,56,0,552,7,1100,541,234,318
10,BUZĂU,"GRĂDINIŢA CU PROGRAM NORMAL",120,"ORAŞ PĂTÂRLAGELE",48325,1,PART,PRCNCT,PRSD,PRSD_SV,"2025-05-18 22:02:21",508,294,266,28,0,291,3,550,256,157,134
10,BUZĂU,"ŞCOALĂ GIMNAZIALĂ",121,"ORAŞ PĂTÂRLAGELE",48325,1,PART,PRCNCT,PRSD,PRSD_SV,"2025-05-18 21:38:51",1163,628,539,89,0,623,5,1250,622,319,304
10,BUZĂU,"ŞCOALA GENERALĂ",122,"ORAŞ PĂTÂRLAGELE",48325,1,PART,PRCNCT,PRSD,PRSD_SV,"2025-05-18 21:37:15",557,307,279,28,0,304,3,600,293,180,124
10,BUZĂU,"ŞCOALĂ PRIMARĂ",123,"ORAŞ PĂTÂRLAGELE",48325,1,PART,PRCNCT,PRSD,PRSD_SV,"2025-05-18 21:25:10",236,149,108,41,0,148,1,250,101,93,55
10,BUZĂU,"CĂMIN CULTURAL",124,"ORAŞ PĂTÂRLAGELE",48325,1,PART,PRCNCT,PRSD,PRSD_SV,"2025-05-18 21:48:39",689,420,352,68,0,412,8,750,330,201,211
10,BUZĂU,"GRĂDINIŢA CU PROGRAM NORMAL",125,"ORAŞ PĂTÂRLAGELE",48325,1,PART,PRCNCT,PRSD,PRSD_SV,"2025-05-18 21:34:59",349,200,158,42,0,198,2,400,200,95,103
10,BUZĂU,"CĂMIN CULTURAL",126,"ORAŞ PĂTÂRLAGELE",48325,1,PART,PRCNCT,PRSD,PRSD_SV,"2025-05-18 22:03:15",180,129,98,31,0,127,2,201,72,43,84
10,BUZĂU,"ŞCOALA PRIMARĂ",127,"ORAŞ PĂTÂRLAGELE",48325,1,PART,PRCNCT,PRSD,PRSD_SV,"2025-05-18 21:41:16",367,201,168,33,0,199,2,400,199,83,116
10,BUZĂU,"LICEUL TEORETIC POGOANELE",128,"ORAŞ POGOANELE",48744,1,PART,PRCNCT,PRSD,PRSD_SV,"2025-05-18 21:55:30",1422,748,639,74,35,739,9,1550,802,384,355
10,BUZĂU,"CLUBUL COPIILOR POGOANELE",129,"ORAŞ POGOANELE",48744,1,PART,PRCNCT,PRSD,PRSD_SV,"2025-05-18 22:00:09",1361,696,86,610,0,687,9,1500,804,418,269
10,BUZĂU,"ŞCOALA GENERALĂ NR.2 POGOANELE",130,"ORAŞ POGOANELE",48744,1,PART,PRCNCT,PRSD,PRSD_SV,"2025-05-18 22:18:16",1355,700,628,72,0,693,7,1500,800,396,297
10,BUZĂU,"ŞCOALA GENERALĂ CĂLDĂRĂŞTI",131,"ORAŞ POGOANELE",48744,1,PART,PRCNCT,PRSD,PRSD_SV,"2025-05-18 22:08:58",1410,778,701,77,0,770,8,1550,772,456,314
10,BUZĂU,"CASA DE CULTURĂ AMARU",132,AMARU,44863,1,PART,PRCNCT,PRSD,PRSD_SV,"2025-05-18 21:37:39",877,474,403,71,0,465,9,950,476,259,206
10,BUZĂU,"CĂMINUL CULTURAL",133,AMARU,44863,1,PART,PRCNCT,PRSD,PRSD_SV,"2025-05-18 21:34:46",387,203,173,30,0,203,0,450,247,143,60
10,BUZĂU,"CĂMINUL CULTURAL",134,AMARU,44863,1,PART,PRCNCT,PRSD,PRSD_SV,"2025-05-18 21:34:05",176,112,76,36,0,112,0,200,88,81,31
10,BUZĂU,"CAMINUL CULTURAL LUNCA",135,AMARU,44863,1,PART,PRCNCT,PRSD,PRSD_SV,"2025-05-18 21:23:17",272,155,108,47,0,155,0,300,145,93,62
10,BUZĂU,"GRĂDINIŢA CU PROGRAM NORMAL SAT BALTA ALBĂ",136,"BALTA ALBĂ",44934,1,PART,PRCNCT,PRSD,PRSD_SV,"2025-05-18 21:26:42",403,238,182,56,0,238,0,450,212,136,102
10,BUZĂU,"CĂMINUL CULTURAL AMARA",137,"BALTA ALBĂ",44934,1,PART,PRCNCT,PRSD,PRSD_SV,"2025-05-18 22:27:16",1117,578,482,96,0,576,2,1200,622,346,230
10,BUZĂU,"CAMINUL CULTURAL BAILE",138,"BALTA ALBĂ",44934,1,PART,PRCNCT,PRSD,PRSD_SV,"2025-05-18 21:34:54",335,218,147,71,0,217,1,400,182,132,85
10,BUZĂU,"PRIMARIA COMUNEI BĂLĂCEANU",139,BĂLĂCEANU,44989,1,PART,PRCNCT,PRSD,PRSD_SV,"2025-05-18 21:54:14",1195,652,536,81,35,647,5,1300,648,400,247
10,BUZĂU,"ŞCOALA PRIMARĂ BECENI",140,BECENI,45003,1,PART,PRCNCT,PRSD,PRSD_SV,"2025-05-18 22:14:59",776,452,368,70,14,448,4,850,398,226,222
10,BUZĂU,"ŞCOALA PRIMARĂ FLOREŞTI",141,BECENI,45003,1,PART,PRCNCT,PRSD,PRSD_SV,"2025-05-18 21:32:16",172,115,64,38,13,113,2,200,85,44,69
10,BUZĂU,"ŞCOALA GIMNAZIALĂ GURA DIMIENII",142,BECENI,45003,1,PART,PRCNCT,PRSD,PRSD_SV,"2025-05-18 21:42:19",728,467,374,75,18,459,8,800,333,240,219
10,BUZĂU,"ŞCOALA PRIMARĂ IZVORU DULCE",143,BECENI,45003,1,PART,PRCNCT,PRSD,PRSD_SV,"2025-05-18 21:34:35",660,362,291,65,6,359,3,750,388,175,184
10,BUZĂU,"ŞCOALA GIMNAZIALĂ VALEA PĂRULUI",144,BECENI,45003,1,PART,PRCNCT,PRSD,PRSD_SV,"2025-05-18 22:16:20",1056,579,464,99,16,573,6,1150,571,256,317
10,BUZĂU,"CASA DE CULTURĂ BERCA-PARTER",145,BERCA,45101,1,PART,PRCNCT,PRSD,PRSD_SV,"2025-05-18 22:07:17",1234,734,646,87,1,727,7,1350,616,295,432
10,BUZĂU,"GRĂDINIȚA CU PROGRAM NORMAL NITRARIA BERCA",146,BERCA,45101,1,PART,PRCNCT,PRSD,PRSD_SV,"2025-05-18 21:45:30",890,508,457,51,0,504,4,1000,492,222,282
10,BUZĂU,"LICEUL TEHNOLOGIC SF.MUCENIC SAVA, BERCA",147,BERCA,45101,1,PART,PRCNCT,PRSD,PRSD_SV,"2025-05-18 21:24:49",652,416,340,74,2,415,1,700,284,168,247
10,BUZĂU,"CĂMIN CULTURAL JOSENI",148,BERCA,45101,1,PART,PRCNCT,PRSD,PRSD_SV,"2025-05-18 21:25:31",672,429,334,95,0,426,3,750,321,188,238
10,BUZĂU,"CĂMIN CULTURAL PÎCLE",149,BERCA,45101,1,PART,PRCNCT,PRSD,PRSD_SV,"2025-05-18 21:12:53",113,62,44,16,2,60,2,150,88,36,24
10,BUZĂU,"GRĂDINIȚA CU PROGRAM NORMAL SAT PLEȘCOI",150,BERCA,45101,1,PART,PRCNCT,PRSD,PRSD_SV,"2025-05-18 21:26:34",805,475,414,60,1,468,7,900,425,199,269
10,BUZĂU,"GRĂDINIȚA CU PROGRAM NORMAL SAT PLEȘCOI",151,BERCA,45101,1,PART,PRCNCT,PRSD,PRSD_SV,"2025-05-18 21:32:13",711,462,401,61,0,453,9,800,338,201,252
10,BUZĂU,"GRĂDINIȚA CU PROGRAM NORMAL RĂTEŞTI",152,BERCA,45101,1,PART,PRCNCT,PRSD,PRSD_SV,"2025-05-18 21:28:24",699,367,309,58,0,360,7,750,383,155,205
10,BUZĂU,"GRĂDINIŢA SĂTUC",153,BERCA,45101,1,PART,PRCNCT,PRSD,PRSD_SV,"2025-05-18 21:27:50",543,351,282,69,0,346,5,600,249,162,184
10,BUZĂU,"ŞCOALA PRIMARĂ VALEA NUCULUI",154,BERCA,45101,1,PART,PRCNCT,PRSD,PRSD_SV,"2025-05-18 21:44:27",564,370,306,64,0,365,5,650,280,184,181
10,BUZĂU,"SALA DE FESTIVITATI A PRIMARIEI BISOCA",155,BISOCA,45245,1,PART,PRCNCT,PRSD,PRSD_SV,"2025-05-18 21:27:52",419,198,160,38,0,195,3,450,252,95,100
10,BUZĂU,"ŞCOALA GENERALĂ PLEŞI",156,BISOCA,45245,1,PART,PRCNCT,PRSD,PRSD_SV,"2025-05-18 21:53:02",311,147,137,10,0,146,1,350,203,95,51
10,BUZĂU,"CAMPUS PENTRU COPII SF.SAVA - RECEA",157,BISOCA,45245,1,PART,PRCNCT,PRSD,PRSD_SV,"2025-05-18 21:41:39",703,284,261,22,1,282,2,750,466,150,132
10,BUZĂU,"ŞCOALA GENERALĂ SĂRILE",158,BISOCA,45245,1,PART,PRCNCT,PRSD,PRSD_SV,"2025-05-18 21:36:30",355,157,133,24,0,155,2,400,243,80,75
10,BUZĂU,"CĂMINUL CULTURAL BLĂJANI",159,BLĂJANI,45334,1,PART,PRCNCT,PRSD,PRSD_SV,"2025-05-18 21:36:52",544,355,280,74,1,348,7,600,245,182,166
10,BUZĂU,"CĂMINUL CULTURAL SOREŞTI",160,BLĂJANI,45334,1,PART,PRCNCT,PRSD,PRSD_SV,"2025-05-18 21:22:04",219,160,117,43,0,158,2,250,90,90,68
10,BUZĂU,"CLUBUL PRIMĂRIEI BOLDU",161,BOLDU,45361,1,PART,PRCNCT,PRSD,PRSD_SV,"2025-05-18 21:54:03",923,507,430,63,14,498,9,1000,493,276,222
10,BUZĂU,"ȘCOALA GIMNAZIALĂ BOLDU",162,BOLDU,45361,1,PART,PRCNCT,PRSD,PRSD_SV,"2025-05-18 21:41:26",784,411,355,39,17,401,10,850,439,212,189
10,BUZĂU,"ŞCOALA GIMNAZIALĂ BOZIORU",163,BOZIORU,45389,1,PART,PRCNCT,PRSD,PRSD_SV,"2025-05-18 21:41:38",444,268,198,65,5,267,1,499,231,114,153
10,BUZĂU,"ŞCOALA PRIMARĂ FIŞICI",164,BOZIORU,45389,1,PART,PRCNCT,PRSD,PRSD_SV,"2025-05-18 21:21:00",276,148,102,46,0,146,2,300,152,81,65
10,BUZĂU,"ȘCOALA GIMNAZIALĂ COMUNA BRĂDEANU",165,BRĂDEANU,45496,1,PART,PRCNCT,PRSD,PRSD_SV,"2025-05-18 21:35:36",865,372,310,62,0,370,2,950,578,212,158
10,BUZĂU,"GRĂDINIȚA CU PROGRAM NORMAL MITROPOLIA",166,BRĂDEANU,45496,1,PART,PRCNCT,PRSD,PRSD_SV,"2025-05-18 21:31:01",315,201,148,53,0,198,3,350,149,113,85
10,BUZĂU,"ȘCOALA PRIMARĂ SMÂRDAN",167,BRĂDEANU,45496,1,PART,PRCNCT,PRSD,PRSD_SV,"2025-05-18 22:27:27",650,344,278,66,0,339,5,700,356,198,141
10,BUZĂU,"ŞCOALA GIMNAZIALĂ COMUNA BRĂEŞTI",168,BRĂEŞTI,45539,1,PART,PRCNCT,PRSD,PRSD_SV,"2025-05-18 21:29:13",349,188,146,41,1,183,5,400,212,68,115
10,BUZĂU,"ȘCOALA GIMNAZIALĂ BRĂTILEȘTI",169,BRĂEŞTI,45539,1,PART,PRCNCT,PRSD,PRSD_SV,"2025-05-18 21:35:00",993,415,380,34,1,409,6,1100,685,238,171
10,BUZĂU,"CAMINUL CULTURAL PINU",170,BRĂEŞTI,45539,1,PART,PRCNCT,PRSD,PRSD_SV,"2025-05-18 21:21:31",243,170,123,47,0,168,2,300,130,58,110
10,BUZĂU,"CĂMINUL CULTURAL BREAZA",171,BREAZA,45619,1,PART,PRCNCT,PRSD,PRSD_SV,"2025-05-18 21:44:49",744,446,354,92,0,444,2,800,354,238,206
10,BUZĂU,"ŞCOALA GENERALĂ GRECEANCA",172,BREAZA,45619,1,PART,PRCNCT,PRSD,PRSD_SV,"2025-05-18 21:29:18",745,449,322,103,24,445,4,800,351,226,219
10,BUZĂU,"CĂMINUL CULTURAL VISPEȘTI",173,BREAZA,45619,1,PART,PRCNCT,PRSD,PRSD_SV,"2025-05-18 21:34:11",540,346,250,96,0,344,2,600,254,202,142
10,BUZĂU,"ȘCOALA GIMNAZIALĂ COMUNA BUDA",174,BUDA,45673,1,PART,PRCNCT,PRSD,PRSD_SV,"2025-05-18 21:38:02",811,440,371,69,0,435,5,900,460,271,164
10,BUZĂU,"ȘCOALA PRIMARĂ SAT MUCEȘTI-DĂNULEȘTI",175,BUDA,45673,1,PART,PRCNCT,PRSD,PRSD_SV,"2025-05-18 21:30:45",881,410,359,51,0,404,6,1000,590,303,101
10,BUZĂU,"GRADINITA PN PIETROIU",176,BUDA,45673,1,PART,PRCNCT,PRSD,PRSD_SV,"2025-05-18 21:37:29",508,226,206,20,0,216,10,550,324,163,53
10,BUZĂU,"ANEXĂ IMOBIL-PRIMĂRIA COMUNEI CALVINI",177,CALVINI,45753,1,PART,PRCNCT,PRSD,PRSD_SV,"2025-05-18 22:15:39",774,350,306,44,0,347,3,850,500,228,119
10,BUZĂU,"SCOALA GIMNAZIALA ”DUMITRU I. IONESCU” CALVINI",178,CALVINI,45753,1,PART,PRCNCT,PRSD,PRSD_SV,"2025-05-18 21:35:05",1528,384,359,25,0,378,6,1700,1316,309,69
10,BUZĂU,"SCOALA PRIMARA BÎSCENII DE JOS",179,CALVINI,45753,1,PART,PRCNCT,PRSD,PRSD_SV,"2025-05-18 21:25:26",475,240,210,30,0,234,6,550,310,128,106
10,BUZĂU,"SCOALA GIMNAZIALA BÎSCENII DE SUS",180,CALVINI,45753,1,PART,PRCNCT,PRSD,PRSD_SV,"2025-05-18 21:41:04",714,335,289,44,2,330,5,750,415,170,160
10,BUZĂU,"ȘCOALA GIMNAZIALĂ C.A.ROSETTI",181,"C.A. ROSETTI",45815,1,PART,PRCNCT,PRSD,PRSD_SV,"2025-05-18 21:25:33",635,350,294,56,0,344,6,700,350,171,173
10,BUZĂU,"CAMIN CULTURAL BALTENI",182,"C.A. ROSETTI",45815,1,PART,PRCNCT,PRSD,PRSD_SV,"2025-05-18 21:11:32",346,199,155,44,0,198,1,400,201,127,71
10,BUZĂU,"CĂMINUL CULTURAL BÎLHACU",183,"C.A. ROSETTI",45815,1,PART,PRCNCT,PRSD,PRSD_SV,"2025-05-18 21:18:52",145,94,67,27,0,94,0,200,106,56,38
10,BUZĂU,"ŞCOALA PRIMARĂ COTU CIORII",184,"C.A. ROSETTI",45815,1,PART,PRCNCT,PRSD,PRSD_SV,"2025-05-18 21:23:43",455,237,185,52,0,234,3,500,263,152,82
10,BUZĂU,"ȘCOALA GIMNAZIALĂ LUNCA",185,"C.A. ROSETTI",45815,1,PART,PRCNCT,PRSD,PRSD_SV,"2025-05-18 21:40:49",757,379,300,79,0,379,0,850,471,244,135
10,BUZĂU,"ŞCOALA PRIMARĂ VIZIRENI",186,"C.A. ROSETTI",45815,1,PART,PRCNCT,PRSD,PRSD_SV,"2025-05-18 21:19:19",363,227,197,30,0,225,2,400,173,134,91
10,BUZĂU,"CĂMIN CULTURAL CĂNEŞTI",187,CĂNEŞTI,45888,1,PART,PRCNCT,PRSD,PRSD_SV,"2025-05-18 21:30:03",383,276,180,58,38,274,2,450,174,119,155
10,BUZĂU,"SCOALA PRIMARA NEGOSINA",188,CĂNEŞTI,45888,1,PART,PRCNCT,PRSD,PRSD_SV,"2025-05-18 21:30:30",141,118,75,34,9,115,3,150,32,60,55
10,BUZĂU,"ŞCOALA GIMNAZIALĂ NR.1 CĂTINA",189,CĂTINA,45959,1,PART,PRCNCT,PRSD,PRSD_SV,"2025-05-18 21:34:50",556,313,248,64,1,312,1,600,287,139,173
10,BUZĂU,"ŞCOALA GIMNAZIALĂ NR.2 CORBU",190,CĂTINA,45959,1,PART,PRCNCT,PRSD,PRSD_SV,"2025-05-18 21:36:47",614,348,263,85,0,341,7,650,302,187,154
10,BUZĂU,"ŞCOALA CU CLS.I-IV SLOBOZIA",191,CĂTINA,45959,1,PART,PRCNCT,PRSD,PRSD_SV,"2025-05-18 21:46:36",163,104,75,29,0,104,0,201,97,75,29
10,BUZĂU,"ŞCOALA PRIMARĂ NR.1 VALEA CĂTINEI",192,CĂTINA,45959,1,PART,PRCNCT,PRSD,PRSD_SV,"2025-05-18 21:38:47",357,181,155,25,1,180,1,400,219,107,73
10,BUZĂU,"ŞCOALA PRIMARĂ NR.2 ZELETIN",193,CĂTINA,45959,1,PART,PRCNCT,PRSD,PRSD_SV,"2025-05-18 21:18:27",158,31,18,13,0,31,0,200,169,19,12
10,BUZĂU,"GRADINITA CU PROGRAM NORMAL CERNATESTI",194,CERNĂTEŞTI,46019,1,PART,PRCNCT,PRSD,PRSD_SV,"2025-05-18 21:27:20",864,504,419,79,6,499,5,950,446,275,224
10,BUZĂU,"CĂMINUL CULTURAL DIN SATUL ALDENI",195,CERNĂTEŞTI,46019,1,PART,PRCNCT,PRSD,PRSD_SV,"2025-05-18 21:19:58",650,485,367,92,26,474,11,700,215,242,232
10,BUZĂU,"ŞCOALA PRIMARA DIN SATUL FULGA",196,CERNĂTEŞTI,46019,1,PART,PRCNCT,PRSD,PRSD_SV,"2025-05-18 21:17:33",359,229,175,52,2,226,3,400,171,95,131
10,BUZĂU,"CĂMINUL CULTURAL DIN SATUL ZĂRNEŞTI SLĂNIC",197,CERNĂTEŞTI,46019,1,PART,PRCNCT,PRSD,PRSD_SV,"2025-05-18 21:20:54",1045,615,541,71,3,610,5,1150,535,304,306
10,BUZĂU,"CAMINUL CULTURAL CHILIILE",198,CHILIILE,46108,1,PART,PRCNCT,PRSD,PRSD_SV,"2025-05-18 21:22:25",205,146,88,40,18,146,0,250,104,56,90
10,BUZĂU,"ŞCOALA TRESTIOARA",199,CHILIILE,46108,1,PART,PRCNCT,PRSD,PRSD_SV,"2025-05-18 21:37:45",152,97,67,20,10,97,0,200,103,31,66
10,BUZĂU,"GRADINITA CU PROGRAM NORMAL CHIOJDU",200,CHIOJDU,46180,1,PART,PRCNCT,PRSD,PRSD_SV,"2025-05-18 21:31:55",806,461,356,101,4,457,4,900,439,210,247
10,BUZĂU,"ŞCOALA GIMNAZIALA BISCA-CHIOJDULUI",201,CHIOJDU,46180,1,PART,PRCNCT,PRSD,PRSD_SV,"2025-05-18 21:30:34",887,416,367,49,0,410,6,1000,584,236,174
10,BUZĂU,"ŞCOALA PRIMARA CATIASU",202,CHIOJDU,46180,1,PART,PRCNCT,PRSD,PRSD_SV,"2025-05-18 21:25:21",262,124,94,30,0,124,0,300,176,64,60
10,BUZĂU,"ŞCOALA PRIMARA LERA",203,CHIOJDU,46180,1,PART,PRCNCT,PRSD,PRSD_SV,"2025-05-18 21:25:34",331,190,152,38,0,187,3,400,210,131,56
10,BUZĂU,"ŞCOALA PRIMARA PLESCIOARA",204,CHIOJDU,46180,1,PART,PRCNCT,PRSD,PRSD_SV,"2025-05-18 21:14:21",114,72,54,18,0,72,0,150,78,28,44
10,BUZĂU,"ŞCOALA PRIMARA POENITELE",205,CHIOJDU,46180,1,PART,PRCNCT,PRSD,PRSD_SV,"2025-05-18 21:34:04",147,85,56,29,0,83,2,200,115,36,47
10,BUZĂU,"CLĂDIRE SEDIUL ADMINISTRATIV",206,CILIBIA,46251,1,PART,PRCNCT,PRSD,PRSD_SV,"2025-05-18 21:40:32",1203,542,479,62,1,535,7,1300,758,347,188
10,BUZĂU,"ŞCOALA PRIMARĂ DIN SATUL MOVILA OII",207,CILIBIA,46251,1,PART,PRCNCT,PRSD,PRSD_SV,"2025-05-18 21:41:01",264,171,128,43,0,170,1,300,129,111,59
10,BUZĂU,"GRĂDINIŢA CU PROGRAM NORMAL NR. 1 COMUNA CISLĂU",208,CISLĂU,46313,1,PART,PRCNCT,PRSD,PRSD_SV,"2025-05-18 21:46:27",1771,936,817,113,6,923,13,1900,964,483,440
10,BUZĂU,"CENTRUL DE ZI « DOAMNA NEAGA » PENTRU COPII CU VÂRSTE CUPRINSE ÎNTRE 3-6 ANI",209,CISLĂU,46313,2,PART,PRCNCT,PRSD,PRSD_SV,"2025-05-19 00:29:05",603,350,295,54,1,349,1,650,300,222,127
10,BUZĂU,"ŞCOALA PRIMARĂ SAT GURA BÂSCEI, COMUNA CISLĂU",210,CISLĂU,46313,1,PART,PRCNCT,PRSD,PRSD_SV,"2025-05-18 21:38:19",357,197,162,35,0,193,4,400,203,93,100
10,BUZĂU,"ŞCOALA GIMNAZIALĂ SAT SCĂRIŞOARA, COMUNA CISLĂU",211,CISLĂU,46313,1,PART,PRCNCT,PRSD,PRSD_SV,"2025-05-18 21:38:27",1006,636,553,83,0,633,3,1100,464,341,292
10,BUZĂU,"SCOALA GIMNAZIALA COCHIRLEANCA NR.1",212,COCHIRLEANCA,46377,1,PART,PRCNCT,PRSD,PRSD_SV,"2025-05-18 21:28:20",1211,602,549,52,1,597,5,1300,698,387,210
10,BUZĂU,"SCOALA GIMNAZIALA COCHIRLEANCA NR.2",213,COCHIRLEANCA,46377,1,PART,PRCNCT,PRSD,PRSD_SV,"2025-05-18 21:23:15",799,395,363,31,1,391,4,900,505,263,128
10,BUZĂU,"ȘCOALA GIMNAZIALĂ BOBOC",214,COCHIRLEANCA,46377,1,PART,PRCNCT,PRSD,PRSD_SV,"2025-05-18 21:36:12",1317,655,586,69,0,652,3,1450,795,369,283
10,BUZĂU,"SCOALA PRIMARA GARA BOBOCU",215,COCHIRLEANCA,46377,1,PART,PRCNCT,PRSD,PRSD_SV,"2025-05-18 21:25:29",310,247,167,80,0,247,0,350,103,144,103
10,BUZĂU,"CĂMIN CULTURAL ROȘIORU",216,COCHIRLEANCA,46377,1,PART,PRCNCT,PRSD,PRSD_SV,"2025-05-18 21:22:17",532,293,230,63,0,290,3,600,307,147,143
10,BUZĂU,"SCOALA PRIMARA TARLELE",217,COCHIRLEANCA,46377,1,PART,PRCNCT,PRSD,PRSD_SV,"2025-05-18 21:11:46",34,35,18,17,0,35,0,50,15,14,21
10,BUZĂU,"ȘCOALA GIMNAZIALĂ COLȚI",218,COLŢI,46439,1,PART,PRCNCT,PRSD,PRSD_SV,"2025-05-18 21:56:05",344,232,173,59,0,227,5,365,133,96,131
10,BUZĂU,"ȘCOALA GIMNAZIALĂ ALUNIȘ",219,COLŢI,46439,1,PART,PRCNCT,PRSD,PRSD_SV,"2025-05-18 21:24:14",108,114,76,38,0,114,0,150,36,65,49
10,BUZĂU,"ŞCOALA GIMNAZIALĂ COLȚII DE JOS",220,COLŢI,46439,1,PART,PRCNCT,PRSD,PRSD_SV,"2025-05-18 21:19:58",223,123,111,11,1,123,0,250,127,41,82
10,BUZĂU,"CĂMINUL CULTURAL MUSCELUL CĂRĂMĂNEŞTI",221,COLŢI,46439,1,PART,PRCNCT,PRSD,PRSD_SV,"2025-05-18 21:16:52",44,48,20,28,0,47,1,85,37,17,30
10,BUZĂU,"ȘCOALA GIMNAZIALĂ COSTEȘTI",222,COSTEŞTI,46484,1,PART,PRCNCT,PRSD,PRSD_SV,"2025-05-18 21:36:49",1306,765,603,160,2,760,5,1400,635,401,359
10,BUZĂU,"GRĂDINIȚA CU PROGRAM NORMAL BUDIȘTENI",223,COSTEŞTI,46484,1,PART,PRCNCT,PRSD,PRSD_SV,"2025-05-18 21:17:49",371,183,152,31,0,182,1,400,217,124,58
10,BUZĂU,"ŞCOALA PRIMARĂ GOMOEȘTI",224,COSTEŞTI,46484,1,PART,PRCNCT,PRSD,PRSD_SV,"2025-05-18 21:20:43",176,131,89,42,0,129,2,200,69,54,75
10,BUZĂU,"GRĂDINIŢA CU PROGRAM NORMAL PIETROSU",225,COSTEŞTI,46484,1,PART,PRCNCT,PRSD,PRSD_SV,"2025-05-18 21:37:22",1048,427,375,52,0,424,3,1150,723,261,163
10,BUZĂU,"ŞCOALA GIMNAZIALĂ ”GENERAL ȘTEFAN GUȘĂ” SPĂTARU",226,COSTEŞTI,46484,1,PART,PRCNCT,PRSD,PRSD_SV,"2025-05-18 21:58:33",1203,821,664,157,0,816,5,1300,479,338,478
10,BUZĂU,"ŞCOALA COZIENI",227,COZIENI,46554,1,PART,PRCNCT,PRSD,PRSD_SV,"2025-05-18 21:44:36",459,269,205,63,1,267,2,500,231,149,118
10,BUZĂU,"ŞCOALA PRIMARĂ SAT BĂLĂNEȘTI",228,COZIENI,46554,1,PART,PRCNCT,PRSD,PRSD_SV,"2025-05-18 22:10:42",512,322,241,81,0,321,1,550,228,145,176
10,BUZĂU,"ŞCOALA PIETRARU",229,COZIENI,46554,1,PART,PRCNCT,PRSD,PRSD_SV,"2025-05-18 21:23:39",134,106,53,53,0,105,1,150,44,47,58
10,BUZĂU,"CĂMINUL CULTURAL TRESTIA",230,COZIENI,46554,1,PART,PRCNCT,PRSD,PRSD_SV,"2025-05-18 21:17:33",283,167,118,49,0,166,1,350,183,72,94
10,BUZĂU,"ŞCOALA GIMNAZIALA FLORICA",231,FLORICA,50564,1,PART,PRCNCT,PRSD,PRSD_SV,"2025-05-18 21:39:22",968,634,490,143,1,625,9,1050,416,318,307
10,BUZĂU,"ŞCOALA GIMNAZIALĂ GĂLBINAŞI",232,GĂLBINAŞI,46769,1,PART,PRCNCT,PRSD,PRSD_SV,"2025-05-18 21:39:07",1128,646,566,80,0,632,14,1200,554,394,238
10,BUZĂU,"CĂMINUL CULTURAL BENTU",233,GĂLBINAŞI,46769,1,PART,PRCNCT,PRSD,PRSD_SV,"2025-05-18 21:28:46",781,475,403,71,1,472,3,850,375,274,198
10,BUZĂU,"CĂMIN CULTURAL TĂBĂRĂȘTI",234,GĂLBINAŞI,46769,1,PART,PRCNCT,PRSD,PRSD_SV,"2025-05-18 21:39:28",786,442,375,66,1,440,2,900,458,251,189
10,BUZĂU,"GRĂDINIȚA CU PROGRAM NORMAL NR. 2 TĂBĂRĂȘTI",235,GĂLBINAŞI,46769,1,PART,PRCNCT,PRSD,PRSD_SV,"2025-05-18 21:33:10",905,491,440,51,0,486,5,1000,509,272,214
10,BUZĂU,"CĂMIN CULTURAL CU BIBLIOTECĂ",236,GHERĂSENI,46803,1,PART,PRCNCT,PRSD,PRSD_SV,"2025-05-18 22:01:26",1441,848,747,100,1,842,6,1600,752,445,397
10,BUZĂU,"ŞCOALA CU CLASELE I-IV GHERASENI",237,GHERĂSENI,46803,1,PART,PRCNCT,PRSD,PRSD_SV,"2025-05-18 21:42:07",784,449,405,44,0,446,3,850,401,224,222
10,BUZĂU,"ŞCOALA CU CLS.I-IV SUDITI",238,GHERĂSENI,46803,1,PART,PRCNCT,PRSD,PRSD_SV,"2025-05-18 21:41:30",410,242,198,44,0,239,3,450,208,122,117
10,BUZĂU,"ŞCOALA GIMNAZIALA GHERGHEASA",239,GHERGHEASA,46830,1,PART,PRCNCT,PRSD,PRSD_SV,"2025-05-18 21:35:22",934,485,396,84,5,484,1,1000,515,286,198
10,BUZĂU,"ȘCOALA PRIMARĂ SĂLCIOARA",240,GHERGHEASA,46830,1,PART,PRCNCT,PRSD,PRSD_SV,"2025-05-18 21:35:31",774,451,366,74,11,448,3,850,399,249,199
10,BUZĂU,"SCOALA GIMNAZIALA GLODEANU SARAT",241,"GLODEANU SĂRAT",46867,1,PART,PRCNCT,PRSD,PRSD_SV,"2025-05-18 22:24:36",1579,894,748,146,0,882,12,1700,806,532,350
10,BUZĂU,"GRĂDINIȚA CU PROGRAM NORMAL",242,"GLODEANU SĂRAT",46867,1,PART,PRCNCT,PRSD,PRSD_SV,"2025-05-18 21:40:50",460,330,245,85,0,328,2,500,170,160,168
10,BUZĂU,"GRADINITA CU PROGRAM NORMAL ILEANA",243,"GLODEANU SĂRAT",46867,1,PART,PRCNCT,PRSD,PRSD_SV,"2025-05-18 21:34:59",313,206,162,44,0,203,3,350,144,132,71
10,BUZĂU,"ŞCOALA GIMNAZIALA PITULICEA",244,"GLODEANU SĂRAT",46867,1,PART,PRCNCT,PRSD,PRSD_SV,"2025-05-18 21:31:03",718,425,366,59,0,420,5,800,375,230,190
10,BUZĂU,"ȘCOALA GIMNAZIALĂ GLODEANU-SILIȘTEA",245,GLODEANU-SILIŞTEA,46910,1,PART,PRCNCT,PRSD,PRSD_SV,"2025-05-18 21:56:23",933,638,439,192,7,633,5,1000,362,313,320
10,BUZĂU,"GRĂDINIŢA CAŞOTA",246,GLODEANU-SILIŞTEA,46910,1,PART,PRCNCT,PRSD,PRSD_SV,"2025-05-18 21:20:38",265,158,119,39,0,158,0,300,142,92,66
10,BUZĂU,"ŞCOALA CÎRLIGU MARE",247,GLODEANU-SILIŞTEA,46910,1,PART,PRCNCT,PRSD,PRSD_SV,"2025-05-18 21:36:30",293,199,137,61,1,194,5,350,151,82,112
10,BUZĂU,"ȘCOALA PRIMARĂ COTORCA",248,GLODEANU-SILIŞTEA,46910,1,PART,PRCNCT,PRSD,PRSD_SV,"2025-05-18 21:50:31",733,430,325,103,2,426,4,800,370,254,172
10,BUZĂU,"ŞCOALA GIMNAZIALĂ VĂCĂREASCA",249,GLODEANU-SILIŞTEA,46910,1,PART,PRCNCT,PRSD,PRSD_SV,"2025-05-18 21:24:28",346,238,135,101,2,233,5,400,162,138,95
10,BUZĂU,"ŞCOALA GIMNAZIALĂ GREBĂNU",250,GREBĂNU,47006,1,PART,PRCNCT,PRSD,PRSD_SV,"2025-05-18 21:50:26",1825,858,744,86,28,851,7,2000,1142,636,215
10,BUZĂU,"ŞCOALA PRIMARĂ HOMEŞTI",251,GREBĂNU,47006,1,PART,PRCNCT,PRSD,PRSD_SV,"2025-05-18 21:18:51",832,402,328,65,9,397,5,900,498,268,129
10,BUZĂU,"ŞCOALA PRIMARĂ LIVADA",252,GREBĂNU,47006,1,PART,PRCNCT,PRSD,PRSD_SV,"2025-05-18 21:22:25",544,379,276,95,8,373,6,600,221,200,173
10,BUZĂU,"ŞCOALA GIMNAZIALĂ PLEVNA",253,GREBĂNU,47006,1,PART,PRCNCT,PRSD,PRSD_SV,"2025-05-18 21:44:42",1111,666,596,60,10,662,4,1200,534,367,295
10,BUZĂU,"CAMINUL CULTURAL SATUL GURA TEGHII",254,"GURA TEGHII",47079,1,PART,PRCNCT,PRSD,PRSD_SV,"2025-05-18 21:36:34",1053,635,555,79,1,629,6,1150,515,339,290
10,BUZĂU,"CĂMINUL CULTURAL SAT FURTUNEŞTI",255,"GURA TEGHII",47079,1,PART,PRCNCT,PRSD,PRSD_SV,"2025-05-18 22:07:34",691,377,329,47,1,373,4,750,373,189,184
10,BUZĂU,"ŞCOALA GIMNAZIALĂ PĂLTINIŞ",256,"GURA TEGHII",47079,1,PART,PRCNCT,PRSD,PRSD_SV,"2025-05-18 21:54:55",464,278,234,44,0,276,2,500,222,169,107
10,BUZĂU,"ŞCOALA PRIMARĂ VARLAAM",257,"GURA TEGHII",47079,1,PART,PRCNCT,PRSD,PRSD_SV,"2025-05-18 22:00:28",409,234,183,51,0,229,5,450,216,129,100
10,BUZĂU,"PRIMARIA LARGU",258,LARGU,47159,1,PART,PRCNCT,PRSD,PRSD_SV,"2025-05-18 21:29:28",1147,654,550,97,7,647,7,1250,596,342,305
10,BUZĂU,"CLĂDIRE CĂMIN CULTURAL SAT LOPĂTARI",259,LOPĂTARI,47186,1,PART,PRCNCT,PRSD,PRSD_SV,"2025-05-18 21:57:21",828,478,378,92,8,473,5,900,422,215,258
10,BUZĂU,"ŞCOALA PRIMARĂ SAT LUNCILE",260,LOPĂTARI,47186,1,PART,PRCNCT,PRSD,PRSD_SV,"2025-05-18 21:27:59",587,263,241,22,0,261,2,650,387,160,101
10,BUZĂU,"ȘCOALA GIMNAZIALĂ PLAIUL NUCULUI",261,LOPĂTARI,47186,1,PART,PRCNCT,PRSD,PRSD_SV,"2025-05-18 21:44:35",517,248,213,33,2,247,1,599,351,144,103
10,BUZĂU,"ŞCOALA PRIMARĂ SAT PLOŞTINA",262,LOPĂTARI,47186,1,PART,PRCNCT,PRSD,PRSD_SV,"2025-05-18 21:42:38",356,193,167,26,0,193,0,400,207,123,70
10,BUZĂU,"ȘCOALA PRIMARĂ TERCA",263,LOPĂTARI,47186,1,PART,PRCNCT,PRSD,PRSD_SV,"2025-05-18 21:36:56",302,154,129,25,0,153,1,349,195,108,45
10,BUZĂU,"CĂMINUL CULTURAL LUCIU",264,LUCIU,47300,1,PART,PRCNCT,PRSD,PRSD_SV,"2025-05-18 21:55:51",1534,746,658,85,3,738,8,1700,954,471,267
10,BUZĂU,"ŞCOALA CARAGELE",265,LUCIU,47300,1,PART,PRCNCT,PRSD,PRSD_SV,"2025-05-18 21:32:18",627,328,270,58,0,325,3,699,371,168,157
10,BUZĂU,"ȘCOALA GIMNAZIALĂ MĂGURA",266,MĂGURA,47337,1,PART,PRCNCT,PRSD,PRSD_SV,"2025-05-18 22:01:46",1043,727,551,148,28,717,10,1150,423,279,438
10,BUZĂU,"ŞCOALA GIMNAZIALĂ CIUTA",267,MĂGURA,47337,1,PART,PRCNCT,PRSD,PRSD_SV,"2025-05-18 21:34:39",673,344,294,50,0,340,4,750,406,201,139
10,BUZĂU,"SCOALA GENERALA MARACINENI",268,MĂRĂCINENI,47373,1,PART,PRCNCT,PRSD,PRSD_SV,"2025-05-18 21:38:40",1487,939,842,97,0,921,18,1600,661,455,466
10,BUZĂU,"ŞCOALA GENERALĂ MĂRĂCINENI",269,MĂRĂCINENI,47373,1,PART,PRCNCT,PRSD,PRSD_SV,"2025-05-18 21:51:47",1273,789,694,95,0,780,9,1400,611,384,396
10,BUZĂU,"GRĂDINIȚA CU PROGRAM NORMAL CĂPĂȚÂNEȘTI",270,MĂRĂCINENI,47373,1,PART,PRCNCT,PRSD,PRSD_SV,"2025-05-18 21:47:00",1579,951,829,121,1,938,13,1700,749,510,428
10,BUZĂU,"GRĂDINIŢA CU PROGRAM NORMAL CĂPĂŢÂNEŞTI",271,MĂRĂCINENI,47373,1,PART,PRCNCT,PRSD,PRSD_SV,"2025-05-18 21:52:14",1647,998,907,90,1,991,7,1800,802,553,438
10,BUZĂU,"ŞCOALA GENERALĂ POTOCENI",272,MĂRĂCINENI,47373,1,PART,PRCNCT,PRSD,PRSD_SV,"2025-05-18 21:53:20",1818,1182,1044,138,0,1173,9,2000,818,581,592
10,BUZĂU,"PRIMARIA MĂRGĂRITEŞTI",273,MĂRGĂRITEŞTI,47417,1,PART,PRCNCT,PRSD,PRSD_SV,"2025-05-18 21:27:55",435,223,172,51,0,223,0,500,277,102,121
10,BUZĂU,"ŞCOALA GIMNAZIALĂ MÎNZĂLEŞTI",274,MÂNZĂLEŞTI,47630,1,PART,PRCNCT,PRSD,PRSD_SV,"2025-05-18 21:34:49",589,326,294,30,2,322,4,650,324,164,158
10,BUZĂU,"ŞCOALA GIMNAZIALĂ ”DUMITRU N. CRISTEA” BEŞLII",275,MÂNZĂLEŞTI,47630,1,PART,PRCNCT,PRSD,PRSD_SV,"2025-05-18 21:31:04",380,256,190,64,2,254,2,450,194,127,127
10,BUZĂU,"ŞCOALA GIMNAZIALĂ GURA BĂDICULUI",276,MÂNZĂLEŞTI,47630,1,PART,PRCNCT,PRSD,PRSD_SV,"2025-05-18 21:32:25",334,173,144,29,0,171,2,400,227,103,68
10,BUZĂU,"ŞCOALA PRIMARĂ TRESTIOARA",277,MÂNZĂLEŞTI,47630,1,PART,PRCNCT,PRSD,PRSD_SV,"2025-05-18 21:25:43",271,139,126,13,0,138,1,300,161,74,64
10,BUZĂU,"ŞCOALA PRIMARĂ VALEA COTOAREI",278,MÂNZĂLEŞTI,47630,1,PART,PRCNCT,PRSD,PRSD_SV,"2025-05-18 21:22:54",160,104,79,25,0,104,0,200,96,59,45
10,BUZĂU,"ŞCOALA GIMNAZIALĂ MEREI",279,MEREI,47453,1,PART,PRCNCT,PRSD,PRSD_SV,"2025-05-18 21:55:57",955,584,430,154,0,578,6,850,266,297,281
10,BUZĂU,"ŞCOALA PRIMARĂ DEALUL VIEI",280,MEREI,47453,1,PART,PRCNCT,PRSD,PRSD_SV,"2025-05-18 21:42:01",615,408,330,77,1,400,8,700,292,200,200
10,BUZĂU,"ŞCOALA GURA SĂRĂŢII",281,MEREI,47453,1,PART,PRCNCT,PRSD,PRSD_SV,"2025-05-18 21:22:36",140,102,69,33,0,100,2,150,48,46,54
10,BUZĂU,"GRĂDINIȚA CU PROGRAM NORMAL SAT IZVORU DULCE COMUNA MEREI",282,MEREI,47453,1,PART,PRCNCT,PRSD,PRSD_SV,"2025-05-18 21:25:37",700,396,320,76,0,394,2,750,354,248,146
10,BUZĂU,"GRĂDINIȚA CU PROGRAM PRELUNGIT LIPIA",283,MEREI,47453,1,PART,PRCNCT,PRSD,PRSD_SV,"2025-05-18 22:28:55",1582,1007,828,177,2,999,8,1700,693,558,441
10,BUZĂU,"ŞCOALA NENCIULEŞTI",284,MEREI,47453,1,PART,PRCNCT,PRSD,PRSD_SV,"2025-05-18 21:22:19",229,143,107,36,0,140,3,250,107,58,82
10,BUZĂU,"ŞCOALA PRIMARĂ OGRĂZILE",285,MEREI,47453,1,PART,PRCNCT,PRSD,PRSD_SV,"2025-05-18 21:49:31",572,319,262,57,0,318,1,650,331,164,154
10,BUZĂU,"SALA DE SPORT SĂRATA MONTEORU",286,MEREI,47453,1,PART,PRCNCT,PRSD,PRSD_SV,"2025-05-18 21:57:35",676,813,369,444,0,801,12,950,137,305,496
10,BUZĂU,"CENTRU EDUCAȚIONAL MULTIFUNCȚIONAL ”ÎMPREUNĂ”",287,MIHĂILEŞTI,47578,1,PART,PRCNCT,PRSD,PRSD_SV,"2025-05-18 21:37:08",935,465,379,86,0,452,13,1000,535,269,183
10,BUZĂU,"ŞCOALA PRIMARA MĂRGINEANU",288,MIHĂILEŞTI,47578,1,PART,PRCNCT,PRSD,PRSD_SV,"2025-05-18 21:36:40",683,326,292,32,2,321,5,750,424,248,73
10,BUZĂU,"GRĂDINIȚA CU PROGRAM NORMAL MOVILA BANULUI",289,"MOVILA BANULUI",47774,1,PART,PRCNCT,PRSD,PRSD_SV,"2025-05-18 22:03:40",1159,686,527,159,0,678,8,1250,564,356,322
10,BUZĂU,"GRĂDINIŢA CU PROGRAM NORMAL LIMPEZIŞ",290,"MOVILA BANULUI",47774,1,PART,PRCNCT,PRSD,PRSD_SV,"2025-05-18 22:03:48",776,478,404,74,0,473,5,850,372,244,229
10,BUZĂU,"CĂMINUL CULTURAL MURGEȘTI",291,MURGEŞTI,47818,1,PART,PRCNCT,PRSD,PRSD_SV,"2025-05-18 21:48:04",653,390,308,82,0,384,6,700,310,216,168
10,BUZĂU,"ŞCOALA GIMNAZIALĂ NĂENI",292,NĂENI,47854,1,PART,PRCNCT,PRSD,PRSD_SV,"2025-05-18 21:32:47",454,290,222,68,0,289,1,500,210,171,118
10,BUZĂU,"ŞCOALA PRIMARĂ FINŢESTI",293,NĂENI,47854,1,PART,PRCNCT,PRSD,PRSD_SV,"2025-05-18 21:27:53",448,281,231,50,0,279,2,500,219,131,148
10,BUZĂU,"GRĂDINIŢA PROSCA",294,NĂENI,47854,1,PART,PRCNCT,PRSD,PRSD_SV,"2025-05-18 21:25:36",159,114,83,31,0,113,1,200,86,66,47
10,BUZĂU,"ŞCOALA VÎRF",295,NĂENI,47854,1,PART,PRCNCT,PRSD,PRSD_SV,"2025-05-18 21:16:01",170,113,82,31,0,110,3,200,87,77,33
10,BUZĂU,"ŞCOALA GIMNAZIALĂ ODĂILE",296,ODĂILE,48021,1,PART,PRCNCT,PRSD,PRSD_SV,"2025-05-18 21:34:07",529,312,249,55,8,310,2,600,288,123,187
10,BUZĂU,"GRADINITA CU PROGRAM NORMAL NR. 2 COMUNA PADINA",297,PADINA,48138,1,PART,PRCNCT,PRSD,PRSD_SV,"2025-05-18 22:04:04",1219,595,521,74,0,593,2,1300,705,375,218
10,BUZĂU,"CĂMINUL CULTURAL PADINA",298,PADINA,48138,1,PART,PRCNCT,PRSD,PRSD_SV,"2025-05-18 22:02:23",778,384,298,86,0,376,8,850,466,203,173
10,BUZĂU,"SCOALA GIMNAZIALA NR.1 COMUNA PADINA",299,PADINA,48138,1,PART,PRCNCT,PRSD,PRSD_SV,"2025-05-18 21:56:40",890,495,350,144,1,485,10,1000,505,239,246
10,BUZĂU,"ŞCOALA PARDOŞI",300,PARDOŞI,48165,1,PART,PRCNCT,PRSD,PRSD_SV,"2025-05-18 21:47:53",258,164,121,43,0,163,1,300,136,73,90
10,BUZĂU,"ŞCOALA GIMNAZIALĂ PĂNĂTĂU",301,PĂNĂTĂU,48227,1,PART,PRCNCT,PRSD,PRSD_SV,"2025-05-18 22:02:42",1159,616,531,84,1,599,17,1250,634,276,323
10,BUZĂU,"ŞCOALA PRIMARĂ BEGU",302,PĂNĂTĂU,48227,1,PART,PRCNCT,PRSD,PRSD_SV,"2025-05-18 21:29:22",168,110,94,16,0,108,2,182,72,50,58
10,BUZĂU,"ŞCOALA TEGA",303,PĂNĂTĂU,48227,1,PART,PRCNCT,PRSD,PRSD_SV,"2025-05-18 21:31:28",453,274,220,54,0,271,3,500,226,133,138
10,BUZĂU,"CĂMINUL CULTURAL PÎRSCOV",304,PÂRSCOV,48557,2,PART,PRCNCT,PRSD,PRSD_SV,"2025-05-18 23:18:38",1216,613,517,95,1,605,8,1300,687,318,287
10,BUZĂU,"CĂMINUL CULTURAL PÎRSCOV",305,PÂRSCOV,48557,1,PART,PRCNCT,PRSD,PRSD_SV,"2025-05-18 21:57:07",1170,636,556,80,0,628,8,1300,664,332,296
10,BUZĂU,"ŞCOALA GENERALĂ BĂDILA",306,PÂRSCOV,48557,1,PART,PRCNCT,PRSD,PRSD_SV,"2025-05-18 21:40:14",628,279,249,30,0,277,2,700,421,198,79
10,BUZĂU,"ŞCOALA LUNCA FRUMOASA",307,PÂRSCOV,48557,1,PART,PRCNCT,PRSD,PRSD_SV,"2025-05-18 21:42:54",850,469,405,64,0,463,6,900,431,225,238
10,BUZĂU,"ŞCOALA GENERALĂ ROBEŞTI",308,PÂRSCOV,48557,1,PART,PRCNCT,PRSD,PRSD_SV,"2025-05-18 21:34:50",457,297,223,67,7,294,3,500,203,121,173
10,BUZĂU,"FOSTUL MAGAZIN TRESTIENI",309,PÂRSCOV,48557,1,PART,PRCNCT,PRSD,PRSD_SV,"2025-05-18 21:16:10",21,31,7,24,0,31,0,50,19,20,11
10,BUZĂU,"ŞCOALA GIMNAZIALĂ PIETROASELE",310,PIETROASELE,48487,1,PART,PRCNCT,PRSD,PRSD_SV,"2025-05-18 22:47:42",1464,844,646,174,24,839,5,1600,756,403,436
10,BUZĂU,"GRĂDINIŢA CU PROGRAM NORMAL DIN SATUL ŞARÎNGA",311,PIETROASELE,48487,1,PART,PRCNCT,PRSD,PRSD_SV,"2025-05-18 22:16:14",1096,657,506,129,22,645,12,1200,543,311,334
10,BUZĂU,"ŞCOALA GIMNAZIALĂ PODGORIA",312,PODGORIA,48682,1,PART,PRCNCT,PRSD,PRSD_SV,"2025-05-18 22:00:02",1278,756,678,75,3,745,11,1400,644,450,295
10,BUZĂU,"ŞCOALA GIMNAZIALĂ COȚATCU",313,PODGORIA,48682,1,PART,PRCNCT,PRSD,PRSD_SV,"2025-05-18 21:47:34",943,490,411,79,0,483,7,1050,560,318,165
10,BUZĂU,"ŞCOALA PRIMARĂ PLEȘEȘTI",314,PODGORIA,48682,1,PART,PRCNCT,PRSD,PRSD_SV,"2025-05-18 21:40:00",277,155,127,27,1,153,2,300,145,99,54
10,BUZĂU,"GRĂDINIŢA DE COPII POŞTA CÎLNĂU",315,"POŞTA CÂLNĂU",48771,1,PART,PRCNCT,PRSD,PRSD_SV,"2025-05-18 21:22:36",1024,607,543,64,0,606,1,1100,493,332,274
10,BUZĂU,"GRĂDINIŢA DE COPII POŞTA CÎLNĂU",316,"POŞTA CÂLNĂU",48771,1,PART,PRCNCT,PRSD,PRSD_SV,"2025-05-18 21:38:52",975,618,540,76,2,608,10,1050,432,288,320
10,BUZĂU,"SCOALA GENERALA DIN POTIRNICHESTI",317,"POŞTA CÂLNĂU",48771,1,PART,PRCNCT,PRSD,PRSD_SV,"2025-05-18 21:23:13",418,272,219,53,0,271,1,450,178,160,111
10,BUZĂU,"ŞCOALA GENERALĂ, SATUL SUDIŢI",318,"POŞTA CÂLNĂU",48771,1,PART,PRCNCT,PRSD,PRSD_SV,"2025-05-18 21:42:24",1435,829,713,116,0,823,6,1600,771,446,377
10,BUZĂU,"ŞCOALA GENERALĂ ZILIŞTEANCA",319,"POŞTA CÂLNĂU",48771,1,PART,PRCNCT,PRSD,PRSD_SV,"2025-05-18 21:21:44",1066,568,529,39,0,563,5,1150,582,316,247
10,BUZĂU,"ŞCOALA GIMNAZIALĂ PUIEŞTII DE JOS",320,PUIEŞTI,48842,1,PART,PRCNCT,PRSD,PRSD_SV,"2025-05-18 21:32:08",986,506,417,86,3,499,7,1100,594,258,241
10,BUZĂU,"GRĂDINIŢA DĂSCĂLEŞTI",321,PUIEŞTI,48842,1,PART,PRCNCT,PRSD,PRSD_SV,"2025-05-18 21:30:16",530,268,209,59,0,267,1,600,332,128,139
10,BUZĂU,"ŞCOALA MĂCRINA",322,PUIEŞTI,48842,1,PART,PRCNCT,PRSD,PRSD_SV,"2025-05-18 21:23:35",405,233,167,66,0,232,1,450,217,105,127
10,BUZĂU,"ŞCOALA GIMNAZIALĂ NICOLEŞTI",323,PUIEŞTI,48842,1,PART,PRCNCT,PRSD,PRSD_SV,"2025-05-18 21:39:44",524,267,214,53,0,261,6,600,333,133,128
10,BUZĂU,"ŞCOALA PUIEŞTII DE SUS",324,PUIEŞTI,48842,1,PART,PRCNCT,PRSD,PRSD_SV,"2025-05-18 21:27:28",265,166,120,46,0,164,2,300,134,78,86
10,BUZĂU,"PRIMĂRIA RACOVIŢENI",325,RACOVIŢENI,48922,1,PART,PRCNCT,PRSD,PRSD_SV,"2025-05-18 22:10:37",970,530,439,91,0,524,6,1051,521,285,239
10,BUZĂU,"CĂMIN CULTURAL",326,RÂMNICELU,48968,1,PART,PRCNCT,PRSD,PRSD_SV,"2025-05-18 21:40:52",1048,443,371,72,0,439,4,1150,707,278,161
10,BUZĂU,"SCOALA NR.2 SAT RAMNICELU",327,RÂMNICELU,48968,1,PART,PRCNCT,PRSD,PRSD_SV,"2025-05-18 21:39:35",1472,517,497,20,0,509,8,1600,1083,417,92
10,BUZĂU,"ŞCOALA SAT COLIBAŞI",328,RÂMNICELU,48968,1,PART,PRCNCT,PRSD,PRSD_SV,"2025-05-18 21:21:49",337,193,162,31,0,190,3,400,207,96,94
10,BUZĂU,"ŞCOALA SAT FOTIN",329,RÂMNICELU,48968,2,PART,PRCNCT,PRSD,PRSD_SV,"2025-05-18 22:59:58",195,136,108,28,0,134,2,250,114,85,49
10,BUZĂU,"SCOALA SAT ŞTIUBEI",330,RÂMNICELU,48968,1,PART,PRCNCT,PRSD,PRSD_SV,"2025-05-18 21:27:42",475,303,246,57,0,301,2,550,247,194,107
10,BUZĂU,"ŞCOALA GIMNAZIALĂ ROBEASCA",331,ROBEASCA,49019,1,PART,PRCNCT,PRSD,PRSD_SV,"2025-05-18 21:48:31",539,241,196,45,0,236,5,600,359,147,89
10,BUZĂU,"CAMINUL CULTURAL MOŞEŞTI",332,ROBEASCA,49019,1,PART,PRCNCT,PRSD,PRSD_SV,"2025-05-18 21:37:18",242,200,101,93,6,199,1,300,100,95,104
10,BUZĂU,"LICEUL TEHNOLOGIC RUȘEȚU",333,RUŞEŢU,49046,1,PART,PRCNCT,PRSD,PRSD_SV,"2025-05-18 21:56:47",920,463,395,67,1,459,4,1000,537,322,137
10,BUZĂU,"CLĂDIREA GRĂDINIŢEI CU PROGRAM NORMAL",334,RUŞEŢU,49046,1,PART,PRCNCT,PRSD,PRSD_SV,"2025-05-18 21:51:56",875,439,406,33,0,436,3,950,511,281,155
10,BUZĂU,"CĂMINUL CULTURAL ”DIMITRIE GUSTI”",335,RUŞEŢU,49046,1,PART,PRCNCT,PRSD,PRSD_SV,"2025-05-18 21:59:55",874,504,390,114,0,501,3,950,446,305,196
10,BUZĂU,"ŞCOALA PRIMARĂ",336,RUŞEŢU,49046,1,PART,PRCNCT,PRSD,PRSD_SV,"2025-05-18 21:27:24",148,101,86,15,0,99,2,200,99,56,43
10,BUZĂU,"ȘCOALA GIMNAZIALĂ „NICOLAE EFRIMESCU” SĂGEATA",337,SĂGEATA,49073,1,PART,PRCNCT,PRSD,PRSD_SV,"2025-05-18 21:40:06",1006,638,522,91,25,626,12,1100,462,336,290
10,BUZĂU,"CĂMINUL CULTURAL SĂGEATA",338,SĂGEATA,49073,1,PART,PRCNCT,PRSD,PRSD_SV,"2025-05-18 21:27:30",306,207,167,39,1,206,1,350,143,108,98
10,BUZĂU,"SCOALA BANIŢA",339,SĂGEATA,49073,1,PART,PRCNCT,PRSD,PRSD_SV,"2025-05-18 21:36:48",208,165,107,58,0,163,2,250,85,98,65
10,BUZĂU,"ŞCOALA BEILIC",340,SĂGEATA,49073,1,PART,PRCNCT,PRSD,PRSD_SV,"2025-05-18 21:17:48",285,190,164,26,0,187,3,350,160,125,62
10,BUZĂU,"ŞCOALA GIMNAZIALĂ SAT DÂMBROCA",341,SĂGEATA,49073,2,PART,PRCNCT,PRSD,PRSD_SV,"2025-05-18 22:51:07",955,619,509,84,26,613,6,1050,431,348,265
10,BUZĂU,"ŞCOALA GĂVĂNEŞTI",342,SĂGEATA,49073,1,PART,PRCNCT,PRSD,PRSD_SV,"2025-05-18 21:33:38",761,419,359,59,1,416,3,850,431,257,159
10,BUZĂU,"GRĂDINIȚA CU PROGRAM NORMAL SĂHĂTENI",343,SĂHĂTENI,49153,1,PART,PRCNCT,PRSD,PRSD_SV,"2025-05-18 21:53:56",1292,715,611,91,13,708,7,1400,685,366,342
10,BUZĂU,"ŞCOALA CU CLS.I-IV GĂGENI",344,SĂHĂTENI,49153,1,PART,PRCNCT,PRSD,PRSD_SV,"2025-05-18 21:33:38",358,194,158,36,0,190,4,400,206,136,54
10,BUZĂU,"ŞCOALA CU CLS.I-IV ISTRIŢA DE JOS",345,SĂHĂTENI,49153,1,PART,PRCNCT,PRSD,PRSD_SV,"2025-05-18 22:02:09",250,161,110,51,0,160,1,300,139,109,51
10,BUZĂU,"ŞCOALA CLS.I-VIII VINTILEANCA",346,SĂHĂTENI,49153,1,PART,PRCNCT,PRSD,PRSD_SV,"2025-05-18 21:43:20",636,336,292,44,0,329,7,700,364,202,127
10,BUZĂU,"ȘCOALA GIMNAZIALĂ SĂPOCA",347,SĂPOCA,49206,1,PART,PRCNCT,PRSD,PRSD_SV,"2025-05-18 22:45:55",1468,1065,770,145,150,1053,12,1600,535,539,514
10,BUZĂU,"ȘCOALA GIMNAZIALĂ MĂTESTI",348,SĂPOCA,49206,1,PART,PRCNCT,PRSD,PRSD_SV,"2025-05-18 22:31:01",1436,890,780,90,20,882,8,1600,710,473,409
10,BUZĂU,"CĂMINUL CULTURAL SĂRULEŞTI",349,SĂRULEŞTI,49233,1,PART,PRCNCT,PRSD,PRSD_SV,"2025-05-18 21:39:18",971,502,419,83,0,495,7,1050,548,286,209
10,BUZĂU,"SALA DE FESTIVITĂŢI SCORTOASA",350,SCORŢOASA,49313,1,PART,PRCNCT,PRSD,PRSD_SV,"2025-05-18 21:55:26",957,509,418,89,2,502,7,1050,541,275,227
10,BUZĂU,"SCOALA GIMNAZIALĂ SAT BALTA TOCILA",351,SCORŢOASA,49313,1,PART,PRCNCT,PRSD,PRSD_SV,"2025-05-18 21:19:34",237,141,110,29,2,140,1,250,109,71,69
10,BUZĂU,"ŞCOALA PRIMARĂ SAT BECIU",352,SCORŢOASA,49313,1,PART,PRCNCT,PRSD,PRSD_SV,"2025-05-18 21:15:53",109,80,51,29,0,79,1,150,70,41,38
10,BUZĂU,"ŞCOALA PRIMARĂ SAT GOLU GRABICINA",353,SCORŢOASA,49313,1,PART,PRCNCT,PRSD,PRSD_SV,"2025-05-18 21:31:32",224,127,102,25,0,125,2,250,123,80,45
10,BUZĂU,"ŞCOALA PRIMARĂ SAT GRABICINA DE JOS",354,SCORŢOASA,49313,1,PART,PRCNCT,PRSD,PRSD_SV,"2025-05-18 21:22:25",115,82,66,16,0,82,0,150,68,42,40
10,BUZĂU,"ŞCOALA PRIMARĂ SAT GURA VĂII",355,SCORŢOASA,49313,1,PART,PRCNCT,PRSD,PRSD_SV,"2025-05-18 21:10:35",161,100,68,32,0,98,2,200,100,42,56
10,BUZĂU,"ŞCOALA PRIMARĂ SAT PLOPEASA DE SUS",356,SCORŢOASA,49313,1,PART,PRCNCT,PRSD,PRSD_SV,"2025-05-18 21:12:32",115,49,34,15,0,49,0,150,101,30,19
10,BUZĂU,"GRĂDINIȚA CU PROGRAM NORMAL SCUTELNICI",357,SCUTELNICI,49439,1,PART,PRCNCT,PRSD,PRSD_SV,"2025-05-18 22:16:23",814,441,322,103,16,435,6,900,459,238,197
10,BUZĂU,"ŞCOALA PRIMARA SAT ARCANU",358,SCUTELNICI,49439,1,PART,PRCNCT,PRSD,PRSD_SV,"2025-05-18 21:20:56",309,186,152,28,6,184,2,350,164,81,103
10,BUZĂU,"GRĂDINIȚA CU PROGRAM NORMAL BRĂGĂREASA",359,SCUTELNICI,49439,1,PART,PRCNCT,PRSD,PRSD_SV,"2025-05-18 21:24:24",471,314,222,83,9,311,3,550,236,151,160
10,BUZĂU,"CĂMIN CULTURAL SIRIU",360,SIRIU,49484,1,PART,PRCNCT,PRSD,PRSD_SV,"2025-05-18 21:53:30",1350,822,718,95,9,807,15,1500,678,435,372
10,BUZĂU,"ŞCOALA PRIMARĂ SAT COLŢU PIETRII,COMUNA SIRIU,JUDETUL BUZĂU",361,SIRIU,49484,1,PART,PRCNCT,PRSD,PRSD_SV,"2025-05-18 22:09:26",1144,717,664,45,8,703,14,1250,533,439,264
10,BUZĂU,"CĂMINUL DE NUNTI SMEENI",362,SMEENI,49545,1,PART,PRCNCT,PRSD,PRSD_SV,"2025-05-18 21:43:42",1108,548,483,65,0,542,6,1200,652,298,244
10,BUZĂU,"GRĂDINIȚA CU PROGRAM NORMAL SMEENI",363,SMEENI,49545,1,PART,PRCNCT,PRSD,PRSD_SV,"2025-05-18 21:31:00",1099,599,493,80,26,595,4,1200,601,282,313
10,BUZĂU,"ȘCOALA PRIMARĂ SĂLCIOARA",364,SMEENI,49545,1,PART,PRCNCT,PRSD,PRSD_SV,"2025-05-18 21:27:39",550,278,242,36,0,270,8,600,322,120,150
10,BUZĂU,"ŞCOALA GIMNAZIALĂ ALBEŞTI",365,SMEENI,49545,1,PART,PRCNCT,PRSD,PRSD_SV,"2025-05-18 21:32:43",670,333,284,49,0,331,2,750,417,183,148
10,BUZĂU,"ŞCOALA PRMARĂ CĂLŢUNA",366,SMEENI,49545,1,PART,PRCNCT,PRSD,PRSD_SV,"2025-05-18 21:25:57",396,229,201,28,0,228,1,450,221,177,51
10,BUZĂU,"GRĂDINIȚA CU PROGRAM NORMAL MOISICA",367,SMEENI,49545,1,PART,PRCNCT,PRSD,PRSD_SV,"2025-05-18 21:14:51",282,162,132,30,0,162,0,350,188,92,70
10,BUZĂU,"ŞCOALA PRMARĂ LUCIENI",368,SMEENI,49545,1,PART,PRCNCT,PRSD,PRSD_SV,"2025-05-18 21:17:53",305,134,110,24,0,133,1,350,216,89,44
10,BUZĂU,"GRĂDINIȚA CU PROGRAM NORMAL UDAŢI- MÂNZU",369,SMEENI,49545,1,PART,PRCNCT,PRSD,PRSD_SV,"2025-05-18 21:35:25",708,365,309,56,0,362,3,800,435,231,131
10,BUZĂU,"SCOALA GIMNAZIALA STILPU",370,STÂLPU,49625,1,PART,PRCNCT,PRSD,PRSD_SV,"2025-05-18 22:08:31",1386,738,663,74,1,733,5,1500,762,421,312
10,BUZĂU,"PRIMARIA STILPU",371,STÂLPU,49625,1,PART,PRCNCT,PRSD,PRSD_SV,"2025-05-18 22:06:34",1160,634,579,54,1,630,4,1250,616,356,274
10,BUZĂU,"CAMINUL CULTURAL SAT GRAJDANA",372,TISĂU,49643,1,PART,PRCNCT,PRSD,PRSD_SV,"2025-05-18 21:35:33",822,506,426,80,0,501,5,900,394,273,228
10,BUZĂU,"ŞCOALA GIMNAZIALA SAT HALEŞ, COMUNA TISAU",373,TISĂU,49643,1,PART,PRCNCT,PRSD,PRSD_SV,"2025-05-18 21:21:38",751,415,317,94,4,410,5,850,435,248,162
10,BUZĂU,"SCOALA PRIMARA, SAT IZVORANU, COMUNA TISAU",374,TISĂU,49643,1,PART,PRCNCT,PRSD,PRSD_SV,"2025-05-18 21:14:10",86,69,38,31,0,69,0,100,31,37,32
10,BUZĂU,"GRADINITA CU PROGRAM NORMAL SAT PADURENI, COMUNA TISAU",375,TISĂU,49643,1,PART,PRCNCT,PRSD,PRSD_SV,"2025-05-18 21:26:55",397,217,183,34,0,211,6,450,233,139,72
10,BUZĂU,"SCOALA PRIMARĂ SAT STREZENI, COMUNA TISAU",376,TISĂU,49643,1,PART,PRCNCT,PRSD,PRSD_SV,"2025-05-18 21:37:40",430,284,212,72,0,282,2,500,216,152,130
10,BUZĂU,"GRADINIŢĂ CU PROGRAM NORMAL COMUNA TISAU",377,TISĂU,49643,1,PART,PRCNCT,PRSD,PRSD_SV,"2025-05-18 22:05:20",583,340,276,64,0,334,6,650,310,181,153
10,BUZĂU,"GRADINIŢA CU PROGRAM NORMAL SAT VALEA SĂLCIILOR, COMUNA TISAU",378,TISĂU,49643,1,PART,PRCNCT,PRSD,PRSD_SV,"2025-05-18 21:23:12",526,305,240,63,2,303,2,550,245,185,118
10,BUZĂU,"GRĂDINIȚA CU PROGRAM NORMAL TOPLICENI",379,TOPLICENI,49769,1,PART,PRCNCT,PRSD,PRSD_SV,"2025-05-18 21:34:28",991,510,461,49,0,501,9,1100,590,341,160
10,BUZĂU,"ŞCOALA GIMNAZIALA BĂBENI ”ION ARISTOTEL”",380,TOPLICENI,49769,1,PART,PRCNCT,PRSD,PRSD_SV,"2025-05-18 21:29:14",790,368,308,60,0,366,2,900,532,230,136
10,BUZĂU,"GRADINITA CU PROGRAM NORMAL DEDULEŞTI",381,TOPLICENI,49769,1,PART,PRCNCT,PRSD,PRSD_SV,"2025-05-18 21:42:44",714,344,301,43,0,337,7,800,456,239,98
10,BUZĂU,"SCOALA GURA-FAGETULUI",382,TOPLICENI,49769,1,PART,PRCNCT,PRSD,PRSD_SV,"2025-05-18 21:15:25",149,120,84,36,0,119,1,200,80,84,35
10,BUZĂU,"ŞCOALA PRIMARA POŞTA",383,TOPLICENI,49769,1,PART,PRCNCT,PRSD,PRSD_SV,"2025-05-18 21:22:40",417,302,212,90,0,292,10,450,148,194,98
10,BUZĂU,"GRADINITA CU PROGRAM NORMAL RĂDUCEŞTI",384,TOPLICENI,49769,1,PART,PRCNCT,PRSD,PRSD_SV,"2025-05-18 21:37:53",391,199,175,24,0,197,2,450,251,143,54
10,BUZĂU,"ŞCOALA PRIMARA SAT ŢINTEŞTI",385,ŢINTEŞTI,49849,1,PART,PRCNCT,PRSD,PRSD_SV,"2025-05-18 21:55:47",1784,978,876,102,0,969,9,1950,972,653,316
10,BUZĂU,"CÃMIN CULTURAL",386,ŢINTEŞTI,49849,1,PART,PRCNCT,PRSD,PRSD_SV,"2025-05-18 22:00:56",1791,961,854,107,0,949,12,2000,1039,594,355
10,BUZĂU,"CLĂDIRE SALA DE EDUCAȚIE FIZICĂ ȘCOLARA ULMENI",387,ULMENI,49894,1,PART,PRCNCT,PRSD,PRSD_SV,"2025-05-18 22:05:55",1213,707,524,183,0,702,5,1300,593,375,327
10,BUZĂU,"CLĂDIRE CĂMIN CULTURAL CLONDIRU",388,ULMENI,49894,1,PART,PRCNCT,PRSD,PRSD_SV,"2025-05-18 21:46:37",1284,656,548,106,2,650,6,1400,744,334,316
10,BUZĂU,"SCOALA GIMNAZIALA ING. OPRISAN IARCA UNGURIU",389,UNGURIU,50549,1,PART,PRCNCT,PRSD,PRSD_SV,"2025-05-18 21:52:48",926,526,444,0,82,523,3,1000,474,258,265
10,BUZĂU,"SCOALA GIMNAZIALA ING. OPRISAN IARCA UNGURIU",390,UNGURIU,50549,1,PART,PRCNCT,PRSD,PRSD_SV,"2025-05-18 21:42:07",953,567,418,149,0,562,5,1050,483,250,312
10,BUZĂU,"SALA DE FESTIVITĂŢI A PRIMĂRIEI COMUNEI VADU PAŞII",391,"VADU PAŞII",49956,1,PART,PRCNCT,PRSD,PRSD_SV,"2025-05-18 22:06:20",1847,1178,1018,154,6,1167,11,2000,822,589,578
10,BUZĂU,"GRĂDINIŢA CU PROGRAM NORMAL VADU PAŞII",392,"VADU PAŞII",49956,1,PART,PRCNCT,PRSD,PRSD_SV,"2025-05-18 22:07:13",1655,1016,933,82,1,997,19,1800,784,549,448
10,BUZĂU,"SCOALA FOCŞĂNEI",393,"VADU PAŞII",49956,1,PART,PRCNCT,PRSD,PRSD_SV,"2025-05-18 22:09:31",1505,910,778,126,6,902,8,1650,740,469,433
10,BUZĂU,"SCOALA CIOCÂRLIA",394,"VADU PAŞII",49956,1,PART,PRCNCT,PRSD,PRSD_SV,"2025-05-18 21:48:18",562,354,318,35,1,352,2,612,258,175,177
10,BUZĂU,"SCOALA GIMNAZIALA SCURTEŞTI",395,"VADU PAŞII",49956,2,PART,PRCNCT,PRSD,PRSD_SV,"2025-05-18 23:10:21",1666,949,868,77,4,945,4,1800,851,568,377
10,BUZĂU,"GRĂDINIȚA CU PROGRAM NORMAL STĂNCEŞTI",396,"VADU PAŞII",49956,1,PART,PRCNCT,PRSD,PRSD_SV,"2025-05-18 21:35:19",1180,680,620,57,3,677,3,1300,620,436,241
10,BUZĂU,"SCOALA GIMNAZIALA VALEA RAMNICULUI",397,"VALEA RÂMNICULUI",50022,1,PART,PRCNCT,PRSD,PRSD_SV,"2025-05-18 22:11:47",1757,990,912,77,1,975,15,1900,910,583,392
10,BUZĂU,"ȘCOALA GIMNAZIALĂ OREAVUL",398,"VALEA RÂMNICULUI",50022,1,PART,PRCNCT,PRSD,PRSD_SV,"2025-05-18 22:16:10",1785,991,908,83,0,977,14,2000,1009,580,397
10,BUZĂU,"GRADINITA CU PROGRAM NORMAL RUBLA",399,"VALEA RÂMNICULUI",50022,1,PART,PRCNCT,PRSD,PRSD_SV,"2025-05-18 21:47:44",914,521,467,54,0,519,2,1000,479,265,254
10,BUZĂU,"CĂMINUL CULTURAL VALEA SALCIEI",400,"VALEA SALCIEI",50068,1,PART,PRCNCT,PRSD,PRSD_SV,"2025-05-18 21:37:27",505,276,229,47,0,274,2,550,274,130,144
10,BUZĂU,"SCOALA GIMNAZIALA NR 1 VILCELELE",401,VÂLCELELE,50399,1,PART,PRCNCT,PRSD,PRSD_SV,"2025-05-18 22:13:37",1052,593,468,124,1,583,10,1150,557,314,269
10,BUZĂU,"ŞCOALA GIMNAZIALĂ ”NICOLAE IOAN JILINSCHI” VERNEȘTI",402,VERNEŞTI,50102,1,PART,PRCNCT,PRSD,PRSD_SV,"2025-05-18 22:09:20",2143,1393,1130,263,0,1383,10,2400,1007,626,757
10,BUZĂU,"ŞCOALA GIMNAZIALĂ SAT CÎNDEȘTI",403,VERNEŞTI,50102,1,PART,PRCNCT,PRSD,PRSD_SV,"2025-05-18 21:31:54",1384,676,602,74,0,672,4,1500,824,527,145
10,BUZĂU,"ŞCOALA GIMNAZIALĂ SAT CINDEŞTI",404,VERNEŞTI,50102,1,PART,PRCNCT,PRSD,PRSD_SV,"2025-05-18 21:44:53",1329,634,569,65,0,622,12,1450,816,437,185
10,BUZĂU,"CASA PRAZNICALĂ A PAROHIEI MIEREA",405,VERNEŞTI,50102,1,PART,PRCNCT,PRSD,PRSD_SV,"2025-05-18 21:43:37",406,303,211,92,0,301,2,450,147,132,169
10,BUZĂU,"GRĂDINIȚA CU PROGRAM NORMAL NIȘCOV",406,VERNEŞTI,50102,1,PART,PRCNCT,PRSD,PRSD_SV,"2025-05-18 21:57:23",1046,624,495,128,1,618,6,1150,526,342,276
10,BUZĂU,"ŞCOALA PRIMARĂ SĂSENII NOI",407,VERNEŞTI,50102,1,PART,PRCNCT,PRSD,PRSD_SV,"2025-05-18 21:33:35",288,204,148,56,0,204,0,350,146,111,93
10,BUZĂU,"ŞCOALA GIMNAZIALĂ ”VASILE ALDEA” ZOREȘTI",408,VERNEŞTI,50102,1,PART,PRCNCT,PRSD,PRSD_SV,"2025-05-18 22:04:19",1122,711,604,107,0,707,4,1200,489,398,309
10,BUZĂU,"ŞCOALA GIMNAZIALĂ TACHE ŞI ECATERINA TOCILESCU",409,"VINTILĂ VODĂ",50228,1,PART,PRCNCT,PRSD,PRSD_SV,"2025-05-18 21:53:55",1188,665,514,98,53,664,1,1300,635,331,333
10,BUZĂU,"ŞCOALA PRIMARĂ SAT COCA ANTIMIREŞTI",410,"VINTILĂ VODĂ",50228,1,PART,PRCNCT,PRSD,PRSD_SV,"2025-05-18 21:33:50",165,96,65,29,2,96,0,200,104,48,48
10,BUZĂU,"ŞCOALA PRIMARĂ SAT NICULEŞTI",411,"VINTILĂ VODĂ",50228,1,PART,PRCNCT,PRSD,PRSD_SV,"2025-05-18 21:41:10",883,478,388,72,18,473,5,1000,522,227,246
10,BUZĂU,"ŞCOALA GIMNAZIALA VIPEREŞTI",412,VIPEREŞTI,50326,1,PART,PRCNCT,PRSD,PRSD_SV,"2025-05-18 21:28:39",929,479,386,84,9,475,4,1000,521,257,218
10,BUZĂU,"ŞCOALA PRIMARA MUŞCEL",413,VIPEREŞTI,50326,1,PART,PRCNCT,PRSD,PRSD_SV,"2025-05-18 21:15:32",74,51,21,30,0,51,0,100,49,19,32
10,BUZĂU,"ŞCOALA PRIMARA TRONARI",414,VIPEREŞTI,50326,1,PART,PRCNCT,PRSD,PRSD_SV,"2025-05-18 21:31:47",753,422,376,46,0,417,5,800,378,287,130
10,BUZĂU,"ŞCOALA GIMNAZIALA URSOAIA",415,VIPEREŞTI,50326,1,PART,PRCNCT,PRSD,PRSD_SV,"2025-05-18 21:50:51",794,431,339,91,1,429,2,900,469,249,180
10,BUZĂU,"ŞCOALA GIMNAZIALĂ ”CONSTANTIN POPESCU” FUNDENI",416,ZĂRNEŞTI,50415,1,PART,PRCNCT,PRSD,PRSD_SV,"2025-05-18 21:54:02",1842,949,827,119,3,942,7,2000,1051,573,369
10,BUZĂU,"SCOALA GENERALA PRUNENI",417,ZĂRNEŞTI,50415,1,PART,PRCNCT,PRSD,PRSD_SV,"2025-05-18 21:26:39",276,195,137,58,0,193,2,300,105,106,87
10,BUZĂU,"GRĂDINIŢA DE COPII VADU SOREŞTI",418,ZĂRNEŞTI,50415,1,PART,PRCNCT,PRSD,PRSD_SV,"2025-05-18 21:45:00",991,541,474,67,0,536,5,1100,559,309,227
10,BUZĂU,"GRĂDINIŢA DE COPII ZĂRNEŞTI",419,ZĂRNEŞTI,50415,1,PART,PRCNCT,PRSD,PRSD_SV,"2025-05-18 21:22:29",828,530,429,101,0,524,6,900,370,262,262
10,BUZĂU,"SALA DE ŞEDINŢE PRIMĂRIA ZIDURI",420,ZIDURI,50479,1,PART,PRCNCT,PRSD,PRSD_SV,"2025-05-18 21:45:11",801,404,338,66,0,402,2,900,496,215,187
10,BUZĂU,"ŞCOALA PRIMARĂ COSTIENI",421,ZIDURI,50479,1,PART,PRCNCT,PRSD,PRSD_SV,"2025-05-18 21:46:34",555,286,218,68,0,283,3,600,314,179,104
10,BUZĂU,"ŞCOALA PRIMARĂ CUCULEASA",422,ZIDURI,50479,1,PART,PRCNCT,PRSD,PRSD_SV,"2025-05-18 21:26:31",357,193,160,32,1,192,1,400,207,112,80
10,BUZĂU,"ŞCOALA PRIMARĂ HELIADE RĂDULESCU",423,ZIDURI,50479,1,PART,PRCNCT,PRSD,PRSD_SV,"2025-05-18 21:40:16",582,326,233,93,0,321,5,650,324,196,125
10,BUZĂU,"CĂMINUL CULTURAL LANURILE",424,ZIDURI,50479,1,PART,PRCNCT,PRSD,PRSD_SV,"2025-05-18 21:24:23",544,290,233,57,0,286,4,600,310,158,128
10,BUZĂU,"CĂMINUL CULTURAL ZOIŢA",425,ZIDURI,50479,1,PART,PRCNCT,PRSD,PRSD_SV,"2025-05-18 21:25:44",421,215,174,41,0,212,3,500,285,127,85
11,CARAŞ-SEVERIN,"ȘCOALA GIMNAZIALĂ NR. 5",1,"MUNICIPIUL REŞIŢA",50790,1,PART,PRCNCT,PRSD,PRSD_SV,"2025-05-18 22:22:10",1227,495,431,47,17,483,12,1349,854,230,253
11,CARAŞ-SEVERIN,"ȘCOALA GIMNAZIALĂ NR.5",2,"MUNICIPIUL REŞIŢA",50790,1,PART,PRCNCT,PRSD,PRSD_SV,"2025-05-18 21:48:59",557,213,180,33,0,209,4,612,399,92,117
11,CARAŞ-SEVERIN,"OCOLUL SILVIC ”BANATUL MONTAN” REGIE AUTONOMĂ",3,"MUNICIPIUL REŞIŢA",50790,1,PART,PRCNCT,PRSD,PRSD_SV,"2025-05-18 22:27:54",1041,391,354,33,4,386,5,1146,755,209,177
11,CARAŞ-SEVERIN,"ȘCOALA GIMNAZIALĂ NR. 1 (BETON)",4,"MUNICIPIUL REŞIŢA",50790,1,PART,PRCNCT,PRSD,PRSD_SV,"2025-05-18 22:05:27",579,262,234,28,0,254,8,636,374,88,166
11,CARAŞ-SEVERIN,"ȘCOALA GIMNAZIALĂ NR. 1 (BETON)",5,"MUNICIPIUL REŞIŢA",50790,1,PART,PRCNCT,PRSD,PRSD_SV,"2025-05-18 22:13:29",990,378,356,21,1,373,5,1089,711,173,200
11,CARAŞ-SEVERIN,"ȘCOALA GIMNAZIALĂ NR. 1 (CASA MUNCITOREASCĂ)",6,"MUNICIPIUL REŞIŢA",50790,1,PART,PRCNCT,PRSD,PRSD_SV,"2025-05-18 21:42:48",1378,510,476,34,0,505,5,1516,1006,196,309
11,CARAŞ-SEVERIN,"ȘCOALA GIMNAZIALĂ NR. 1 (CASA MUNCITOREASCĂ)",7,"MUNICIPIUL REŞIŢA",50790,1,PART,PRCNCT,PRSD,PRSD_SV,"2025-05-18 22:01:10",986,288,269,19,0,285,3,1085,797,155,130
11,CARAŞ-SEVERIN,"ȘCOALA PRIMARĂ DEALU MARE",8,"MUNICIPIUL REŞIŢA",50790,1,PART,PRCNCT,PRSD,PRSD_SV,"2025-05-18 21:25:41",666,194,174,20,0,192,2,732,538,117,75
11,CARAŞ-SEVERIN,"ȘCOALA PRIMARĂ DEALU MARE",9,"MUNICIPIUL REŞIŢA",50790,1,PART,PRCNCT,PRSD,PRSD_SV,"2025-05-18 21:37:13",799,301,284,16,1,297,4,878,577,229,68
11,CARAŞ-SEVERIN,"ȘCOALA GIMNAZIALĂ NR. 2",10,"MUNICIPIUL REŞIŢA",50790,1,PART,PRCNCT,PRSD,PRSD_SV,"2025-05-18 22:06:40",1034,445,383,62,0,438,7,1137,692,216,222
11,CARAŞ-SEVERIN,"ȘCOALA GIMNAZIALĂ NR. 2",11,"MUNICIPIUL REŞIŢA",50790,1,PART,PRCNCT,PRSD,PRSD_SV,"2025-05-18 21:49:13",1142,564,498,34,32,558,6,1257,693,189,369
11,CARAŞ-SEVERIN,"ȘCOALA GIMNAZIALĂ NR. 2",12,"MUNICIPIUL REŞIŢA",50790,1,PART,PRCNCT,PRSD,PRSD_SV,"2025-05-18 21:55:02",1102,514,498,16,0,505,9,1213,699,154,351
11,CARAŞ-SEVERIN,"ȘCOALA GIMNAZIALĂ „MARIUS ȘANDRU”, REȘIȚA",13,"MUNICIPIUL REŞIŢA",50790,1,PART,PRCNCT,PRSD,PRSD_SV,"2025-05-18 21:58:42",915,395,373,21,1,385,10,1009,614,144,241
11,CARAŞ-SEVERIN,"COLEGIUL NAȚIONAL ”TRAIAN LALESCU” - ȘCOALA PRIMARĂ",14,"MUNICIPIUL REŞIŢA",50790,1,PART,PRCNCT,PRSD,PRSD_SV,"2025-05-18 22:01:21",475,156,146,10,0,152,4,523,367,116,36
11,CARAŞ-SEVERIN,"CASA MUNICIPALĂ DE CĂSĂTORII",15,"MUNICIPIUL REŞIŢA",50790,1,PART,PRCNCT,PRSD,PRSD_SV,"2025-05-18 22:08:07",1093,610,510,100,0,600,10,1204,594,179,421
11,CARAŞ-SEVERIN,"CASA MUNICIPALĂ DE CĂSĂTORII",16,"MUNICIPIUL REŞIŢA",50790,2,PART,PRCNCT,PRSD,PRSD_SV,"2025-05-18 22:53:39",1291,580,541,38,1,567,13,1420,840,225,342
11,CARAŞ-SEVERIN,"UNIVERSITATEA EFTIMIE MURGU - CAMPUSUL CAFE",17,"MUNICIPIUL REŞIŢA",50790,2,PART,PRCNCT,PRSD,PRSD_SV,"2025-05-18 23:19:05",1015,422,381,10,31,416,6,1117,695,149,267
11,CARAŞ-SEVERIN,"UNIVERSITATEA ”EFTIMIE MURGU”",18,"MUNICIPIUL REŞIŢA",50790,1,PART,PRCNCT,PRSD,PRSD_SV,"2025-05-18 21:49:21",526,273,203,70,0,267,6,578,305,110,157
11,CARAŞ-SEVERIN,"UNIVERSITATEA ”EFTIMIE MURGU”",19,"MUNICIPIUL REŞIŢA",50790,2,PART,PRCNCT,PRSD,PRSD_SV,"2025-05-18 22:08:41",996,466,407,29,30,460,6,1095,629,157,303
11,CARAŞ-SEVERIN,"COLEGIUL NAȚIONAL ”TRAIAN LALESCU”",20,"MUNICIPIUL REŞIŢA",50790,1,PART,PRCNCT,PRSD,PRSD_SV,"2025-05-18 21:52:33",1011,411,392,19,0,405,6,1112,701,141,264
11,CARAŞ-SEVERIN,"COLEGIUL NAȚIONAL ”TRAIAN LALESCU”",21,"MUNICIPIUL REŞIŢA",50790,1,PART,PRCNCT,PRSD,PRSD_SV,"2025-05-18 21:58:30",881,365,323,42,0,359,6,968,603,155,204
11,CARAŞ-SEVERIN,"COLEGIUL NAȚIONAL ”TRAIAN LALESCU”",22,"MUNICIPIUL REŞIŢA",50790,1,PART,PRCNCT,PRSD,PRSD_SV,"2025-05-18 21:51:29",1170,436,404,32,0,432,4,1286,850,158,274
11,CARAŞ-SEVERIN,"COLEGIUL NAȚIONAL ”TRAIAN LALESCU”",23,"MUNICIPIUL REŞIŢA",50790,1,PART,PRCNCT,PRSD,PRSD_SV,"2025-05-18 21:45:45",675,314,297,16,1,310,4,742,428,107,203
11,CARAŞ-SEVERIN,"ȘCOALA GIMNAZIALĂ ”MIHAI PEIA”",24,"MUNICIPIUL REŞIŢA",50790,1,PART,PRCNCT,PRSD,PRSD_SV,"2025-05-18 21:23:11",811,428,357,69,2,422,6,891,463,147,275
11,CARAŞ-SEVERIN,"ȘCOALA GIMNAZIALĂ ”MIHAI PEIA”",25,"MUNICIPIUL REŞIŢA",50790,1,PART,PRCNCT,PRSD,PRSD_SV,"2025-05-18 21:30:55",713,298,276,22,0,293,5,783,485,104,189
11,CARAŞ-SEVERIN,"ȘCOALA GIMNAZIALĂ ”MIHAI PEIA”",26,"MUNICIPIUL REŞIŢA",50790,1,PART,PRCNCT,PRSD,PRSD_SV,"2025-05-18 21:58:34",868,361,316,21,24,348,13,955,594,143,205
11,CARAŞ-SEVERIN,"COLEGIUL TEHNIC REȘIȚA",27,"MUNICIPIUL REŞIŢA",50790,2,PART,PRCNCT,PRSD,PRSD_SV,"2025-05-18 23:27:03",1109,457,422,35,0,453,4,1221,764,194,259
11,CARAŞ-SEVERIN,"COLEGIUL TEHNIC REȘIȚA",28,"MUNICIPIUL REŞIŢA",50790,1,PART,PRCNCT,PRSD,PRSD_SV,"2025-05-18 21:47:43",722,360,318,42,0,354,6,793,433,124,230
11,CARAŞ-SEVERIN,"COLEGIUL TEHNIC REȘIȚA",29,"MUNICIPIUL REŞIŢA",50790,1,PART,PRCNCT,PRSD,PRSD_SV,"2025-05-18 21:37:08",900,359,329,30,0,349,10,990,631,135,214
11,CARAŞ-SEVERIN,"DIRECȚIA SANITARĂ VETERINARĂ ȘI PENTRU SIGURANȚA ALIMENTELOR CARAȘ-SEVERIN",30,"MUNICIPIUL REŞIŢA",50790,1,PART,PRCNCT,PRSD,PRSD_SV,"2025-05-18 21:31:12",656,240,214,25,1,238,2,721,481,127,111
11,CARAŞ-SEVERIN,"GRĂDINIȚA CU PROGRAM NORMAL ”DEGEȚICA”",31,"MUNICIPIUL REŞIŢA",50790,2,PART,PRCNCT,PRSD,PRSD_SV,"2025-05-18 23:33:55",1010,433,400,33,0,427,6,1110,677,240,187
11,CARAŞ-SEVERIN,"LICEUL TEORETIC ”TRAIAN VUIA”",32,"MUNICIPIUL REŞIŢA",50790,1,PART,PRCNCT,PRSD,PRSD_SV,"2025-05-18 22:01:11",1180,452,408,44,0,448,4,1298,846,271,177
11,CARAŞ-SEVERIN,"LICEUL TEORETIC ”TRAIAN VUIA”",33,"MUNICIPIUL REŞIŢA",50790,1,PART,PRCNCT,PRSD,PRSD_SV,"2025-05-18 21:55:00",866,329,284,45,0,325,4,952,623,207,118
11,CARAŞ-SEVERIN,"LICEUL TEORETIC ”TRAIAN VUIA”",34,"MUNICIPIUL REŞIŢA",50790,1,PART,PRCNCT,PRSD,PRSD_SV,"2025-05-18 21:52:45",1310,513,489,24,0,505,8,1441,928,280,225
11,CARAŞ-SEVERIN,"LICEUL TEORETIC ”TRAIAN VUIA”",35,"MUNICIPIUL REŞIŢA",50790,1,PART,PRCNCT,PRSD,PRSD_SV,"2025-05-18 21:21:51",1005,412,384,28,0,407,5,1105,693,164,243
11,CARAŞ-SEVERIN,"LICEUL TEORETIC ”TRAIAN VUIA”",36,"MUNICIPIUL REŞIŢA",50790,1,PART,PRCNCT,PRSD,PRSD_SV,"2025-05-18 21:56:15",966,418,389,29,0,411,7,1065,647,175,236
11,CARAŞ-SEVERIN,"LICEUL TEORETIC ”TRAIAN VUIA”",37,"MUNICIPIUL REŞIŢA",50790,1,PART,PRCNCT,PRSD,PRSD_SV,"2025-05-18 21:59:46",781,262,242,20,0,262,0,858,596,190,72
11,CARAŞ-SEVERIN,"GRĂDINIȚA CU PROGRAM PRELUNGIT „DUMBRAVA MINUNATĂ”, REȘIȚA",38,"MUNICIPIUL REŞIŢA",50790,1,PART,PRCNCT,PRSD,PRSD_SV,"2025-05-18 21:53:30",1217,505,473,32,0,492,13,1339,834,279,213
11,CARAŞ-SEVERIN,"GRĂDINIȚA CU PROGRAM PRELUNGIT „DUMBRAVA MINUNATĂ”, REȘIȚA",39,"MUNICIPIUL REŞIŢA",50790,1,PART,PRCNCT,PRSD,PRSD_SV,"2025-05-18 22:00:41",1249,524,499,25,0,518,6,1375,851,253,265
11,CARAŞ-SEVERIN,"GRĂDINIȚA CU PROGRAM PRELUNGIT „DUMBRAVA MINUNATĂ”, REȘIȚA",40,"MUNICIPIUL REŞIŢA",50790,1,PART,PRCNCT,PRSD,PRSD_SV,"2025-05-18 22:23:17",967,412,350,62,0,401,11,1064,652,183,218
11,CARAŞ-SEVERIN,"COLEGIUL NAŢIONAL”MIRCEA ELIADE”REŞIŢA",41,"MUNICIPIUL REŞIŢA",50790,1,PART,PRCNCT,PRSD,PRSD_SV,"2025-05-18 22:15:11",893,367,316,49,2,365,2,981,614,171,194
11,CARAŞ-SEVERIN,"COLEGIUL NAŢIONAL”MIRCEA ELIADE”,REŞIŢA",42,"MUNICIPIUL REŞIŢA",50790,1,PART,PRCNCT,PRSD,PRSD_SV,"2025-05-18 21:43:42",839,387,361,26,0,383,4,921,534,178,205
11,CARAŞ-SEVERIN,"COLEGIUL TEHNIC CĂRĂŞAN, REȘIȚA",43,"MUNICIPIUL REŞIŢA",50790,1,PART,PRCNCT,PRSD,PRSD_SV,"2025-05-18 21:50:50",1054,438,404,33,1,429,9,1160,722,172,257
11,CARAŞ-SEVERIN,"COLEGIUL TEHNIC CĂRĂŞAN, REȘIȚA",44,"MUNICIPIUL REŞIŢA",50790,1,PART,PRCNCT,PRSD,PRSD_SV,"2025-05-18 21:40:02",885,351,334,17,0,348,3,976,625,142,206
11,CARAŞ-SEVERIN,"LICEUL TEOLOGIC BAPTIST",45,"MUNICIPIUL REŞIŢA",50790,1,PART,PRCNCT,PRSD,PRSD_SV,"2025-05-18 21:26:18",1233,518,489,28,1,503,15,1355,837,220,283
11,CARAŞ-SEVERIN,"LICEUL TEOLOGIC BAPTIST",46,"MUNICIPIUL REŞIŢA",50790,1,PART,PRCNCT,PRSD,PRSD_SV,"2025-05-18 21:26:05",1070,445,414,30,1,431,14,1177,732,176,255
11,CARAŞ-SEVERIN,"LICEUL TEOLOGIC BAPTIST",47,"MUNICIPIUL REŞIŢA",50790,1,PART,PRCNCT,PRSD,PRSD_SV,"2025-05-18 21:24:11",974,435,420,15,0,425,10,1072,637,189,236
11,CARAŞ-SEVERIN,"LICEUL TEOLOGIC BAPTIST",48,"MUNICIPIUL REŞIŢA",50790,1,PART,PRCNCT,PRSD,PRSD_SV,"2025-05-18 21:27:14",763,277,251,25,1,273,4,838,561,130,143
11,CARAŞ-SEVERIN,"ȘCOALA GIMNAZIALĂ NR. 7,CORP A",49,"MUNICIPIUL REŞIŢA",50790,1,PART,PRCNCT,PRSD,PRSD_SV,"2025-05-18 21:43:19",1198,553,501,52,0,535,18,1317,764,269,266
11,CARAŞ-SEVERIN,"ȘCOALA GIMNAZIALĂ NR. 7,CORP A",50,"MUNICIPIUL REŞIŢA",50790,1,PART,PRCNCT,PRSD,PRSD_SV,"2025-05-18 21:45:43",1026,422,378,44,0,412,10,1128,706,186,226
11,CARAŞ-SEVERIN,"ȘCOALA GIMNAZIALĂ NR. 7,CORP A",51,"MUNICIPIUL REŞIŢA",50790,1,PART,PRCNCT,PRSD,PRSD_SV,"2025-05-18 22:22:00",1352,596,567,29,0,586,10,1487,891,260,326
11,CARAŞ-SEVERIN,"ȘCOALA GIMNAZIALĂ NR. 7,CORP A",52,"MUNICIPIUL REŞIŢA",50790,1,PART,PRCNCT,PRSD,PRSD_SV,"2025-05-18 21:47:07",952,411,365,46,0,401,10,1047,636,185,216
11,CARAŞ-SEVERIN,"ȘCOALA GIMNAZIALĂ NR. 9",53,"MUNICIPIUL REŞIŢA",50790,1,PART,PRCNCT,PRSD,PRSD_SV,"2025-05-18 21:37:39",1019,429,361,67,1,424,5,1121,692,226,198
11,CARAŞ-SEVERIN,"ȘCOALA GIMNAZIALĂ NR. 9",54,"MUNICIPIUL REŞIŢA",50790,1,PART,PRCNCT,PRSD,PRSD_SV,"2025-05-18 21:35:57",1257,511,487,24,0,500,11,1383,872,265,235
11,CARAŞ-SEVERIN,"ȘCOALA GIMNAZIALĂ NR. 9",55,"MUNICIPIUL REŞIŢA",50790,1,PART,PRCNCT,PRSD,PRSD_SV,"2025-05-18 21:48:31",1126,450,422,28,0,449,1,1242,792,199,250
11,CARAŞ-SEVERIN,"ȘCOALA GIMNAZIALĂ NR. 9",56,"MUNICIPIUL REŞIŢA",50790,1,PART,PRCNCT,PRSD,PRSD_SV,"2025-05-18 21:28:53",1276,507,459,48,0,504,3,1404,897,247,257
11,CARAŞ-SEVERIN,"LICEUL DE ARTE ”SABIN PĂUȚA”",57,"MUNICIPIUL REŞIŢA",50790,1,PART,PRCNCT,PRSD,PRSD_SV,"2025-05-18 22:01:13",873,375,334,41,0,370,5,959,584,174,196
11,CARAŞ-SEVERIN,"LICEUL DE ARTE ”SABIN PĂUȚA”",58,"MUNICIPIUL REŞIŢA",50790,1,PART,PRCNCT,PRSD,PRSD_SV,"2025-05-18 21:34:39",1102,480,455,25,0,474,6,1212,732,224,250
11,CARAŞ-SEVERIN,"LICEUL DE ARTE „SABIN PĂUȚA”, REȘIȚA-SALA DE SPORT",59,"MUNICIPIUL REŞIŢA",50790,1,PART,PRCNCT,PRSD,PRSD_SV,"2025-05-18 21:38:36",1226,540,496,43,1,531,9,1348,808,192,339
11,CARAŞ-SEVERIN,"LICEUL DE ARTE „SABIN PĂUȚA”, REȘIȚA-SALA DE SPORT",60,"MUNICIPIUL REŞIŢA",50790,1,PART,PRCNCT,PRSD,PRSD_SV,"2025-05-18 21:49:01",1000,464,429,35,0,453,11,1099,635,192,261
11,CARAŞ-SEVERIN,"ȘCOALA GIMNAZIALĂ NR. 12",61,"MUNICIPIUL REŞIŢA",50790,1,PART,PRCNCT,PRSD,PRSD_SV,"2025-05-18 21:57:56",1106,556,451,64,41,545,11,1217,661,213,332
11,CARAŞ-SEVERIN,"ȘCOALA GIMNAZIALĂ NR. 12",62,"MUNICIPIUL REŞIŢA",50790,2,PART,PRCNCT,PRSD,PRSD_SV,"2025-05-18 23:13:09",1186,528,457,32,39,516,12,1304,776,230,286
11,CARAŞ-SEVERIN,"ȘCOALA GIMNAZIALĂ NR. 12",63,"MUNICIPIUL REŞIŢA",50790,1,PART,PRCNCT,PRSD,PRSD_SV,"2025-05-18 21:25:59",1035,384,359,25,0,381,3,1138,754,171,210
11,CARAŞ-SEVERIN,"ȘCOALA GIMNAZIALĂ NR. 12",64,"MUNICIPIUL REŞIŢA",50790,1,PART,PRCNCT,PRSD,PRSD_SV,"2025-05-18 21:44:37",914,376,359,17,0,369,7,1004,628,175,194
11,CARAŞ-SEVERIN,"COLEGIUL NAȚIONAL ”MIRCEA ELIADE” - ȘCOALA CÂLNIC (CORP D)",65,"MUNICIPIUL REŞIŢA",50790,1,PART,PRCNCT,PRSD,PRSD_SV,"2025-05-18 21:46:46",1340,564,534,29,1,554,10,1473,909,271,283
11,CARAŞ-SEVERIN,"CĂMINUL CULTURAL CUPTOARE",66,"MUNICIPIUL REŞIŢA",50790,1,PART,PRCNCT,PRSD,PRSD_SV,"2025-05-18 21:45:58",262,132,119,13,0,132,0,287,155,73,59
11,CARAŞ-SEVERIN,"GRĂDINIȚA CU PROGRAM NORMAL DOMAN",67,"MUNICIPIUL REŞIŢA",50790,1,PART,PRCNCT,PRSD,PRSD_SV,"2025-05-18 21:26:42",580,215,205,10,0,213,2,637,422,128,85
11,CARAŞ-SEVERIN,"LICEUL TEORETIC ”DIACONOVICI TIETZ” - ȘCOALA CU CLS I-IV",68,"MUNICIPIUL REŞIŢA",50790,1,PART,PRCNCT,PRSD,PRSD_SV,"2025-05-18 21:12:38",401,123,112,11,0,121,2,440,317,83,38
11,CARAŞ-SEVERIN,"ȘCOALA GIMNAZIALĂ NR. 8 - ȘCOALA PRIMARĂ ȚEROVA",69,"MUNICIPIUL REŞIŢA",50790,1,PART,PRCNCT,PRSD,PRSD_SV,"2025-05-18 21:28:03",442,198,185,13,0,194,4,485,287,109,85
11,CARAŞ-SEVERIN,"COLEGIUL NAȚIONAL ”MIRCEA ELIADE” - GRĂDINIȚA MONIOM (CORP F)",70,"MUNICIPIUL REŞIŢA",50790,1,PART,PRCNCT,PRSD,PRSD_SV,"2025-05-18 21:20:58",271,163,141,22,0,159,4,297,134,73,86
11,CARAŞ-SEVERIN,"CLĂDIRE A MUNICIPIULUI CARANSEBEȘ (FOSTA ȘCOALĂ PRIMARĂ)",71,"MUNICIPIUL CARANSEBEŞ",51010,1,PART,PRCNCT,PRSD,PRSD_SV,"2025-05-18 21:46:10",1155,480,431,49,0,471,9,1271,791,274,197
11,CARAŞ-SEVERIN,"GRĂDINIȚA CU PROGRAM NORMAL NR. 3",72,"MUNICIPIUL CARANSEBEŞ",51010,1,PART,PRCNCT,PRSD,PRSD_SV,"2025-05-18 21:34:42",549,325,277,48,0,323,2,604,279,164,159
11,CARAŞ-SEVERIN,"SALA DE SPORT „VALERIA BORZA”",73,"MUNICIPIUL CARANSEBEŞ",51010,1,PART,PRCNCT,PRSD,PRSD_SV,"2025-05-18 21:43:19",1170,641,542,83,16,630,11,1267,626,294,336
11,CARAŞ-SEVERIN,"SALA DE SPORT „VALERIA BORZA”",74,"MUNICIPIUL CARANSEBEŞ",51010,1,PART,PRCNCT,PRSD,PRSD_SV,"2025-05-18 22:07:35",1164,593,504,88,1,583,10,1283,690,256,327
11,CARAŞ-SEVERIN,"LICEUL TEHNOLOGIC ”DACIA”",75,"MUNICIPIUL CARANSEBEŞ",51010,1,PART,PRCNCT,PRSD,PRSD_SV,"2025-05-18 21:56:34",1369,642,546,93,3,632,10,1506,864,247,385
11,CARAŞ-SEVERIN,"CASA MUNICIPALĂ DE CULTURĂ ”GEORGE SURU”",76,"MUNICIPIUL CARANSEBEŞ",51010,2,PART,PRCNCT,PRSD,PRSD_SV,"2025-05-19 01:01:03",1146,660,514,146,0,652,8,1261,601,271,381
11,CARAŞ-SEVERIN,"GRĂDINIȚA CU PROGRAM PRELUNGIT NR. 1 CARANSEBEȘ",77,"MUNICIPIUL CARANSEBEŞ",51010,1,PART,PRCNCT,PRSD,PRSD_SV,"2025-05-18 22:44:22",1577,738,618,94,26,724,14,1735,997,337,387
11,CARAŞ-SEVERIN,"LICEUL TEOLOGIC BAPTIST REȘIȚA",78,"MUNICIPIUL CARANSEBEŞ",51010,1,PART,PRCNCT,PRSD,PRSD_SV,"2025-05-18 21:28:05",1122,433,392,28,13,424,9,1234,801,244,180
11,CARAŞ-SEVERIN,"LICEUL TEOLOGIC BAPTIST REȘIȚA",79,"MUNICIPIUL CARANSEBEŞ",51010,1,PART,PRCNCT,PRSD,PRSD_SV,"2025-05-18 21:34:31",1111,450,415,35,0,441,9,1223,773,206,235
11,CARAŞ-SEVERIN,"CLUBUL SPORTIV ȘCOLAR",80,"MUNICIPIUL CARANSEBEŞ",51010,1,PART,PRCNCT,PRSD,PRSD_SV,"2025-05-18 22:02:38",1046,371,332,39,0,362,9,1152,781,152,210
11,CARAŞ-SEVERIN,"COLEGIUL NAȚIONAL „C.D. LOGA” CARANSEBEȘ",81,"MUNICIPIUL CARANSEBEŞ",51010,1,PART,PRCNCT,PRSD,PRSD_SV,"2025-05-18 22:34:17",1023,380,329,51,0,365,15,1125,745,199,166
11,CARAŞ-SEVERIN,"COLEGIUL NAȚIONAL „C.D. LOGA” CARANSEBEȘ",82,"MUNICIPIUL CARANSEBEŞ",51010,1,PART,PRCNCT,PRSD,PRSD_SV,"2025-05-18 22:10:23",1548,701,583,93,25,691,10,1702,1001,320,371
11,CARAŞ-SEVERIN,"GRĂDINIȚA CU PROGRAM NORMAL NR. 8",83,"MUNICIPIUL CARANSEBEŞ",51010,1,PART,PRCNCT,PRSD,PRSD_SV,"2025-05-18 21:45:08",1163,472,418,53,1,467,5,1283,811,284,183
11,CARAŞ-SEVERIN,"GRĂDINIȚA CU PROGRAM NORMAL NR. 8",84,"MUNICIPIUL CARANSEBEŞ",51010,1,PART,PRCNCT,PRSD,PRSD_SV,"2025-05-18 21:39:08",1138,529,469,60,0,514,15,1253,724,242,272
11,CARAŞ-SEVERIN,"LICEUL TEHNOLOGIC ”DECEBAL”",85,"MUNICIPIUL CARANSEBEŞ",51010,1,PART,PRCNCT,PRSD,PRSD_SV,"2025-05-18 21:34:20",1253,504,464,40,0,495,9,1377,873,237,258
11,CARAŞ-SEVERIN,"LICEUL TEHNOLOGIC ”DECEBAL”",86,"MUNICIPIUL CARANSEBEŞ",51010,1,PART,PRCNCT,PRSD,PRSD_SV,"2025-05-18 21:58:47",1231,493,436,57,0,485,8,1353,860,291,194
11,CARAŞ-SEVERIN,"LICEUL TEHNOLOGIC ”DECEBAL”",87,"MUNICIPIUL CARANSEBEŞ",51010,1,PART,PRCNCT,PRSD,PRSD_SV,"2025-05-18 22:12:17",1308,581,538,43,0,577,4,1438,857,302,275
11,CARAŞ-SEVERIN,"GRĂDINIȚA CU PROGRAM NORMAL NR.5",88,"MUNICIPIUL CARANSEBEŞ",51010,1,PART,PRCNCT,PRSD,PRSD_SV,"2025-05-18 22:08:44",1176,488,427,60,1,484,4,1294,806,245,239
11,CARAŞ-SEVERIN,"LICEUL TEHNOLOGIC „DACIA” CARANSEBEȘ, CORP B",89,"MUNICIPIUL CARANSEBEŞ",51010,3,PART,PRCNCT,PRSD,PRSD_SV,"2025-05-19 01:13:46",726,343,303,40,0,337,6,799,456,182,155
11,CARAŞ-SEVERIN,"LICEUL TEHNOLOGIC „DACIA” CARANSEBEȘ, CORP B",90,"MUNICIPIUL CARANSEBEŞ",51010,1,PART,PRCNCT,PRSD,PRSD_SV,"2025-05-18 21:47:15",950,349,333,15,1,343,6,1045,696,222,121
11,CARAŞ-SEVERIN,"CĂMINUL CULTURAL JUPA",91,"MUNICIPIUL CARANSEBEŞ",51010,1,PART,PRCNCT,PRSD,PRSD_SV,"2025-05-18 21:46:35",528,340,272,68,0,332,8,580,240,172,160
11,CARAŞ-SEVERIN,"LICEUL ”MATHIAS HAMMER”",92,"ORAŞ ANINA",50889,1,PART,PRCNCT,PRSD,PRSD_SV,"2025-05-18 21:43:36",780,274,217,21,36,271,3,857,583,141,130
11,CARAŞ-SEVERIN,"CENTRUL DE AFACERI ANINA",93,"ORAŞ ANINA",50889,1,PART,PRCNCT,PRSD,PRSD_SV,"2025-05-18 21:44:38",793,300,260,38,2,293,7,871,571,149,144
11,CARAŞ-SEVERIN,"GRĂDINIŢA CU PROGRAM NORMAL NR. 1 CELNIC",94,"ORAŞ ANINA",50889,1,PART,PRCNCT,PRSD,PRSD_SV,"2025-05-18 21:31:37",602,202,183,19,0,199,3,661,459,131,68
11,CARAŞ-SEVERIN,"SEDIUL S.C. GOSTRANS S.A.",95,"ORAŞ ANINA",50889,1,PART,PRCNCT,PRSD,PRSD_SV,"2025-05-18 21:42:28",475,146,129,17,0,144,2,524,378,95,49
11,CARAŞ-SEVERIN,"ŞCOALA GIMNAZIALĂ NR.1 CELNIC ( FOSTA GRĂDINIȚĂ CU PROGRAM NORMAL NR. 2 ORAȘUL NOU)",96,"ORAŞ ANINA",50889,1,PART,PRCNCT,PRSD,PRSD_SV,"2025-05-18 21:47:01",588,151,138,13,0,148,3,647,496,112,36
11,CARAŞ-SEVERIN,"CENTRUL DE ZI ANINA",97,"ORAŞ ANINA",50889,1,PART,PRCNCT,PRSD,PRSD_SV,"2025-05-18 21:39:44",612,221,206,15,0,218,3,679,458,147,71
11,CARAŞ-SEVERIN,"SEDIUL DEPOZITUL FINAL CÂNTAR",98,"ORAŞ ANINA",50889,1,PART,PRCNCT,PRSD,PRSD_SV,"2025-05-18 21:30:05",587,189,169,19,1,181,8,646,457,101,80
11,CARAŞ-SEVERIN,"GRĂDINIŢA CU PROGRAM NORMAL NR.4 SIGISMUND",99,"ORAŞ ANINA",50889,1,PART,PRCNCT,PRSD,PRSD_SV,"2025-05-18 21:37:20",544,163,139,24,0,158,5,600,437,101,57
11,CARAŞ-SEVERIN,"ŞCOALA GIMNAZIALĂ NR.2 STEIERDORF",100,"ORAŞ ANINA",50889,1,PART,PRCNCT,PRSD,PRSD_SV,"2025-05-18 21:40:56",1053,347,308,39,0,343,4,1157,810,234,109
11,CARAŞ-SEVERIN,"GRĂDINIŢA CU PROGRAM NORMAL NR.5 STEIERDORF",101,"ORAŞ ANINA",50889,1,PART,PRCNCT,PRSD,PRSD_SV,"2025-05-18 22:18:10",551,174,155,18,1,165,9,606,432,109,56
11,CARAŞ-SEVERIN,"ŞCOALA GIMNAZIALĂ NR.3 BRĂDET",102,"ORAŞ ANINA",50889,1,PART,PRCNCT,PRSD,PRSD_SV,"2025-05-18 21:17:55",307,92,78,14,0,89,3,338,246,69,20
11,CARAŞ-SEVERIN,"PROTOPOPIAT ORTODOX ROMÂN",103,"ORAŞ BĂILE HERCULANE",50923,1,PART,PRCNCT,PRSD,PRSD_SV,"2025-05-18 22:03:35",193,390,77,313,0,388,2,712,322,167,221
11,CARAŞ-SEVERIN,"LICEUL HERCULES(FOSTA SCOALA GENERALA)",104,"ORAŞ BĂILE HERCULANE",50923,1,PART,PRCNCT,PRSD,PRSD_SV,"2025-05-18 23:50:47",1363,1591,496,1095,0,1567,24,1798,207,829,738
11,CARAŞ-SEVERIN,"LICEUL HERCULES",105,"ORAŞ BĂILE HERCULANE",50923,1,PART,PRCNCT,PRSD,PRSD_SV,"2025-05-18 21:55:01",830,528,332,196,0,523,5,912,384,269,254
11,CARAŞ-SEVERIN,"LICEUL HERCULES",106,"ORAŞ BĂILE HERCULANE",50923,1,PART,PRCNCT,PRSD,PRSD_SV,"2025-05-18 22:03:12",895,594,384,210,0,583,11,984,390,321,262
11,CARAŞ-SEVERIN,"CĂMINUL CULTURAL",107,"ORAŞ BĂILE HERCULANE",50923,2,PART,PRCNCT,PRSD,PRSD_SV,"2025-05-19 03:11:37",472,301,244,57,0,295,6,518,217,150,145
11,CARAŞ-SEVERIN,"ȘCOALA GIMNAZIALĂ NR. 1 BOCŞA",108,"ORAŞ BOCŞA",50969,1,PART,PRCNCT,PRSD,PRSD_SV,"2025-05-18 21:31:51",1307,507,452,54,1,498,9,1438,931,277,221
11,CARAŞ-SEVERIN,"ȘCOALA GIMNAZIALĂ NR. 1 BOCŞA",109,"ORAŞ BOCŞA",50969,1,PART,PRCNCT,PRSD,PRSD_SV,"2025-05-18 21:41:05",1183,486,434,52,0,480,6,1301,815,258,222
11,CARAŞ-SEVERIN,"ȘCOALA GIMNAZIALĂ NR.1",110,"ORAŞ BOCŞA",50969,2,PART,PRCNCT,PRSD,PRSD_SV,"2025-05-18 23:31:26",1198,406,371,35,0,399,7,1327,921,248,151
11,CARAŞ-SEVERIN,"ȘCOALA GIMNAZIALĂ NR. 1 BOCŞA - SALA DE SPORT",111,"ORAŞ BOCŞA",50969,1,PART,PRCNCT,PRSD,PRSD_SV,"2025-05-18 21:49:57",1308,544,508,35,1,539,5,1439,895,284,255
11,CARAŞ-SEVERIN,"LICEUL TEORETIC TATA OANCEA",112,"ORAŞ BOCŞA",50969,1,PART,PRCNCT,PRSD,PRSD_SV,"2025-05-18 22:12:18",1056,420,379,41,0,417,3,1162,742,197,220
11,CARAŞ-SEVERIN,"LICEUL TEORETIC TATA OANCEA",113,"ORAŞ BOCŞA",50969,1,PART,PRCNCT,PRSD,PRSD_SV,"2025-05-18 21:39:56",808,299,268,31,0,295,4,890,591,178,117
11,CARAŞ-SEVERIN,"LICEUL TEORETIC TATA OANCEA",114,"ORAŞ BOCŞA",50969,1,PART,PRCNCT,PRSD,PRSD_SV,"2025-05-18 21:47:43",1209,477,419,51,7,466,11,1330,853,240,226
11,CARAŞ-SEVERIN,"GRĂDINIȚA CU PROGRAM NORMAL NR. 4 BOCȘA",115,"ORAŞ BOCŞA",50969,1,PART,PRCNCT,PRSD,PRSD_SV,"2025-05-18 21:50:19",1413,572,541,30,1,567,5,1554,982,321,246
11,CARAŞ-SEVERIN,"ȘCOALA GIMNAZIALĂ NR. 2 BOCŞA",116,"ORAŞ BOCŞA",50969,1,PART,PRCNCT,PRSD,PRSD_SV,"2025-05-18 21:39:07",1343,399,382,16,1,395,4,1477,1078,331,64
11,CARAŞ-SEVERIN,"LICEUL TEHNOLOGIC ”CONSTANTIN LUCACI” BOCSA",117,"ORAŞ BOCŞA",50969,1,PART,PRCNCT,PRSD,PRSD_SV,"2025-05-18 21:43:08",1339,525,477,48,0,517,8,1473,948,301,216
11,CARAŞ-SEVERIN,"LICEUL TEHNOLOGIC „CONSTANTIN LUCACI” BOCȘA",118,"ORAŞ BOCŞA",50969,1,PART,PRCNCT,PRSD,PRSD_SV,"2025-05-18 21:56:24",1325,449,414,35,0,446,3,1458,1009,282,164
11,CARAŞ-SEVERIN,"ȘCOALA GIMNAZIALĂ NR. 1",119,"ORAŞ BOCŞA",50969,1,PART,PRCNCT,PRSD,PRSD_SV,"2025-05-18 21:42:24",1166,378,350,27,1,373,5,1282,904,250,123
11,CARAŞ-SEVERIN,"CENTRUL CULTURAL PENTRU TINERET",120,"ORAŞ MOLDOVA NOUĂ",51056,1,PART,PRCNCT,PRSD,PRSD_SV,"2025-05-18 21:42:23",1235,493,457,36,0,486,7,1359,866,317,169
11,CARAŞ-SEVERIN,"CASA DE CULTURĂ",121,"ORAŞ MOLDOVA NOUĂ",51056,1,PART,PRCNCT,PRSD,PRSD_SV,"2025-05-18 21:55:25",849,387,347,40,0,385,2,935,548,216,169
11,CARAŞ-SEVERIN,"GRĂDINIŢA CU PROGRAM NORMAL ”BAMBI”",122,"ORAŞ MOLDOVA NOUĂ",51056,1,PART,PRCNCT,PRSD,PRSD_SV,"2025-05-18 21:45:56",499,209,193,15,1,208,1,550,341,150,58
11,CARAŞ-SEVERIN,"CENTRUL DE AFACERI - BIROUL TAXE ȘI IMPOZITE",123,"ORAŞ MOLDOVA NOUĂ",51056,1,PART,PRCNCT,PRSD,PRSD_SV,"2025-05-18 22:14:59",1091,416,363,52,1,408,8,1199,783,243,165
11,CARAŞ-SEVERIN,"LICEUL TEHNOLOGIC ”CLISURA DUNĂRII” MOLDOVA NOUĂ (CICLUL LICEAL-INTRARE ELEVI)",124,"ORAŞ MOLDOVA NOUĂ",51056,1,PART,PRCNCT,PRSD,PRSD_SV,"2025-05-18 21:37:29",1012,322,296,25,1,318,4,1113,791,179,139
11,CARAŞ-SEVERIN,"LICEUL TEHNOLOGIC ”CLISURA DUNĂRII” (CICLUL LICEAL)",125,"ORAŞ MOLDOVA NOUĂ",51056,1,PART,PRCNCT,PRSD,PRSD_SV,"2025-05-18 21:50:48",755,322,231,67,24,319,3,830,508,193,126
11,CARAŞ-SEVERIN,"LICEUL TEHNOLOGIC ”CLISURA DUNĂRII” (CICLUL GIMNAZIAL)",126,"ORAŞ MOLDOVA NOUĂ",51056,1,PART,PRCNCT,PRSD,PRSD_SV,"2025-05-18 21:57:25",933,312,290,22,0,305,7,1027,715,174,131
11,CARAŞ-SEVERIN,"LICEUL TEHNOLOGIC „CLISURA DUNĂRII” MOLDOVA NOUĂ - SEDIUL ALIANȚEI PENSIONARILOR DIN ROMÂNIA-FILIALA MOLDOVA NOUĂ",127,"ORAŞ MOLDOVA NOUĂ",51056,1,PART,PRCNCT,PRSD,PRSD_SV,"2025-05-18 21:39:36",870,277,264,13,0,274,3,956,679,173,101
11,CARAŞ-SEVERIN,"LICEUL TEHNOLOGIC ”CLISURA DUNĂRII ” CORP C4- ȘCOALA CU 10 CLASE",128,"ORAŞ MOLDOVA NOUĂ",51056,1,PART,PRCNCT,PRSD,PRSD_SV,"2025-05-18 21:38:51",1253,373,351,21,1,370,3,1378,1005,249,121
11,CARAŞ-SEVERIN,"ŞCOALA PRIMARĂ ”SVETI PETAR I PAVLE/SFÂNTUL PETRU ŞI PAVEL”",129,"ORAŞ MOLDOVA NOUĂ",51056,1,PART,PRCNCT,PRSD,PRSD_SV,"2025-05-18 21:52:54",418,192,173,19,0,186,6,459,267,122,64
11,CARAŞ-SEVERIN,"CĂMIN CULTURAL",130,"ORAŞ MOLDOVA NOUĂ",51056,1,PART,PRCNCT,PRSD,PRSD_SV,"2025-05-18 21:44:22",1256,532,501,30,1,523,9,1379,847,350,173
11,CARAŞ-SEVERIN,"CĂMIN CULTURAL",131,"ORAŞ MOLDOVA NOUĂ",51056,1,PART,PRCNCT,PRSD,PRSD_SV,"2025-05-18 21:44:38",156,61,50,11,0,60,1,172,110,35,25
11,CARAŞ-SEVERIN,"ŞCOALA GIMNAZIALĂ NR. 3 ORAVIŢA",132,"ORAŞ ORAVIŢA",51118,1,PART,PRCNCT,PRSD,PRSD_SV,"2025-05-18 21:33:41",946,405,360,45,0,401,4,1040,635,234,167
11,CARAŞ-SEVERIN,"ȘCOALA PRIMARĂ „REGINA MARIA” ORAVIȚA",133,"ORAŞ ORAVIŢA",51118,3,PART,PRCNCT,PRSD,PRSD_SV,"2025-05-19 00:57:01",803,395,363,32,0,386,9,883,488,202,184
11,CARAŞ-SEVERIN,"GRĂDINIŢA PN NR. 2",134,"ORAŞ ORAVIŢA",51118,1,PART,PRCNCT,PRSD,PRSD_SV,"2025-05-18 21:46:26",840,437,403,33,1,425,12,924,487,247,178
11,CARAŞ-SEVERIN,"LICEUL TEHNOLOGIC ” MIHAI NOVAC” ORAVIŢA",135,"ORAŞ ORAVIŢA",51118,1,PART,PRCNCT,PRSD,PRSD_SV,"2025-05-18 21:41:59",1109,519,466,52,1,502,17,1219,700,307,195
11,CARAŞ-SEVERIN,"ŞCOALA GIMNAZIALĂ ” ROMUL LADEA ”ORAVIŢA",136,"ORAŞ ORAVIŢA",51118,1,PART,PRCNCT,PRSD,PRSD_SV,"2025-05-18 22:03:04",1132,493,436,57,0,487,6,1246,753,299,188
11,CARAŞ-SEVERIN,"ŞCOALA GIMNAZIALĂ ”ROMUL LADEA” ORAVIŢA",137,"ORAŞ ORAVIŢA",51118,1,PART,PRCNCT,PRSD,PRSD_SV,"2025-05-18 22:28:12",1355,522,483,39,0,514,8,1490,968,380,134
11,CARAŞ-SEVERIN,"ŞCOALA GIMNAZIALĂ ” ROMUL LADEA” ORAVIŢA",138,"ORAŞ ORAVIŢA",51118,1,PART,PRCNCT,PRSD,PRSD_SV,"2025-05-18 21:40:00",938,369,325,43,1,363,6,1031,662,256,107
11,CARAŞ-SEVERIN,"CREŞA CĂMIN",139,"ORAŞ ORAVIŢA",51118,2,PART,PRCNCT,PRSD,PRSD_SV,"2025-05-19 00:33:52",902,431,343,88,0,429,2,991,560,268,161
11,CARAŞ-SEVERIN,"CĂMIN CULTURAL",140,"ORAŞ ORAVIŢA",51118,1,PART,PRCNCT,PRSD,PRSD_SV,"2025-05-18 21:29:14",452,269,206,63,0,266,3,497,228,169,97
11,CARAŞ-SEVERIN,"ŞCOALA PRIMARĂ AGADICI",141,"ORAŞ ORAVIŢA",51118,1,PART,PRCNCT,PRSD,PRSD_SV,"2025-05-18 21:28:47",145,71,56,15,0,69,2,159,88,51,18
11,CARAŞ-SEVERIN,"ŞCOALA PRIMARĂ BRĂDIŞORU DE JOS",142,"ORAŞ ORAVIŢA",51118,1,PART,PRCNCT,PRSD,PRSD_SV,"2025-05-18 21:48:16",424,160,135,25,0,156,4,465,305,119,37
11,CARAŞ-SEVERIN,"GRĂDINȚA CU PROGRAM NORMAL",143,"ORAŞ ORAVIŢA",51118,1,PART,PRCNCT,PRSD,PRSD_SV,"2025-05-18 21:36:55",499,245,215,30,0,242,3,548,303,172,70
11,CARAŞ-SEVERIN,"CĂMINUL CULTURAL RĂCHITOVA",144,"ORAŞ ORAVIŢA",51118,1,PART,PRCNCT,PRSD,PRSD_SV,"2025-05-18 22:07:00",271,141,120,21,0,138,3,297,156,111,27
11,CARAŞ-SEVERIN,"CASA DE CULTURĂ",145,"ORAŞ OŢELU ROŞU",51207,1,PART,PRCNCT,PRSD,PRSD_SV,"2025-05-18 21:40:08",855,405,329,76,0,399,6,941,536,247,152
11,CARAŞ-SEVERIN,"CASA DE CULTURĂ",146,"ORAŞ OŢELU ROŞU",51207,1,PART,PRCNCT,PRSD,PRSD_SV,"2025-05-18 21:36:37",700,312,272,39,1,307,5,769,457,189,118
11,CARAŞ-SEVERIN,"SCOALA GIMNZIALĂ NR. 3",147,"ORAŞ OŢELU ROŞU",51207,1,PART,PRCNCT,PRSD,PRSD_SV,"2025-05-18 22:02:21",1209,420,388,32,0,414,6,1335,915,240,174
11,CARAŞ-SEVERIN,"GRĂDINIŢA CU PROGRAM PRELUNGIT NR. 3",148,"ORAŞ OŢELU ROŞU",51207,1,PART,PRCNCT,PRSD,PRSD_SV,"2025-05-18 21:32:45",1033,431,390,41,0,423,8,1135,704,218,205
11,CARAŞ-SEVERIN,"CANTINA DE AJUTOR SOCIAL",149,"ORAŞ OŢELU ROŞU",51207,1,PART,PRCNCT,PRSD,PRSD_SV,"2025-05-18 21:33:03",835,367,339,28,0,364,3,919,552,191,173
11,CARAŞ-SEVERIN,"GRĂDINIȚA CU PROGRAM NORMAL NR.2",150,"ORAŞ OŢELU ROŞU",51207,1,PART,PRCNCT,PRSD,PRSD_SV,"2025-05-18 21:53:46",1128,539,479,60,0,534,5,1240,701,292,242
11,CARAŞ-SEVERIN,"GRĂDINIŢA CU PROGRAM NORMAL GAI",151,"ORAŞ OŢELU ROŞU",51207,1,PART,PRCNCT,PRSD,PRSD_SV,"2025-05-18 21:43:24",1116,518,488,30,0,506,12,1227,709,295,211
11,CARAŞ-SEVERIN,"GRĂDINIŢA CU PROGRAM NORMAL VALEA OHĂBII",152,"ORAŞ OŢELU ROŞU",51207,1,PART,PRCNCT,PRSD,PRSD_SV,"2025-05-18 21:37:43",524,220,197,23,0,219,1,578,358,132,87
11,CARAŞ-SEVERIN,"ȘCOALA GIMNAZIALĂ NR.1 OȚELU ROȘU - SALA DE SPORT",153,"ORAŞ OŢELU ROŞU",51207,1,PART,PRCNCT,PRSD,PRSD_SV,"2025-05-18 21:57:18",328,179,153,26,0,177,2,360,181,97,80
11,CARAŞ-SEVERIN,"S.C. ”ROMFLEX” S.A.",154,"ORAŞ OŢELU ROŞU",51207,1,PART,PRCNCT,PRSD,PRSD_SV,"2025-05-18 21:51:57",1159,462,440,22,0,455,7,1274,812,342,113
11,CARAŞ-SEVERIN,"CĂMINUL CULTURAL CIREȘA",155,"ORAŞ OŢELU ROŞU",51207,1,PART,PRCNCT,PRSD,PRSD_SV,"2025-05-18 21:29:57",634,338,294,44,0,333,5,696,358,177,156
11,CARAŞ-SEVERIN,"CĂMINUL CULTURAL MAL",156,"ORAŞ OŢELU ROŞU",51207,1,PART,PRCNCT,PRSD,PRSD_SV,"2025-05-18 21:26:28",294,177,163,13,1,174,3,322,145,120,54
11,CARAŞ-SEVERIN,"CĂMINUL CULTURAL ARMENIȘ",157,ARMENIŞ,51243,1,PART,PRCNCT,PRSD,PRSD_SV,"2025-05-18 22:14:25",1055,700,608,88,4,693,7,1161,461,367,326
11,CARAŞ-SEVERIN,"CĂMINUL CULTURAL FENEȘ",158,ARMENIŞ,51243,1,PART,PRCNCT,PRSD,PRSD_SV,"2025-05-18 21:53:31",449,270,234,36,0,265,5,494,224,172,93
11,CARAŞ-SEVERIN,"ŞCOALA PRIMARĂ SAT BĂTRÂN",159,ARMENIŞ,51243,1,PART,PRCNCT,PRSD,PRSD_SV,"2025-05-18 21:22:46",276,168,148,20,0,166,2,303,135,94,72
11,CARAŞ-SEVERIN,"CĂMINUL CULTURAL SUB MARGINE",160,ARMENIŞ,51243,1,PART,PRCNCT,PRSD,PRSD_SV,"2025-05-18 21:28:46",137,91,78,11,2,91,0,150,59,61,30
11,CARAŞ-SEVERIN,"ȘCOALA GIMNAZIALĂ BĂNIA",161,BĂNIA,51305,1,PART,PRCNCT,PRSD,PRSD_SV,"2025-05-18 21:47:10",899,436,414,22,0,430,6,989,553,260,170
11,CARAŞ-SEVERIN,"CĂMINUL CULTURAL GÂRBOVĂȚ",162,BĂNIA,51305,1,PART,PRCNCT,PRSD,PRSD_SV,"2025-05-18 21:31:22",446,190,151,38,1,187,3,491,301,117,70
11,CARAŞ-SEVERIN,"CĂMINUL CULTURAL BĂUȚARUL DE JOS",163,BĂUŢAR,51332,1,PART,PRCNCT,PRSD,PRSD_SV,"2025-05-18 21:44:45",627,347,290,52,5,346,1,690,343,213,133
11,CARAŞ-SEVERIN,"CASA CULTURALĂ BĂUŢARUL DE SUS",164,BĂUŢAR,51332,1,PART,PRCNCT,PRSD,PRSD_SV,"2025-05-18 21:45:42",634,333,295,23,15,331,2,696,363,204,127
11,CARAŞ-SEVERIN,"CĂMINUL CULTURAL BUCOVA",165,BĂUŢAR,51332,1,PART,PRCNCT,PRSD,PRSD_SV,"2025-05-18 21:51:13",727,377,336,31,10,376,1,799,422,207,169
11,CARAŞ-SEVERIN,"ŞCOALA GIMNAZIALĂ BERLIŞTE",166,BERLIŞTE,51387,1,PART,PRCNCT,PRSD,PRSD_SV,"2025-05-18 21:47:36",289,131,109,22,0,124,7,317,186,91,33
11,CARAŞ-SEVERIN,"ŞCOALA PRIMARĂ IAM",167,BERLIŞTE,51387,1,PART,PRCNCT,PRSD,PRSD_SV,"2025-05-18 21:32:20",269,160,128,32,0,159,1,296,136,115,44
11,CARAŞ-SEVERIN,"CĂMINUL CULTURAL MILCOVENI",168,BERLIŞTE,51387,1,PART,PRCNCT,PRSD,PRSD_SV,"2025-05-18 21:40:06",196,114,93,21,0,113,1,215,101,71,42
11,CARAŞ-SEVERIN,"ŞCOALA PRIMARĂ RUSOVA-NOUĂ",169,BERLIŞTE,51387,1,PART,PRCNCT,PRSD,PRSD_SV,"2025-05-18 21:24:57",160,109,73,36,0,108,1,176,67,73,35
11,CARAŞ-SEVERIN,"CENTRU DE INFORMARE TURISTICĂ",170,BERZASCA,51449,1,PART,PRCNCT,PRSD,PRSD_SV,"2025-05-18 21:47:34",1095,504,425,77,2,495,9,1205,701,369,126
11,CARAŞ-SEVERIN,"ŞCOALA GIMNAZIALĂ BIGĂR",171,BERZASCA,51449,1,PART,PRCNCT,PRSD,PRSD_SV,"2025-05-18 21:16:27",164,48,34,14,0,47,1,180,132,25,22
11,CARAŞ-SEVERIN,"GRĂDINIȚA LIUBCOVA",172,BERZASCA,51449,1,PART,PRCNCT,PRSD,PRSD_SV,"2025-05-18 22:02:39",823,334,304,30,0,329,5,905,571,272,57
11,CARAŞ-SEVERIN,"CĂMINUL CULTURAL BERZOVIA",173,BERZOVIA,51500,1,PART,PRCNCT,PRSD,PRSD_SV,"2025-05-18 22:06:41",877,379,319,59,1,373,6,965,586,199,174
11,CARAŞ-SEVERIN,"CĂMINUL CULTURAL BERZOVIA",174,BERZOVIA,51500,1,PART,PRCNCT,PRSD,PRSD_SV,"2025-05-18 21:48:28",908,323,293,29,1,323,0,999,676,200,123
11,CARAŞ-SEVERIN,"CĂMINUL CULTURAL FIZEȘ",175,BERZOVIA,51500,1,PART,PRCNCT,PRSD,PRSD_SV,"2025-05-18 22:21:36",601,267,218,49,0,264,3,661,394,158,106
11,CARAŞ-SEVERIN,"ŞCOALA PRIMARA GHERTENIS",176,BERZOVIA,51500,1,PART,PRCNCT,PRSD,PRSD_SV,"2025-05-18 22:00:23",785,424,353,55,16,421,3,863,439,329,92
11,CARAŞ-SEVERIN,"CLUBUL TINERETULUI",177,BOLVAŞNIŢA,51546,1,PART,PRCNCT,PRSD,PRSD_SV,"2025-05-18 21:23:57",361,203,184,19,0,200,3,396,193,153,47
11,CARAŞ-SEVERIN,"CLUBUL TINERETULUI",178,BOLVAŞNIŢA,51546,1,PART,PRCNCT,PRSD,PRSD_SV,"2025-05-18 21:32:38",737,351,325,26,0,348,3,811,460,233,115
11,CARAŞ-SEVERIN,"GRĂDINIŢA CU PROGRAM NORMAL BOZOVICI",179,BOZOVICI,51573,1,PART,PRCNCT,PRSD,PRSD_SV,"2025-05-18 22:08:08",1043,501,438,54,9,493,8,1146,645,270,223
11,CARAŞ-SEVERIN,"LICEUL TEORETIC ”EFTIMIE MURGU” BOZOVICI",180,BOZOVICI,51573,1,PART,PRCNCT,PRSD,PRSD_SV,"2025-05-18 21:59:55",657,316,246,68,2,313,3,723,407,167,146
11,CARAŞ-SEVERIN,"GRĂDINIŢA CU PROGRAM NORMAL PRILIPEŢ",181,BOZOVICI,51573,2,PART,PRCNCT,PRSD,PRSD_SV,"2025-05-19 01:19:20",555,286,236,49,1,281,5,611,325,181,100
11,CARAŞ-SEVERIN,"ŞCOALA GIMNAZIALĂ ”SFÂNTUL IACOB” BREBU",182,BREBU,51626,1,PART,PRCNCT,PRSD,PRSD_SV,"2025-05-18 21:50:33",577,398,257,122,19,393,5,634,236,266,127
11,CARAŞ-SEVERIN,"CĂMINUL CULTURAL APADIA",183,BREBU,51626,1,PART,PRCNCT,PRSD,PRSD_SV,"2025-05-18 21:28:17",195,117,76,41,0,115,2,214,97,88,27
11,CARAŞ-SEVERIN,"ŞCOALA CU CLASELE I - IV",184,BREBU,51626,1,PART,PRCNCT,PRSD,PRSD_SV,"2025-05-18 21:35:31",200,158,81,66,11,156,2,220,62,106,50
11,CARAŞ-SEVERIN,"CĂMINUL CULTURAL",185,"BREBU NOU",51662,2,PART,PRCNCT,PRSD,PRSD_SV,"2025-05-18 23:06:00",303,205,64,141,0,204,1,333,128,57,147
11,CARAŞ-SEVERIN,"ŞCOALA CU CLASELE I - IV",186,BUCHIN,51699,1,PART,PRCNCT,PRSD,PRSD_SV,"2025-05-18 21:44:50",777,446,303,143,0,438,8,855,409,301,137
11,CARAŞ-SEVERIN,"CLĂDIREA APARȚINĂTOARE COMUNEI BUCHIN (FOST SEDIU AL PRIMĂRIEI)",187,BUCHIN,51699,1,PART,PRCNCT,PRSD,PRSD_SV,"2025-05-18 21:19:55",493,233,207,26,0,230,3,542,309,193,37
11,CARAŞ-SEVERIN,GRĂDINIŢA,188,BUCHIN,51699,1,PART,PRCNCT,PRSD,PRSD_SV,"2025-05-18 21:38:49",432,237,208,29,0,236,1,475,238,152,84
11,CARAŞ-SEVERIN,"ȘCOALA PRIMARĂ BUCOȘNIȚA",189,BUCOŞNIŢA,51751,1,PART,PRCNCT,PRSD,PRSD_SV,"2025-05-18 21:30:11",588,244,213,31,0,243,1,647,403,182,61
11,CARAŞ-SEVERIN,"ȘCOALA PRIMARĂ GOLEȚ",190,BUCOŞNIŢA,51751,1,PART,PRCNCT,PRSD,PRSD_SV,"2025-05-18 21:19:30",427,214,197,17,0,207,7,470,256,175,32
11,CARAŞ-SEVERIN,"ȘCOALA GIMNAZIALĂ PETROȘNIȚA",191,BUCOŞNIŢA,51751,1,PART,PRCNCT,PRSD,PRSD_SV,"2025-05-18 21:22:27",802,366,324,42,0,365,1,882,516,262,103
11,CARAŞ-SEVERIN,"ȘCOALA PRIMARĂ VĂLIȘOARA",192,BUCOŞNIŢA,51751,1,PART,PRCNCT,PRSD,PRSD_SV,"2025-05-18 21:25:32",513,272,240,31,1,271,1,563,291,177,94
11,CARAŞ-SEVERIN,"CĂMINUL CULTURAL CARAȘOVA",193,CARAŞOVA,51804,1,PART,PRCNCT,PRSD,PRSD_SV,"2025-05-18 21:33:19",834,323,282,41,0,317,6,917,594,179,138
11,CARAŞ-SEVERIN,"GRĂDINIȚA CU PROGRAM NORMAL CARAȘOVA",194,CARAŞOVA,51804,1,PART,PRCNCT,PRSD,PRSD_SV,"2025-05-18 21:35:11",993,309,287,21,1,304,5,1093,784,167,137
11,CARAŞ-SEVERIN,"ŞCOALA IABALCEA",195,CARAŞOVA,51804,1,PART,PRCNCT,PRSD,PRSD_SV,"2025-05-18 21:33:06",165,130,87,43,0,128,2,182,52,57,71
11,CARAŞ-SEVERIN,"ŞCOALA PRIMARĂ NERMED",196,CARAŞOVA,51804,1,PART,PRCNCT,PRSD,PRSD_SV,"2025-05-18 21:19:49",408,184,165,19,0,182,2,449,265,125,57
11,CARAŞ-SEVERIN,"ŞCOALA GIMNAZIALĂ CĂRBUNARI",197,CĂRBUNARI,51840,1,PART,PRCNCT,PRSD,PRSD_SV,"2025-05-18 21:47:40",445,216,178,38,0,211,5,490,274,157,54
11,CARAŞ-SEVERIN,"ŞCOALA PRIMARĂ CLASELE I-IV ȘI GRĂDINIȚA DE COPII ȘTINĂPARI",198,CĂRBUNARI,51840,1,PART,PRCNCT,PRSD,PRSD_SV,"2025-05-18 21:36:12",263,141,109,32,0,138,3,288,147,104,34
11,CARAŞ-SEVERIN,"SCOALA GIMNAZIALA CICLOVA ROMANA",199,"CICLOVA ROMÂNĂ",51948,1,PART,PRCNCT,PRSD,PRSD_SV,"2025-05-18 22:29:02",926,480,403,73,4,471,9,1019,539,280,191
11,CARAŞ-SEVERIN,"ŞCOALA PRIMARA ILIDIA",200,"CICLOVA ROMÂNĂ",51948,1,PART,PRCNCT,PRSD,PRSD_SV,"2025-05-18 21:43:58",277,170,98,72,0,167,3,304,134,95,72
11,CARAŞ-SEVERIN,"CADIREA PRIMARIEI(FOSTUL SEDIU AL PRIMARIEI DIN SOCOLARI)",201,"CICLOVA ROMÂNĂ",51948,1,PART,PRCNCT,PRSD,PRSD_SV,"2025-05-18 21:25:26",115,102,44,58,0,100,2,127,25,62,38
11,CARAŞ-SEVERIN,"CASA DE CULTURĂ",202,CIUCHICI,51984,1,PART,PRCNCT,PRSD,PRSD_SV,"2025-05-18 22:06:31",394,254,191,63,0,250,4,382,128,161,89
11,CARAŞ-SEVERIN,"CASA DE CULTURĂ",203,CIUCHICI,51984,1,PART,PRCNCT,PRSD,PRSD_SV,"2025-05-18 21:49:06",73,95,51,44,0,93,2,130,35,50,43
11,CARAŞ-SEVERIN,"ȘCOALA NICOLINȚ (CORP CLĂDIRE B), NIVEL PRIMAR",204,CIUCHICI,51984,1,PART,PRCNCT,PRSD,PRSD_SV,"2025-05-18 21:31:11",291,126,84,42,0,120,6,319,193,99,21
11,CARAŞ-SEVERIN,"CLĂDIRE ADMINISTRATIVĂ PETRILOVA",205,CIUCHICI,51984,1,PART,PRCNCT,PRSD,PRSD_SV,"2025-05-18 21:27:28",114,88,57,31,0,85,3,124,36,62,23
11,CARAŞ-SEVERIN,"ŞCOALA GIMNAZIALĂ",206,CIUDANOVIŢA,52035,1,PART,PRCNCT,PRSD,PRSD_SV,"2025-05-18 21:40:50",359,144,122,22,0,141,3,394,250,92,49
11,CARAŞ-SEVERIN,"CĂMINUL CULTURAL",207,CIUDANOVIŢA,52035,1,PART,PRCNCT,PRSD,PRSD_SV,"2025-05-18 21:19:56",89,81,53,28,0,77,4,97,16,52,25
11,CARAŞ-SEVERIN,"GRĂDINIŢA CU PROGRAM NORMAL CONSTANTIN DAICOVICIU",208,"CONSTANTIN DAICOVICIU",51877,1,PART,PRCNCT,PRSD,PRSD_SV,"2025-05-18 21:27:29",537,303,237,66,0,298,5,590,287,201,97
11,CARAŞ-SEVERIN,"ŞCOALA GIMNAZIALĂ MACIOVA",209,"CONSTANTIN DAICOVICIU",51877,1,PART,PRCNCT,PRSD,PRSD_SV,"2025-05-18 21:29:42",393,169,152,17,0,167,2,431,262,106,61
11,CARAŞ-SEVERIN,"ŞCOALA PRIMARĂ MÂTNICU MARE",210,"CONSTANTIN DAICOVICIU",51877,1,PART,PRCNCT,PRSD,PRSD_SV,"2025-05-18 21:22:33",314,158,137,21,0,151,7,344,186,86,65
11,CARAŞ-SEVERIN,"ŞCOALA PRIMARĂ PEȘTERE",211,"CONSTANTIN DAICOVICIU",51877,1,PART,PRCNCT,PRSD,PRSD_SV,"2025-05-18 21:41:27",184,104,90,14,0,103,1,201,97,46,57
11,CARAŞ-SEVERIN,"ŞCOALA PRIMARĂ PRISACA",212,"CONSTANTIN DAICOVICIU",51877,1,PART,PRCNCT,PRSD,PRSD_SV,"2025-05-18 21:23:06",349,185,157,26,2,181,4,383,198,109,72
11,CARAŞ-SEVERIN,"ŞCOALA GIMNAZIALĂ ZĂGUJENI",213,"CONSTANTIN DAICOVICIU",51877,1,PART,PRCNCT,PRSD,PRSD_SV,"2025-05-18 21:51:18",447,270,216,52,2,266,4,491,221,164,102
11,CARAŞ-SEVERIN,"ŞCOALA GIMNAZIALĂ COPĂCELE",214,COPĂCELE,52062,1,PART,PRCNCT,PRSD,PRSD_SV,"2025-05-18 21:28:16",275,129,98,30,1,128,1,303,174,79,49
11,CARAŞ-SEVERIN,"CĂMINUL CULTURAL OHABA-MÂTNIC",215,COPĂCELE,52062,1,PART,PRCNCT,PRSD,PRSD_SV,"2025-05-18 21:23:56",207,97,74,19,4,96,1,227,130,71,25
11,CARAŞ-SEVERIN,"ŞCOALA GENERALĂ RUGINOSU",216,COPĂCELE,52062,1,PART,PRCNCT,PRSD,PRSD_SV,"2025-05-18 21:14:50",100,71,48,21,2,70,1,110,39,55,15
11,CARAŞ-SEVERIN,"CĂMINUL CULTURAL ZORILE",217,COPĂCELE,52062,2,PART,PRCNCT,PRSD,PRSD_SV,"2025-05-18 23:09:07",293,162,106,56,0,161,1,321,159,104,57
11,CARAŞ-SEVERIN,"ŞCOALA GIMNAZIALĂ ” TRAIAN LALESCU ” CORNEA",218,CORNEA,52115,1,PART,PRCNCT,PRSD,PRSD_SV,"2025-05-18 21:26:48",562,305,257,43,5,304,1,618,313,199,105
11,CARAŞ-SEVERIN,"GRĂDINIŢA CU PROGRAM NORMAL ” PRICHINDELUL” CRUŞOVĂŢ",219,CORNEA,52115,1,PART,PRCNCT,PRSD,PRSD_SV,"2025-05-18 21:46:49",350,240,185,35,20,238,2,384,144,185,53
11,CARAŞ-SEVERIN,"ŞCOALA GIMNAZIALĂ CUPTOARE",220,CORNEA,52115,1,PART,PRCNCT,PRSD,PRSD_SV,"2025-05-18 21:24:04",471,259,232,26,1,258,1,518,259,162,96
11,CARAŞ-SEVERIN,"CENTRUL LOCAL DE INFORMARE TURISTICĂ",221,CORNEREVA,52160,1,PART,PRCNCT,PRSD,PRSD_SV,"2025-05-18 21:41:41",369,208,171,37,0,203,5,406,198,152,51
11,CARAŞ-SEVERIN,"CĂMINUL CULTURAL BOGÂLTIN",222,CORNEREVA,52160,1,PART,PRCNCT,PRSD,PRSD_SV,"2025-05-18 21:23:51",288,141,114,27,0,139,2,316,175,74,65
11,CARAŞ-SEVERIN,"ŞCOALA PRIMARĂ DOBRAIA",223,CORNEREVA,52160,1,PART,PRCNCT,PRSD,PRSD_SV,"2025-05-18 21:18:37",67,39,23,16,0,38,1,73,34,23,15
11,CARAŞ-SEVERIN,"ŞCOALA PRIMARĂ DOLINA",224,CORNEREVA,52160,1,PART,PRCNCT,PRSD,PRSD_SV,"2025-05-18 21:39:39",644,271,255,16,0,269,2,707,436,198,71
11,CARAŞ-SEVERIN,"ŞCOALA GIMNAZIALĂ GRUNI",225,CORNEREVA,52160,1,PART,PRCNCT,PRSD,PRSD_SV,"2025-05-18 21:36:54",811,345,323,21,1,342,3,891,546,238,104
11,CARAŞ-SEVERIN,"ŞCOALA GENERALĂ CL. I-IV INELEȚ",226,CORNEREVA,52160,1,PART,PRCNCT,PRSD,PRSD_SV,"2025-05-18 21:12:40",62,33,18,15,0,33,0,68,35,16,17
11,CARAŞ-SEVERIN,"ȘCOALA GIMNAZIALĂ CORONINI",227,CORONINI,53489,1,PART,PRCNCT,PRSD,PRSD_SV,"2025-05-18 22:08:11",1130,679,566,112,1,674,5,1243,564,438,236
11,CARAŞ-SEVERIN,"CĂMINUL CULTURAL SF. ELENA",228,CORONINI,53489,1,PART,PRCNCT,PRSD,PRSD_SV,"2025-05-18 22:00:31",487,186,160,26,0,182,4,537,351,91,91
11,CARAŞ-SEVERIN,"CENTRUL DE INFORMARE TURISTICĂ DALBOȘEȚ",229,DALBOŞEŢ,52570,1,PART,PRCNCT,PRSD,PRSD_SV,"2025-05-18 21:58:47",771,576,457,65,54,570,6,848,272,206,364
11,CARAŞ-SEVERIN,"CĂMINUL CULTURAL ȘOPOTU VECHI",230,DALBOŞEŢ,52570,1,PART,PRCNCT,PRSD,PRSD_SV,"2025-05-18 21:33:34",472,293,216,28,49,290,3,519,226,129,161
11,CARAŞ-SEVERIN,"ŞCOALA PRIMARĂ DOCLIN",231,DOCLIN,52650,1,PART,PRCNCT,PRSD,PRSD_SV,"2025-05-18 21:36:12",408,197,156,41,0,195,2,448,251,127,68
11,CARAŞ-SEVERIN,"ŞCOALA PRIMARĂ BINIŞ",232,DOCLIN,52650,1,PART,PRCNCT,PRSD,PRSD_SV,"2025-05-18 21:41:41",608,273,244,28,1,271,2,668,395,166,105
11,CARAŞ-SEVERIN,"ŞCOALA GIMNAZIALĂ TIROL",233,DOCLIN,52650,1,PART,PRCNCT,PRSD,PRSD_SV,"2025-05-18 21:45:01",495,159,133,25,1,157,2,544,385,110,47
11,CARAŞ-SEVERIN,"CĂMINUL CULTURAL DOGNECEA",234,DOGNECEA,52696,1,PART,PRCNCT,PRSD,PRSD_SV,"2025-05-18 21:33:33",921,397,335,60,2,393,4,1014,617,282,111
11,CARAŞ-SEVERIN,"SCOALA GIMNAZIALA",235,DOGNECEA,52696,1,PART,PRCNCT,PRSD,PRSD_SV,"2025-05-18 21:24:05",580,245,218,27,0,243,2,637,392,212,31
11,CARAŞ-SEVERIN,"CĂMINUL CULTURAL",236,DOGNECEA,52696,1,PART,PRCNCT,PRSD,PRSD_SV,"2025-05-18 21:16:50",73,54,31,23,0,53,1,79,25,29,24
11,CARAŞ-SEVERIN,"CĂMINUL CULTURAL",237,DOMAŞNEA,52721,1,PART,PRCNCT,PRSD,PRSD_SV,"2025-05-18 21:30:05",730,343,281,61,1,340,3,802,459,239,101
11,CARAŞ-SEVERIN,"CĂMINUL CULTURAL",238,DOMAŞNEA,52721,1,PART,PRCNCT,PRSD,PRSD_SV,"2025-05-18 21:29:29",299,159,146,13,0,159,0,328,169,142,17
11,CARAŞ-SEVERIN,"CĂMINUL CULTURAL",239,"EFTIMIE MURGU",53700,1,PART,PRCNCT,PRSD,PRSD_SV,"2025-05-18 22:03:19",1202,675,561,83,31,668,7,1322,647,378,290
11,CARAŞ-SEVERIN,"CĂMINUL CULTURAL EZERIȘ",240,EZERIŞ,52758,1,PART,PRCNCT,PRSD,PRSD_SV,"2025-05-18 21:46:11",544,340,241,91,8,340,0,598,258,184,156
11,CARAŞ-SEVERIN,"CĂMINUL CULTURAL SOCENI",241,EZERIŞ,52758,1,PART,PRCNCT,PRSD,PRSD_SV,"2025-05-18 21:30:23",557,374,254,94,26,372,2,613,239,170,202
11,CARAŞ-SEVERIN,"ŞCOALA GIMNAZIALĂ FÂRLIUG",242,FÂRLIUG,52785,1,PART,PRCNCT,PRSD,PRSD_SV,"2025-05-18 22:01:33",605,344,267,67,10,344,0,666,322,238,106
11,CARAŞ-SEVERIN,"CENTRUL AGRICOL DEZEŞTI",243,FÂRLIUG,52785,1,PART,PRCNCT,PRSD,PRSD_SV,"2025-05-18 21:19:56",142,109,68,41,0,109,0,155,46,72,37
11,CARAŞ-SEVERIN,"CLĂDIRE ADMINISTRATIVĂ",244,FÂRLIUG,52785,1,PART,PRCNCT,PRSD,PRSD_SV,"2025-05-18 21:21:08",183,109,80,29,0,109,0,200,91,84,25
11,CARAŞ-SEVERIN,"ŞCOALA PRIMARĂ REMETEA-POGĂNICI",245,FÂRLIUG,52785,1,PART,PRCNCT,PRSD,PRSD_SV,"2025-05-18 21:19:35",179,107,65,38,4,106,1,197,90,81,25
11,CARAŞ-SEVERIN,"CĂMINUL CULTURAL SCĂIUȘ",246,FÂRLIUG,52785,1,PART,PRCNCT,PRSD,PRSD_SV,"2025-05-18 21:28:14",234,136,97,39,0,135,1,256,120,73,62
11,CARAŞ-SEVERIN,"CĂMINUL CULTURAL VALEA MARE",247,FÂRLIUG,52785,1,PART,PRCNCT,PRSD,PRSD_SV,"2025-05-18 21:26:06",94,93,51,42,0,93,0,102,9,61,32
11,CARAŞ-SEVERIN,"SEDIUL PRIMĂRIEI COMUNEI FOROTIC",248,FOROTIC,52856,1,PART,PRCNCT,PRSD,PRSD_SV,"2025-05-18 21:25:46",557,259,210,49,0,255,4,612,353,177,78
11,CARAŞ-SEVERIN,"ŞCOALA PRIMARĂ COMORÂȘTE",249,FOROTIC,52856,1,PART,PRCNCT,PRSD,PRSD_SV,"2025-05-18 21:32:53",423,240,206,34,0,239,1,464,224,137,102
11,CARAŞ-SEVERIN,"ŞCOALA PRIMARĂ SURDUCU MARE",250,FOROTIC,52856,1,PART,PRCNCT,PRSD,PRSD_SV,"2025-05-18 21:38:00",323,166,131,35,0,166,0,354,188,105,61
11,CARAŞ-SEVERIN,"CASA CULTURALĂ PETR. GLASER",251,GÂRNIC,52909,1,PART,PRCNCT,PRSD,PRSD_SV,"2025-05-18 21:36:19",381,134,106,18,10,134,0,419,285,44,90
11,CARAŞ-SEVERIN,"CĂMINUL CULTURAL PADINA MATEI",252,GÂRNIC,52909,1,PART,PRCNCT,PRSD,PRSD_SV,"2025-05-18 21:26:56",696,297,269,27,1,288,9,766,469,182,106
11,CARAŞ-SEVERIN,"CĂMINUL CULTURAL",253,GLIMBOCA,52936,2,PART,PRCNCT,PRSD,PRSD_SV,"2025-05-18 23:37:21",1508,716,630,79,7,709,7,1661,945,421,288
11,CARAŞ-SEVERIN,"CENTRUL LOCAL DE INFORMARE ȘI PROMOVARE TURISTICĂ GORUIA",254,GORUIA,52954,1,PART,PRCNCT,PRSD,PRSD_SV,"2025-05-18 21:32:43",307,186,145,37,4,180,6,338,152,131,49
11,CARAŞ-SEVERIN,"BIBLIOTECA VALERIU LEU",255,GORUIA,52954,1,PART,PRCNCT,PRSD,PRSD_SV,"2025-05-18 21:27:04",231,162,92,69,1,159,3,253,91,89,70
11,CARAŞ-SEVERIN,"ŞCOALA CU CLASELE I - IV",256,GORUIA,52954,1,PART,PRCNCT,PRSD,PRSD_SV,"2025-05-18 21:20:20",126,88,50,36,2,87,1,138,50,50,37
11,CARAŞ-SEVERIN,"GRĂDINIȚA CU PROGRAM NORMAL GRĂDINARI",257,GRĂDINARI,52990,1,PART,PRCNCT,PRSD,PRSD_SV,"2025-05-18 21:39:04",826,395,334,59,2,386,9,908,513,252,134
11,CARAŞ-SEVERIN,"CLĂDIRE PRIMĂRIE - FOSTUL SEDIU CAP",258,GRĂDINARI,52990,1,PART,PRCNCT,PRSD,PRSD_SV,"2025-05-18 21:51:51",785,352,312,40,0,351,1,864,512,243,108
11,CARAŞ-SEVERIN,"CĂMINUL CULTURAL IABLANIŢA",259,IABLANIŢA,53023,1,PART,PRCNCT,PRSD,PRSD_SV,"2025-05-18 22:07:35",587,286,243,43,0,283,3,646,360,177,106
11,CARAŞ-SEVERIN,"ŞCOALA PRIMARĂ GLOBU CRAIOVEI",260,IABLANIŢA,53023,1,PART,PRCNCT,PRSD,PRSD_SV,"2025-05-18 21:38:25",476,274,222,51,1,272,2,523,249,210,62
11,CARAŞ-SEVERIN,"CĂMINUL CULTURAL PETNIC",261,IABLANIŢA,53023,1,PART,PRCNCT,PRSD,PRSD_SV,"2025-05-18 21:45:00",560,292,235,57,0,289,3,616,323,214,75
11,CARAŞ-SEVERIN,"CLĂDIREA AFTER SCHOOL",262,LĂPUŞNICEL,53069,1,PART,PRCNCT,PRSD,PRSD_SV,"2025-05-18 21:24:45",329,158,136,22,0,158,0,361,203,98,60
11,CARAŞ-SEVERIN,"ŞCOALA PRIMARĂ PÂRVOVA",263,LĂPUŞNICEL,53069,1,PART,PRCNCT,PRSD,PRSD_SV,"2025-05-18 21:25:46",341,184,147,37,0,184,0,375,191,125,59
11,CARAŞ-SEVERIN,"ŞCOALA PRIMARĂ ŞUMIŢA",264,LĂPUŞNICEL,53069,1,PART,PRCNCT,PRSD,PRSD_SV,"2025-05-18 21:24:36",62,48,29,19,0,46,2,68,20,27,19
11,CARAŞ-SEVERIN,"CĂMINUL CULTURAL LĂPUŞNICU MARE",265,"LĂPUŞNICU MARE",53103,1,PART,PRCNCT,PRSD,PRSD_SV,"2025-05-18 21:43:30",827,393,345,47,1,382,11,910,517,222,160
11,CARAŞ-SEVERIN,"CĂMINUL CULTURAL MOCERIŞ",266,"LĂPUŞNICU MARE",53103,1,PART,PRCNCT,PRSD,PRSD_SV,"2025-05-18 21:44:44",442,200,169,30,1,199,1,486,286,125,74
11,CARAŞ-SEVERIN,"GRĂDINIȚA CU PROGRAM NORMAL LUNCAVIȚA",267,LUNCAVIŢA,53130,1,PART,PRCNCT,PRSD,PRSD_SV,"2025-05-18 21:27:20",611,260,231,29,0,258,2,673,413,154,104
11,CARAŞ-SEVERIN,"ȘCOALA GIMNAZIALĂ VERENDIN",268,LUNCAVIŢA,53130,1,PART,PRCNCT,PRSD,PRSD_SV,"2025-05-18 22:06:17",1213,471,424,47,0,468,3,1334,863,358,110
11,CARAŞ-SEVERIN,"ŞCOALA GIMNAZIALĂ LUPAC",269,LUPAC,53167,1,PART,PRCNCT,PRSD,PRSD_SV,"2025-05-18 21:18:19",719,222,206,16,0,221,1,790,568,117,104
11,CARAŞ-SEVERIN,"ŞCOALA GIMNAZIALĂ CLOCOTICI",270,LUPAC,53167,1,PART,PRCNCT,PRSD,PRSD_SV,"2025-05-18 21:25:18",673,268,223,45,0,267,1,739,471,125,142
11,CARAŞ-SEVERIN,"ŞCOALA PRIMARĂ RAFNIC",271,LUPAC,53167,1,PART,PRCNCT,PRSD,PRSD_SV,"2025-05-18 21:23:54",451,163,146,17,0,161,2,496,333,105,56
11,CARAŞ-SEVERIN,"ŞCOALA PRIMARĂ VODNIC",272,LUPAC,53167,1,PART,PRCNCT,PRSD,PRSD_SV,"2025-05-18 21:10:27",327,98,86,12,0,98,0,359,261,67,31
11,CARAŞ-SEVERIN,"CASA CULTURALĂ ”DUMBRĂVIȚA” MARGA",273,MARGA,53210,1,PART,PRCNCT,PRSD,PRSD_SV,"2025-05-18 21:46:20",865,507,448,49,10,496,11,953,446,314,182
11,CARAŞ-SEVERIN,"ȘCOALA GIMNAZIALĂ MĂURENI",274,MĂURENI,53247,1,PART,PRCNCT,PRSD,PRSD_SV,"2025-05-18 22:07:08",1553,745,632,89,24,736,9,1707,962,505,231
11,CARAŞ-SEVERIN,"GRĂDINIȚA CU PROGRAM NORMAL ȘOȘDEA",275,MĂURENI,53247,1,PART,PRCNCT,PRSD,PRSD_SV,"2025-05-18 22:16:46",707,409,321,71,17,404,5,777,368,282,122
11,CARAŞ-SEVERIN,"LICEUL TEHNOLOGIC ”NICOLAE STOICA DE HATEG”",276,MEHADIA,53274,1,PART,PRCNCT,PRSD,PRSD_SV,"2025-05-18 21:38:47",1209,554,495,58,1,543,11,1328,774,329,214
11,CARAŞ-SEVERIN,"LICEUL TEHNOLOGIC ”NICOLAE STOICA DE HATEG”",277,MEHADIA,53274,3,PART,PRCNCT,PRSD,PRSD_SV,"2025-05-19 01:40:51",862,380,324,56,0,376,4,949,568,232,144
11,CARAŞ-SEVERIN,"ŞCOALA GENERALĂ",278,MEHADIA,53274,1,PART,PRCNCT,PRSD,PRSD_SV,"2025-05-18 21:28:05",193,119,93,26,0,117,2,212,93,96,21
11,CARAŞ-SEVERIN,"ŞCOALA GENERALĂ",279,MEHADIA,53274,1,PART,PRCNCT,PRSD,PRSD_SV,"2025-05-18 21:35:49",620,304,241,61,2,303,1,681,377,153,150
11,CARAŞ-SEVERIN,"ŞCOALA GENERALĂ",280,MEHADIA,53274,1,PART,PRCNCT,PRSD,PRSD_SV,"2025-05-18 21:39:11",518,274,208,66,0,273,1,570,296,172,101
11,CARAŞ-SEVERIN,"ŞCOALA GIMNAZIALĂ MEHADICA",281,MEHADICA,53327,1,PART,PRCNCT,PRSD,PRSD_SV,"2025-05-18 22:12:27",510,279,199,80,0,273,6,560,281,165,108
11,CARAŞ-SEVERIN,"PRIMĂRIA VECHE",282,NAIDĂŞ,53345,1,PART,PRCNCT,PRSD,PRSD_SV,"2025-05-18 21:47:36",658,389,316,71,2,384,5,724,335,261,123
11,CARAŞ-SEVERIN,"CĂMINUL CULTURAL",283,NAIDĂŞ,53345,1,PART,PRCNCT,PRSD,PRSD_SV,"2025-05-18 21:36:45",189,153,83,63,7,152,1,208,55,84,68
11,CARAŞ-SEVERIN,"ȘCOALA GIMNAZIALĂ OBREJA",284,OBREJA,53372,1,PART,PRCNCT,PRSD,PRSD_SV,"2025-05-18 22:49:51",1418,713,649,63,1,702,11,1559,846,444,258
11,CARAŞ-SEVERIN,"ȘCOALA GENERALĂ CU CLASELE I-IV CIUTA",285,OBREJA,53372,1,PART,PRCNCT,PRSD,PRSD_SV,"2025-05-18 21:34:05",297,165,135,29,1,157,8,327,162,100,57
11,CARAŞ-SEVERIN,"ȘCOALA GENERALĂ CU CLASELE I-IV IAZ",286,OBREJA,53372,1,PART,PRCNCT,PRSD,PRSD_SV,"2025-05-18 21:52:18",629,362,298,64,0,359,3,691,329,250,109
11,CARAŞ-SEVERIN,"ȘCOLA GENERALĂ CU CLASELE I-IV VAR",287,OBREJA,53372,1,PART,PRCNCT,PRSD,PRSD_SV,"2025-05-18 21:26:52",359,223,173,50,0,219,4,394,171,154,65
11,CARAŞ-SEVERIN,"ŞCOALA GIMNAZIALĂ OCNA DE FIER",288,"OCNA DE FIER",50987,1,PART,PRCNCT,PRSD,PRSD_SV,"2025-05-18 21:37:50",585,296,217,63,16,295,1,643,347,151,144
11,CARAŞ-SEVERIN,"CENTRUL LOCAL DE INFORMARE TURISTICĂ",289,PĂLTINIŞ,53425,1,PART,PRCNCT,PRSD,PRSD_SV,"2025-05-18 21:35:09",589,340,293,45,2,333,7,648,308,202,131
11,CARAŞ-SEVERIN,"ŞCOALA GIMNAZIALĂ CORNUȚEL",290,PĂLTINIŞ,53425,1,PART,PRCNCT,PRSD,PRSD_SV,"2025-05-18 21:20:20",895,371,328,43,0,369,2,984,613,262,107
11,CARAŞ-SEVERIN,"ŞCOALA GIMNAZIALĂ DELINEȘTI",291,PĂLTINIŞ,53425,1,PART,PRCNCT,PRSD,PRSD_SV,"2025-05-18 21:14:50",346,149,114,32,3,146,3,380,231,106,40
11,CARAŞ-SEVERIN,"CĂMINUL CULTURAL",292,PĂLTINIŞ,53425,1,PART,PRCNCT,PRSD,PRSD_SV,"2025-05-18 21:23:44",56,54,22,32,0,53,1,62,8,33,20
11,CARAŞ-SEVERIN,GRĂDINIȚA,293,PĂLTINIŞ,53425,1,PART,PRCNCT,PRSD,PRSD_SV,"2025-05-18 21:19:55",226,135,99,36,0,134,1,248,113,95,39
11,CARAŞ-SEVERIN,"ŞCOALA GIMNAZIALĂ ”ATANASIE COJOCARU” POJEJENA",294,POJEJENA,53513,1,PART,PRCNCT,PRSD,PRSD_SV,"2025-05-18 21:41:30",864,437,391,46,0,430,7,951,514,302,128
11,CARAŞ-SEVERIN,"CĂMINUL CULTURAL BELOBREȘCA",295,POJEJENA,53513,1,PART,PRCNCT,PRSD,PRSD_SV,"2025-05-18 21:19:06",451,220,187,33,0,219,1,498,278,173,46
11,CARAŞ-SEVERIN,"GRĂDINIŢA CU PROGRAM NORMAL DIVICI",296,POJEJENA,53513,1,PART,PRCNCT,PRSD,PRSD_SV,"2025-05-18 21:30:08",205,135,82,53,0,135,0,226,91,82,53
11,CARAŞ-SEVERIN,"GRĂDINIŢA CU PROGRAM NORMAL RADIMNA",297,POJEJENA,53513,1,PART,PRCNCT,PRSD,PRSD_SV,"2025-05-18 21:24:17",433,204,173,31,0,202,2,476,272,157,45
11,CARAŞ-SEVERIN,"CĂMINUL CULTURAL ȘUȘCA",298,POJEJENA,53513,1,PART,PRCNCT,PRSD,PRSD_SV,"2025-05-18 21:21:14",329,165,143,22,0,160,5,363,198,101,59
11,CARAŞ-SEVERIN,"LICEUL TEHNOLOGIC „IOSIF CORIOLAN BURACU” PRIGOR",299,PRIGOR,53577,1,PART,PRCNCT,PRSD,PRSD_SV,"2025-05-18 21:38:41",725,397,354,43,0,395,2,798,401,284,111
11,CARAŞ-SEVERIN,"ŞCOALA PRIMARĂ BORLOVENII NOI",300,PRIGOR,53577,1,PART,PRCNCT,PRSD,PRSD_SV,"2025-05-18 21:17:08",306,136,112,24,0,135,1,337,201,93,42
11,CARAŞ-SEVERIN,"CĂMIN CULTURAL BORLOVENII VECHI",301,PRIGOR,53577,1,PART,PRCNCT,PRSD,PRSD_SV,"2025-05-18 21:24:52",335,183,156,27,0,183,0,369,186,130,53
11,CARAŞ-SEVERIN,"ŞCOALA PRIMARĂ PĂTAȘ",302,PRIGOR,53577,1,PART,PRCNCT,PRSD,PRSD_SV,"2025-05-18 21:21:50",412,192,153,37,2,192,0,453,261,120,72
11,CARAŞ-SEVERIN,"ŞCOALA GENERALĂ",303,PRIGOR,53577,1,PART,PRCNCT,PRSD,PRSD_SV,"2025-05-18 21:27:21",124,78,59,19,0,78,0,136,58,56,22
11,CARAŞ-SEVERIN,"ŞCOALA GIMNAZIALĂ RAMNA",304,RAMNA,53639,1,PART,PRCNCT,PRSD,PRSD_SV,"2025-05-18 21:40:43",960,533,448,63,22,527,6,1055,522,285,242
11,CARAŞ-SEVERIN,"CĂMINUL CULTURAL VALEAPAI",305,RAMNA,53639,1,PART,PRCNCT,PRSD,PRSD_SV,"2025-05-18 21:20:59",304,180,129,46,5,176,4,335,155,99,77
11,CARAŞ-SEVERIN,"CĂMINUL CULTURAL RĂCĂȘDIA",306,RĂCĂŞDIA,53675,1,PART,PRCNCT,PRSD,PRSD_SV,"2025-05-18 21:57:56",1320,668,563,104,1,655,13,1453,785,410,245
11,CARAŞ-SEVERIN,"CLĂDIREA FOSTEI PRIMĂRII VRĂNIUŢ",307,RĂCĂŞDIA,53675,1,PART,PRCNCT,PRSD,PRSD_SV,"2025-05-18 21:59:12",300,137,85,52,0,136,1,320,183,96,40
11,CARAŞ-SEVERIN,"ŞCOALA GIMNAZIALĂ ŞTEFAN VELOVAN",308,"RUSCA MONTANĂ",53728,1,PART,PRCNCT,PRSD,PRSD_SV,"2025-05-18 22:05:13",1249,625,550,63,12,621,4,1374,749,464,157
11,CARAŞ-SEVERIN,"GRĂDINIŢA CU PROGRAM NORMAL",309,"RUSCA MONTANĂ",53728,1,PART,PRCNCT,PRSD,PRSD_SV,"2025-05-18 21:23:46",232,108,90,17,1,105,3,255,147,82,23
11,CARAŞ-SEVERIN,"GRĂDINIȚA CU PROGRAM NORMAL SACU",310,SACU,53755,1,PART,PRCNCT,PRSD,PRSD_SV,"2025-05-18 21:58:32",652,430,321,104,5,428,2,718,288,281,147
11,CARAŞ-SEVERIN,"ȘCOALA PRIMARĂ SĂLBĂGELU NOU",311,SACU,53755,1,PART,PRCNCT,PRSD,PRSD_SV,"2025-05-18 21:16:05",214,116,102,14,0,115,1,234,118,92,23
11,CARAŞ-SEVERIN,"GRĂDINIȚA CU PROGRAM NORMAL TINCOVA",312,SACU,53755,2,PART,PRCNCT,PRSD,PRSD_SV,"2025-05-18 23:45:06",384,212,171,41,0,210,2,422,210,178,32
11,CARAŞ-SEVERIN,"SCOALA GIMNAZIALA ”MIHAI NOVAC” SASCA MONTANA",313,"SASCA MONTANĂ",53791,1,PART,PRCNCT,PRSD,PRSD_SV,"2025-05-18 21:28:48",374,224,145,69,10,219,5,410,186,109,110
11,CARAŞ-SEVERIN,"CĂMINUL CULTURAL",314,"SASCA MONTANĂ",53791,1,PART,PRCNCT,PRSD,PRSD_SV,"2025-05-18 21:13:49",92,93,53,37,3,90,3,100,7,68,22
11,CARAŞ-SEVERIN,"ŞCOALA PRIMARA POTOC",315,"SASCA MONTANĂ",53791,1,PART,PRCNCT,PRSD,PRSD_SV,"2025-05-18 21:37:29",209,155,107,40,8,155,0,229,74,113,42
11,CARAŞ-SEVERIN,"CĂMINUL CULTURAL",316,"SASCA MONTANĂ",53791,1,PART,PRCNCT,PRSD,PRSD_SV,"2025-05-18 21:14:26",264,178,125,47,6,177,1,290,112,99,78
11,CARAŞ-SEVERIN,"CĂMINUL CULTURAL SLATINA-NERA",317,"SASCA MONTANĂ",53791,1,PART,PRCNCT,PRSD,PRSD_SV,"2025-05-18 21:33:05",300,141,87,52,2,136,5,330,189,92,44
11,CARAŞ-SEVERIN,"CAMIN CULTURAL SICHEVITA",318,SICHEVIŢA,53853,2,PART,PRCNCT,PRSD,PRSD_SV,"2025-05-19 01:29:46",1156,597,529,58,10,592,5,1272,675,438,154
11,CARAŞ-SEVERIN,"GRĂDINIŢA CU PROGRAM NORMAL GORNEA",319,SICHEVIŢA,53853,1,PART,PRCNCT,PRSD,PRSD_SV,"2025-05-18 21:52:01",446,217,172,40,5,216,1,491,274,142,74
11,CARAŞ-SEVERIN,"CENTRUL LOCAL DE INFORMARE TURISTICĂ LIBORAJDEA",320,SICHEVIŢA,53853,1,PART,PRCNCT,PRSD,PRSD_SV,"2025-05-18 21:24:33",55,34,15,19,0,34,0,61,27,23,11
11,CARAŞ-SEVERIN,"CENTRU DE ZI PENTRU PERSOANE VÂRSTNICE SLATINA-TIMIȘ",321,SLATINA-TIMIŞ,54056,1,PART,PRCNCT,PRSD,PRSD_SV,"2025-05-18 22:11:25",1366,621,558,58,5,618,3,1503,882,325,293
11,CARAŞ-SEVERIN,"ȘCOALA PRIMARĂ ILOVA",322,SLATINA-TIMIŞ,54056,1,PART,PRCNCT,PRSD,PRSD_SV,"2025-05-18 21:36:44",581,262,233,29,0,260,2,639,377,213,47
11,CARAŞ-SEVERIN,"CĂMINUL CULTURAL SADOVA NOUĂ",323,SLATINA-TIMIŞ,54056,1,PART,PRCNCT,PRSD,PRSD_SV,"2025-05-18 21:15:50",171,97,79,18,0,95,2,188,91,72,23
11,CARAŞ-SEVERIN,"CĂMINUL CULTURAL SADOVA VECHE",324,SLATINA-TIMIŞ,54056,1,PART,PRCNCT,PRSD,PRSD_SV,"2025-05-18 21:29:53",309,141,100,41,0,137,4,340,199,98,39
11,CARAŞ-SEVERIN,"ŞCOALA GIMNAZIALĂ ”SF. SAVA” SOCOL",325,SOCOL,54109,1,PART,PRCNCT,PRSD,PRSD_SV,"2025-05-18 21:25:02",587,210,181,29,0,208,2,647,437,164,44
11,CARAŞ-SEVERIN,"CENTRUL CULTURAL SÂRBESC ”SFÂNTUL SAVA” BAZIAȘ",326,SOCOL,54109,1,PART,PRCNCT,PRSD,PRSD_SV,"2025-05-18 21:19:02",42,44,25,19,0,43,1,45,1,33,10
11,CARAŞ-SEVERIN,"ŞCOALA PRIMARĂ CÂMPIA",327,SOCOL,54109,1,PART,PRCNCT,PRSD,PRSD_SV,"2025-05-18 21:37:35",460,178,157,19,2,173,5,507,329,142,31
11,CARAŞ-SEVERIN,"ŞCOALA PRIMARĂ ZLATIȚA",328,SOCOL,54109,1,PART,PRCNCT,PRSD,PRSD_SV,"2025-05-18 21:35:40",605,284,251,33,0,276,8,666,382,231,45
11,CARAŞ-SEVERIN,"CĂMINUL CULTURAL ȘOPOTU NOU",329,"ŞOPOTU NOU",54163,1,PART,PRCNCT,PRSD,PRSD_SV,"2025-05-18 21:44:46",251,126,101,25,0,126,0,276,150,66,60
11,CARAŞ-SEVERIN,"CĂMINUL CULTURAL-RAVENSCA",330,"ŞOPOTU NOU",54163,1,PART,PRCNCT,PRSD,PRSD_SV,"2025-05-18 21:30:19",102,37,26,11,0,37,0,112,75,11,26
11,CARAŞ-SEVERIN,"CASA PARTICULARĂ NR.5",331,"ŞOPOTU NOU",54163,1,PART,PRCNCT,PRSD,PRSD_SV,"2025-05-18 21:19:42",83,47,37,10,0,47,0,91,44,18,29
11,CARAŞ-SEVERIN,"CAMININUL CULTURAL-STANCILOVA DE JOS",332,"ŞOPOTU NOU",54163,1,PART,PRCNCT,PRSD,PRSD_SV,"2025-05-18 21:36:53",80,62,48,14,0,62,0,87,25,43,19
11,CARAŞ-SEVERIN,"CAMINNUL CULTURAL STANCILOVA DE SUS",333,"ŞOPOTU NOU",54163,1,PART,PRCNCT,PRSD,PRSD_SV,"2025-05-18 21:35:42",114,51,42,9,0,50,1,124,73,22,28
11,CARAŞ-SEVERIN,"ȘCOALA VALEA ROȘIE",334,"ŞOPOTU NOU",54163,1,PART,PRCNCT,PRSD,PRSD_SV,"2025-05-18 21:16:09",190,99,88,11,0,98,1,209,110,52,46
11,CARAŞ-SEVERIN,"ŞCOALA GIMNAZIALĂ TÂRNOVA",335,TÂRNOVA,54350,1,PART,PRCNCT,PRSD,PRSD_SV,"2025-05-18 22:15:31",1374,618,532,86,0,607,11,1511,893,366,241
11,CARAŞ-SEVERIN,"CĂMINUL CULTURAL TEREGOVA",336,TEREGOVA,54270,1,PART,PRCNCT,PRSD,PRSD_SV,"2025-05-18 21:35:31",1118,539,488,45,6,534,5,1231,692,379,155
11,CARAŞ-SEVERIN,"LICEUL TEHNOLOGIC ”SF. DIMITRIE” TEREGOVA",337,TEREGOVA,54270,1,PART,PRCNCT,PRSD,PRSD_SV,"2025-05-18 21:36:42",1045,542,497,41,4,537,5,1146,604,369,168
11,CARAŞ-SEVERIN,"OFICIUL PRIMĂRIEI RUSCA",338,TEREGOVA,54270,1,PART,PRCNCT,PRSD,PRSD_SV,"2025-05-18 21:35:04",932,457,421,36,0,455,2,1024,567,309,146
11,CARAŞ-SEVERIN,"CASA NR. 372",339,"TICVANIU MARE",54305,1,PART,PRCNCT,PRSD,PRSD_SV,"2025-05-18 21:48:38",711,217,177,39,1,214,3,782,565,142,72
11,CARAŞ-SEVERIN,"CĂMINUL CULTURAL CÂRNECEA",340,"TICVANIU MARE",54305,1,PART,PRCNCT,PRSD,PRSD_SV,"2025-05-18 21:30:59",256,144,105,36,3,143,1,281,137,107,36
11,CARAŞ-SEVERIN,"CASA PAROHIALĂ",341,"TICVANIU MARE",54305,1,PART,PRCNCT,PRSD,PRSD_SV,"2025-05-18 21:22:21",286,152,110,41,1,150,2,314,162,105,45
11,CARAŞ-SEVERIN,"ŞCOALA PRIMARĂ TICVANIU MIC",342,"TICVANIU MARE",54305,1,PART,PRCNCT,PRSD,PRSD_SV,"2025-05-18 21:36:22",276,155,123,30,2,152,3,303,148,108,44
11,CARAŞ-SEVERIN,"CĂMINUL CULTURAL TOPLEŢ",343,TOPLEŢ,54387,1,PART,PRCNCT,PRSD,PRSD_SV,"2025-05-18 22:21:37",1111,562,481,81,0,555,7,922,360,340,215
11,CARAŞ-SEVERIN,"ŞCOALA PRIMARĂ BÂRZA",344,TOPLEŢ,54387,1,PART,PRCNCT,PRSD,PRSD_SV,"2025-05-18 22:04:27",954,434,365,69,0,430,4,1049,615,305,125
11,CARAŞ-SEVERIN,"ȘCOALA GIMNAZIALĂ „TRANDAFIR COCÎRLĂ” TURNU RUIENI",345,"TURNU RUIENI",54412,1,PART,PRCNCT,PRSD,PRSD_SV,"2025-05-18 21:47:50",694,335,303,29,3,331,4,762,427,218,113
11,CARAŞ-SEVERIN,"ȘCOALA GIMNAZIALĂ BORLOVA",346,"TURNU RUIENI",54412,1,PART,PRCNCT,PRSD,PRSD_SV,"2025-05-18 21:45:47",1180,492,432,60,0,486,6,1298,806,349,137
11,CARAŞ-SEVERIN,"ŞCOALA PRIMARĂ DALCI",347,"TURNU RUIENI",54412,1,PART,PRCNCT,PRSD,PRSD_SV,"2025-05-18 21:35:49",198,134,107,27,0,134,0,218,84,85,49
11,CARAŞ-SEVERIN,"CASA NR.174",348,"TURNU RUIENI",54412,1,PART,PRCNCT,PRSD,PRSD_SV,"2025-05-18 21:23:27",460,226,209,17,0,220,6,506,280,181,39
11,CARAŞ-SEVERIN,"CĂMINUL CULTURAL ZLAGNA",349,"TURNU RUIENI",54412,1,PART,PRCNCT,PRSD,PRSD_SV,"2025-05-18 21:59:45",258,167,150,17,0,164,3,284,117,107,57
11,CARAŞ-SEVERIN,"ŞCOALA GIMNAZIALĂ ”PETRE SAVA BĂLEANU” -VĂLIUG",350,VĂLIUG,54485,1,PART,PRCNCT,PRSD,PRSD_SV,"2025-05-18 21:42:58",672,494,320,168,6,491,3,739,245,224,267
11,CARAŞ-SEVERIN,"CĂMINUL CULTURAL VĂRĂDIA",351,VĂRĂDIA,54500,1,PART,PRCNCT,PRSD,PRSD_SV,"2025-05-18 21:54:58",658,246,207,38,1,239,7,723,477,166,73
11,CARAŞ-SEVERIN,"CLĂDIREA ADMINISTRAŢIEI LOCALE",352,VĂRĂDIA,54500,1,PART,PRCNCT,PRSD,PRSD_SV,"2025-05-18 21:28:41",502,232,187,45,0,232,0,552,320,169,63
11,CARAŞ-SEVERIN,"SALA DE SPORT",353,VERMEŞ,54537,1,PART,PRCNCT,PRSD,PRSD_SV,"2025-05-18 21:52:38",732,399,348,51,0,394,5,805,406,239,155
11,CARAŞ-SEVERIN,"ŞCOALA PRIMARĂ ERSIG",354,VERMEŞ,54537,1,PART,PRCNCT,PRSD,PRSD_SV,"2025-05-18 21:22:42",249,131,99,31,1,131,0,273,142,88,43
11,CARAŞ-SEVERIN,"ŞCOALA PRIMARĂ IZGAR",355,VERMEŞ,54537,1,PART,PRCNCT,PRSD,PRSD_SV,"2025-05-18 21:31:04",215,124,87,37,0,122,2,237,113,84,38
11,CARAŞ-SEVERIN,"CĂMINUL CULTURAL VRANI",356,VRANI,54573,1,PART,PRCNCT,PRSD,PRSD_SV,"2025-05-18 21:34:54",672,336,276,58,2,325,11,738,402,245,80
11,CARAŞ-SEVERIN,"SCOALA PRIMARA CIORTEA",357,VRANI,54573,1,PART,PRCNCT,PRSD,PRSD_SV,"2025-05-18 21:33:57",141,96,73,23,0,96,0,154,58,62,34
11,CARAŞ-SEVERIN,"CĂMINUL CULTURAL-ZAVOI",358,ZĂVOI,54617,1,PART,PRCNCT,PRSD,PRSD_SV,"2025-05-18 21:35:20",1472,648,588,60,0,642,6,1418,770,427,215
11,CARAŞ-SEVERIN,"CĂMINUL CULTURAL MĂGURA",359,ZĂVOI,54617,1,PART,PRCNCT,PRSD,PRSD_SV,"2025-05-18 21:34:50",438,253,220,19,14,252,1,482,229,128,124
11,CARAŞ-SEVERIN,"CĂMINUL CULTURAL MĂRU",360,ZĂVOI,54617,1,PART,PRCNCT,PRSD,PRSD_SV,"2025-05-18 21:45:37",862,485,436,47,2,477,8,948,463,296,181
11,CARAŞ-SEVERIN,"OCOLUL SILVIC",361,ZĂVOI,54617,1,PART,PRCNCT,PRSD,PRSD_SV,"2025-05-18 21:17:04",72,167,32,135,0,167,0,278,111,55,112
11,CARAŞ-SEVERIN,"CĂMINUL CULTURAL VOISLOVA",362,ZĂVOI,54617,1,PART,PRCNCT,PRSD,PRSD_SV,"2025-05-18 21:46:30",436,244,195,49,0,241,3,479,235,141,100
11,CARAŞ-SEVERIN,"ŞCOALA GIMNAZIALĂ ZORLENȚU MARE",363,"ZORLENŢU MARE",54699,1,PART,PRCNCT,PRSD,PRSD_SV,"2025-05-18 21:53:29",770,531,298,165,68,528,3,856,325,255,273
11,CARAŞ-SEVERIN,"CĂMINUL CULTURAL ZORLENCIOR",364,"ZORLENŢU MARE",54699,1,PART,PRCNCT,PRSD,PRSD_SV,"2025-05-18 21:20:02",133,109,74,33,2,107,2,146,37,85,22
12,CĂLĂRAŞI,"SCOALA GIMNAZIALA CAROL I CALARASI",1,"MUNICIPIUL CĂLĂRAŞI",92569,1,PART,PRCNCT,PRSD,PRSD_SV,"2025-05-18 22:08:39",1332,760,689,71,0,747,13,1400,640,279,468
12,CĂLĂRAŞI,"SCOALA GIMNAZIALA CAROL I CALARASI",2,"MUNICIPIUL CĂLĂRAŞI",92569,1,PART,PRCNCT,PRSD,PRSD_SV,"2025-05-18 21:27:47",617,383,335,46,2,376,7,701,318,111,265
12,CĂLĂRAŞI,"CENTRUL JUDEŢEAN DE RESURSE ŞI ASISTENŢĂ EDUCAŢIONALĂ CĂLĂRAŞI",3,"MUNICIPIUL CĂLĂRAŞI",92569,1,PART,PRCNCT,PRSD,PRSD_SV,"2025-05-18 22:16:33",926,574,479,54,41,568,6,1000,426,217,351
12,CĂLĂRAŞI,"CENTRUL JUDEŢEAN DE RESURSE ŞI ASISTENŢĂ EDUCAŢIONALĂ CĂLĂRAŞI",4,"MUNICIPIUL CĂLĂRAŞI",92569,1,PART,PRCNCT,PRSD,PRSD_SV,"2025-05-18 21:38:39",699,472,399,23,50,467,5,800,328,157,310
12,CĂLĂRAŞI,"ŞCOALA GIMNAZIALĂ SPECIALĂ NR. 1",5,"MUNICIPIUL CĂLĂRAŞI",92569,1,PART,PRCNCT,PRSD,PRSD_SV,"2025-05-18 22:03:58",1089,697,617,55,25,687,10,1200,503,271,416
12,CĂLĂRAŞI,"ŞCOALA GIMNAZIALĂ SPECIALĂ NR. 1",6,"MUNICIPIUL CĂLĂRAŞI",92569,1,PART,PRCNCT,PRSD,PRSD_SV,"2025-05-18 21:55:02",955,491,452,36,3,484,7,1100,609,243,241
12,CĂLĂRAŞI,"SCOALA GIMNAZIALĂ ” CAROL I” CĂLĂRAŞI",7,"MUNICIPIUL CĂLĂRAŞI",92569,1,PART,PRCNCT,PRSD,PRSD_SV,"2025-05-18 21:31:39",1365,646,615,31,0,636,10,1500,854,286,350
12,CĂLĂRAŞI,"GRĂDINIŢA CU PR.NORMAL NR.4 CALARASI",8,"MUNICIPIUL CĂLĂRAŞI",92569,1,PART,PRCNCT,PRSD,PRSD_SV,"2025-05-18 22:15:29",1435,646,607,38,1,637,9,1500,854,340,297
12,CĂLĂRAŞI,"GRĂDINIŢA CU PROGRAM PRELUNGIT STEP BY STEP CĂLĂRAŞI (FOSTA GRĂDINIŢA CU PR. PREL. MICRO6)",9,"MUNICIPIUL CĂLĂRAŞI",92569,1,PART,PRCNCT,PRSD,PRSD_SV,"2025-05-18 22:00:03",1172,618,577,39,2,610,8,1200,582,245,365
12,CĂLĂRAŞI,"LICEUL AGRICOL ”SANDU ALDEA” CĂLĂRAŞI",10,"MUNICIPIUL CĂLĂRAŞI",92569,1,PART,PRCNCT,PRSD,PRSD_SV,"2025-05-18 21:45:50",1040,519,466,52,1,509,10,1100,581,200,309
12,CĂLĂRAŞI,"LICEUL AGRICOL ”SANDU ALDEA” CĂLĂRAŞI",11,"MUNICIPIUL CĂLĂRAŞI",92569,1,PART,PRCNCT,PRSD,PRSD_SV,"2025-05-18 21:56:54",908,554,522,32,0,550,4,1000,446,200,350
12,CĂLĂRAŞI,"LICEUL AGRICOL ”SANDU ALDEA” CĂLĂRAŞI",12,"MUNICIPIUL CĂLĂRAŞI",92569,1,PART,PRCNCT,PRSD,PRSD_SV,"2025-05-18 21:46:45",937,381,357,24,0,377,4,1100,719,234,143
12,CĂLĂRAŞI,"LIC. TEORETIC ”MIHAI EMINESCU”",13,"MUNICIPIUL CĂLĂRAŞI",92569,1,PART,PRCNCT,PRSD,PRSD_SV,"2025-05-18 21:59:06",945,521,475,46,0,517,4,1100,579,219,298
12,CĂLĂRAŞI,"LIC. TEORETIC ”MIHAI EMINESCU”",14,"MUNICIPIUL CĂLĂRAŞI",92569,1,PART,PRCNCT,PRSD,PRSD_SV,"2025-05-18 21:41:26",1285,671,635,36,0,660,11,1400,729,293,367
12,CĂLĂRAŞI,"LIC. TEORETIC ”MIHAI EMINESCU”",15,"MUNICIPIUL CĂLĂRAŞI",92569,1,PART,PRCNCT,PRSD,PRSD_SV,"2025-05-18 22:06:29",1177,600,571,26,3,587,13,1200,600,292,295
12,CĂLĂRAŞI,"ŞCOALA GIMNAZIALA MIHAI VITEAZUL CALARASI",16,"MUNICIPIUL CĂLĂRAŞI",92569,2,PART,PRCNCT,PRSD,PRSD_SV,"2025-05-18 22:22:52",1274,690,654,36,0,682,8,1300,610,307,375
12,CĂLĂRAŞI,"ŞCOALA GIMNAZIALA MIHAI VITEAZUL CALARASI",17,"MUNICIPIUL CĂLĂRAŞI",92569,1,PART,PRCNCT,PRSD,PRSD_SV,"2025-05-18 21:32:47",1079,569,538,31,0,564,5,1200,631,257,307
12,CĂLĂRAŞI,"ŞCOALA GIMNAZIALA MIHAI VITEAZUL CALARASI",18,"MUNICIPIUL CĂLĂRAŞI",92569,1,PART,PRCNCT,PRSD,PRSD_SV,"2025-05-18 21:40:43",1269,616,588,27,1,611,5,1300,684,293,318
12,CĂLĂRAŞI,"ŞCOALA GIMNAZIALA MIHAI VITEAZUL CALARASI",19,"MUNICIPIUL CĂLĂRAŞI",92569,1,PART,PRCNCT,PRSD,PRSD_SV,"2025-05-18 21:23:11",666,339,324,14,1,335,4,800,461,141,194
12,CĂLĂRAŞI,"SALA DE SPORT A SCOLII GIMNAZIALE NICOLAE TITULESCU",20,"MUNICIPIUL CĂLĂRAŞI",92569,1,PART,PRCNCT,PRSD,PRSD_SV,"2025-05-18 21:39:31",677,370,348,22,0,365,5,800,430,145,220
12,CĂLĂRAŞI,"SALA DE SPORT A SCOLII GIMNAZIALE NICOLAE TITULESCU",21,"MUNICIPIUL CĂLĂRAŞI",92569,1,PART,PRCNCT,PRSD,PRSD_SV,"2025-05-18 21:49:30",1351,652,600,51,1,644,8,1400,748,317,327
12,CĂLĂRAŞI,"GRĂDINIŢA CU PROGRAM PRELUNGIT ”ŢARA COPILĂRIEI” CĂLĂRAŞI(FOSTA GRĂDINIŢĂ CU PR. PREL. NR.1)",22,"MUNICIPIUL CĂLĂRAŞI",92569,1,PART,PRCNCT,PRSD,PRSD_SV,"2025-05-18 22:09:55",995,578,543,35,0,576,2,1100,522,219,357
12,CĂLĂRAŞI,"GRĂDINIŢA CU PROGRAM PRELUNGIT ”ROSTOGOL” CĂLĂRAŞI(FOSTA GRĂDINIŢA CU PROGRAM NORMAL NR.2)",23,"MUNICIPIUL CĂLĂRAŞI",92569,2,PART,PRCNCT,PRSD,PRSD_SV,"2025-05-18 22:55:35",1539,785,744,41,0,779,6,1600,815,393,386
12,CĂLĂRAŞI,"LICEUL ”DANUBIUS” CĂLĂRAŞI",24,"MUNICIPIUL CĂLĂRAŞI",92569,1,PART,PRCNCT,PRSD,PRSD_SV,"2025-05-18 22:09:03",1413,697,613,84,0,686,11,1500,803,406,280
12,CĂLĂRAŞI,"LICEUL ”DANUBIUS” CĂLĂRAŞI",25,"MUNICIPIUL CĂLĂRAŞI",92569,1,PART,PRCNCT,PRSD,PRSD_SV,"2025-05-18 21:54:42",1382,691,652,39,0,687,4,1500,809,400,287
12,CĂLĂRAŞI,"LICEUL ”DANUBIUS” CĂLĂRAŞI",26,"MUNICIPIUL CĂLĂRAŞI",92569,1,PART,PRCNCT,PRSD,PRSD_SV,"2025-05-18 21:47:12",1910,821,780,40,1,805,16,2000,1179,508,297
12,CĂLĂRAŞI,"LICEUL ”DANUBIUS” CĂLĂRAŞI",27,"MUNICIPIUL CĂLĂRAŞI",92569,1,PART,PRCNCT,PRSD,PRSD_SV,"2025-05-18 21:21:12",1457,505,481,24,0,495,10,1600,1095,356,139
12,CĂLĂRAŞI,"CREŞA NR. 1 CĂLĂRAŞI ( FOSTA CREŞA SĂPTĂMÂNALĂ CU 100 LOCURI)",28,"MUNICIPIUL CĂLĂRAŞI",92569,1,PART,PRCNCT,PRSD,PRSD_SV,"2025-05-18 21:59:36",1323,635,600,35,0,627,8,1400,765,355,272
12,CĂLĂRAŞI,"CREŞA NR. 1 CĂLĂRAŞI ( FOSTA CREŞA SĂPTĂMÂNALĂ CU 100 LOCURI)",29,"MUNICIPIUL CĂLĂRAŞI",92569,1,PART,PRCNCT,PRSD,PRSD_SV,"2025-05-18 21:28:10",717,315,289,26,0,311,4,800,485,201,110
12,CĂLĂRAŞI,"ŞCOALA GIMNAZIALĂ ”TUDOR VLADIMIRESCU” CĂLĂRAŞI",30,"MUNICIPIUL CĂLĂRAŞI",92569,1,PART,PRCNCT,PRSD,PRSD_SV,"2025-05-18 22:16:03",1334,765,690,75,0,757,8,1400,635,360,397
12,CĂLĂRAŞI,"ŞCOALA GIMNAZIALĂ ”TUDOR VLADIMIRESCU” CĂLĂRAŞI",31,"MUNICIPIUL CĂLĂRAŞI",92569,1,PART,PRCNCT,PRSD,PRSD_SV,"2025-05-18 21:56:39",1223,706,644,62,0,691,15,1300,594,256,435
12,CĂLĂRAŞI,"ŞCOALA GIMNAZIALĂ ”TUDOR VLADIMIRESCU” CĂLĂRAŞI",32,"MUNICIPIUL CĂLĂRAŞI",92569,1,PART,PRCNCT,PRSD,PRSD_SV,"2025-05-18 21:44:10",1163,660,628,32,0,652,8,1200,540,255,397
12,CĂLĂRAŞI,"ŞCOALA GIMNAZIALĂ ”TUDOR VLADIMIRESCU” CĂLĂRAŞI",33,"MUNICIPIUL CĂLĂRAŞI",92569,1,PART,PRCNCT,PRSD,PRSD_SV,"2025-05-18 21:46:26",1269,674,657,16,1,667,7,1300,626,307,360
12,CĂLĂRAŞI,"COLEGIUL NAŢIONAL ” BARBU ŞTIRBEI” CĂLĂRAŞI",34,"MUNICIPIUL CĂLĂRAŞI",92569,2,PART,PRCNCT,PRSD,PRSD_SV,"2025-05-18 23:12:51",1191,656,582,74,0,656,0,1300,644,308,348
12,CĂLĂRAŞI,"COLEGIUL NAŢIONAL ” BARBU ŞTIRBEI” CĂLĂRAŞI",35,"MUNICIPIUL CĂLĂRAŞI",92569,1,PART,PRCNCT,PRSD,PRSD_SV,"2025-05-18 21:55:55",1055,551,527,24,0,546,5,1100,549,279,267
12,CĂLĂRAŞI,"ŞCOALA GIMNAZIALA MIRCEA VODĂ",36,"MUNICIPIUL CĂLĂRAŞI",92569,1,PART,PRCNCT,PRSD,PRSD_SV,"2025-05-18 21:42:04",1187,691,621,70,0,683,8,1300,609,310,373
12,CĂLĂRAŞI,"ŞCOALA GIMNAZIALA MIRCEA VODĂ",37,"MUNICIPIUL CĂLĂRAŞI",92569,1,PART,PRCNCT,PRSD,PRSD_SV,"2025-05-18 21:43:10",1110,604,576,28,0,597,7,1200,596,367,230
12,CĂLĂRAŞI,"ŞCOALA GIMNAZIALA MIRCEA VODĂ",38,"MUNICIPIUL CĂLĂRAŞI",92569,1,PART,PRCNCT,PRSD,PRSD_SV,"2025-05-18 22:16:13",1478,801,774,27,0,796,5,1600,799,364,432
12,CĂLĂRAŞI,"ŞCOALA GIMNAZIALA MIRCEA VODĂ",39,"MUNICIPIUL CĂLĂRAŞI",92569,1,PART,PRCNCT,PRSD,PRSD_SV,"2025-05-18 21:43:20",1024,538,521,16,1,528,10,1100,562,273,255
12,CĂLĂRAŞI,"GRĂDINIŢA CU PROGRAM PRELUNGIT ”VOINICEL” CĂLĂRAŞI",40,"MUNICIPIUL CĂLĂRAŞI",92569,1,PART,PRCNCT,PRSD,PRSD_SV,"2025-05-18 22:05:07",1402,758,715,43,0,753,5,1500,742,407,346
12,CĂLĂRAŞI,"GRĂDINIŢA CU PROGRAM PRELUNGIT ”VOINICEL” CĂLĂRAŞI",41,"MUNICIPIUL CĂLĂRAŞI",92569,2,PART,PRCNCT,PRSD,PRSD_SV,"2025-05-18 22:49:34",1064,588,563,25,0,584,4,1097,509,297,287
12,CĂLĂRAŞI,"GRĂDINIŢA CU PROGRAM PRELUNGIT ”ARICEL” CĂLĂRAŞI",42,"MUNICIPIUL CĂLĂRAŞI",92569,1,PART,PRCNCT,PRSD,PRSD_SV,"2025-05-18 21:25:19",718,405,383,22,0,404,1,800,395,171,233
12,CĂLĂRAŞI,"COLEGIUL ECONOMIC SEDIUL B",43,"MUNICIPIUL CĂLĂRAŞI",92569,1,PART,PRCNCT,PRSD,PRSD_SV,"2025-05-18 21:19:47",1027,560,517,41,2,559,1,1100,540,258,301
12,CĂLĂRAŞI,"LICEUL TEHNOLOGIC TRANSPORTURI AUTO CĂLĂRAŞI",44,"MUNICIPIUL CĂLĂRAŞI",92569,1,PART,PRCNCT,PRSD,PRSD_SV,"2025-05-18 21:53:23",1205,689,618,62,9,680,9,1300,611,365,315
12,CĂLĂRAŞI,"ŞCOALA GIMNAZIALA C-TIN BRÂNCOVEANU",45,"MUNICIPIUL CĂLĂRAŞI",92569,1,PART,PRCNCT,PRSD,PRSD_SV,"2025-05-18 22:11:26",1240,759,677,43,39,751,8,1300,541,408,343
12,CĂLĂRAŞI,"ŞCOALA GIMNAZIALA C-TIN BRÂNCOVEANU",46,"MUNICIPIUL CĂLĂRAŞI",92569,1,PART,PRCNCT,PRSD,PRSD_SV,"2025-05-18 21:30:43",1017,470,434,36,0,467,3,1100,630,238,229
12,CĂLĂRAŞI,"ŞCOALA GIMNAZIALA C-TIN BRÂNCOVEANU",47,"MUNICIPIUL CĂLĂRAŞI",92569,1,PART,PRCNCT,PRSD,PRSD_SV,"2025-05-18 21:39:52",1177,659,637,22,0,651,8,1300,641,357,294
12,CĂLĂRAŞI,"ŞCOALA PRIMARA NR.6",48,"MUNICIPIUL CĂLĂRAŞI",92569,1,PART,PRCNCT,PRSD,PRSD_SV,"2025-05-18 21:51:10",948,541,506,35,0,534,7,1100,559,273,261
12,CĂLĂRAŞI,"ŞCOALA PRIMARA NR.6",49,"MUNICIPIUL CĂLĂRAŞI",92569,1,PART,PRCNCT,PRSD,PRSD_SV,"2025-05-18 21:43:30",937,471,438,32,1,464,7,1100,629,272,192
12,CĂLĂRAŞI,"CANTINA DE AJUTOR SOCIAL",50,"MUNICIPIUL CĂLĂRAŞI",92569,1,PART,PRCNCT,PRSD,PRSD_SV,"2025-05-18 21:47:55",524,247,219,28,0,237,10,600,353,185,52
12,CĂLĂRAŞI,"COLEGIUL ECONOMIC SEDIU",51,"MUNICIPIUL CĂLĂRAŞI",92569,1,PART,PRCNCT,PRSD,PRSD_SV,"2025-05-18 22:12:34",1273,808,723,82,3,795,13,1400,592,290,505
12,CĂLĂRAŞI,"GRADINIȚA CU PROGRAM NORMAL NR. 6 ( INCINTA ȘCOALA GIMNAZIALĂ” ALEXANDRU D. GHICA”)",52,"MUNICIPIUL OLTENIŢA",100610,2,PART,PRCNCT,PRSD,PRSD_SV,"2025-05-19 01:05:36",1909,1018,937,81,0,998,20,2000,982,600,398
12,CĂLĂRAŞI,"CANTINA DE AJUTOR SOCIAL",53,"MUNICIPIUL OLTENIŢA",100610,2,PART,PRCNCT,PRSD,PRSD_SV,"2025-05-19 00:35:53",1082,613,574,39,0,602,11,1200,587,292,310
12,CĂLĂRAŞI,"GRĂDINIŢA CU PROGRAM NORMAL NR.1",54,"MUNICIPIUL OLTENIŢA",100610,1,PART,PRCNCT,PRSD,PRSD_SV,"2025-05-18 22:33:44",1087,532,468,63,1,519,13,1200,668,270,249
12,CĂLĂRAŞI,"GRĂDINIŢA CU PROGRAM NORMAL NR. 1,",55,"MUNICIPIUL OLTENIŢA",100610,1,PART,PRCNCT,PRSD,PRSD_SV,"2025-05-18 22:14:06",1351,733,671,62,0,715,18,1400,667,298,417
12,CĂLĂRAŞI,"COLEGIUL NAŢIONAL ”NEAGOE BASARAB” - SALA DE SPORT",56,"MUNICIPIUL OLTENIŢA",100610,1,PART,PRCNCT,PRSD,PRSD_SV,"2025-05-18 22:16:13",1629,849,797,38,14,841,8,1700,851,363,478
12,CĂLĂRAŞI,"COLEGIUL NAŢIONAL ”NEAGOE BASARAB” - SALA DE SPORT",57,"MUNICIPIUL OLTENIŢA",100610,1,PART,PRCNCT,PRSD,PRSD_SV,"2025-05-18 22:13:14",1618,824,771,52,1,813,11,1700,876,325,488
12,CĂLĂRAŞI,"GRĂDINIŢA CU PROGRAM NORMAL NR. 5",58,"MUNICIPIUL OLTENIŢA",100610,1,PART,PRCNCT,PRSD,PRSD_SV,"2025-05-18 21:53:18",1667,790,743,45,2,784,6,1800,1010,416,368
12,CĂLĂRAŞI,"COLEGIUL NAȚIONAL ”NEAGOE BASARAB”",59,"MUNICIPIUL OLTENIŢA",100610,1,PART,PRCNCT,PRSD,PRSD_SV,"2025-05-18 22:34:15",1715,1028,852,138,38,1013,15,1800,772,437,576
12,CĂLĂRAŞI,"GRĂDINIŢA CU PROGRAM NORMAL NR. 4",60,"MUNICIPIUL OLTENIŢA",100610,1,PART,PRCNCT,PRSD,PRSD_SV,"2025-05-18 22:00:49",1592,706,664,41,1,693,13,1700,994,303,390
12,CĂLĂRAŞI,"GRĂDINIŢA CU PROGRAM NORMAL NR.4",61,"MUNICIPIUL OLTENIŢA",100610,1,PART,PRCNCT,PRSD,PRSD_SV,"2025-05-18 22:20:44",1581,688,654,34,0,678,10,1700,1012,324,354
12,CĂLĂRAŞI,"DIRECŢIA DE CULTURĂ",62,"MUNICIPIUL OLTENIŢA",100610,1,PART,PRCNCT,PRSD,PRSD_SV,"2025-05-18 22:15:24",1510,669,594,75,0,654,15,1600,931,297,357
12,CĂLĂRAŞI,"ŞCOALA CU CLS I-IV ”CONSTANTIN DECULESCU”",63,"MUNICIPIUL OLTENIŢA",100610,1,PART,PRCNCT,PRSD,PRSD_SV,"2025-05-18 22:00:24",1683,566,530,36,0,560,6,1800,1234,293,267
12,CĂLĂRAŞI,"ŞCOALA GIMNAZIALĂ ”MIRCEA ELIADE” - SALA DE SPORT",64,"MUNICIPIUL OLTENIŢA",100610,1,PART,PRCNCT,PRSD,PRSD_SV,"2025-05-18 22:19:39",1180,631,558,73,0,627,4,1300,669,288,339
12,CĂLĂRAŞI,"GRADINIȚA CU PROGRAM NORMAL NR.2",65,"MUNICIPIUL OLTENIŢA",100610,1,PART,PRCNCT,PRSD,PRSD_SV,"2025-05-18 21:36:27",1482,799,759,40,0,783,16,1600,801,436,347
12,CĂLĂRAŞI,"GRĂDINIȚA CU PROGRAM NORMAL NR.1 BUDEȘTI",66,"ORAŞ BUDEŞTI",101458,1,PART,PRCNCT,PRSD,PRSD_SV,"2025-05-18 22:22:44",1898,785,639,146,0,783,2,2000,1215,540,243
12,CĂLĂRAŞI,"GRĂDINIȚA CU PROGRAM NORMAL NR.1 BUDEȘTI",67,"ORAŞ BUDEŞTI",101458,1,PART,PRCNCT,PRSD,PRSD_SV,"2025-05-18 21:47:04",1997,717,646,71,0,712,5,2100,1383,523,189
12,CĂLĂRAŞI,"SCOALA GIMNAZIALA NR.1APROZI",68,"ORAŞ BUDEŞTI",101458,2,PART,PRCNCT,PRSD,PRSD_SV,"2025-05-19 01:23:03",784,423,311,112,0,419,4,900,477,297,122
12,CĂLĂRAŞI,"SCOALA PRIMARA NR.2 BUCIUMENI",69,"ORAŞ BUDEŞTI",101458,1,PART,PRCNCT,PRSD,PRSD_SV,"2025-05-18 21:35:46",494,367,263,104,0,363,4,600,233,245,118
12,CĂLĂRAŞI,"SCOALA PRIMARA NR.1 GRUIU",70,"ORAŞ BUDEŞTI",101458,1,PART,PRCNCT,PRSD,PRSD_SV,"2025-05-18 21:52:51",542,464,270,194,0,456,8,600,136,258,198
12,CĂLĂRAŞI,"LICEUL TEHNOLOGIC NR. 1",71,"ORAŞ FUNDULEA",103032,2,PART,PRCNCT,PRSD,PRSD_SV,"2025-05-19 00:50:51",878,583,468,114,1,576,7,1000,417,241,335
12,CĂLĂRAŞI,"GRADINITA CU PROGRAM PRELUNGIT",72,"ORAŞ FUNDULEA",103032,2,PART,PRCNCT,PRSD,PRSD_SV,"2025-05-19 00:56:49",1428,917,687,230,0,907,10,1500,583,473,434
12,CĂLĂRAŞI,"SCOALA GIMNAZIALA MIRCEA NEDELCIU",73,"ORAŞ FUNDULEA",103032,1,PART,PRCNCT,PRSD,PRSD_SV,"2025-05-18 21:50:58",1021,714,562,152,0,703,11,1200,486,372,331
12,CĂLĂRAŞI,"GRĂDINIȚA CU PROGRAM PRELUNGIT ”TĂRÂMUL VESELIEI” (CRÂNGU)",74,"ORAŞ FUNDULEA",103032,1,PART,PRCNCT,PRSD,PRSD_SV,"2025-05-18 22:15:29",1321,798,623,175,0,788,10,1400,602,481,307
12,CĂLĂRAŞI,"SCOALA GIMNAZIALA NR. 1 GOSTILELE",75,"ORAŞ FUNDULEA",103032,1,PART,PRCNCT,PRSD,PRSD_SV,"2025-05-18 21:54:00",513,454,267,187,0,451,3,600,146,293,158
12,CĂLĂRAŞI,PRIMARIE,76,"ORAŞ LEHLIU-GARĂ",93888,1,PART,PRCNCT,PRSD,PRSD_SV,"2025-05-18 23:03:23",1415,1026,796,218,12,1012,14,1500,474,508,504
12,CĂLĂRAŞI,"CASA DE CULTURA",77,"ORAŞ LEHLIU-GARĂ",93888,1,PART,PRCNCT,PRSD,PRSD_SV,"2025-05-18 22:33:56",1476,1101,875,226,0,1085,16,1600,499,507,578
12,CĂLĂRAŞI,"SCOALA CU CLS. I-IV",78,"ORAŞ LEHLIU-GARĂ",93888,1,PART,PRCNCT,PRSD,PRSD_SV,"2025-05-18 21:47:04",340,260,196,64,0,260,0,400,140,188,72
12,CĂLĂRAŞI,"SCOALA CU CLS. I-VIII",79,"ORAŞ LEHLIU-GARĂ",93888,1,PART,PRCNCT,PRSD,PRSD_SV,"2025-05-18 21:56:42",678,393,320,73,0,390,3,800,407,285,105
12,CĂLĂRAŞI,"SCOALA CU CLS. I-IV",80,"ORAŞ LEHLIU-GARĂ",93888,1,PART,PRCNCT,PRSD,PRSD_SV,"2025-05-18 22:00:04",1112,708,585,122,1,695,13,1200,492,551,144
12,CĂLĂRAŞI,"SCOALA GIMNAZIALA NR1 NICOLAE BALCESCU",81,"ALEXANDRU ODOBESCU",94125,1,PART,PRCNCT,PRSD,PRSD_SV,"2025-05-18 22:12:27",1015,676,497,145,34,667,9,1200,524,364,303
12,CĂLĂRAŞI,"SCOALA GIMNAZIALA NR. 2 ALEXANDRU ODOBESCU",82,"ALEXANDRU ODOBESCU",94125,1,PART,PRCNCT,PRSD,PRSD_SV,"2025-05-18 21:53:28",914,612,465,115,32,602,10,1000,388,312,290
12,CĂLĂRAŞI,"GRĂDINIŢA CU PROGRAM NORMAL NR.3 GĂLĂŢUI",83,"ALEXANDRU ODOBESCU",94125,1,PART,PRCNCT,PRSD,PRSD_SV,"2025-05-18 21:39:08",252,223,136,69,18,223,0,300,77,121,102
12,CĂLĂRAŞI,"SCOALA GIMNAZIALA NR. 1 BELCIUGATELE",84,BELCIUGATELE,101083,1,PART,PRCNCT,PRSD,PRSD_SV,"2025-05-18 22:07:57",1249,1089,664,417,8,1080,9,1300,211,651,429
12,CĂLĂRAŞI,"SCOALA PRIMARA MARIUTA",85,BELCIUGATELE,101083,1,PART,PRCNCT,PRSD,PRSD_SV,"2025-05-18 21:27:42",407,343,218,125,0,340,3,500,157,229,111
12,CĂLĂRAŞI,"SCOALA GIMNAZIALA NR. 3 BORCEA",86,BORCEA,92961,1,PART,PRCNCT,PRSD,PRSD_SV,"2025-05-18 22:02:19",1023,467,416,42,9,461,6,1200,733,297,164
12,CĂLĂRAŞI,"GRADINITA CU PROGRAM NORMAL NR. 3 BORCEA",87,BORCEA,92961,1,PART,PRCNCT,PRSD,PRSD_SV,"2025-05-18 21:57:42",810,450,386,60,4,448,2,900,450,255,193
12,CĂLĂRAŞI,"LICEUL TEHNOLOGIC NR. 1 BORCEA CLASELE I-IV SALA A",88,BORCEA,92961,1,PART,PRCNCT,PRSD,PRSD_SV,"2025-05-18 21:55:33",1484,780,681,99,0,773,7,1600,820,517,256
12,CĂLĂRAŞI,"LICEUL TEHNOLOGIC NR. 1 BORCEA CLASELE I-IV SALA B",89,BORCEA,92961,1,PART,PRCNCT,PRSD,PRSD_SV,"2025-05-18 21:36:59",1368,736,652,83,1,734,2,1500,764,475,259
12,CĂLĂRAŞI,"SCOALA GIMNAZIALA NR. 2 BORCEA",90,BORCEA,92961,1,PART,PRCNCT,PRSD,PRSD_SV,"2025-05-18 21:45:10",1632,852,771,81,0,847,5,1700,848,567,280
12,CĂLĂRAŞI,"ȘCOALA GIMNAZIALĂ NR.1 CĂSCIOARELE",91,CĂSCIOARELE,101724,1,PART,PRCNCT,PRSD,PRSD_SV,"2025-05-18 21:43:51",1298,743,611,131,1,739,4,1400,657,460,279
12,CĂLĂRAŞI,"SCOALA CU CLASELE I-VIII, NR.1",92,CHIRNOGI,101804,1,PART,PRCNCT,PRSD,PRSD_SV,"2025-05-18 22:05:25",1611,686,629,57,0,676,10,1700,1014,512,164
12,CĂLĂRAŞI,"SCOALA CU CLASELE I-VIII, NR.2",93,CHIRNOGI,101804,1,PART,PRCNCT,PRSD,PRSD_SV,"2025-05-18 22:16:26",1424,739,679,60,0,732,7,1509,770,415,317
12,CĂLĂRAŞI,"SCOALA CU CLASELE I-VIII, NR.2",94,CHIRNOGI,101804,1,PART,PRCNCT,PRSD,PRSD_SV,"2025-05-18 22:17:18",1555,752,698,52,2,740,12,1700,948,436,304
12,CĂLĂRAŞI,"SCOALA CU CLASELE I-VIII, NR.3",95,CHIRNOGI,101804,1,PART,PRCNCT,PRSD,PRSD_SV,"2025-05-18 22:04:18",1098,616,544,72,0,607,9,1200,584,354,253
12,CĂLĂRAŞI,"ȘCOALA GIMNAZIALĂ NR. 1",96,CHISELET,101822,2,PART,PRCNCT,PRSD,PRSD_SV,"2025-05-19 00:49:23",506,330,239,91,0,321,9,600,270,166,155
12,CĂLĂRAŞI,"ȘCOALA GIMNAZIALĂ NR. 1",97,CHISELET,101822,1,PART,PRCNCT,PRSD,PRSD_SV,"2025-05-18 22:03:13",1350,641,599,42,0,627,14,1400,759,370,257
12,CĂLĂRAŞI,"GRĂDINIȚA CU PROGRAM NORMAL NR.2 DUNĂREA",98,CHISELET,101822,1,PART,PRCNCT,PRSD,PRSD_SV,"2025-05-18 21:46:26",568,336,268,68,0,333,3,700,364,200,133
12,CĂLĂRAŞI,"SCOALA SMARDAN",99,CIOCĂNEŞTI,93085,1,PART,PRCNCT,PRSD,PRSD_SV,"2025-05-18 21:58:01",727,479,362,115,2,473,6,800,321,309,164
12,CĂLĂRAŞI,"SCOALA MARGINENI",100,CIOCĂNEŞTI,93085,1,PART,PRCNCT,PRSD,PRSD_SV,"2025-05-18 21:45:02",669,349,282,66,1,344,5,800,451,187,157
12,CĂLĂRAŞI,"GRADINITA NR.1 SARBI",101,CIOCĂNEŞTI,93085,1,PART,PRCNCT,PRSD,PRSD_SV,"2025-05-18 21:28:20",983,536,461,72,3,527,9,1100,564,281,246
12,CĂLĂRAŞI,"SCOALA ANDOLINA",102,CIOCĂNEŞTI,93085,1,PART,PRCNCT,PRSD,PRSD_SV,"2025-05-18 21:38:22",798,436,338,69,29,431,5,900,464,237,194
12,CĂLĂRAŞI,"ȘCOALA GIMNAZIALĂ ”NICOLAE PETRESCU”",103,CRIVĂŢ,180055,1,PART,PRCNCT,PRSD,PRSD_SV,"2025-05-18 21:55:12",756,461,349,112,0,454,7,900,439,268,186
12,CĂLĂRAŞI,"ȘCOALA GIMNAZIALĂ ”NICOLAE PETRESCU”",104,CRIVĂŢ,180055,1,PART,PRCNCT,PRSD,PRSD_SV,"2025-05-18 21:40:36",768,472,366,106,0,469,3,900,428,284,185
12,CĂLĂRAŞI,"ȘCOALA GIMNAZIALĂ NR. 1, CORP A",105,CURCANI,102419,1,PART,PRCNCT,PRSD,PRSD_SV,"2025-05-18 21:40:43",715,444,310,134,0,444,0,800,356,283,161
12,CĂLĂRAŞI,"ȘCOALA GIMNAZIALĂ NR. 1, CORP B",106,CURCANI,102419,1,PART,PRCNCT,PRSD,PRSD_SV,"2025-05-18 21:51:34",583,317,279,36,2,315,2,700,383,189,126
12,CĂLĂRAŞI,"ȘCOALA GIMNAZIALĂ NR. 1, CORP C",107,CURCANI,102419,1,PART,PRCNCT,PRSD,PRSD_SV,"2025-05-18 22:19:53",1440,655,577,74,4,649,6,1500,845,489,160
12,CĂLĂRAŞI,"ȘCOALA PRIMARĂ NR. 2",108,CURCANI,102419,1,PART,PRCNCT,PRSD,PRSD_SV,"2025-05-18 21:48:20",1247,550,486,64,0,537,13,1300,750,456,81
12,CĂLĂRAŞI,"ŞCOALA PRIMARĂ NR.1 CEACU",109,"CUZA VODĂ",93281,1,PART,PRCNCT,PRSD,PRSD_SV,"2025-05-18 21:50:47",1101,724,612,112,0,714,10,1200,476,401,313
12,CĂLĂRAŞI,"CENTRUL CULTURAL MULTIFUNCȚIONAL ”JIENII”",110,"CUZA VODĂ",93281,1,PART,PRCNCT,PRSD,PRSD_SV,"2025-05-18 21:21:42",579,348,284,64,0,344,4,700,352,202,142
12,CĂLĂRAŞI,"ŞCOALA GIMNAZIALĂ NR.1 CUZA VODĂ",111,"CUZA VODĂ",93281,1,PART,PRCNCT,PRSD,PRSD_SV,"2025-05-18 21:56:01",1780,1008,871,137,0,998,10,1900,892,590,408
12,CĂLĂRAŞI,"ŞC. GIMNAZIALĂ NR.1 DICHISENI",112,DICHISENI,93325,1,PART,PRCNCT,PRSD,PRSD_SV,"2025-05-18 21:39:27",692,431,327,97,7,425,6,800,369,235,190
12,CĂLĂRAŞI,"ŞC. PRIMARĂ NR.1",113,DICHISENI,93325,1,PART,PRCNCT,PRSD,PRSD_SV,"2025-05-18 21:32:28",757,422,355,64,3,418,4,899,477,278,140
12,CĂLĂRAŞI,"ȘCOALA GIMNAZIALĂ NR.2 DOR MĂRUNT GARĂ",114,"DOR MĂRUNT",93370,1,PART,PRCNCT,PRSD,PRSD_SV,"2025-05-18 22:11:47",1003,547,440,105,2,545,2,1200,653,327,218
12,CĂLĂRAŞI,"ȘCOALA GIMNAZIALĂ NR.2 DOR MĂRUNT GARĂ",115,"DOR MĂRUNT",93370,1,PART,PRCNCT,PRSD,PRSD_SV,"2025-05-18 21:45:08",450,222,174,48,0,219,3,500,278,132,87
12,CĂLĂRAŞI,"ȘCOALA GIMNAZIALĂ NR.1 DOR MĂRUNT SAT",116,"DOR MĂRUNT",93370,1,PART,PRCNCT,PRSD,PRSD_SV,"2025-05-18 21:46:38",1372,787,611,176,0,781,6,1500,713,495,286
12,CĂLĂRAŞI,"ȘCOALA PRIMARĂ NR.1 DÎLGA SAT",117,"DOR MĂRUNT",93370,2,PART,PRCNCT,PRSD,PRSD_SV,"2025-05-19 01:00:43",619,354,293,61,0,351,3,700,346,247,104
12,CĂLĂRAŞI,"ȘCOALA GIMNAZIALĂ NR.1 DÎLGA GARĂ",118,"DOR MĂRUNT",93370,1,PART,PRCNCT,PRSD,PRSD_SV,"2025-05-18 21:52:26",1059,515,454,60,1,513,2,1200,685,414,99
12,CĂLĂRAŞI,"GRĂDINIȚA CU PROGRAM NORMAL NR.3 INFRĂȚIREA",119,"DOR MĂRUNT",93370,2,PART,PRCNCT,PRSD,PRSD_SV,"2025-05-19 00:47:22",265,159,106,53,0,156,3,301,142,125,31
12,CĂLĂRAŞI,"PROPRIETATE PRIVATA",120,"DOR MĂRUNT",93370,1,PART,PRCNCT,PRSD,PRSD_SV,"2025-05-18 21:35:41",268,203,145,58,0,202,1,300,97,105,97
12,CĂLĂRAŞI,"CENTRUL CULTURAL MULTIFUNCȚIONAL",121,DOROBANŢU,93441,1,PART,PRCNCT,PRSD,PRSD_SV,"2025-05-18 22:08:46",1149,778,589,189,0,768,10,1200,422,433,335
12,CĂLĂRAŞI,"ŞCOALA DIN SATUL BOŞNEAGU",122,DOROBANŢU,93441,1,PART,PRCNCT,PRSD,PRSD_SV,"2025-05-18 21:21:07",261,175,123,52,0,173,2,300,125,76,97
12,CĂLĂRAŞI,"ŞCOALA PRIMARĂ NR. 1 VĂRĂŞTI",123,DOROBANŢU,93441,1,PART,PRCNCT,PRSD,PRSD_SV,"2025-05-18 22:14:19",706,467,360,107,0,462,5,800,333,254,208
12,CĂLĂRAŞI,"SCOALA GIMNAZIALA NR.1 DRAGALINA",124,DRAGALINA,93487,2,PART,PRCNCT,PRSD,PRSD_SV,"2025-05-19 01:18:05",1045,540,471,59,10,538,2,1200,660,341,197
12,CĂLĂRAŞI,"SCOALA GIMNAZIALA NR.1 DRAGALINA",125,DRAGALINA,93487,1,PART,PRCNCT,PRSD,PRSD_SV,"2025-05-18 22:26:52",1315,657,602,53,2,645,12,1400,743,427,218
12,CĂLĂRAŞI,"SCOALA GIMNAZIALA NR.1 DRAGALINA",126,DRAGALINA,93487,1,PART,PRCNCT,PRSD,PRSD_SV,"2025-05-18 22:20:28",1152,519,485,34,0,514,5,1200,681,346,168
12,CĂLĂRAŞI,"GRĂDINIȚA CU PROGRAM NORMAL DRAGALINA",127,DRAGALINA,93487,1,PART,PRCNCT,PRSD,PRSD_SV,"2025-05-18 22:16:25",1269,672,609,53,10,667,5,1300,628,458,209
12,CĂLĂRAŞI,"ȘCOALA PRIMARA NR.1 CONSTANTIN BRÂNCOVEANU",128,DRAGALINA,93487,1,PART,PRCNCT,PRSD,PRSD_SV,"2025-05-18 22:05:55",712,402,295,107,0,400,2,800,398,248,152
12,CĂLĂRAŞI,"SCOALA GIMNAZIALA NR.1 DRAJNA NOUA",129,DRAGALINA,93487,1,PART,PRCNCT,PRSD,PRSD_SV,"2025-05-18 22:17:12",1038,608,517,91,0,601,7,1200,592,396,205
12,CĂLĂRAŞI,"ȘCOALA GIMNAZIALĂ NR.1 DRAGOȘ VODĂ - SALA DE SPORT",130,"DRAGOŞ VODĂ",93539,1,PART,PRCNCT,PRSD,PRSD_SV,"2025-05-18 21:50:59",988,553,456,71,26,551,2,1100,547,344,207
12,CĂLĂRAŞI,"ȘCOALA GIMNAZIALĂ NR.1 DRAGOȘ VODĂ - SALA DE SPORT",131,"DRAGOŞ VODĂ",93539,1,PART,PRCNCT,PRSD,PRSD_SV,"2025-05-18 22:02:16",1023,539,456,56,27,536,3,1200,661,417,119
12,CĂLĂRAŞI,"GRĂDINIȚA CU PROGRAM NORMAL NR. 3",132,"DRAGOŞ VODĂ",93539,1,PART,PRCNCT,PRSD,PRSD_SV,"2025-05-18 21:40:21",165,133,74,51,8,132,1,200,67,52,80
12,CĂLĂRAŞI,"SCOALA GIMNAZIALA NR.1 FRASINET",133,FRĂSINET,102838,2,PART,PRCNCT,PRSD,PRSD_SV,"2025-05-18 23:59:38",794,544,382,99,63,542,2,900,356,290,252
12,CĂLĂRAŞI,"SCOALA PRIMARA NR.1 LUPTATORI",134,FRĂSINET,102838,1,PART,PRCNCT,PRSD,PRSD_SV,"2025-05-18 21:39:03",432,346,214,105,27,344,2,500,154,206,138
12,CĂLĂRAŞI,"SCOALA GENERALA NR 1.FRUMUSANI",135,FRUMUŞANI,102945,1,PART,PRCNCT,PRSD,PRSD_SV,"2025-05-18 22:31:19",975,585,345,240,0,580,5,1100,515,363,217
12,CĂLĂRAŞI,"SCOALA GENERALA NR 1.FRUMUSANI",136,FRUMUŞANI,102945,1,PART,PRCNCT,PRSD,PRSD_SV,"2025-05-18 21:59:13",1065,571,355,216,0,565,6,1200,629,351,214
12,CĂLĂRAŞI,"SCOALA GENERALA ORASTI",137,FRUMUŞANI,102945,1,PART,PRCNCT,PRSD,PRSD_SV,"2025-05-18 22:07:22",695,621,327,294,0,612,9,800,179,359,253
12,CĂLĂRAŞI,"SCOALA GENERALA PASAREA",138,FRUMUŞANI,102945,1,PART,PRCNCT,PRSD,PRSD_SV,"2025-05-18 22:18:02",618,463,281,182,0,458,5,700,237,272,186
12,CĂLĂRAŞI,"ȘCOALA PRIMARĂ NR.5 PĂDURIȘU",139,FRUMUŞANI,102945,1,PART,PRCNCT,PRSD,PRSD_SV,"2025-05-18 22:13:35",618,570,303,267,0,562,8,700,130,354,208
12,CĂLĂRAŞI,"ŞCOALA GIMNAZIALĂ NR. 1 FUNDENI",140,FUNDENI,103014,1,PART,PRCNCT,PRSD,PRSD_SV,"2025-05-18 21:57:15",1282,913,673,240,0,905,8,1400,487,637,268
12,CĂLĂRAŞI,"ȘCOALA PRIMARĂ NR. 2",141,FUNDENI,103014,3,PART,PRCNCT,PRSD,PRSD_SV,"2025-05-19 01:57:52",1214,909,557,351,1,897,12,1300,391,603,294
12,CĂLĂRAŞI,"SCOALA CLASELE 1-4 NR. 3",142,FUNDENI,103014,1,PART,PRCNCT,PRSD,PRSD_SV,"2025-05-18 21:45:25",1115,631,520,111,0,625,6,1200,569,447,178
12,CĂLĂRAŞI,"SCOALA GIMNAZIĂ NR. 1 GĂLBINAȘI",143,GĂLBINAŞI,179962,1,PART,PRCNCT,PRSD,PRSD_SV,"2025-05-18 22:38:06",1426,701,560,141,0,695,6,1500,799,531,164
12,CĂLĂRAŞI,"ȘCOALA GIMNAZIALĂ NR. 1 GĂLBINAȘI",144,GĂLBINAŞI,179962,1,PART,PRCNCT,PRSD,PRSD_SV,"2025-05-18 22:51:39",1291,644,561,82,1,634,10,1400,756,529,105
12,CĂLĂRAŞI,"ŞCOALA VECHE",145,GRĂDIŞTEA,93664,1,PART,PRCNCT,PRSD,PRSD_SV,"2025-05-18 22:02:01",1747,1000,839,160,1,996,4,1900,900,593,403
12,CĂLĂRAŞI,"ŞCOALA BOGATA",146,GRĂDIŞTEA,93664,1,PART,PRCNCT,PRSD,PRSD_SV,"2025-05-18 21:39:01",484,301,242,59,0,299,2,600,299,211,88
12,CĂLĂRAŞI,"GRĂDINIȚA CU PROGRAM NORMAL NR.2 CUNEȘTI",147,GRĂDIŞTEA,93664,1,PART,PRCNCT,PRSD,PRSD_SV,"2025-05-18 21:43:50",670,408,334,73,1,404,4,800,392,222,182
12,CĂLĂRAŞI,"ŞCOALA VECHE",148,GRĂDIŞTEA,93664,1,PART,PRCNCT,PRSD,PRSD_SV,"2025-05-18 21:45:33",986,536,447,89,0,532,4,1100,564,365,167
12,CĂLĂRAŞI,"SCOALA GIMNAZIALA NR. 1 GURBANESTI",149,GURBĂNEŞTI,103568,1,PART,PRCNCT,PRSD,PRSD_SV,"2025-05-18 22:16:21",387,290,166,124,0,285,5,500,210,157,128
12,CĂLĂRAŞI,"GRADINITA CU PROGRAM NORMAL COTOFANCA",150,GURBĂNEŞTI,103568,1,PART,PRCNCT,PRSD,PRSD_SV,"2025-05-18 21:42:29",262,179,106,73,0,177,2,300,121,110,67
12,CĂLĂRAŞI,"GRADINITA CU PROGRAM NORMAL VALEA PRESNEI",151,GURBĂNEŞTI,103568,1,PART,PRCNCT,PRSD,PRSD_SV,"2025-05-18 21:28:33",125,128,59,69,0,126,2,200,72,59,67
12,CĂLĂRAŞI,"SCOALA ILEANA",152,ILEANA,103764,1,PART,PRCNCT,PRSD,PRSD_SV,"2025-05-18 21:45:06",753,518,343,175,0,509,9,899,381,319,190
12,CĂLĂRAŞI,"SCOALA ARTARI",153,ILEANA,103764,1,PART,PRCNCT,PRSD,PRSD_SV,"2025-05-18 21:55:18",483,294,227,67,0,292,2,600,306,172,120
12,CĂLĂRAŞI,"GRĂDINIȚA CU PROGRAM NORMAL NR. 3 FLORICA",154,ILEANA,103764,1,PART,PRCNCT,PRSD,PRSD_SV,"2025-05-18 22:03:08",482,324,224,100,0,320,4,600,276,219,101
12,CĂLĂRAŞI,"CĂMIN CULTURAL ȘTEFĂNEȘTI",155,ILEANA,103764,1,PART,PRCNCT,PRSD,PRSD_SV,"2025-05-18 21:53:59",606,450,295,155,0,443,7,700,250,256,187
12,CĂLĂRAŞI,"GRADINITA DE COPII",156,INDEPENDENŢA,93771,1,PART,PRCNCT,PRSD,PRSD_SV,"2025-05-18 22:26:19",1727,933,805,122,6,926,7,1800,867,549,377
12,CĂLĂRAŞI,"GRĂDINIŢA ALBĂ CA ZĂPADA",157,INDEPENDENŢA,93771,1,PART,PRCNCT,PRSD,PRSD_SV,"2025-05-18 21:59:45",641,346,274,72,0,343,3,800,454,215,128
12,CĂLĂRAŞI,"GRADINITA DE COPII",158,INDEPENDENŢA,93771,1,PART,PRCNCT,PRSD,PRSD_SV,"2025-05-18 22:11:04",442,248,190,58,0,245,3,500,252,165,80
12,CĂLĂRAŞI,"SCOALA GIMNAZIALA NR. 1",159,JEGĂLIA,93815,1,PART,PRCNCT,PRSD,PRSD_SV,"2025-05-18 21:39:41",1493,769,704,63,2,762,7,1600,831,484,278
12,CĂLĂRAŞI,"SCOALA PRIMARA NR. 1",160,JEGĂLIA,93815,1,PART,PRCNCT,PRSD,PRSD_SV,"2025-05-18 22:01:32",1080,591,517,74,0,588,3,1200,609,388,200
12,CĂLĂRAŞI,"SALA DE EDUCAȚIE FIZICĂ ȘCOLARĂ",161,JEGĂLIA,93815,1,PART,PRCNCT,PRSD,PRSD_SV,"2025-05-18 21:35:58",702,447,380,67,0,442,5,800,353,237,205
12,CĂLĂRAŞI,"CAMIN CULTURAL",162,LEHLIU,93851,1,PART,PRCNCT,PRSD,PRSD_SV,"2025-05-18 21:59:15",1316,816,667,148,1,805,11,1400,584,505,300
12,CĂLĂRAŞI,"SCOALA SAPUNARI",163,LEHLIU,93851,1,PART,PRCNCT,PRSD,PRSD_SV,"2025-05-18 21:38:26",590,419,278,105,36,411,8,700,281,263,148
12,CĂLĂRAŞI,"SCOALA CU CLASELE I-VIII LUICA",164,LUICA,104083,1,PART,PRCNCT,PRSD,PRSD_SV,"2025-05-18 22:33:54",1161,612,442,170,0,601,11,1201,589,356,245
12,CĂLĂRAŞI,"SCOALA CU CLASELE I-IV VALEA STANII",165,LUICA,104083,1,PART,PRCNCT,PRSD,PRSD_SV,"2025-05-18 22:58:06",409,251,167,84,0,248,3,500,249,163,85
12,CĂLĂRAŞI,"GRADINITA CU PROGRAM NORMAL NR.3 LUPSANU",166,LUPŞANU,93931,1,PART,PRCNCT,PRSD,PRSD_SV,"2025-05-18 21:46:08",456,306,236,70,0,305,1,600,294,187,118
12,CĂLĂRAŞI,"GRADINITA CU PROGRAM NORMAL NR.4 NUCETU",167,LUPŞANU,93931,1,PART,PRCNCT,PRSD,PRSD_SV,"2025-05-18 21:43:50",492,339,249,87,3,338,1,600,261,210,128
12,CĂLĂRAŞI,"SCOALA PRIMARA NR.1 PLEVNA",168,LUPŞANU,93931,2,PART,PRCNCT,PRSD,PRSD_SV,"2025-05-18 23:53:35",459,272,165,106,1,268,4,600,328,162,106
12,CĂLĂRAŞI,"SCOALA GIMNAZIALA NR.1 RADU-VODA",169,LUPŞANU,93931,1,PART,PRCNCT,PRSD,PRSD_SV,"2025-05-18 21:53:41",893,560,406,154,0,556,4,1000,440,355,201
12,CĂLĂRAŞI,"LICEUL TEHNOLOGIC MATEI BASARAB",170,MÂNĂSTIREA,104181,1,PART,PRCNCT,PRSD,PRSD_SV,"2025-05-18 21:35:02",1339,684,575,108,1,672,12,1400,716,433,239
12,CĂLĂRAŞI,"LICEUL TEHNOLOGIC MATEI BASARAB",171,MÂNĂSTIREA,104181,1,PART,PRCNCT,PRSD,PRSD_SV,"2025-05-18 22:09:58",1368,750,656,94,0,738,12,1500,750,434,304
12,CĂLĂRAŞI,"GRĂDINIŢA CU PROGRAM NORMAL NR. 3, COCONI",172,MÂNĂSTIREA,104181,1,PART,PRCNCT,PRSD,PRSD_SV,"2025-05-18 21:37:16",618,338,227,111,0,330,8,700,362,197,133
12,CĂLĂRAŞI,"ŞCOALA GIMNAZIALĂ NR. 2 SULTANA",173,MÂNĂSTIREA,104181,1,PART,PRCNCT,PRSD,PRSD_SV,"2025-05-18 21:42:13",705,415,311,104,0,411,4,800,385,265,146
12,CĂLĂRAŞI,"SCOALA GIMNAZIALA NR. 2 MITRENI",174,MITRENI,100638,1,PART,PRCNCT,PRSD,PRSD_SV,"2025-05-18 21:57:49",1070,656,541,114,1,647,9,1200,544,368,279
12,CĂLĂRAŞI,"PROPRIETATE PRIVATĂ",175,MITRENI,100638,1,PART,PRCNCT,PRSD,PRSD_SV,"2025-05-18 21:42:19",383,230,169,61,0,227,3,500,270,132,95
12,CĂLĂRAŞI,"ȘCOALA GIMNAZIALĂ NR. 1 VALEA ROȘIE",176,MITRENI,100638,1,PART,PRCNCT,PRSD,PRSD_SV,"2025-05-18 22:25:12",1708,832,689,143,0,821,11,1800,968,514,307
12,CĂLĂRAŞI,"SCOALA GENERALA NR.1",177,MODELU,92587,1,PART,PRCNCT,PRSD,PRSD_SV,"2025-05-18 21:52:24",1576,869,813,56,0,862,7,1700,831,510,352
12,CĂLĂRAŞI,"SCOALA GENERALA NR.1",178,MODELU,92587,1,PART,PRCNCT,PRSD,PRSD_SV,"2025-05-18 22:11:12",1604,846,779,67,0,837,9,1700,854,501,336
12,CĂLĂRAŞI,"SCOALA GENERALA NR.1",179,MODELU,92587,1,PART,PRCNCT,PRSD,PRSD_SV,"2025-05-18 21:55:29",1746,907,824,83,0,904,3,1900,993,623,281
12,CĂLĂRAŞI,"SCOALA GENERALA NR.2",180,MODELU,92587,1,PART,PRCNCT,PRSD,PRSD_SV,"2025-05-18 22:03:25",1571,858,811,47,0,848,10,1700,842,516,332
12,CĂLĂRAŞI,"SCOALA TONEA",181,MODELU,92587,1,PART,PRCNCT,PRSD,PRSD_SV,"2025-05-18 21:54:38",1791,846,780,66,0,838,8,1900,1054,598,240
12,CĂLĂRAŞI,"SCOALA GIMNAZIALA NR. 1",182,NANA,104323,1,PART,PRCNCT,PRSD,PRSD_SV,"2025-05-18 22:18:26",790,379,284,88,7,375,4,900,521,223,152
12,CĂLĂRAŞI,"SCOALA GIMNAZIALA NR. 1",183,NANA,104323,1,PART,PRCNCT,PRSD,PRSD_SV,"2025-05-18 22:02:07",936,450,343,103,4,446,4,1100,650,272,174
12,CĂLĂRAŞI,"SCOALA CU CLASELE I-VIII",184,"NICOLAE BĂLCESCU",104341,1,PART,PRCNCT,PRSD,PRSD_SV,"2025-05-18 22:10:24",1037,610,494,116,0,605,5,1200,590,414,191
12,CĂLĂRAŞI,"SCOALA CU CLASELE I-IV",185,"NICOLAE BĂLCESCU",104341,1,PART,PRCNCT,PRSD,PRSD_SV,"2025-05-18 21:50:42",205,156,93,63,0,155,1,299,143,100,55
12,CĂLĂRAŞI,"ŞCOALA GIMNAZIALĂ NR. 1 PERIŞORU - CORP B",186,PERIŞORU,94223,1,PART,PRCNCT,PRSD,PRSD_SV,"2025-05-18 22:55:52",1856,934,876,58,0,929,5,2000,1066,628,301
12,CĂLĂRAŞI,"ŞCOALA GIMNAZIALĂ NR. 1 PERIŞORU- CORP B",187,PERIŞORU,94223,1,PART,PRCNCT,PRSD,PRSD_SV,"2025-05-18 22:13:04",1645,737,661,76,0,730,7,1800,1063,474,256
12,CĂLĂRAŞI,"ŞCOALA GIMNAZIALA NR. 2 PERIŞORU",188,PERIŞORU,94223,1,PART,PRCNCT,PRSD,PRSD_SV,"2025-05-18 22:04:20",616,350,299,51,0,348,2,700,350,242,106
12,CĂLĂRAŞI,"PRIMĂRIA PLĂTĂREŞTI",189,PLĂTĂREŞTI,104635,1,PART,PRCNCT,PRSD,PRSD_SV,"2025-05-18 21:58:19",985,684,429,253,2,675,9,1100,416,397,278
12,CĂLĂRAŞI,"ŞCOALA PRIMARĂ NR.3 DOROBANȚU",190,PLĂTĂREŞTI,104635,1,PART,PRCNCT,PRSD,PRSD_SV,"2025-05-18 22:03:46",794,528,353,175,0,522,6,900,372,380,142
12,CĂLĂRAŞI,"GRĂDINIȚA CU PROGRAM NORMAL NR.5 PODU PITARULUI",191,PLĂTĂREŞTI,104635,1,PART,PRCNCT,PRSD,PRSD_SV,"2025-05-18 21:30:59",428,267,180,87,0,265,2,500,233,182,83
12,CĂLĂRAŞI,"GRĂDINIȚA CU PROGRAM NORMAL NR.5 PODU PITARULUI",192,PLĂTĂREŞTI,104635,1,PART,PRCNCT,PRSD,PRSD_SV,"2025-05-18 21:25:52",323,250,169,81,0,247,3,400,150,171,76
12,CĂLĂRAŞI,"ȘCOALA GIMNAZIALĂ ”DIMITRIE ION GHICA ”",193,RADOVANU,104751,1,PART,PRCNCT,PRSD,PRSD_SV,"2025-05-18 21:57:50",875,593,429,149,15,589,4,1000,407,286,303
12,CĂLĂRAŞI,"ȘCOALA GIMNAZIALĂ ”DIMITRIE ION GHICA ”",194,RADOVANU,104751,1,PART,PRCNCT,PRSD,PRSD_SV,"2025-05-18 22:01:47",798,537,395,119,23,529,8,900,363,238,291
12,CĂLĂRAŞI,"ȘCOALA CU CLASELE I-IV COADELE",195,RADOVANU,104751,1,PART,PRCNCT,PRSD,PRSD_SV,"2025-05-18 21:42:56",889,578,426,137,15,574,4,1000,422,292,282
12,CĂLĂRAŞI,"ȘCOALA CU CLASELE I-IV VALEA POPII",196,RADOVANU,104751,1,PART,PRCNCT,PRSD,PRSD_SV,"2025-05-18 21:55:47",408,307,227,74,6,301,6,500,193,172,129
12,CĂLĂRAŞI,"SCOALA GENERALA CU CLS I-IV-SECTOR",197,ROSEŢI,94312,1,PART,PRCNCT,PRSD,PRSD_SV,"2025-05-18 22:01:35",1983,770,733,37,0,756,14,2100,1330,615,141
12,CĂLĂRAŞI,"SCOALA GIMNAZIALA IANCU ROSETTI-CENTRU",198,ROSEŢI,94312,1,PART,PRCNCT,PRSD,PRSD_SV,"2025-05-18 21:48:39",1235,647,572,75,0,641,6,1300,653,423,218
12,CĂLĂRAŞI,"SCOALA CU CLS. I-IV-DEAL",199,ROSEŢI,94312,1,PART,PRCNCT,PRSD,PRSD_SV,"2025-05-18 22:10:46",1866,972,927,45,0,959,13,2000,1028,613,346
12,CĂLĂRAŞI,"SCOALA CU CLASELE I-IV",200,SĂRULEŞTI,104886,1,PART,PRCNCT,PRSD,PRSD_SV,"2025-05-18 21:59:56",318,201,141,60,0,196,5,400,199,137,59
12,CĂLĂRAŞI,"SCOALA CU CLASELE I-IV",201,SĂRULEŞTI,104886,1,PART,PRCNCT,PRSD,PRSD_SV,"2025-05-18 21:59:23",518,334,256,78,0,328,6,600,266,249,79
12,CĂLĂRAŞI,"GRADINITA CU 4 GRUPE",202,SĂRULEŞTI,104886,1,PART,PRCNCT,PRSD,PRSD_SV,"2025-05-18 22:18:40",1193,672,587,85,0,657,15,1300,628,465,192
12,CĂLĂRAŞI,"SCOALA CU CLASELE I-IV",203,SĂRULEŞTI,104886,1,PART,PRCNCT,PRSD,PRSD_SV,"2025-05-18 21:34:15",204,107,77,30,0,102,5,300,193,56,46
12,CĂLĂRAŞI,"ȘCOALA GENERALA NR.1",204,SOHATU,105222,1,PART,PRCNCT,PRSD,PRSD_SV,"2025-05-18 21:55:18",1114,701,421,280,0,694,7,1200,499,429,265
12,CĂLĂRAŞI,"ȘCOALA GENERALA NR.2",205,SOHATU,105222,1,PART,PRCNCT,PRSD,PRSD_SV,"2025-05-18 22:01:14",668,483,263,220,0,475,8,800,317,249,226
12,CĂLĂRAŞI,"SCOALA GIMNAZIALA NR. 1 SPANTOV",206,SPANŢOV,105259,1,PART,PRCNCT,PRSD,PRSD_SV,"2025-05-18 21:59:14",746,459,381,78,0,451,8,900,441,226,225
12,CĂLĂRAŞI,"GRĂDINIŢA CU PROGRAM NORMAL NR. 3",207,SPANŢOV,105259,1,PART,PRCNCT,PRSD,PRSD_SV,"2025-05-18 21:45:26",643,381,342,39,0,380,1,800,419,279,101
12,CĂLĂRAŞI,"ŞCOALA GIMNAZIALĂ NR. 2 STANCEA",208,SPANŢOV,105259,1,PART,PRCNCT,PRSD,PRSD_SV,"2025-05-18 21:43:12",1197,601,533,68,0,597,4,1300,699,439,158
12,CĂLĂRAŞI,"ŞCOALA PRIMARĂ NR. 1 CLINCIU",209,SPANŢOV,105259,1,PART,PRCNCT,PRSD,PRSD_SV,"2025-05-18 21:48:29",965,488,458,30,0,484,4,1100,612,383,101
12,CĂLĂRAŞI,"ŞCOALA GIMNAZIALĂ ”CONSTANTIN TEODORESCU” ŞOLDANU",210,ŞOLDANU,105384,1,PART,PRCNCT,PRSD,PRSD_SV,"2025-05-18 22:28:42",1705,813,655,156,2,803,10,1800,987,451,352
12,CĂLĂRAŞI,"ŞCOALA PRIMARĂ NR.1 NEGOEŞTI",211,ŞOLDANU,105384,1,PART,PRCNCT,PRSD,PRSD_SV,"2025-05-18 23:08:52",782,415,292,123,0,406,9,900,485,248,158
12,CĂLĂRAŞI,"ȘCOALA GIMNAZIALĂ „DRAGOȘ MARIN”",212,"ŞTEFAN CEL MARE",94562,1,PART,PRCNCT,PRSD,PRSD_SV,"2025-05-18 22:08:11",1312,687,570,99,18,680,7,1400,713,399,281
12,CĂLĂRAŞI,"ȘCOALA GIMNAZIALĂ „DRAGOȘ MARIN”",213,"ŞTEFAN CEL MARE",94562,1,PART,PRCNCT,PRSD,PRSD_SV,"2025-05-18 22:08:35",1354,819,715,94,10,814,5,1400,581,478,336
12,CĂLĂRAŞI,"GRĂDINIȚA CU PROGRAM NORMAL ȘTEFAN VODĂ",214,"ŞTEFAN VODĂ",94580,1,PART,PRCNCT,PRSD,PRSD_SV,"2025-05-18 22:04:40",1026,614,521,65,28,609,5,1200,586,384,225
12,CĂLĂRAŞI,"GRĂDINIȚA CU PROGRAM NORMAL ȘTEFAN VODĂ",215,"ŞTEFAN VODĂ",94580,1,PART,PRCNCT,PRSD,PRSD_SV,"2025-05-18 21:37:19",773,442,375,55,12,433,9,900,458,310,123
12,CĂLĂRAŞI,"ȘCOALA GIMNAZIALA NR.1, TĂMĂDĂU MARE",216,"TĂMĂDĂU MARE",105455,1,PART,PRCNCT,PRSD,PRSD_SV,"2025-05-18 22:01:15",1222,838,613,225,0,831,7,1300,462,551,280
12,CĂLĂRAŞI,"SCOALA PRIMARA NR.2",217,"TĂMĂDĂU MARE",105455,1,PART,PRCNCT,PRSD,PRSD_SV,"2025-05-18 21:32:55",687,418,281,137,0,411,7,800,382,252,159
12,CĂLĂRAŞI,"SCOALA GIMNAZIALA GRIGORE MOISIL",218,ULMENI,105605,1,PART,PRCNCT,PRSD,PRSD_SV,"2025-05-18 21:59:19",1153,604,520,83,1,599,5,1200,596,339,260
12,CĂLĂRAŞI,"SCOALA GIMNAZIALA NR.2 ULMENI",219,ULMENI,105605,1,PART,PRCNCT,PRSD,PRSD_SV,"2025-05-18 21:31:24",1387,555,502,53,0,555,0,1500,945,449,106
12,CĂLĂRAŞI,"SCOALA PRIMARA NR.3 ULMENI",220,ULMENI,105605,2,PART,PRCNCT,PRSD,PRSD_SV,"2025-05-18 23:46:01",1159,681,600,81,0,673,8,1200,519,416,257
12,CĂLĂRAŞI,"SCOALA CU CLASELE I-VIII ULMU",221,ULMU,94606,1,PART,PRCNCT,PRSD,PRSD_SV,"2025-05-18 21:38:29",582,466,273,161,32,459,7,700,234,164,295
12,CĂLĂRAŞI,"SCOALA CU CLASELE I-IV FAUREI",222,ULMU,94606,1,PART,PRCNCT,PRSD,PRSD_SV,"2025-05-18 21:30:10",284,254,151,90,13,250,4,400,146,107,143
12,CĂLĂRAŞI,"FOSTA SCOALA PRIMARA ZIMBRU",223,ULMU,94606,1,PART,PRCNCT,PRSD,PRSD_SV,"2025-05-18 21:10:14",87,100,48,52,0,98,2,189,89,43,55
12,CĂLĂRAŞI,"SCOALA GIMNAZIALA NR 1 (LOCAL LANGA BISERICA)",224,UNIREA,94651,1,PART,PRCNCT,PRSD,PRSD_SV,"2025-05-18 21:48:50",1061,596,498,84,14,590,6,1200,604,322,268
12,CĂLĂRAŞI,"SCOALA GIMNAZIALA NR 1 (LOCAL LANGA CAMINUL CULTURAL)",225,UNIREA,94651,1,PART,PRCNCT,PRSD,PRSD_SV,"2025-05-18 21:32:02",1172,655,559,65,31,648,7,1200,545,400,248
12,CĂLĂRAŞI,"SCOALA GIMNAZIALA VALEA ARGOVEI",226,"VALEA ARGOVEI",105712,1,PART,PRCNCT,PRSD,PRSD_SV,"2025-05-18 22:16:36",1258,712,494,216,2,700,12,1300,588,385,315
12,CĂLĂRAŞI,"SCOALA GENERALA SILISTEA",227,"VALEA ARGOVEI",105712,1,PART,PRCNCT,PRSD,PRSD_SV,"2025-05-18 21:56:01",499,364,255,109,0,363,1,600,236,227,136
12,CĂLĂRAŞI,"ȘCOALA CONSTANTIN BRÂNCOVEANU, LOCALUL CU ETAJ",228,VASILAŢI,105829,1,PART,PRCNCT,PRSD,PRSD_SV,"2025-05-18 21:39:13",884,583,374,209,0,582,1,1000,417,376,206
12,CĂLĂRAŞI,"GRĂDINIȚA CU PROGRAM NORMAL VASILAȚI",229,VASILAŢI,105829,1,PART,PRCNCT,PRSD,PRSD_SV,"2025-05-18 22:10:54",1753,956,781,175,0,949,7,1900,944,684,265
12,CĂLĂRAŞI,"ȘCOALA GIMNAZIALĂ NUCI",230,VASILAŢI,105829,1,PART,PRCNCT,PRSD,PRSD_SV,"2025-05-18 21:39:26",281,198,120,78,0,197,1,400,202,140,57
12,CĂLĂRAŞI,"ȘCOALA GIMNAZIALĂ POPEȘTI",231,VASILAŢI,105829,1,PART,PRCNCT,PRSD,PRSD_SV,"2025-05-18 21:32:24",257,188,110,78,0,187,1,300,112,135,52
12,CĂLĂRAŞI,"SCOALA GIMNAZIALA FLORENTA ALBU VILCELELE",232,VÂLCELELE,94731,1,PART,PRCNCT,PRSD,PRSD_SV,"2025-05-18 21:39:01",867,520,366,141,13,509,11,1000,480,275,234
12,CĂLĂRAŞI,"CONSILIUL LOCAL VILCELELE",233,VÂLCELELE,94731,1,PART,PRCNCT,PRSD,PRSD_SV,"2025-05-18 21:52:26",466,310,237,73,0,302,8,600,290,167,135
12,CĂLĂRAŞI,"ȘCOALA GIMNAZIALĂ NR.1 VLAD ȚEPEȘ",234,"VLAD ŢEPEŞ",94768,1,PART,PRCNCT,PRSD,PRSD_SV,"2025-05-18 21:53:28",1029,553,424,129,0,548,5,1200,647,319,229
12,CĂLĂRAŞI,"GRĂDINIȚA MIHAI VITEAZU",235,"VLAD ŢEPEŞ",94768,1,PART,PRCNCT,PRSD,PRSD_SV,"2025-05-18 21:47:24",488,344,195,149,0,337,7,600,256,190,147
13,CLUJ,"COLEGIUL ECONOMIC ”IULIAN POP”",1,"MUNICIPIUL CLUJ-NAPOCA",54975,1,PART,PRCNCT,PRSD,PRSD_SV,"2025-05-18 22:37:21",1054,1132,63,970,99,1121,11,1457,325,142,979
13,CLUJ,"COLEGIUL ECONOMIC ”IULIAN POP”",2,"MUNICIPIUL CLUJ-NAPOCA",54975,1,PART,PRCNCT,PRSD,PRSD_SV,"2025-05-18 23:33:08",1044,1038,513,411,114,1029,9,1147,109,175,854
13,CLUJ,"COLEGIUL TEHNIC DE TELECOMUNICATII ”AUGUSTIN MAIOR”,",3,"MUNICIPIUL CLUJ-NAPOCA",54975,1,PART,PRCNCT,PRSD,PRSD_SV,"2025-05-18 22:26:06",1430,1339,724,470,145,1330,9,1572,233,265,1065
13,CLUJ,"COLEGIUL TEHNIC DE TELECOMUNICATII ”AUGUSTIN MAIOR”,",4,"MUNICIPIUL CLUJ-NAPOCA",54975,1,PART,PRCNCT,PRSD,PRSD_SV,"2025-05-19 01:44:08",1358,1637,777,817,43,1623,14,1991,354,177,1446
13,CLUJ,"ŞCOALA ”ION CREANGĂ” ,",5,"MUNICIPIUL CLUJ-NAPOCA",54975,1,PART,PRCNCT,PRSD,PRSD_SV,"2025-05-18 22:24:27",983,961,560,398,3,952,9,1280,319,132,820
13,CLUJ,"ŞCOALA ”ION CREANGĂ” ,",6,"MUNICIPIUL CLUJ-NAPOCA",54975,1,PART,PRCNCT,PRSD,PRSD_SV,"2025-05-18 22:17:29",1403,1119,802,315,2,1110,9,1542,423,245,865
13,CLUJ,"ŞCOALA ”ION CREANGĂ” ,",7,"MUNICIPIUL CLUJ-NAPOCA",54975,1,PART,PRCNCT,PRSD,PRSD_SV,"2025-05-18 22:04:17",1166,845,623,222,0,841,4,1282,437,188,653
13,CLUJ,"GRADINITA DUMBRAVA MINUNATA",8,"MUNICIPIUL CLUJ-NAPOCA",54975,1,PART,PRCNCT,PRSD,PRSD_SV,"2025-05-18 22:50:33",1150,777,600,175,2,768,9,1165,388,156,612
13,CLUJ,"GRADINITA ”DUMBRAVA MINUNATĂ”",9,"MUNICIPIUL CLUJ-NAPOCA",54975,2,PART,PRCNCT,PRSD,PRSD_SV,"2025-05-19 01:48:01",1470,996,849,141,6,986,10,1219,223,193,793
13,CLUJ,"GRĂDINIŢA ”DUMBRAVA MINUNATĂ” (FOSTA 66),",10,"MUNICIPIUL CLUJ-NAPOCA",54975,1,PART,PRCNCT,PRSD,PRSD_SV,"2025-05-18 22:35:51",1432,872,726,146,0,861,11,1574,702,188,673
13,CLUJ,"ŞCOALA ”IULIU HAŢIEGANU” (FOSTĂ NR.21)",11,"MUNICIPIUL CLUJ-NAPOCA",54975,1,PART,PRCNCT,PRSD,PRSD_SV,"2025-05-18 21:50:28",818,545,418,74,53,542,3,900,355,148,394
13,CLUJ,"ŞCOALA ”IULIU HAŢIEGANU” (FOSTĂ NR.21)",12,"MUNICIPIUL CLUJ-NAPOCA",54975,1,PART,PRCNCT,PRSD,PRSD_SV,"2025-05-18 23:27:12",833,937,435,426,76,924,13,1117,180,180,744
13,CLUJ,"ŞCOALA ”IULIU HAŢIEGANU” (FOSTĂ NR.21)",13,"MUNICIPIUL CLUJ-NAPOCA",54975,1,PART,PRCNCT,PRSD,PRSD_SV,"2025-05-18 22:31:16",1467,966,738,226,2,961,5,1214,248,171,790
13,CLUJ,"ŞCOALA ”IULIU HAŢIEGANU” (FOSTĂ NR.21)",14,"MUNICIPIUL CLUJ-NAPOCA",54975,1,PART,PRCNCT,PRSD,PRSD_SV,"2025-05-18 22:29:39",1769,1164,982,182,0,1159,5,1947,783,243,916
13,CLUJ,"ŞCOALA ”IULIU HAŢIEGANU” (FOSTĂ NR.21)",15,"MUNICIPIUL CLUJ-NAPOCA",54975,2,PART,PRCNCT,PRSD,PRSD_SV,"2025-05-19 03:07:33",1266,886,666,213,7,877,9,1393,507,150,727
13,CLUJ,"ŞCOALA ”IULIU HAŢIEGANU” (FOSTĂ NR.21)",16,"MUNICIPIUL CLUJ-NAPOCA",54975,1,PART,PRCNCT,PRSD,PRSD_SV,"2025-05-18 22:09:27",1782,1335,1124,171,40,1324,11,1961,626,232,1092
13,CLUJ,"ŞCOALA ”IULIU HAŢIEGANU” (FOSTĂ NR.21)",17,"MUNICIPIUL CLUJ-NAPOCA",54975,1,PART,PRCNCT,PRSD,PRSD_SV,"2025-05-18 22:24:18",1762,1319,1070,240,9,1307,12,1937,618,186,1121
13,CLUJ,"GRĂDINIŢA ”ALBINUŢA” (FOSTĂ CĂSUŢA POVEŞTILOR), STR. GRIGORE ALEXANDRESCU, NR.21/A",18,"MUNICIPIUL CLUJ-NAPOCA",54975,1,PART,PRCNCT,PRSD,PRSD_SV,"2025-05-18 21:55:53",1505,891,779,109,3,882,9,1655,764,161,721
13,CLUJ,"COLEGIUL TEHNIC NAPOCA",19,"MUNICIPIUL CLUJ-NAPOCA",54975,1,PART,PRCNCT,PRSD,PRSD_SV,"2025-05-18 22:33:55",1374,1154,714,440,0,1144,10,1513,359,247,897
13,CLUJ,"LICEUL CU PROGRAM SPORTIV (FOSTA SCOALA NR.20).",20,"MUNICIPIUL CLUJ-NAPOCA",54975,1,PART,PRCNCT,PRSD,PRSD_SV,"2025-05-18 22:19:12",1551,1261,954,306,1,1251,10,1706,445,277,974
13,CLUJ,"LICEUL CU PROGRAM SPORTIV (FOSTA SCOALA NR.20).",21,"MUNICIPIUL CLUJ-NAPOCA",54975,1,PART,PRCNCT,PRSD,PRSD_SV,"2025-05-18 22:02:33",1525,1024,873,151,0,1013,11,1680,656,256,757
13,CLUJ,"LICEUL CU PROGRAM SPORTIV (FOSTA SCOALA NR.20).",22,"MUNICIPIUL CLUJ-NAPOCA",54975,2,PART,PRCNCT,PRSD,PRSD_SV,"2025-05-19 02:05:37",1464,930,792,137,1,922,7,1412,482,219,703
13,CLUJ,"LICEUL TEORETIC ”EUGEN PORA”",23,"MUNICIPIUL CLUJ-NAPOCA",54975,1,PART,PRCNCT,PRSD,PRSD_SV,"2025-05-18 22:45:19",1555,1034,877,157,0,1023,11,1713,679,225,798
13,CLUJ,"LICEUL TEORETIC ”EUGEN PORA”",24,"MUNICIPIUL CLUJ-NAPOCA",54975,3,PART,PRCNCT,PRSD,PRSD_SV,"2025-05-19 03:17:05",1512,1002,846,155,1,996,6,1673,671,232,764
13,CLUJ,"LICEUL TEORETIC ”EUGEN PORA”",25,"MUNICIPIUL CLUJ-NAPOCA",54975,1,PART,PRCNCT,PRSD,PRSD_SV,"2025-05-18 21:45:11",794,603,436,112,55,598,5,874,271,136,462
13,CLUJ,"LICEUL TEORETIC ”EUGEN PORA”",26,"MUNICIPIUL CLUJ-NAPOCA",54975,1,PART,PRCNCT,PRSD,PRSD_SV,"2025-05-18 22:27:09",1641,1224,909,315,0,1216,8,1810,586,264,952
13,CLUJ,"LICEUL TEORETIC ”EUGEN PORA”",27,"MUNICIPIUL CLUJ-NAPOCA",54975,1,PART,PRCNCT,PRSD,PRSD_SV,"2025-05-18 22:35:03",1475,1105,766,336,3,1093,12,1622,517,229,864
13,CLUJ,"SCOALA INTERNATIONALA ”SPECTRUM”",28,"MUNICIPIUL CLUJ-NAPOCA",54975,1,PART,PRCNCT,PRSD,PRSD_SV,"2025-05-18 22:46:02",2029,1494,1247,244,3,1484,10,2233,739,199,1285
13,CLUJ,"SCOALA INTERNATIONALA ”SPECTRUM”",29,"MUNICIPIUL CLUJ-NAPOCA",54975,1,PART,PRCNCT,PRSD,PRSD_SV,"2025-05-18 22:49:04",1382,1384,776,478,130,1373,11,1517,133,256,1117
13,CLUJ,"SCOALA INTERNATIONALA ”SPECTRUM”",30,"MUNICIPIUL CLUJ-NAPOCA",54975,1,PART,PRCNCT,PRSD,PRSD_SV,"2025-05-18 22:14:48",1200,1202,661,482,59,1192,10,1322,120,186,1006
13,CLUJ,"SCOALA INTERNATIONALA ”SPECTRUM”",31,"MUNICIPIUL CLUJ-NAPOCA",54975,1,PART,PRCNCT,PRSD,PRSD_SV,"2025-05-18 22:23:51",1113,918,610,307,1,913,5,1224,306,111,802
13,CLUJ,"SALA SPORTURILOR ”HOREA DEMIAN”",32,"MUNICIPIUL CLUJ-NAPOCA",54975,1,PART,PRCNCT,PRSD,PRSD_SV,"2025-05-18 22:30:51",856,894,462,357,75,891,3,1343,449,164,727
13,CLUJ,"SALA SPORTURILOR ”HOREA DEMIAN”",33,"MUNICIPIUL CLUJ-NAPOCA",54975,1,PART,PRCNCT,PRSD,PRSD_SV,"2025-05-18 22:44:47",1283,971,711,258,2,962,9,1411,440,209,753
13,CLUJ,"SALA SPORTURILOR ”HOREA DEMIAN”",34,"MUNICIPIUL CLUJ-NAPOCA",54975,1,PART,PRCNCT,PRSD,PRSD_SV,"2025-05-18 21:50:24",1455,1113,827,283,3,1108,5,1401,288,186,922
13,CLUJ,"CENTRUL REGIONAL DE EXCELENŢĂ,",35,"MUNICIPIUL CLUJ-NAPOCA",54975,1,PART,PRCNCT,PRSD,PRSD_SV,"2025-05-18 22:41:48",1520,1078,882,194,2,1074,4,1272,194,141,933
13,CLUJ,"LICEUL TEORETIC ”ONISIFOR GHIBU”,",36,"MUNICIPIUL CLUJ-NAPOCA",54975,1,PART,PRCNCT,PRSD,PRSD_SV,"2025-05-18 22:03:56",1768,1188,1096,87,5,1179,9,1948,760,187,992
13,CLUJ,"LICEUL TEORETIC ”ONISIFOR GHIBU”,",37,"MUNICIPIUL CLUJ-NAPOCA",54975,1,PART,PRCNCT,PRSD,PRSD_SV,"2025-05-18 22:37:31",1420,1066,835,228,3,1059,7,1363,297,178,881
13,CLUJ,"LICEUL TEORETIC ”ONISIFOR GHIBU”,",38,"MUNICIPIUL CLUJ-NAPOCA",54975,1,PART,PRCNCT,PRSD,PRSD_SV,"2025-05-18 22:05:11",1242,1036,761,270,5,1028,8,1366,330,137,891
13,CLUJ,"LICEUL TEORETIC ”ONISIFOR GHIBU”,",39,"MUNICIPIUL CLUJ-NAPOCA",54975,1,PART,PRCNCT,PRSD,PRSD_SV,"2025-05-18 22:27:30",1560,1171,909,261,1,1165,6,1715,544,165,1000
13,CLUJ,"LICEUL TEORETIC ”ONISIFOR GHIBU”,",40,"MUNICIPIUL CLUJ-NAPOCA",54975,1,PART,PRCNCT,PRSD,PRSD_SV,"2025-05-18 22:07:53",1201,969,710,256,3,960,9,1315,346,143,817
13,CLUJ,"GRADINIŢA” MICA SIRENA” (FOSTĂ 64),",41,"MUNICIPIUL CLUJ-NAPOCA",54975,1,PART,PRCNCT,PRSD,PRSD_SV,"2025-05-18 22:03:01",1422,1017,877,137,3,1005,12,1164,147,150,855
13,CLUJ,"GRADINIŢA ”LICURICI” (FOSTA STELUŢA FERMECATĂ), STR.FÂNTÂNELE NR.46",42,"MUNICIPIUL CLUJ-NAPOCA",54975,1,PART,PRCNCT,PRSD,PRSD_SV,"2025-05-18 22:31:36",1288,1062,778,283,1,1051,11,1421,359,146,905
13,CLUJ,"GRADINIŢA ”LICURICI” (FOSTA STELUŢA FERMECATĂ), STR.FÂNTÂNELE NR.46",43,"MUNICIPIUL CLUJ-NAPOCA",54975,1,PART,PRCNCT,PRSD,PRSD_SV,"2025-05-18 22:01:17",1559,1016,901,112,3,1010,6,1715,699,155,855
13,CLUJ,"INSTITUTUL DE CERCETARI ÎN CHIMIE ”RALUCA RIPAN”",44,"MUNICIPIUL CLUJ-NAPOCA",54975,1,PART,PRCNCT,PRSD,PRSD_SV,"2025-05-18 22:03:52",1519,959,899,60,0,951,8,1378,419,178,773
13,CLUJ,"INSTITUTUL DE CERCETARI ÎN CHIMIE ”RALUCA RIPAN”",45,"MUNICIPIUL CLUJ-NAPOCA",54975,1,PART,PRCNCT,PRSD,PRSD_SV,"2025-05-18 22:19:30",1389,1148,824,323,1,1139,9,1532,384,169,970
13,CLUJ,"INSTITUTUL DE CERCETARI ÎN CHIMIE” RALUCA RIPAN”,",46,"MUNICIPIUL CLUJ-NAPOCA",54975,1,PART,PRCNCT,PRSD,PRSD_SV,"2025-05-18 21:54:26",1490,1158,924,225,9,1151,7,1640,482,191,960
13,CLUJ,"INSTITUTUL DE CERCETARI ÎN CHIMIE” RALUCA RIPAN”,",47,"MUNICIPIUL CLUJ-NAPOCA",54975,1,PART,PRCNCT,PRSD,PRSD_SV,"2025-05-18 22:09:57",1791,1179,993,183,3,1170,9,1569,390,183,987
13,CLUJ,"LICEUL DE INFORMATICĂ „TIBERIU POPOVICIU”",48,"MUNICIPIUL CLUJ-NAPOCA",54975,1,PART,PRCNCT,PRSD,PRSD_SV,"2025-05-18 22:28:38",1440,1278,820,458,0,1269,9,1584,306,227,1042
13,CLUJ,"LICEUL DE INFORMATICĂ „TIBERIU POPOVICIU”",49,"MUNICIPIUL CLUJ-NAPOCA",54975,1,PART,PRCNCT,PRSD,PRSD_SV,"2025-05-18 22:53:53",1338,998,716,277,5,994,4,1542,544,175,819
13,CLUJ,"LICEUL DE INFORMATICĂ „TIBERIU POPOVICIU”",50,"MUNICIPIUL CLUJ-NAPOCA",54975,1,PART,PRCNCT,PRSD,PRSD_SV,"2025-05-18 22:14:52",1462,1001,830,171,0,994,7,1612,611,189,805
13,CLUJ,"LICEUL DE INFORMATICĂ „TIBERIU POPOVICIU”",51,"MUNICIPIUL CLUJ-NAPOCA",54975,1,PART,PRCNCT,PRSD,PRSD_SV,"2025-05-18 22:35:56",1295,971,739,231,1,953,18,1425,454,150,803
13,CLUJ,"LICEUL DE INFORMATICĂ „TIBERIU POPOVICIU”",52,"MUNICIPIUL CLUJ-NAPOCA",54975,1,PART,PRCNCT,PRSD,PRSD_SV,"2025-05-18 23:26:32",1098,1062,647,415,0,1053,9,1207,145,178,875
13,CLUJ,"LICEUL DE INFORMATICĂ „TIBERIU POPOVICIU”",53,"MUNICIPIUL CLUJ-NAPOCA",54975,1,PART,PRCNCT,PRSD,PRSD_SV,"2025-05-18 23:31:37",1987,1771,1214,550,7,1759,12,2187,416,225,1534
13,CLUJ,"LICEUL DE INFORMATICĂ „TIBERIU POPOVICIU”",54,"MUNICIPIUL CLUJ-NAPOCA",54975,1,PART,PRCNCT,PRSD,PRSD_SV,"2025-05-18 21:54:43",1518,1593,1019,571,3,1582,11,1871,278,180,1402
13,CLUJ,"LICEUL DE INFORMATICĂ „TIBERIU POPOVICIU”",55,"MUNICIPIUL CLUJ-NAPOCA",54975,1,PART,PRCNCT,PRSD,PRSD_SV,"2025-05-18 22:51:36",2015,1565,1185,379,1,1556,9,2216,651,205,1351
13,CLUJ,"LICEUL DE INFORMATICĂ „TIBERIU POPOVICIU”",56,"MUNICIPIUL CLUJ-NAPOCA",54975,1,PART,PRCNCT,PRSD,PRSD_SV,"2025-05-18 22:42:39",1959,1803,1265,538,0,1791,12,2155,352,228,1563
13,CLUJ,"ASOCIAŢIA ”CARITATEA”",57,"MUNICIPIUL CLUJ-NAPOCA",54975,1,PART,PRCNCT,PRSD,PRSD_SV,"2025-05-18 22:14:23",1147,1292,769,523,0,1283,9,1464,172,179,1104
13,CLUJ,"GRADINIŢA ”ZÎNA ZORILOR”, STR.L.PASTEUR NR.12",58,"MUNICIPIUL CLUJ-NAPOCA",54975,1,PART,PRCNCT,PRSD,PRSD_SV,"2025-05-18 22:41:29",1634,1196,892,285,19,1191,5,1798,602,207,984
13,CLUJ,"FACULTATEA DE ARHITECTURĂ ŞI URBANISM, STR.OBSERVATORULUI NR.72",59,"MUNICIPIUL CLUJ-NAPOCA",54975,1,PART,PRCNCT,PRSD,PRSD_SV,"2025-05-18 23:26:27",1412,1232,786,444,2,1221,11,1554,322,203,1018
13,CLUJ,"FACULTATEA DE ARHITECTURĂ ŞI URBANISM, STR.OBSERVATORULUI NR.72",60,"MUNICIPIUL CLUJ-NAPOCA",54975,1,PART,PRCNCT,PRSD,PRSD_SV,"2025-05-18 23:17:33",1309,1564,710,854,0,1554,10,1841,277,215,1339
13,CLUJ,"FACULTATEA DE ARHITECTURĂ ŞI URBANISM, STR.OBSERVATORULUI NR.72",61,"MUNICIPIUL CLUJ-NAPOCA",54975,1,PART,PRCNCT,PRSD,PRSD_SV,"2025-05-18 22:56:21",926,1310,547,742,21,1303,7,1422,112,176,1127
13,CLUJ,"FACULTATEA DE ARHITECTURĂ ŞI URBANISM, STR.OBSERVATORULUI NR.72",62,"MUNICIPIUL CLUJ-NAPOCA",54975,1,PART,PRCNCT,PRSD,PRSD_SV,"2025-05-18 23:10:53",1240,1153,747,404,2,1144,9,1723,570,188,956
13,CLUJ,"LICEUL TEORETIC „ELF”",63,"MUNICIPIUL CLUJ-NAPOCA",54975,1,PART,PRCNCT,PRSD,PRSD_SV,"2025-05-18 23:45:25",1860,2442,1143,1299,0,2426,16,2645,203,216,2210
13,CLUJ,"”PALATUL COPIILOR ”",64,"MUNICIPIUL CLUJ-NAPOCA",54975,1,PART,PRCNCT,PRSD,PRSD_SV,"2025-05-18 23:39:56",1283,1474,711,616,147,1463,11,1564,90,211,1252
13,CLUJ,"LICEUL WALDORF",65,"MUNICIPIUL CLUJ-NAPOCA",54975,1,PART,PRCNCT,PRSD,PRSD_SV,"2025-05-18 23:22:00",1633,1518,1135,381,2,1508,10,1795,277,169,1339
13,CLUJ,"SCOALA ”IOAN BOB”",66,"MUNICIPIUL CLUJ-NAPOCA",54975,1,PART,PRCNCT,PRSD,PRSD_SV,"2025-05-18 22:48:48",1250,1669,643,1021,5,1660,9,1974,305,208,1452
13,CLUJ,"COLEGIUL NAŢIONAL ”GEORGE COŞBUC”",67,"MUNICIPIUL CLUJ-NAPOCA",54975,1,PART,PRCNCT,PRSD,PRSD_SV,"2025-05-18 22:05:28",1096,897,662,231,4,892,5,1205,308,149,743
13,CLUJ,"COLEGIUL NAŢIONAL ”GEORGE COŞBUC”",68,"MUNICIPIUL CLUJ-NAPOCA",54975,1,PART,PRCNCT,PRSD,PRSD_SV,"2025-05-18 22:15:20",1148,898,626,158,114,890,8,1267,369,202,688
13,CLUJ,"COLEGIUL NAŢIONAL ”GEORGE COŞBUC”",69,"MUNICIPIUL CLUJ-NAPOCA",54975,1,PART,PRCNCT,PRSD,PRSD_SV,"2025-05-18 21:31:56",871,615,499,115,1,608,7,959,344,86,522
13,CLUJ,"COLEGIUL NAȚIONAL „GHEORGHE ȘINCAI”",70,"MUNICIPIUL CLUJ-NAPOCA",54975,1,PART,PRCNCT,PRSD,PRSD_SV,"2025-05-18 22:39:38",1389,1207,824,377,6,1192,15,1527,320,166,1026
13,CLUJ,"COLEGIUL NAȚIONAL „GHEORGHE ȘINCAI”",71,"MUNICIPIUL CLUJ-NAPOCA",54975,1,PART,PRCNCT,PRSD,PRSD_SV,"2025-05-19 00:05:24",1131,966,719,244,3,954,12,1246,280,151,803
13,CLUJ,"COLEGIUL NAȚIONAL „GHEORGHE ȘINCAI”",72,"MUNICIPIUL CLUJ-NAPOCA",54975,1,PART,PRCNCT,PRSD,PRSD_SV,"2025-05-18 22:31:23",1561,1206,924,269,13,1197,9,1721,515,252,945
13,CLUJ,"COLEGIUL NAȚIONAL „GHEORGHE ȘINCAI”",73,"MUNICIPIUL CLUJ-NAPOCA",54975,1,PART,PRCNCT,PRSD,PRSD_SV,"2025-05-18 22:47:05",1083,948,679,268,1,941,7,1190,242,165,776
13,CLUJ,"COLEGIUL NAȚIONAL „GHEORGHE ȘINCAI”",74,"MUNICIPIUL CLUJ-NAPOCA",54975,1,PART,PRCNCT,PRSD,PRSD_SV,"2025-05-19 00:06:46",1348,1173,764,408,1,1160,13,1482,309,215,945
13,CLUJ,"COLEGIUL NAȚIONAL „GHEORGHE ȘINCAI”",75,"MUNICIPIUL CLUJ-NAPOCA",54975,1,PART,PRCNCT,PRSD,PRSD_SV,"2025-05-18 22:56:08",1322,946,773,173,0,938,8,1457,511,153,785
13,CLUJ,"ŞCOALA GIMNAZIALĂ ”ION CREANGĂ”",76,"MUNICIPIUL CLUJ-NAPOCA",54975,1,PART,PRCNCT,PRSD,PRSD_SV,"2025-05-18 22:27:04",1398,884,724,160,0,875,9,1539,655,186,689
13,CLUJ,"ŞCOALA GIMNAZIALĂ ”ION CREANGĂ”",77,"MUNICIPIUL CLUJ-NAPOCA",54975,1,PART,PRCNCT,PRSD,PRSD_SV,"2025-05-18 22:55:05",1529,1027,863,163,1,1014,13,1682,655,195,819
13,CLUJ,"ŞCOALA GIMNAZIALĂ ”ION CREANGĂ”",78,"MUNICIPIUL CLUJ-NAPOCA",54975,1,PART,PRCNCT,PRSD,PRSD_SV,"2025-05-18 22:17:07",1392,942,788,153,1,934,8,1531,589,198,736
13,CLUJ,"ŞCOALA ”LIVIU REBREANU”",79,"MUNICIPIUL CLUJ-NAPOCA",54975,1,PART,PRCNCT,PRSD,PRSD_SV,"2025-05-18 22:10:19",1440,1005,819,185,1,997,8,1583,578,184,813
13,CLUJ,"ŞCOALA ”LIVIU REBREANU”",80,"MUNICIPIUL CLUJ-NAPOCA",54975,1,PART,PRCNCT,PRSD,PRSD_SV,"2025-05-18 22:34:06",1461,1003,785,218,0,991,12,1608,605,251,740
13,CLUJ,"ŞCOALA ”LIVIU REBREANU”",81,"MUNICIPIUL CLUJ-NAPOCA",54975,1,PART,PRCNCT,PRSD,PRSD_SV,"2025-05-18 22:37:32",1438,913,733,178,2,908,5,1583,670,228,680
13,CLUJ,"GRADINIŢA ”UNIVERSUL COPIILOR” (FOSTĂ NR.71)",82,"MUNICIPIUL CLUJ-NAPOCA",54975,1,PART,PRCNCT,PRSD,PRSD_SV,"2025-05-18 22:36:57",1299,972,704,264,4,962,10,1428,456,197,765
13,CLUJ,"ŞCOALA ” LIVIU REBREANU”( FOSTA CONSTANTIN BRÂNCOVEANU),ALEEA RETEZAT NR.4",83,"MUNICIPIUL CLUJ-NAPOCA",54975,1,PART,PRCNCT,PRSD,PRSD_SV,"2025-05-18 21:56:56",1382,894,746,148,0,884,10,1519,625,236,648
13,CLUJ,"ŞCOALA ” LIVIU REBREANU” ( FOSTA CONSTANTIN BRÂNCOVEANU), ALEEA RETEZAT NR.4",84,"MUNICIPIUL CLUJ-NAPOCA",54975,1,PART,PRCNCT,PRSD,PRSD_SV,"2025-05-18 21:56:14",1085,743,591,151,1,733,10,1193,450,158,575
13,CLUJ,"ŞCOALA ” LIVIU REBREANU” ( FOSTA CONSTANTIN BRÂNCOVEANU), ALEEA RETEZAT NR.4",85,"MUNICIPIUL CLUJ-NAPOCA",54975,1,PART,PRCNCT,PRSD,PRSD_SV,"2025-05-18 21:45:07",1263,783,694,89,0,778,5,1389,606,180,598
13,CLUJ,"ŞCOALA ” LIVIU REBREANU” ( FOSTA CONSTANTIN BRÂNCOVEANU), ALEEA RETEZAT NR.4",86,"MUNICIPIUL CLUJ-NAPOCA",54975,1,PART,PRCNCT,PRSD,PRSD_SV,"2025-05-18 21:46:58",864,575,440,48,87,571,4,952,377,154,417
13,CLUJ,"GRADINIŢA” BUBURUZA” (FOSTĂ NR. 70),",87,"MUNICIPIUL CLUJ-NAPOCA",54975,1,PART,PRCNCT,PRSD,PRSD_SV,"2025-05-18 21:50:57",1053,801,517,283,1,794,7,1157,356,167,627
13,CLUJ,"GRADINIŢA” BUBURUZA” (FOSTĂ NR. 70),",88,"MUNICIPIUL CLUJ-NAPOCA",54975,1,PART,PRCNCT,PRSD,PRSD_SV,"2025-05-18 21:50:21",1408,793,704,87,2,789,4,1550,757,185,604
13,CLUJ,"GRADINIŢA ”ACADEMIA PITICILOR”(FOSTĂ NR. 72),",89,"MUNICIPIUL CLUJ-NAPOCA",54975,1,PART,PRCNCT,PRSD,PRSD_SV,"2025-05-18 22:37:22",1598,1140,880,258,2,1132,8,1759,619,235,897
13,CLUJ,"GRADINIŢA ”ACADEMIA PITICILOR”(FOSTĂ NR. 72),",90,"MUNICIPIUL CLUJ-NAPOCA",54975,1,PART,PRCNCT,PRSD,PRSD_SV,"2025-05-18 22:03:08",1358,918,710,203,5,915,3,1493,575,176,739
13,CLUJ,"CREȘA „URSULEȚUL”",91,"MUNICIPIUL CLUJ-NAPOCA",54975,1,PART,PRCNCT,PRSD,PRSD_SV,"2025-05-18 22:22:09",1273,829,626,202,1,825,4,1252,423,206,619
13,CLUJ,"CREȘA „URSULEȚUL”",92,"MUNICIPIUL CLUJ-NAPOCA",54975,1,PART,PRCNCT,PRSD,PRSD_SV,"2025-05-18 22:47:25",1486,976,861,113,2,963,13,1635,659,213,750
13,CLUJ,"CREȘA „URSULEȚUL”",93,"MUNICIPIUL CLUJ-NAPOCA",54975,1,PART,PRCNCT,PRSD,PRSD_SV,"2025-05-18 22:40:25",1474,896,753,143,0,890,6,1628,732,225,665
13,CLUJ,"CREȘA „URSULEȚUL”",94,"MUNICIPIUL CLUJ-NAPOCA",54975,1,PART,PRCNCT,PRSD,PRSD_SV,"2025-05-18 21:55:03",1168,853,671,182,0,845,8,1283,430,165,680
13,CLUJ,"ŞCOALA ”OCTAVIAN GOGA”",95,"MUNICIPIUL CLUJ-NAPOCA",54975,1,PART,PRCNCT,PRSD,PRSD_SV,"2025-05-18 21:37:52",1409,942,737,205,0,936,6,1201,259,202,734
13,CLUJ,"ŞCOALA ”OCTAVIAN GOGA”",96,"MUNICIPIUL CLUJ-NAPOCA",54975,1,PART,PRCNCT,PRSD,PRSD_SV,"2025-05-18 22:17:11",1327,989,676,312,1,984,5,1409,420,239,745
13,CLUJ,"ŞCOALA ”OCTAVIAN GOGA”",97,"MUNICIPIUL CLUJ-NAPOCA",54975,1,PART,PRCNCT,PRSD,PRSD_SV,"2025-05-18 22:26:52",1487,1155,769,385,1,1150,5,1436,281,237,913
13,CLUJ,"GRADINIŢA ”POIENIŢA”,",98,"MUNICIPIUL CLUJ-NAPOCA",54975,1,PART,PRCNCT,PRSD,PRSD_SV,"2025-05-18 22:22:27",1578,1299,960,334,5,1284,15,1737,438,157,1127
13,CLUJ,"GRADINIŢA ”POIENIŢA”,",99,"MUNICIPIUL CLUJ-NAPOCA",54975,1,PART,PRCNCT,PRSD,PRSD_SV,"2025-05-18 22:53:17",1934,1627,1332,295,0,1615,12,2128,501,164,1451
13,CLUJ,"GRADINIŢA ”POIENIŢA”,",100,"MUNICIPIUL CLUJ-NAPOCA",54975,1,PART,PRCNCT,PRSD,PRSD_SV,"2025-05-18 22:41:01",1839,1303,1074,226,3,1294,9,1826,523,236,1058
13,CLUJ,"GRADINIŢA ”POIENIŢA”,",101,"MUNICIPIUL CLUJ-NAPOCA",54975,1,PART,PRCNCT,PRSD,PRSD_SV,"2025-05-18 23:58:13",1963,1466,1299,166,1,1453,13,2160,694,159,1294
13,CLUJ,"ŞCOALA ”CONSTANTIN BRÂNCUŞI”",102,"MUNICIPIUL CLUJ-NAPOCA",54975,1,PART,PRCNCT,PRSD,PRSD_SV,"2025-05-18 23:19:07",1975,1577,1257,315,5,1561,16,1975,398,249,1312
13,CLUJ,"ŞCOALA ”CONSTANTIN BRÂNCUŞI”",103,"MUNICIPIUL CLUJ-NAPOCA",54975,1,PART,PRCNCT,PRSD,PRSD_SV,"2025-05-18 22:19:19",1529,1151,907,241,3,1145,6,1684,533,176,969
13,CLUJ,"ŞCOALA ”CONSTANTIN BRÂNCUŞI”",104,"MUNICIPIUL CLUJ-NAPOCA",54975,1,PART,PRCNCT,PRSD,PRSD_SV,"2025-05-18 22:17:19",1781,1408,1163,244,1,1401,7,1959,551,218,1183
13,CLUJ,"ŞCOALA ”CONSTANTIN BRÂNCUŞI”",105,"MUNICIPIUL CLUJ-NAPOCA",54975,1,PART,PRCNCT,PRSD,PRSD_SV,"2025-05-18 22:39:09",1784,1361,1079,275,7,1343,18,1963,602,249,1094
13,CLUJ,"GRĂDINIŢA ”LUMEA COPIILOR”, STR.SEPTIMIU ALBINI NR 53",106,"MUNICIPIUL CLUJ-NAPOCA",54975,1,PART,PRCNCT,PRSD,PRSD_SV,"2025-05-18 22:54:46",936,871,584,221,66,862,9,1029,158,130,732
13,CLUJ,"CREŞA ”CASTELUL FERMECAT”, STR.SEPTIMIU ALBINI NR.91",107,"MUNICIPIUL CLUJ-NAPOCA",54975,1,PART,PRCNCT,PRSD,PRSD_SV,"2025-05-18 21:52:58",1401,1028,816,208,4,1017,11,1542,514,147,870
13,CLUJ,"CREŞA ”CASTELUL FERMECAT”, STR.SEPTIMIU ALBINI NR.91",108,"MUNICIPIUL CLUJ-NAPOCA",54975,1,PART,PRCNCT,PRSD,PRSD_SV,"2025-05-18 22:35:16",1409,933,821,107,5,926,7,1552,619,139,787
13,CLUJ,"GRĂDINIŢA ” LUMEA COPIILOR” (FOSTĂ NR. 20),",109,"MUNICIPIUL CLUJ-NAPOCA",54975,1,PART,PRCNCT,PRSD,PRSD_SV,"2025-05-18 22:56:07",1547,1053,800,250,3,1040,13,1304,251,199,841
13,CLUJ,"GRĂDINIŢA ” LUMEA COPIILOR” (FOSTĂ NR. 20),",110,"MUNICIPIUL CLUJ-NAPOCA",54975,1,PART,PRCNCT,PRSD,PRSD_SV,"2025-05-18 22:09:30",1398,1011,760,248,3,1004,7,1539,528,176,828
13,CLUJ,"LICEUL TEORETIC ”LUCIAN BLAGA”",111,"MUNICIPIUL CLUJ-NAPOCA",54975,1,PART,PRCNCT,PRSD,PRSD_SV,"2025-05-18 22:21:23",1518,1016,846,170,0,1001,15,1671,655,171,830
13,CLUJ,"LICEUL TEORETIC ”LUCIAN BLAGA”",112,"MUNICIPIUL CLUJ-NAPOCA",54975,1,PART,PRCNCT,PRSD,PRSD_SV,"2025-05-18 22:33:35",1242,819,699,116,4,811,8,1166,347,127,684
13,CLUJ,"LICEUL TEORETIC ”LUCIAN BLAGA”",113,"MUNICIPIUL CLUJ-NAPOCA",54975,1,PART,PRCNCT,PRSD,PRSD_SV,"2025-05-18 22:07:47",1132,1043,628,415,0,1039,4,1244,201,156,883
13,CLUJ,"LICEUL TEORETIC ”LUCIAN BLAGA”",114,"MUNICIPIUL CLUJ-NAPOCA",54975,1,PART,PRCNCT,PRSD,PRSD_SV,"2025-05-18 22:02:10",1337,1038,746,291,1,1030,8,1471,433,178,852
13,CLUJ,"ŞCOALA ” N.TITULESCU”",115,"MUNICIPIUL CLUJ-NAPOCA",54975,1,PART,PRCNCT,PRSD,PRSD_SV,"2025-05-18 22:30:52",1786,1378,1052,316,10,1363,15,1966,588,242,1121
13,CLUJ,"ŞCOALA ” N.TITULESCU”",116,"MUNICIPIUL CLUJ-NAPOCA",54975,1,PART,PRCNCT,PRSD,PRSD_SV,"2025-05-18 22:30:16",1544,1210,884,325,1,1195,15,1499,289,196,999
13,CLUJ,"LICEUL TEHNOLOGIC ”AL. BORZA”",117,"MUNICIPIUL CLUJ-NAPOCA",54975,1,PART,PRCNCT,PRSD,PRSD_SV,"2025-05-18 23:55:10",1694,2135,1017,1114,4,2119,16,2265,130,235,1884
13,CLUJ,"LICEUL TEHNOLOGIC ”AL. BORZA”",118,"MUNICIPIUL CLUJ-NAPOCA",54975,1,PART,PRCNCT,PRSD,PRSD_SV,"2025-05-18 23:30:31",1832,2019,1164,855,0,2008,11,2415,396,188,1820
13,CLUJ,"COLEGIUL TEHNIC DE TRANSPORTURI” TRANSILVANIA”",119,"MUNICIPIUL CLUJ-NAPOCA",54975,1,PART,PRCNCT,PRSD,PRSD_SV,"2025-05-18 22:54:09",1420,1157,834,318,5,1150,7,1561,404,165,985
13,CLUJ,"COLEGIUL TEHNIC DE TRANSPORTURI” TRANSILVANIA”",120,"MUNICIPIUL CLUJ-NAPOCA",54975,1,PART,PRCNCT,PRSD,PRSD_SV,"2025-05-18 21:56:40",1752,1208,1058,149,1,1196,12,1928,720,198,998
13,CLUJ,"COLEGIUL TEHNIC ”ENERGETIC”",121,"MUNICIPIUL CLUJ-NAPOCA",54975,1,PART,PRCNCT,PRSD,PRSD_SV,"2025-05-18 23:01:46",1450,1261,846,405,10,1255,6,1598,337,201,1054
13,CLUJ,"UNIVERSITATEA ”BABES-BOLYAI” - FACULTATEA DE ŞTIINŢE ECONOMICE ŞI GESTIUNEA AFACERILOR,",122,"MUNICIPIUL CLUJ-NAPOCA",54975,1,PART,PRCNCT,PRSD,PRSD_SV,"2025-05-18 23:25:46",1773,2008,928,991,89,1990,18,2154,146,290,1700
13,CLUJ,"UNIVERSITATEA ”BABES-BOLYAI” - FACULTATEA DE ŞTIINŢE ECONOMICE ŞI GESTIUNEA AFACERILOR,",123,"MUNICIPIUL CLUJ-NAPOCA",54975,1,PART,PRCNCT,PRSD,PRSD_SV,"2025-05-18 23:39:02",1792,2021,951,1068,2,2009,12,2270,249,278,1731
13,CLUJ,"ŞCOALA ”ION AGÂRBICEANU”,",124,"MUNICIPIUL CLUJ-NAPOCA",54975,1,PART,PRCNCT,PRSD,PRSD_SV,"2025-05-18 21:52:09",1166,978,637,339,2,970,8,1278,300,166,804
13,CLUJ,"ŞCOALA ”ION AGÂRBICEANU”,",125,"MUNICIPIUL CLUJ-NAPOCA",54975,1,PART,PRCNCT,PRSD,PRSD_SV,"2025-05-18 21:52:58",1307,1208,747,461,0,1199,9,1437,229,270,929
13,CLUJ,"ŞCOALA ”ION AGÂRBICEANU”,",126,"MUNICIPIUL CLUJ-NAPOCA",54975,2,PART,PRCNCT,PRSD,PRSD_SV,"2025-05-19 01:04:13",1491,1110,804,305,1,1096,14,1642,532,211,885
13,CLUJ,"ŞCOALA ”ION AGÂRBICEANU”,",127,"MUNICIPIUL CLUJ-NAPOCA",54975,1,PART,PRCNCT,PRSD,PRSD_SV,"2025-05-18 22:07:13",1271,959,676,283,0,948,11,1397,438,227,721
13,CLUJ,"ŞCOALA ”ION AGÂRBICEANU”,",128,"MUNICIPIUL CLUJ-NAPOCA",54975,1,PART,PRCNCT,PRSD,PRSD_SV,"2025-05-18 22:10:20",1282,1040,712,328,0,1023,17,1410,370,179,844
13,CLUJ,"ŞCOALA ”ION AGÂRBICEANU”,",129,"MUNICIPIUL CLUJ-NAPOCA",54975,1,PART,PRCNCT,PRSD,PRSD_SV,"2025-05-18 22:23:25",1288,996,691,304,1,982,14,1416,420,195,787
13,CLUJ,"ŞCOALA ”ION AGÂRBICEANU”,",130,"MUNICIPIUL CLUJ-NAPOCA",54975,1,PART,PRCNCT,PRSD,PRSD_SV,"2025-05-18 22:08:11",1664,1162,869,292,1,1156,6,1829,667,203,953
13,CLUJ,"GRĂDINŢA ”MĂMARUŢA” (FOSTĂ NR. 42),",131,"MUNICIPIUL CLUJ-NAPOCA",54975,1,PART,PRCNCT,PRSD,PRSD_SV,"2025-05-18 22:05:29",1557,1359,943,415,1,1349,10,1712,353,246,1103
13,CLUJ,"COLEGIUL TEHNIC ”ANGHEL SALIGNY”,",132,"MUNICIPIUL CLUJ-NAPOCA",54975,1,PART,PRCNCT,PRSD,PRSD_SV,"2025-05-18 22:25:57",1311,990,713,277,0,984,6,1441,451,188,796
13,CLUJ,"COLEGIUL TEHNIC ”ANGHEL SALIGNY”,",133,"MUNICIPIUL CLUJ-NAPOCA",54975,1,PART,PRCNCT,PRSD,PRSD_SV,"2025-05-18 22:04:52",1155,877,612,262,3,869,8,1271,394,175,694
13,CLUJ,"COLEGIUL TEHNIC ”ANGHEL SALIGNY”,",134,"MUNICIPIUL CLUJ-NAPOCA",54975,1,PART,PRCNCT,PRSD,PRSD_SV,"2025-05-18 22:01:22",1421,1065,805,244,16,1054,11,1412,347,212,842
13,CLUJ,"COLEGIUL TEHNIC ”ANGHEL SALIGNY”",135,"MUNICIPIUL CLUJ-NAPOCA",54975,1,PART,PRCNCT,PRSD,PRSD_SV,"2025-05-18 22:19:56",1483,1063,813,230,20,1058,5,1629,566,181,877
13,CLUJ,"COLEGIUL DE MUZICĂ ”SIGISMUND TODUŢĂ” (FOSTUL GRUP SCOLAR DE MATERIAL RULANT- UNIREA)",136,"MUNICIPIUL CLUJ-NAPOCA",54975,2,PART,PRCNCT,PRSD,PRSD_SV,"2025-05-18 22:55:15",1529,1103,909,190,4,1092,11,1681,578,244,848
13,CLUJ,"COLEGIUL DE MUZICĂ ”SIGISMUND TODUŢĂ” (FOSTUL GRUP SCOLAR DE MATERIAL RULANT- UNIREA)",137,"MUNICIPIUL CLUJ-NAPOCA",54975,1,PART,PRCNCT,PRSD,PRSD_SV,"2025-05-18 22:26:48",925,979,489,490,0,970,9,1019,40,134,836
13,CLUJ,"LICEUL TEORETIC ”A. IANCU”,",138,"MUNICIPIUL CLUJ-NAPOCA",54975,1,PART,PRCNCT,PRSD,PRSD_SV,"2025-05-18 22:54:03",1820,1426,1035,389,2,1416,10,2003,577,197,1219
13,CLUJ,"LICEUL TEORETIC ”VICTOR BABEŞ” (FOSTA SCOALA ”DAVID PRODAN”),",139,"MUNICIPIUL CLUJ-NAPOCA",54975,1,PART,PRCNCT,PRSD,PRSD_SV,"2025-05-18 21:54:35",1772,1319,1004,208,107,1310,9,1949,630,314,996
13,CLUJ,"COLEGIUL ORTODOX „MITROPOLITUL NICOLAE COLAN”",140,"MUNICIPIUL CLUJ-NAPOCA",54975,1,PART,PRCNCT,PRSD,PRSD_SV,"2025-05-18 22:54:33",1993,1511,1140,368,3,1504,7,1792,281,286,1218
13,CLUJ,"ŞCOALA ”HOREA”",141,"MUNICIPIUL CLUJ-NAPOCA",54975,1,PART,PRCNCT,PRSD,PRSD_SV,"2025-05-18 22:29:13",1372,1142,694,406,42,1130,12,1508,366,181,949
13,CLUJ,"LICEUL TEORETIC ”N. BALCESCU”,",142,"MUNICIPIUL CLUJ-NAPOCA",54975,1,PART,PRCNCT,PRSD,PRSD_SV,"2025-05-18 23:13:47",1287,1445,657,759,29,1431,14,1616,171,190,1241
13,CLUJ,"LICEUL TEORETIC UNITARIAN” JANOS ZSIGMOND”",143,"MUNICIPIUL CLUJ-NAPOCA",54975,1,PART,PRCNCT,PRSD,PRSD_SV,"2025-05-18 23:06:48",1160,1891,588,1302,1,1874,17,2005,114,196,1678
13,CLUJ,"PAVILIONUL ”EXPO TRANSILVANIA”",144,"MUNICIPIUL CLUJ-NAPOCA",54975,1,PART,PRCNCT,PRSD,PRSD_SV,"2025-05-18 22:06:53",1611,1197,938,259,0,1186,11,1771,574,250,936
13,CLUJ,"PAVILIONUL ”EXPO TRANSILVANIA”",145,"MUNICIPIUL CLUJ-NAPOCA",54975,1,PART,PRCNCT,PRSD,PRSD_SV,"2025-05-18 22:20:58",1584,1189,917,271,1,1180,9,1743,554,266,914
13,CLUJ,"PAVILIONUL ”EXPO TRANSILVANIA”",146,"MUNICIPIUL CLUJ-NAPOCA",54975,1,PART,PRCNCT,PRSD,PRSD_SV,"2025-05-18 22:21:12",1669,1204,996,208,0,1197,7,1835,631,245,952
13,CLUJ,"PAVILIONUL ”EXPO TRANSILVANIA”",147,"MUNICIPIUL CLUJ-NAPOCA",54975,1,PART,PRCNCT,PRSD,PRSD_SV,"2025-05-18 22:41:09",1573,1197,837,357,3,1186,11,1729,532,280,906
13,CLUJ,"PAVILIONUL ”EXPO TRANSILVANIA”",148,"MUNICIPIUL CLUJ-NAPOCA",54975,1,PART,PRCNCT,PRSD,PRSD_SV,"2025-05-18 22:26:03",1618,1112,837,275,0,1098,14,1779,667,318,780
13,CLUJ,"PAVILIONUL ”EXPO TRANSILVANIA”",149,"MUNICIPIUL CLUJ-NAPOCA",54975,1,PART,PRCNCT,PRSD,PRSD_SV,"2025-05-18 23:02:42",1713,1286,859,427,0,1267,19,1884,598,334,933
13,CLUJ,"GRĂDINIŢA ”DEGEŢICA” (FOSTĂ NR. 53),",150,"MUNICIPIUL CLUJ-NAPOCA",54975,1,PART,PRCNCT,PRSD,PRSD_SV,"2025-05-18 22:31:50",1713,1239,994,243,2,1231,8,1883,644,221,1010
13,CLUJ,"GRĂDINIŢA ”DEGEŢICA” (FOSTĂ NR. 53),",151,"MUNICIPIUL CLUJ-NAPOCA",54975,1,PART,PRCNCT,PRSD,PRSD_SV,"2025-05-18 22:16:20",1432,1062,794,267,1,1054,8,1374,312,229,825
13,CLUJ,"ŞCOALA ” AL.VAIDA VOEVOD”,",152,"MUNICIPIUL CLUJ-NAPOCA",54975,1,PART,PRCNCT,PRSD,PRSD_SV,"2025-05-18 22:02:52",1480,1178,835,343,0,1173,5,1628,450,276,897
13,CLUJ,"ŞCOALA ” AL.VAIDA VOEVOD”,",153,"MUNICIPIUL CLUJ-NAPOCA",54975,1,PART,PRCNCT,PRSD,PRSD_SV,"2025-05-18 22:38:28",1596,1164,974,149,41,1154,10,1755,591,284,870
13,CLUJ,"ŞCOALA ” AL.VAIDA VOEVOD”,",154,"MUNICIPIUL CLUJ-NAPOCA",54975,1,PART,PRCNCT,PRSD,PRSD_SV,"2025-05-18 22:30:22",1426,996,824,170,2,982,14,1569,573,271,711
13,CLUJ,"ŞCOALA ” AL.VAIDA VOEVOD”,",155,"MUNICIPIUL CLUJ-NAPOCA",54975,1,PART,PRCNCT,PRSD,PRSD_SV,"2025-05-18 22:09:14",1158,957,679,277,1,953,4,1273,316,212,741
13,CLUJ,"ŞCOALA ” AL.VAIDA VOEVOD”,",156,"MUNICIPIUL CLUJ-NAPOCA",54975,2,PART,PRCNCT,PRSD,PRSD_SV,"2025-05-19 02:38:55",1184,1132,642,490,0,1119,13,1301,169,230,889
13,CLUJ,"GRUP ŞCOLAR ”SAMUS”",157,"MUNICIPIUL CLUJ-NAPOCA",54975,1,PART,PRCNCT,PRSD,PRSD_SV,"2025-05-18 22:12:10",1563,1080,801,279,0,1071,9,1518,438,204,867
13,CLUJ,"GRUP ŞCOLAR ”SAMUS”",158,"MUNICIPIUL CLUJ-NAPOCA",54975,1,PART,PRCNCT,PRSD,PRSD_SV,"2025-05-18 22:32:39",1544,1076,802,274,0,1068,8,1698,622,240,828
13,CLUJ,"GRUP ŞCOLAR ”SAMUS”",159,"MUNICIPIUL CLUJ-NAPOCA",54975,1,PART,PRCNCT,PRSD,PRSD_SV,"2025-05-18 22:18:53",1402,1070,788,282,0,1057,13,1542,472,251,806
13,CLUJ,"COLEGIUL TEHNIC „ANA ASLAN”",160,"MUNICIPIUL CLUJ-NAPOCA",54975,1,PART,PRCNCT,PRSD,PRSD_SV,"2025-05-18 22:24:48",1526,1138,735,402,1,1130,8,1678,540,225,905
13,CLUJ,"COLEGIUL TEHNIC „ANA ASLAN”",161,"MUNICIPIUL CLUJ-NAPOCA",54975,1,PART,PRCNCT,PRSD,PRSD_SV,"2025-05-18 22:23:08",1485,1057,798,253,6,1050,7,1633,576,187,863
13,CLUJ,"EPARHIA REFORMATĂ DIN ARDEAL , STR.HOREA NR.51",162,"MUNICIPIUL CLUJ-NAPOCA",54975,1,PART,PRCNCT,PRSD,PRSD_SV,"2025-05-18 22:09:28",1233,1105,593,505,7,1098,7,1355,250,231,867
13,CLUJ,"ŞCOALA ”HOREA” (FOSTĂ NR.27)",163,"MUNICIPIUL CLUJ-NAPOCA",54975,1,PART,PRCNCT,PRSD,PRSD_SV,"2025-05-18 23:27:16",1477,1148,930,215,3,1140,8,1627,479,176,964
13,CLUJ,"LICEUL TEOLOGIC ”EMANUEL”",164,"MUNICIPIUL CLUJ-NAPOCA",54975,1,PART,PRCNCT,PRSD,PRSD_SV,"2025-05-18 22:15:41",1733,1323,1048,269,6,1308,15,1909,586,208,1100
13,CLUJ,"LICEUL TEOLOGIC ”EMANUEL”",165,"MUNICIPIUL CLUJ-NAPOCA",54975,1,PART,PRCNCT,PRSD,PRSD_SV,"2025-05-18 21:48:41",1505,953,862,86,5,943,10,1656,703,175,768
13,CLUJ,"GRĂDINIŢA ”NEGHINIŢĂ”",166,"MUNICIPIUL CLUJ-NAPOCA",54975,1,PART,PRCNCT,PRSD,PRSD_SV,"2025-05-18 22:39:10",1797,1341,1103,238,0,1329,12,1978,637,346,983
13,CLUJ,"GRĂDINIŢA ”NEGHINIŢĂ”",167,"MUNICIPIUL CLUJ-NAPOCA",54975,1,PART,PRCNCT,PRSD,PRSD_SV,"2025-05-18 22:45:47",1855,1201,1000,199,2,1187,14,2040,839,324,863
13,CLUJ,"GRĂDINIŢA ”NEGHINIŢĂ”",168,"MUNICIPIUL CLUJ-NAPOCA",54975,1,PART,PRCNCT,PRSD,PRSD_SV,"2025-05-18 22:10:22",1754,1277,1081,196,0,1262,15,1928,651,328,934
13,CLUJ,"GRĂDINIŢA ”NEGHINIŢĂ”",169,"MUNICIPIUL CLUJ-NAPOCA",54975,1,PART,PRCNCT,PRSD,PRSD_SV,"2025-05-18 23:31:03",1835,1310,1088,220,2,1303,7,2020,710,350,953
13,CLUJ,"ŞCOALA ”EMIL ISAC”",170,"MUNICIPIUL CLUJ-NAPOCA",54975,1,PART,PRCNCT,PRSD,PRSD_SV,"2025-05-18 21:50:51",1451,1083,895,187,1,1071,12,1595,512,268,803
13,CLUJ,"ŞCOALA ”EMIL ISAC”",171,"MUNICIPIUL CLUJ-NAPOCA",54975,1,PART,PRCNCT,PRSD,PRSD_SV,"2025-05-18 21:58:58",920,690,500,190,0,686,4,1013,323,182,504
13,CLUJ,"ŞCOALA ”NICOLAE IORGA”",172,"MUNICIPIUL CLUJ-NAPOCA",54975,1,PART,PRCNCT,PRSD,PRSD_SV,"2025-05-18 22:38:58",2019,1349,1116,233,0,1340,9,2170,821,318,1022
13,CLUJ,"ŞCOALA ”NICOLAE IORGA”",173,"MUNICIPIUL CLUJ-NAPOCA",54975,1,PART,PRCNCT,PRSD,PRSD_SV,"2025-05-18 22:38:32",1992,1375,1158,215,2,1359,16,2191,816,378,981
13,CLUJ,"ŞCOALA ”NICOLAE IORGA”",174,"MUNICIPIUL CLUJ-NAPOCA",54975,1,PART,PRCNCT,PRSD,PRSD_SV,"2025-05-18 23:07:10",1889,1425,1087,337,1,1412,13,2077,652,309,1103
13,CLUJ,"ŞCOALA ”NICOLAE IORGA”",175,"MUNICIPIUL CLUJ-NAPOCA",54975,1,PART,PRCNCT,PRSD,PRSD_SV,"2025-05-18 22:35:11",1930,1410,1105,304,1,1396,14,1723,313,293,1103
13,CLUJ,"COLEGIUL TEHNIC „ANGHEL SALIGNY”",176,"MUNICIPIUL CLUJ-NAPOCA",54975,1,PART,PRCNCT,PRSD,PRSD_SV,"2025-05-18 22:06:38",1831,953,792,156,5,947,6,2013,1060,392,555
13,CLUJ,"COLEGIUL TEHNIC „ANGHEL SALIGNY”",177,"MUNICIPIUL CLUJ-NAPOCA",54975,1,PART,PRCNCT,PRSD,PRSD_SV,"2025-05-18 22:58:49",1965,1387,1202,184,1,1379,8,2161,774,323,1056
13,CLUJ,"LICEUL TEHNOLOGIC ”AUREL VLAICU”",178,"MUNICIPIUL CLUJ-NAPOCA",54975,1,PART,PRCNCT,PRSD,PRSD_SV,"2025-05-18 23:02:36",1860,1347,1188,158,1,1337,10,2046,699,251,1086
13,CLUJ,"LICEUL TEHNOLOGIC ”AUREL VLAICU”",179,"MUNICIPIUL CLUJ-NAPOCA",54975,1,PART,PRCNCT,PRSD,PRSD_SV,"2025-05-18 22:39:24",1829,1249,1007,241,1,1236,13,2012,763,416,820
13,CLUJ,"GARAJE COMPANIA DE TRANSPORT PUBLIC CLUJ-NAPOCA S.A.",180,"MUNICIPIUL CLUJ-NAPOCA",54975,1,PART,PRCNCT,PRSD,PRSD_SV,"2025-05-18 21:45:49",1651,1258,1030,226,2,1252,6,1667,409,289,963
13,CLUJ,"ŞCOALA ”TRAIAN DARJAN”",181,"MUNICIPIUL CLUJ-NAPOCA",54975,1,PART,PRCNCT,PRSD,PRSD_SV,"2025-05-18 22:16:59",1630,1120,957,161,2,1107,13,1792,672,334,773
13,CLUJ,"ŞCOALA ”TRAIAN DARJAN”",182,"MUNICIPIUL CLUJ-NAPOCA",54975,1,PART,PRCNCT,PRSD,PRSD_SV,"2025-05-18 22:12:21",1919,1372,1181,178,13,1360,12,1910,538,394,966
13,CLUJ,"ŞCOALA ”TRAIAN DARJAN”",183,"MUNICIPIUL CLUJ-NAPOCA",54975,1,PART,PRCNCT,PRSD,PRSD_SV,"2025-05-18 22:14:33",1824,1203,1064,137,2,1192,11,1807,604,377,815
13,CLUJ,"ŞCOALA ”TRAIAN DARJAN”",184,"MUNICIPIUL CLUJ-NAPOCA",54975,1,PART,PRCNCT,PRSD,PRSD_SV,"2025-05-18 21:51:29",1749,1074,977,74,23,1062,12,1903,829,309,753
13,CLUJ,"COLEGIUL TEHNIC ”VICTOR UNGUREANU”",185,"MUNICIPIUL CÂMPIA TURZII",55357,1,PART,PRCNCT,PRSD,PRSD_SV,"2025-05-18 21:51:39",1249,497,445,51,1,489,8,1373,876,306,183
13,CLUJ,"COLEGIUL TEHNIC ”VICTOR UNGUREANU”",186,"MUNICIPIUL CÂMPIA TURZII",55357,1,PART,PRCNCT,PRSD,PRSD_SV,"2025-05-18 21:30:12",1073,533,501,32,0,530,3,1183,650,196,334
13,CLUJ,"COLEGIUL TEHNIC ”VICTOR UNGUREANU”",187,"MUNICIPIUL CÂMPIA TURZII",55357,1,PART,PRCNCT,PRSD,PRSD_SV,"2025-05-18 21:51:45",1274,561,528,33,0,557,4,1400,839,344,213
13,CLUJ,"LICEUL TEORETIC ”PAVEL DAN”",188,"MUNICIPIUL CÂMPIA TURZII",55357,1,PART,PRCNCT,PRSD,PRSD_SV,"2025-05-18 21:38:52",836,438,394,43,1,427,11,919,481,180,247
13,CLUJ,"LICEUL TEORETIC ”PAVEL DAN”",189,"MUNICIPIUL CÂMPIA TURZII",55357,1,PART,PRCNCT,PRSD,PRSD_SV,"2025-05-18 21:44:51",1065,523,476,45,2,513,10,1171,648,236,277
13,CLUJ,"LICEUL TEORETIC ”PAVEL DAN”",190,"MUNICIPIUL CÂMPIA TURZII",55357,1,PART,PRCNCT,PRSD,PRSD_SV,"2025-05-18 21:36:46",1019,524,459,63,2,516,8,1121,597,245,271
13,CLUJ,"LICEUL TEORETIC ”PAVEL DAN”",191,"MUNICIPIUL CÂMPIA TURZII",55357,1,PART,PRCNCT,PRSD,PRSD_SV,"2025-05-18 22:00:42",1220,599,550,46,3,595,4,1342,743,262,333
13,CLUJ,"LICEUL TEORETIC ”PAVEL DAN”",192,"MUNICIPIUL CÂMPIA TURZII",55357,1,PART,PRCNCT,PRSD,PRSD_SV,"2025-05-18 21:58:02",1018,582,476,104,2,573,9,1119,537,236,337
13,CLUJ,"LICEUL TEORETIC ”PAVEL DAN”",193,"MUNICIPIUL CÂMPIA TURZII",55357,1,PART,PRCNCT,PRSD,PRSD_SV,"2025-05-18 21:55:23",1152,614,542,72,0,604,10,1267,653,205,399
13,CLUJ,"ȘCOALA GIMNAZIALĂ ”AVRAM IANCU”",194,"MUNICIPIUL CÂMPIA TURZII",55357,1,PART,PRCNCT,PRSD,PRSD_SV,"2025-05-18 22:11:48",1140,601,543,58,0,593,8,1253,652,194,399
13,CLUJ,"ȘCOALA GIMNAZIALĂ ”AVRAM IANCU”",195,"MUNICIPIUL CÂMPIA TURZII",55357,1,PART,PRCNCT,PRSD,PRSD_SV,"2025-05-18 22:47:12",1155,669,585,69,15,661,8,1270,601,266,395
13,CLUJ,"ȘCOALA GIMNAZIALĂ ”AVRAM IANCU”",196,"MUNICIPIUL CÂMPIA TURZII",55357,1,PART,PRCNCT,PRSD,PRSD_SV,"2025-05-18 22:07:08",1131,599,563,34,2,589,10,1243,644,215,374
13,CLUJ,"SC GIMNAZIALA MIHAI VITEAZU-SALA DE SPORT",197,"MUNICIPIUL CÂMPIA TURZII",55357,2,PART,PRCNCT,PRSD,PRSD_SV,"2025-05-19 02:11:05",1174,651,608,43,0,647,4,1293,642,214,433
13,CLUJ,"SC.GIMNAZIALA MIHAI VITEAZU-SALA DE SPORT",198,"MUNICIPIUL CÂMPIA TURZII",55357,1,PART,PRCNCT,PRSD,PRSD_SV,"2025-05-18 21:53:24",1222,635,571,64,0,629,6,1344,709,290,339
13,CLUJ,"SC. GIMNAZIALA MIHAI VITEAZU-SALA DE SPORT",199,"MUNICIPIUL CÂMPIA TURZII",55357,1,PART,PRCNCT,PRSD,PRSD_SV,"2025-05-18 21:42:45",1396,753,691,61,1,751,2,1535,782,368,383
13,CLUJ,"ȘCOALA GIMNAZIALĂ ”MIHAI VITEAZU”",200,"MUNICIPIUL CÂMPIA TURZII",55357,1,PART,PRCNCT,PRSD,PRSD_SV,"2025-05-18 21:43:35",991,520,466,34,20,505,15,1090,570,190,315
13,CLUJ,"ȘCOALA GIMNAZIALĂ ”MIHAI VITEAZU”",201,"MUNICIPIUL CÂMPIA TURZII",55357,1,PART,PRCNCT,PRSD,PRSD_SV,"2025-05-18 22:09:16",1396,663,610,53,0,656,7,1535,872,378,278
13,CLUJ,"ȘCOALA GIMNAZIALĂ ”MIHAI VITEAZU”",202,"MUNICIPIUL CÂMPIA TURZII",55357,1,PART,PRCNCT,PRSD,PRSD_SV,"2025-05-18 21:43:07",1306,623,595,28,0,613,10,1436,813,285,328
13,CLUJ,"ȘCOALA GIMNAZIALĂ ”MIHAI VITEAZU”",203,"MUNICIPIUL CÂMPIA TURZII",55357,1,PART,PRCNCT,PRSD,PRSD_SV,"2025-05-18 21:55:20",1078,476,445,31,0,470,6,1185,709,254,216
13,CLUJ,"CASA CĂSPRIAC",204,"MUNICIPIUL DEJ",55008,1,PART,PRCNCT,PRSD,PRSD_SV,"2025-05-18 22:00:20",1298,686,615,70,1,678,8,1427,741,363,315
13,CLUJ,"SCOALA GENERALA NR.1 DEJ",205,"MUNICIPIUL DEJ",55008,1,PART,PRCNCT,PRSD,PRSD_SV,"2025-05-18 21:40:19",1181,789,625,85,79,786,3,1300,511,285,501
13,CLUJ,"SCOALA MIHAI EMINESCU DEJ",206,"MUNICIPIUL DEJ",55008,1,PART,PRCNCT,PRSD,PRSD_SV,"2025-05-18 22:18:29",764,342,290,52,0,338,4,821,479,189,149
13,CLUJ,"SCOALA MIHAI EMINESCU DEJ",207,"MUNICIPIUL DEJ",55008,1,PART,PRCNCT,PRSD,PRSD_SV,"2025-05-18 21:33:51",905,474,443,29,2,473,1,995,521,193,280
13,CLUJ,"SCOALA MIHAI EMINESCU DEJ",208,"MUNICIPIUL DEJ",55008,1,PART,PRCNCT,PRSD,PRSD_SV,"2025-05-18 22:07:37",1547,977,835,142,0,967,10,1623,646,316,651
13,CLUJ,"LICEUL AL.P.ILARIAN DIN DEJ",209,"MUNICIPIUL DEJ",55008,1,PART,PRCNCT,PRSD,PRSD_SV,"2025-05-18 22:24:22",1460,774,724,48,2,767,7,1556,782,277,490
13,CLUJ,"LICEUL AL.P.ILARIAN DIN DEJ",210,"MUNICIPIUL DEJ",55008,1,PART,PRCNCT,PRSD,PRSD_SV,"2025-05-18 22:05:47",1413,792,707,82,3,780,12,1556,764,282,498
13,CLUJ,"OCOLUL SILVIC DEJ",211,"MUNICIPIUL DEJ",55008,1,PART,PRCNCT,PRSD,PRSD_SV,"2025-05-18 22:24:18",1321,830,708,48,74,816,14,1453,623,343,473
13,CLUJ,"CLUBUL COPIILOR DEJ",212,"MUNICIPIUL DEJ",55008,1,PART,PRCNCT,PRSD,PRSD_SV,"2025-05-18 23:01:21",1315,778,674,102,2,763,15,1447,669,267,496
13,CLUJ,"CAMINUL CULTURAL DEJ",213,"MUNICIPIUL DEJ",55008,1,PART,PRCNCT,PRSD,PRSD_SV,"2025-05-18 21:36:40",726,433,403,29,1,432,1,798,365,178,254
13,CLUJ,"SCOALA GENERALA AVRAM IANCU DEJ",214,"MUNICIPIUL DEJ",55008,1,PART,PRCNCT,PRSD,PRSD_SV,"2025-05-18 22:04:39",1290,639,599,40,0,632,7,1419,780,262,370
13,CLUJ,"SCOALA GENERALA AVRAM IANCU DEJ",215,"MUNICIPIUL DEJ",55008,1,PART,PRCNCT,PRSD,PRSD_SV,"2025-05-18 21:45:29",1491,776,746,29,1,766,10,1640,864,263,503
13,CLUJ,"SCOALA GENERALA NR. 5 DEJ",216,"MUNICIPIUL DEJ",55008,1,PART,PRCNCT,PRSD,PRSD_SV,"2025-05-18 22:01:04",1827,1008,949,59,0,1002,6,2008,1000,352,650
13,CLUJ,"SCOALA GENERALA NR.5 DEJ",217,"MUNICIPIUL DEJ",55008,1,PART,PRCNCT,PRSD,PRSD_SV,"2025-05-18 22:03:30",1415,743,688,55,0,736,7,1558,815,275,461
13,CLUJ,"SCOALA GENERALA NR.5 DEJ",218,"MUNICIPIUL DEJ",55008,1,PART,PRCNCT,PRSD,PRSD_SV,"2025-05-18 21:44:06",1326,744,701,43,0,736,8,1459,715,264,472
13,CLUJ,"GRADINITA PITICOT DEJ",219,"MUNICIPIUL DEJ",55008,1,PART,PRCNCT,PRSD,PRSD_SV,"2025-05-18 21:36:08",882,519,463,55,1,515,4,969,450,217,298
13,CLUJ,"GRADINITA PITICOT DEJ",220,"MUNICIPIUL DEJ",55008,1,PART,PRCNCT,PRSD,PRSD_SV,"2025-05-18 22:03:49",1259,649,585,64,0,645,4,1384,735,277,368
13,CLUJ,"GRADINITA PITICOT DEJ",221,"MUNICIPIUL DEJ",55008,1,PART,PRCNCT,PRSD,PRSD_SV,"2025-05-18 21:44:13",1260,660,632,27,1,653,7,1385,725,253,400
13,CLUJ,"GRADINITA PARADISUL PITICILOR DEJ",222,"MUNICIPIUL DEJ",55008,1,PART,PRCNCT,PRSD,PRSD_SV,"2025-05-18 21:37:25",1202,682,603,77,2,677,5,1321,639,254,423
13,CLUJ,"SCOALA GENERALA AVRAM IANCU DEJ - CORP B",223,"MUNICIPIUL DEJ",55008,1,PART,PRCNCT,PRSD,PRSD_SV,"2025-05-18 21:37:42",1265,592,547,45,0,585,7,1392,800,273,312
13,CLUJ,"SCOALA GENERALA AVRAM IANCU DEJ - CORP B",224,"MUNICIPIUL DEJ",55008,1,PART,PRCNCT,PRSD,PRSD_SV,"2025-05-18 21:52:46",1282,680,604,74,2,673,7,1409,729,282,391
13,CLUJ,"SCOALA GENERALA OCNA DEJ",225,"MUNICIPIUL DEJ",55008,1,PART,PRCNCT,PRSD,PRSD_SV,"2025-05-18 21:48:26",984,553,523,30,0,547,6,1081,528,279,268
13,CLUJ,"SCOALA GENERALA OCNA DEJ",226,"MUNICIPIUL DEJ",55008,1,PART,PRCNCT,PRSD,PRSD_SV,"2025-05-18 21:40:57",1127,581,558,23,0,576,5,1239,658,324,252
13,CLUJ,"GRADINITA DE COPII LUMEA PITICILOR",227,"MUNICIPIUL DEJ",55008,1,PART,PRCNCT,PRSD,PRSD_SV,"2025-05-18 21:51:50",1444,751,692,57,2,743,8,1587,836,256,487
13,CLUJ,"PAROHIA GRECO-CATOLICĂ PINTIC",228,"MUNICIPIUL DEJ",55008,1,PART,PRCNCT,PRSD,PRSD_SV,"2025-05-18 21:30:56",155,58,42,16,0,58,0,170,112,26,32
13,CLUJ,"CAMINUL CULTURAL SOMCUTU MIC",229,"MUNICIPIUL DEJ",55008,1,PART,PRCNCT,PRSD,PRSD_SV,"2025-05-18 21:49:54",454,249,211,37,1,248,1,498,249,151,97
13,CLUJ,"LICEUL TEORETIC PETRU MAIOR GHERLA",230,"MUNICIPIUL GHERLA",55384,1,PART,PRCNCT,PRSD,PRSD_SV,"2025-05-18 22:04:12",1516,846,748,96,2,841,5,1667,821,335,506
13,CLUJ,"LICEUL TEORETIC PETRU MAIOR GHERLA",231,"MUNICIPIUL GHERLA",55384,1,PART,PRCNCT,PRSD,PRSD_SV,"2025-05-18 22:35:27",1646,1034,928,104,2,1025,9,1811,777,359,666
13,CLUJ,"LICEUL TEORETIC PETRU MAIOR GHERLA",232,"MUNICIPIUL GHERLA",55384,1,PART,PRCNCT,PRSD,PRSD_SV,"2025-05-18 22:14:18",1062,702,560,41,101,689,13,1167,465,294,395
13,CLUJ,"LICEUL TEORETIC PETRU MAIOR GHERLA",233,"MUNICIPIUL GHERLA",55384,2,PART,PRCNCT,PRSD,PRSD_SV,"2025-05-19 02:29:42",1229,615,558,56,1,611,4,1351,736,251,360
13,CLUJ,"LICEUL TEORETIC PETRU MAIOR GHERLA",234,"MUNICIPIUL GHERLA",55384,1,PART,PRCNCT,PRSD,PRSD_SV,"2025-05-18 22:13:25",1107,729,563,72,94,724,5,1218,489,252,472
13,CLUJ,"LICEUL TEORETIC ANA IPATESCU",235,"MUNICIPIUL GHERLA",55384,1,PART,PRCNCT,PRSD,PRSD_SV,"2025-05-18 22:04:34",1348,798,735,58,5,795,3,1483,685,249,546
13,CLUJ,"ŞCOALA GIMNAZIALĂ NR.1",236,"MUNICIPIUL GHERLA",55384,1,PART,PRCNCT,PRSD,PRSD_SV,"2025-05-18 22:18:16",1824,1007,946,58,3,1001,6,1993,986,308,693
13,CLUJ,"ŞCOALA GIMNAZIALĂ NR.1",237,"MUNICIPIUL GHERLA",55384,1,PART,PRCNCT,PRSD,PRSD_SV,"2025-05-18 22:29:45",795,545,369,57,119,540,5,874,329,236,304
13,CLUJ,"LICEUL TEORETIC ANA IPĂTESCU",238,"MUNICIPIUL GHERLA",55384,1,PART,PRCNCT,PRSD,PRSD_SV,"2025-05-18 22:19:54",1543,936,824,93,19,924,12,1616,680,311,613
13,CLUJ,"LICEUL TEORETIC ANA IPĂTESCU",239,"MUNICIPIUL GHERLA",55384,1,PART,PRCNCT,PRSD,PRSD_SV,"2025-05-18 22:15:21",1354,793,734,59,0,778,15,1488,695,278,500
13,CLUJ,"LICEUL TEORETIC ANA IPĂTESCU",240,"MUNICIPIUL GHERLA",55384,1,PART,PRCNCT,PRSD,PRSD_SV,"2025-05-18 21:59:57",1269,777,691,86,0,773,4,1395,618,261,512
13,CLUJ,"LICEUL TEORETIC ANA IPĂTESCU",241,"MUNICIPIUL GHERLA",55384,1,PART,PRCNCT,PRSD,PRSD_SV,"2025-05-18 22:32:10",1324,692,643,48,1,685,7,1457,765,232,453
13,CLUJ,"CLUBUL COPIILOR GHERLA",242,"MUNICIPIUL GHERLA",55384,1,PART,PRCNCT,PRSD,PRSD_SV,"2025-05-18 22:16:14",1419,789,710,79,0,781,8,1400,611,312,469
13,CLUJ,"CĂMIN CULTURAL BĂIȚA",243,"MUNICIPIUL GHERLA",55384,1,PART,PRCNCT,PRSD,PRSD_SV,"2025-05-18 21:37:42",388,326,206,18,102,323,3,426,100,177,146
13,CLUJ,"ŞCOALA CLS. I - IV HĂŞDATE",244,"MUNICIPIUL GHERLA",55384,1,PART,PRCNCT,PRSD,PRSD_SV,"2025-05-18 21:29:08",265,272,130,28,114,271,1,291,19,182,89
13,CLUJ,"CENTRU COMUNITAR INTEGRAT",245,"MUNICIPIUL GHERLA",55384,1,PART,PRCNCT,PRSD,PRSD_SV,"2025-05-18 21:45:22",137,198,51,17,130,194,4,280,82,151,43
13,CLUJ,"LICEUL TEORETIC ”JOSIKA MIKLOS”",246,"MUNICIPIUL TURDA",55259,1,PART,PRCNCT,PRSD,PRSD_SV,"2025-05-18 21:52:41",991,494,384,110,0,491,3,1089,595,169,322
13,CLUJ,"LICEUL TEORETIC ”JOSIKA MIKLOS”",247,"MUNICIPIUL TURDA",55259,1,PART,PRCNCT,PRSD,PRSD_SV,"2025-05-18 21:38:50",1101,632,595,37,0,622,10,1213,581,185,437
13,CLUJ,"ȘCOALA GIMNAZIALĂ ”TEODOR MURĂŞANU”",248,"MUNICIPIUL TURDA",55259,1,PART,PRCNCT,PRSD,PRSD_SV,"2025-05-18 22:18:41",1071,603,529,71,3,594,9,1177,574,200,394
13,CLUJ,"ȘCOALA GIMNAZIALĂ ”TEODOR MURĂŞANU”",249,"MUNICIPIUL TURDA",55259,1,PART,PRCNCT,PRSD,PRSD_SV,"2025-05-18 21:50:58",1425,816,719,97,0,813,3,1568,752,299,514
13,CLUJ,"ȘCOALA GIMNAZIALĂ ”TEODOR MURĂŞANU”",250,"MUNICIPIUL TURDA",55259,1,PART,PRCNCT,PRSD,PRSD_SV,"2025-05-18 21:38:56",1134,722,583,137,2,720,2,1250,528,243,477
13,CLUJ,"ȘCOALA GIMNAZIALĂ ”TEODOR MURĂŞANU”",251,"MUNICIPIUL TURDA",55259,1,PART,PRCNCT,PRSD,PRSD_SV,"2025-05-18 21:37:52",1076,616,533,81,2,611,5,1183,567,236,375
13,CLUJ,"COLEGIUL TEHNIC ”DR.IOAN RAŢIU”",252,"MUNICIPIUL TURDA",55259,1,PART,PRCNCT,PRSD,PRSD_SV,"2025-05-18 22:12:40",1326,671,633,38,0,665,6,1448,777,305,360
13,CLUJ,"COLEGIUL TEHNIC ”DR.IOAN RAŢIU”",253,"MUNICIPIUL TURDA",55259,1,PART,PRCNCT,PRSD,PRSD_SV,"2025-05-18 21:43:39",900,473,423,49,1,472,1,989,516,355,117
13,CLUJ,"COLEGIUL TEHNIC ”DR.IOAN RAŢIU”",254,"MUNICIPIUL TURDA",55259,1,PART,PRCNCT,PRSD,PRSD_SV,"2025-05-18 21:37:05",1058,473,432,41,0,470,3,1166,693,311,159
13,CLUJ,"COLEGIUL TEHNIC",255,"MUNICIPIUL TURDA",55259,1,PART,PRCNCT,PRSD,PRSD_SV,"2025-05-18 21:48:18",1129,681,596,85,0,676,5,1242,561,238,438
13,CLUJ,"COLEGIUL TEHNIC",256,"MUNICIPIUL TURDA",55259,1,PART,PRCNCT,PRSD,PRSD_SV,"2025-05-18 21:46:19",1123,705,590,43,72,695,10,1234,529,284,411
13,CLUJ,"COLEGIUL NAŢIONAL ”MIHAI VITEAZU”",257,"MUNICIPIUL TURDA",55259,1,PART,PRCNCT,PRSD,PRSD_SV,"2025-05-18 22:06:37",1034,635,513,118,4,626,9,1136,501,209,417
13,CLUJ,"COLEGIUL ”EMIL NEGRUŢIU”",258,"MUNICIPIUL TURDA",55259,1,PART,PRCNCT,PRSD,PRSD_SV,"2025-05-18 21:56:43",1153,697,644,53,0,691,6,1267,570,308,383
13,CLUJ,"ŞCOALA GIMNAZIALĂ ”ANDREI ŞAGUNA”",259,"MUNICIPIUL TURDA",55259,1,PART,PRCNCT,PRSD,PRSD_SV,"2025-05-18 22:03:08",1224,648,573,74,1,644,4,1345,697,304,340
13,CLUJ,"ŞCOALA GIMNAZIALĂ ”ANDREI ŞAGUNA”",260,"MUNICIPIUL TURDA",55259,1,PART,PRCNCT,PRSD,PRSD_SV,"2025-05-18 22:29:21",941,538,464,74,0,529,9,1035,497,216,313
13,CLUJ,"ŞCOALA GIMNAZIALĂ ”ANDREI ŞAGUNA”",261,"MUNICIPIUL TURDA",55259,1,PART,PRCNCT,PRSD,PRSD_SV,"2025-05-18 22:08:17",1013,542,501,41,0,529,13,1114,572,216,313
13,CLUJ,"ŞCOALA GIMNAZIALĂ ”AVRAM IANCU”",262,"MUNICIPIUL TURDA",55259,1,PART,PRCNCT,PRSD,PRSD_SV,"2025-05-18 21:27:01",946,518,466,52,0,517,1,1041,523,255,262
13,CLUJ,"ŞCOALA GIMNAZIALĂ ”AVRAM IANCU”",263,"MUNICIPIUL TURDA",55259,1,PART,PRCNCT,PRSD,PRSD_SV,"2025-05-18 21:25:48",1059,482,437,45,0,477,5,1164,682,244,233
13,CLUJ,"ŞCOALA GIMNAZIALĂ ”AVRAM IANCU”",264,"MUNICIPIUL TURDA",55259,1,PART,PRCNCT,PRSD,PRSD_SV,"2025-05-18 21:34:16",1003,523,493,30,0,518,5,1102,579,164,354
13,CLUJ,"ŞCOALA GIMNAZIALĂ ”AVRAM IANCU”",265,"MUNICIPIUL TURDA",55259,1,PART,PRCNCT,PRSD,PRSD_SV,"2025-05-18 21:46:29",1194,556,538,18,0,551,5,1322,766,276,275
13,CLUJ,"ŞCOALA GIMNAZIALĂ ”ION OPRIŞ”",266,"MUNICIPIUL TURDA",55259,1,PART,PRCNCT,PRSD,PRSD_SV,"2025-05-18 21:51:46",1133,649,597,52,0,643,6,1244,595,231,412
13,CLUJ,"ŞCOALA GIMNAZIALĂ ”ION OPRIŞ”",267,"MUNICIPIUL TURDA",55259,2,PART,PRCNCT,PRSD,PRSD_SV,"2025-05-19 01:52:40",943,546,503,43,0,543,3,1036,490,198,345
13,CLUJ,"ŞCOALA GIMNAZIALĂ ”ION OPRIŞ”",268,"MUNICIPIUL TURDA",55259,1,PART,PRCNCT,PRSD,PRSD_SV,"2025-05-18 21:50:59",1238,731,641,29,61,721,10,1367,636,287,434
13,CLUJ,"LICEUL TEORETIC ”LIVIU REBREANU”",269,"MUNICIPIUL TURDA",55259,1,PART,PRCNCT,PRSD,PRSD_SV,"2025-05-18 21:44:08",1287,742,646,94,2,734,8,1417,675,287,447
13,CLUJ,"LICEUL TEORETIC ”LIVIU REBREANU”",270,"MUNICIPIUL TURDA",55259,1,PART,PRCNCT,PRSD,PRSD_SV,"2025-05-18 21:28:22",1313,611,554,56,1,608,3,1443,832,327,281
13,CLUJ,"LICEUL TEORETIC ”LIVIU REBREANU”",271,"MUNICIPIUL TURDA",55259,1,PART,PRCNCT,PRSD,PRSD_SV,"2025-05-18 21:51:20",1310,645,618,27,0,638,7,1440,795,270,368
13,CLUJ,"LICEUL TEORETIC ”LIVIU REBREANU”",272,"MUNICIPIUL TURDA",55259,1,PART,PRCNCT,PRSD,PRSD_SV,"2025-05-18 21:46:29",1181,638,620,18,0,635,3,1299,661,240,395
13,CLUJ,"LICEUL TEORETIC ”LIVIU REBREANU”",273,"MUNICIPIUL TURDA",55259,1,PART,PRCNCT,PRSD,PRSD_SV,"2025-05-18 21:46:50",1407,718,704,14,0,706,12,1549,831,281,425
13,CLUJ,"LICEUL TEORETIC ”LIVIU REBREANU”",274,"MUNICIPIUL TURDA",55259,1,PART,PRCNCT,PRSD,PRSD_SV,"2025-05-18 21:48:15",991,422,398,24,0,415,7,1089,667,210,205
13,CLUJ,"ŞCOALA GIMNAZIALĂ ”HOREA CLOŞCA ŞI CRIŞAN”",275,"MUNICIPIUL TURDA",55259,1,PART,PRCNCT,PRSD,PRSD_SV,"2025-05-18 21:39:54",1329,689,642,47,0,678,11,1461,772,287,391
13,CLUJ,"ŞCOALA GIMNAZIALĂ ”HOREA CLOŞCA ŞI CRIŞAN”",276,"MUNICIPIUL TURDA",55259,1,PART,PRCNCT,PRSD,PRSD_SV,"2025-05-18 21:36:41",1264,684,585,99,0,678,6,1389,705,372,306
13,CLUJ,"ŞCOALA GIMNAZIALĂ ”HOREA CLOŞCA ŞI CRIŞAN”",277,"MUNICIPIUL TURDA",55259,1,PART,PRCNCT,PRSD,PRSD_SV,"2025-05-18 22:08:32",1342,726,683,42,1,718,8,1476,750,373,345
13,CLUJ,"ŞCOALA GIMNAZIALĂ ”HOREA CLOŞCA ŞI CRIŞAN”",278,"MUNICIPIUL TURDA",55259,1,PART,PRCNCT,PRSD,PRSD_SV,"2025-05-18 21:32:51",1250,601,580,21,0,597,4,1374,773,291,306
13,CLUJ,"ŞCOALA GIMNAZIALĂ ”HOREA CLOŞCA ŞI CRIŞAN”",279,"MUNICIPIUL TURDA",55259,1,PART,PRCNCT,PRSD,PRSD_SV,"2025-05-18 21:32:47",1113,547,523,24,0,537,10,1224,677,243,294
13,CLUJ,"ŞCOALA GIMNAZIALĂ ”HOREA CLOŞCA ŞI CRIŞAN”",280,"MUNICIPIUL TURDA",55259,1,PART,PRCNCT,PRSD,PRSD_SV,"2025-05-18 21:28:48",1122,560,539,17,4,557,3,1234,674,256,301
13,CLUJ,"ŞCOALA GIMNAZIALĂ ”HOREA CLOŞCA ŞI CRIŞAN”",281,"MUNICIPIUL TURDA",55259,1,PART,PRCNCT,PRSD,PRSD_SV,"2025-05-18 21:22:11",1272,619,587,32,0,612,7,1400,781,285,327
13,CLUJ,"ŞCOALA PROFESIONALĂ POIANA",282,"MUNICIPIUL TURDA",55259,1,PART,PRCNCT,PRSD,PRSD_SV,"2025-05-18 21:46:07",1236,694,637,57,0,687,7,1359,665,266,421
13,CLUJ,"ŞCOALA PROFESIONALĂ POIANA",283,"MUNICIPIUL TURDA",55259,1,PART,PRCNCT,PRSD,PRSD_SV,"2025-05-18 21:38:51",1520,819,792,27,0,803,16,1671,852,499,304
13,CLUJ,"SCOALA NOUA CU 16 SALI DE CLASA",284,"ORAŞ HUEDIN",55446,1,PART,PRCNCT,PRSD,PRSD_SV,"2025-05-18 21:52:13",1007,536,473,62,1,523,13,1108,572,203,320
13,CLUJ,"LICEUL TEHNOLOGIC VLADEASA",285,"ORAŞ HUEDIN",55446,1,PART,PRCNCT,PRSD,PRSD_SV,"2025-05-18 22:07:17",1469,645,527,79,39,636,9,1615,970,195,441
13,CLUJ,"ȘCOALA GIMNAZIALĂ SPECIALĂ HUEDIN",286,"ORAŞ HUEDIN",55446,1,PART,PRCNCT,PRSD,PRSD_SV,"2025-05-18 22:34:10",1556,844,742,99,3,833,11,1712,868,335,498
13,CLUJ,"PRIMARIA ORAS HUEDIN",287,"ORAŞ HUEDIN",55446,1,PART,PRCNCT,PRSD,PRSD_SV,"2025-05-18 21:44:55",1373,679,544,134,1,667,12,1483,804,314,353
13,CLUJ,"LICEUL TEORETIC OCTAVIAN GOGA",288,"ORAŞ HUEDIN",55446,2,PART,PRCNCT,PRSD,PRSD_SV,"2025-05-19 01:19:22",1295,784,624,160,0,777,7,1424,640,302,475
13,CLUJ,"FOSTA CASĂ PAROHIALĂ",289,"ORAŞ HUEDIN",55446,1,PART,PRCNCT,PRSD,PRSD_SV,"2025-05-18 21:31:39",354,82,60,21,1,79,3,388,306,59,20
13,CLUJ,"CAMIN CULTURAL",290,"ORAŞ HUEDIN",55446,1,PART,PRCNCT,PRSD,PRSD_SV,"2025-05-18 21:27:13",248,150,112,38,0,150,0,272,122,24,126
13,CLUJ,"SCOALA GENERALA AGHIRESU",291,AGHIREŞU,55473,1,PART,PRCNCT,PRSD,PRSD_SV,"2025-05-18 21:38:09",1005,484,401,69,14,478,6,1103,619,236,242
13,CLUJ,"CĂMINUL CULTURAL AGHIREŞU FABRICI",292,AGHIREŞU,55473,1,PART,PRCNCT,PRSD,PRSD_SV,"2025-05-18 21:52:51",1081,541,474,66,1,537,4,1188,647,277,260
13,CLUJ,"SCOALA GENERALA AGHIRESU-FABRICI",293,AGHIREŞU,55473,1,PART,PRCNCT,PRSD,PRSD_SV,"2025-05-18 21:57:26",1395,717,647,68,2,711,6,1518,801,413,298
13,CLUJ,"CAMIN CULTURAL ARGHISU",294,AGHIREŞU,55473,1,PART,PRCNCT,PRSD,PRSD_SV,"2025-05-18 21:11:47",84,71,36,35,0,71,0,91,20,34,37
13,CLUJ,"CAMIN CULTURAL BAGARA",295,AGHIREŞU,55473,1,PART,PRCNCT,PRSD,PRSD_SV,"2025-05-18 21:40:14",314,204,149,55,0,204,0,344,140,55,149
13,CLUJ,"CAMIN CULTURAL DOROLTU",296,AGHIREŞU,55473,1,PART,PRCNCT,PRSD,PRSD_SV,"2025-05-18 21:16:08",73,74,52,22,0,73,1,79,5,16,57
13,CLUJ,"SCOALA GENERALA INUCU",297,AGHIREŞU,55473,1,PART,PRCNCT,PRSD,PRSD_SV,"2025-05-18 21:25:25",250,189,150,39,0,189,0,274,85,19,170
13,CLUJ,"CAMIN CULTURAL LEGHIA",298,AGHIREŞU,55473,1,PART,PRCNCT,PRSD,PRSD_SV,"2025-05-18 21:27:00",349,238,191,47,0,238,0,383,145,29,209
13,CLUJ,"IMOBIL CONSILIU NR. 7",299,AGHIREŞU,55473,1,PART,PRCNCT,PRSD,PRSD_SV,"2025-05-18 21:26:05",491,349,287,59,3,347,2,539,190,17,330
13,CLUJ,"SCOALA GENERALA TICU-COLONIE",300,AGHIREŞU,55473,1,PART,PRCNCT,PRSD,PRSD_SV,"2025-05-18 21:25:24",221,128,89,39,0,126,2,242,114,65,61
13,CLUJ,"CAMIN CULTURAL AITON",301,AITON,55598,1,PART,PRCNCT,PRSD,PRSD_SV,"2025-05-18 21:53:28",525,428,247,181,0,425,3,578,150,122,303
13,CLUJ,"CAMIN CULTURAL REDIU",302,AITON,55598,1,PART,PRCNCT,PRSD,PRSD_SV,"2025-05-18 21:54:25",357,311,173,138,0,308,3,392,81,121,187
13,CLUJ,"CAMIN CULTURAL ALUNIS",303,ALUNIŞ,55623,1,PART,PRCNCT,PRSD,PRSD_SV,"2025-05-18 21:41:56",426,274,196,78,0,272,2,468,194,158,114
13,CLUJ,"CAMIN CULTURAL CORNENI",304,ALUNIŞ,55623,1,PART,PRCNCT,PRSD,PRSD_SV,"2025-05-18 21:29:40",89,52,33,19,0,51,1,97,45,30,21
13,CLUJ,"SEDIU ADMINISTRATIV GHIROLT",305,ALUNIŞ,55623,1,PART,PRCNCT,PRSD,PRSD_SV,"2025-05-18 21:21:45",304,162,106,54,2,160,2,333,171,97,63
13,CLUJ,"CAMIN CULTURAL VALE",306,ALUNIŞ,55623,1,PART,PRCNCT,PRSD,PRSD_SV,"2025-05-18 21:23:15",77,75,24,51,0,74,1,84,9,30,44
13,CLUJ,"SALA SPORT LICEU TEHNOLOGIC ”ŞTEFAN PASCU”",307,APAHIDA,55687,1,PART,PRCNCT,PRSD,PRSD_SV,"2025-05-18 22:22:53",1859,1304,1038,266,0,1294,10,2045,741,599,695
13,CLUJ,"SALA SPORT LICEU TEHNOLOGIC ”ŞTEFAN PASCU”",308,APAHIDA,55687,1,PART,PRCNCT,PRSD,PRSD_SV,"2025-05-18 22:58:50",2050,1369,1149,218,2,1358,11,2254,885,572,786
13,CLUJ,"SALA SPORT LICEU TEHNOLOGIC ”ŞTEFAN PASCU”",309,APAHIDA,55687,1,PART,PRCNCT,PRSD,PRSD_SV,"2025-05-18 22:27:04",1834,1249,988,232,29,1231,18,2016,767,491,740
13,CLUJ,"SALA SPORT LICEU TEHNOLOGIC ”ŞTEFAN PASCU”",310,APAHIDA,55687,1,PART,PRCNCT,PRSD,PRSD_SV,"2025-05-18 22:35:14",1980,1302,1058,244,0,1292,10,2179,877,553,739
13,CLUJ,"SEDIU SECTOR PISCICOLA",311,APAHIDA,55687,1,PART,PRCNCT,PRSD,PRSD_SV,"2025-05-18 21:56:44",261,360,166,194,0,357,3,386,26,105,252
13,CLUJ,"CĂMIN CULTURAL CORPADEA",312,APAHIDA,55687,1,PART,PRCNCT,PRSD,PRSD_SV,"2025-05-18 21:33:31",355,263,165,98,0,258,5,390,127,137,121
13,CLUJ,"CĂMINUL CULTURAL DEZMIR",313,APAHIDA,55687,1,PART,PRCNCT,PRSD,PRSD_SV,"2025-05-18 22:36:33",1507,1374,1003,371,0,1365,9,1658,284,318,1047
13,CLUJ,"CĂMINUL CULTURAL DEZMIR",314,APAHIDA,55687,1,PART,PRCNCT,PRSD,PRSD_SV,"2025-05-18 22:39:29",1282,1170,797,372,1,1150,20,1410,240,254,896
13,CLUJ,"SEDIU PRIMARIE PATA",315,APAHIDA,55687,1,PART,PRCNCT,PRSD,PRSD_SV,"2025-05-18 21:48:48",534,493,328,165,0,489,4,586,93,177,312
13,CLUJ,"CĂMINUL CULTURAL SÂNNICOARĂ",316,APAHIDA,55687,1,PART,PRCNCT,PRSD,PRSD_SV,"2025-05-18 22:38:48",1126,1024,735,288,1,1021,3,1239,215,341,680
13,CLUJ,"CĂMIN CULTURAL SÎNNICOARĂ",317,APAHIDA,55687,1,PART,PRCNCT,PRSD,PRSD_SV,"2025-05-18 22:31:29",1241,1004,795,209,0,991,13,1364,360,357,634
13,CLUJ,"GRĂDINIŢA AŞCHILEU MARE",318,AŞCHILEU,55776,1,PART,PRCNCT,PRSD,PRSD_SV,"2025-05-18 21:55:16",406,258,162,96,0,253,5,446,188,115,138
13,CLUJ,"GRĂDINIŢA AŞCHILEU MIC",319,AŞCHILEU,55776,1,PART,PRCNCT,PRSD,PRSD_SV,"2025-05-18 21:38:29",226,134,88,46,0,134,0,248,114,66,68
13,CLUJ,"GRĂDINIŢA CRISTOREL",320,AŞCHILEU,55776,1,PART,PRCNCT,PRSD,PRSD_SV,"2025-05-18 21:36:59",297,154,113,41,0,152,2,326,172,89,63
13,CLUJ,"ŞCOALA PRIMARĂ FODORA",321,AŞCHILEU,55776,1,PART,PRCNCT,PRSD,PRSD_SV,"2025-05-18 21:33:13",193,148,87,61,0,146,2,211,63,59,87
13,CLUJ,"GRĂDINIȚĂ CU PROGRAM PRELUNGIT (STRUCTURĂ BLOCURI)",322,BACIU,55838,1,PART,PRCNCT,PRSD,PRSD_SV,"2025-05-18 22:15:58",1684,1368,977,390,1,1356,12,1801,433,269,1087
13,CLUJ,"GRĂDINIȚĂ CU PROGRAM PRELUNGIT (STRUCTURĂ BLOCURI)",323,BACIU,55838,1,PART,PRCNCT,PRSD,PRSD_SV,"2025-05-18 22:11:23",794,1179,514,665,0,1173,6,1272,93,187,986
13,CLUJ,"CASA DE CULTURĂ BACIU",324,BACIU,55838,1,PART,PRCNCT,PRSD,PRSD_SV,"2025-05-18 22:02:17",1522,1179,932,247,0,1166,13,1673,494,262,904
13,CLUJ,"CASA DE CULTURĂ BACIU",325,BACIU,55838,1,PART,PRCNCT,PRSD,PRSD_SV,"2025-05-18 21:44:13",1677,1210,962,247,1,1203,7,1844,634,313,890
13,CLUJ,"CASA DE CULTURĂ BACIU",326,BACIU,55838,1,PART,PRCNCT,PRSD,PRSD_SV,"2025-05-18 21:26:35",1941,1134,969,162,3,1126,8,1824,690,285,841
13,CLUJ,"ȘCOALA CORUȘU",327,BACIU,55838,1,PART,PRCNCT,PRSD,PRSD_SV,"2025-05-18 21:42:58",624,615,412,201,2,609,6,785,170,195,414
13,CLUJ,"ȘCOALA MERA",328,BACIU,55838,1,PART,PRCNCT,PRSD,PRSD_SV,"2025-05-18 21:42:19",1340,837,709,127,1,829,8,1473,636,226,603
13,CLUJ,"ȘCOALA POPEȘTI",329,BACIU,55838,1,PART,PRCNCT,PRSD,PRSD_SV,"2025-05-18 21:44:38",904,819,568,248,3,806,13,993,174,176,630
13,CLUJ,"ȘCOALA SĂLIȘTEA NOUĂ",330,BACIU,55838,1,PART,PRCNCT,PRSD,PRSD_SV,"2025-05-18 21:23:13",162,191,93,98,0,190,1,227,36,73,117
13,CLUJ,"ȘCOALA SUCEAGU",331,BACIU,55838,1,PART,PRCNCT,PRSD,PRSD_SV,"2025-05-18 21:47:23",1247,773,626,120,27,767,6,1371,598,284,483
13,CLUJ,"ŞCOALA GENERALĂ BĂIŞOARA",332,BĂIŞOARA,55918,1,PART,PRCNCT,PRSD,PRSD_SV,"2025-05-18 21:39:46",797,470,377,93,0,464,6,876,406,249,215
13,CLUJ,"GOSPODĂRIA DOMNULUI BUCUR VASILE",333,BĂIŞOARA,55918,1,PART,PRCNCT,PRSD,PRSD_SV,"2025-05-18 21:17:32",129,105,44,61,0,103,2,141,36,50,53
13,CLUJ,"ŞCOALA PRIMARĂ MUNTELE BĂIŞORII",334,BĂIŞOARA,55918,1,PART,PRCNCT,PRSD,PRSD_SV,"2025-05-18 21:25:50",291,201,134,66,1,198,3,319,118,98,100
13,CLUJ,"GOSPODĂRIA DOMNULUI CIREBEA VALER",335,BĂIŞOARA,55918,1,PART,PRCNCT,PRSD,PRSD_SV,"2025-05-18 21:16:16",70,55,35,20,0,53,2,76,21,31,22
13,CLUJ,"GOSPODĂRIA DOAMNEI PINTEA CLAUDIA CRISTINA",336,BĂIŞOARA,55918,1,PART,PRCNCT,PRSD,PRSD_SV,"2025-05-18 21:13:57",53,40,25,15,0,40,0,57,17,25,15
13,CLUJ,"ŞCOALA PRIMARĂ SĂCEL",337,BĂIŞOARA,55918,1,PART,PRCNCT,PRSD,PRSD_SV,"2025-05-18 21:33:26",355,215,176,39,0,215,0,390,175,147,68
13,CLUJ,"PRIMĂRIA BELIŞ",338,BELIŞ,56014,1,PART,PRCNCT,PRSD,PRSD_SV,"2025-05-18 21:36:32",488,473,200,272,1,471,2,536,63,218,253
13,CLUJ,"CĂMIN CULTURAL BĂLCEŞTI",339,BELIŞ,56014,1,PART,PRCNCT,PRSD,PRSD_SV,"2025-05-18 21:19:42",132,107,46,61,0,107,0,144,37,37,70
13,CLUJ,"ŞCOALA PRIMARĂ DEALU BOTII",340,BELIŞ,56014,1,PART,PRCNCT,PRSD,PRSD_SV,"2025-05-18 21:14:24",53,39,17,22,0,38,1,57,18,30,8
13,CLUJ,"MAGAZINUL SǍTESC",341,BELIŞ,56014,1,PART,PRCNCT,PRSD,PRSD_SV,"2025-05-18 21:08:50",102,61,41,20,0,61,0,111,50,42,19
13,CLUJ,"ŞCOALA PRIMARǍ POIANA HOREA",342,BELIŞ,56014,1,PART,PRCNCT,PRSD,PRSD_SV,"2025-05-18 21:24:27",250,137,110,27,0,135,2,274,137,84,51
13,CLUJ,"ŞCOALA PRIMARĂ SMIDA",343,BELIŞ,56014,1,PART,PRCNCT,PRSD,PRSD_SV,"2025-05-18 21:13:16",39,60,18,42,0,58,2,62,2,25,33
13,CLUJ,"SCOALA GENERALA BOBÎLNA",344,BOBÂLNA,56096,1,PART,PRCNCT,PRSD,PRSD_SV,"2025-05-18 21:37:41",281,213,128,85,0,210,3,309,96,94,116
13,CLUJ,"CAMIN CULTURAL BABDIU",345,BOBÂLNA,56096,1,PART,PRCNCT,PRSD,PRSD_SV,"2025-05-18 21:26:54",128,103,55,48,0,102,1,140,37,60,42
13,CLUJ,"SCOALA GENERALA MAIA",346,BOBÂLNA,56096,1,PART,PRCNCT,PRSD,PRSD_SV,"2025-05-18 21:36:37",184,133,89,44,0,133,0,201,68,66,67
13,CLUJ,"CASA PARTICULARA",347,BOBÂLNA,56096,1,PART,PRCNCT,PRSD,PRSD_SV,"2025-05-18 21:23:59",103,79,44,35,0,79,0,112,33,22,57
13,CLUJ,"CAMINUL CULTURAL PRUNI",348,BOBÂLNA,56096,1,PART,PRCNCT,PRSD,PRSD_SV,"2025-05-18 21:12:32",19,38,10,28,0,38,0,40,2,15,23
13,CLUJ,"SCOALA GENERALA RAZBUNENI",349,BOBÂLNA,56096,1,PART,PRCNCT,PRSD,PRSD_SV,"2025-05-18 21:25:10",177,126,87,39,0,126,0,194,68,62,64
13,CLUJ,"CAMINUL CULTURAL SUARĂŞ",350,BOBÂLNA,56096,1,PART,PRCNCT,PRSD,PRSD_SV,"2025-05-18 21:22:12",102,83,49,34,0,79,4,111,28,50,29
13,CLUJ,"SCOALA GENERALA VÎLCELELE",351,BOBÂLNA,56096,1,PART,PRCNCT,PRSD,PRSD_SV,"2025-05-18 21:14:41",77,70,26,44,0,70,0,84,14,32,38
13,CLUJ,"CAMIN CULTURAL BONTIDA",352,BONŢIDA,56210,1,PART,PRCNCT,PRSD,PRSD_SV,"2025-05-18 22:07:39",1651,896,755,141,0,891,5,1790,894,544,347
13,CLUJ,"CLUBUL TINERETULUI",353,BONŢIDA,56210,1,PART,PRCNCT,PRSD,PRSD_SV,"2025-05-18 21:25:49",828,451,383,68,0,449,2,910,459,182,267
13,CLUJ,"CAMIN CULTURAL COASTA",354,BONŢIDA,56210,1,PART,PRCNCT,PRSD,PRSD_SV,"2025-05-18 21:25:28",77,81,29,52,0,81,0,134,53,22,59
13,CLUJ,"CĂMINUL CULTURAL RASCRUCI",355,BONŢIDA,56210,1,PART,PRCNCT,PRSD,PRSD_SV,"2025-05-18 21:27:32",1274,878,635,242,1,872,6,1310,432,416,456
13,CLUJ,"CAMINUL CULTURAL TAUSENI",356,BONŢIDA,56210,1,PART,PRCNCT,PRSD,PRSD_SV,"2025-05-18 21:15:48",32,61,10,51,0,61,0,64,3,21,40
13,CLUJ,"CAMIN CULTURAL MARE BORSA",357,BORŞA,56265,1,PART,PRCNCT,PRSD,PRSD_SV,"2025-05-18 21:52:31",845,645,381,236,28,638,7,929,284,315,323
13,CLUJ,"SCOALA GENERALA CIUMĂFAIA",358,BORŞA,56265,1,PART,PRCNCT,PRSD,PRSD_SV,"2025-05-18 21:16:51",112,101,56,45,0,101,0,122,21,40,61
13,CLUJ,"CAMINUL CULTURAL GIULA",359,BORŞA,56265,1,PART,PRCNCT,PRSD,PRSD_SV,"2025-05-18 21:29:08",108,144,55,89,0,142,2,168,24,63,79
13,CLUJ,"CAMINUL CULTURAL BUZA",360,BUZA,56327,1,PART,PRCNCT,PRSD,PRSD_SV,"2025-05-18 21:28:16",924,519,445,74,0,513,6,1015,496,194,319
13,CLUJ,"CAMINUL CULTURAL",361,CĂIANU,56354,1,PART,PRCNCT,PRSD,PRSD_SV,"2025-05-18 21:38:34",405,226,186,40,0,226,0,445,219,137,89
13,CLUJ,"CAMINUL CULTURAL BĂRĂI",362,CĂIANU,56354,1,PART,PRCNCT,PRSD,PRSD_SV,"2025-05-18 22:11:36",186,144,80,63,1,142,2,204,60,66,76
13,CLUJ,"ȘCOALĂ GIMNAZIALĂ CĂIANU",363,CĂIANU,56354,1,PART,PRCNCT,PRSD,PRSD_SV,"2025-05-18 21:43:28",159,150,82,68,0,148,2,174,24,66,82
13,CLUJ,"SCOALA GENERALĂ CĂIANU VAMĂ",364,CĂIANU,56354,1,PART,PRCNCT,PRSD,PRSD_SV,"2025-05-18 21:38:48",331,209,148,61,0,206,3,363,154,101,105
13,CLUJ,"SCOALA GIMNAZIALA VAIDA CĂMĂRAS",365,CĂIANU,56354,1,PART,PRCNCT,PRSD,PRSD_SV,"2025-05-18 21:40:45",683,347,285,62,0,347,0,750,403,47,300
13,CLUJ,"ȘCOALA PRIMARĂ VĂLENI",366,CĂIANU,56354,1,PART,PRCNCT,PRSD,PRSD_SV,"2025-05-18 21:26:42",143,105,68,37,0,103,2,156,51,52,51
13,CLUJ,"CAMINUL CULTURAL CALARASI",367,CĂLĂRAŞI,56425,1,PART,PRCNCT,PRSD,PRSD_SV,"2025-05-18 21:45:59",753,377,325,52,0,376,1,827,450,146,230
13,CLUJ,"CĂMINUL CULTURAL BOGATA",368,CĂLĂRAŞI,56425,1,PART,PRCNCT,PRSD,PRSD_SV,"2025-05-18 21:53:37",896,483,435,48,0,479,4,985,502,289,190
13,CLUJ,"CAMINUL CULTURAL CALARASI -GARA",369,CĂLĂRAŞI,56425,1,PART,PRCNCT,PRSD,PRSD_SV,"2025-05-18 21:21:27",289,163,142,21,0,161,2,318,155,71,90
13,CLUJ,"ŞCOALA DIN CĂLĂŢELE",370,CĂLĂŢELE,56461,1,PART,PRCNCT,PRSD,PRSD_SV,"2025-05-18 21:35:27",740,321,236,85,0,317,4,813,492,183,134
13,CLUJ,"CAMINUL CULTURAL CĂLĂŢELE PĂDURE",371,CĂLĂŢELE,56461,1,PART,PRCNCT,PRSD,PRSD_SV,"2025-05-18 21:23:20",218,122,84,38,0,122,0,239,117,50,72
13,CLUJ,"SCOALA CĂLATA",372,CĂLĂŢELE,56461,1,PART,PRCNCT,PRSD,PRSD_SV,"2025-05-18 21:52:35",347,221,162,59,0,220,1,381,160,108,112
13,CLUJ,"ŞCOALA DIN DEALU NEGRU",373,CĂLĂŢELE,56461,1,PART,PRCNCT,PRSD,PRSD_SV,"2025-05-18 21:36:40",330,261,147,114,0,258,3,362,101,162,96
13,CLUJ,"CĂMINUL CULTURAL FINCIU",374,CĂLĂŢELE,56461,1,PART,PRCNCT,PRSD,PRSD_SV,"2025-05-18 21:21:00",109,67,41,26,0,66,1,119,52,37,29
13,CLUJ,"CĂMINUL CULTURAL VĂLENI",375,CĂLĂŢELE,56461,1,PART,PRCNCT,PRSD,PRSD_SV,"2025-05-18 21:28:04",264,181,138,43,0,181,0,289,108,25,156
13,CLUJ,"CAMIN CULTURAL CAMARASU",376,CĂMĂRAŞU,56522,1,PART,PRCNCT,PRSD,PRSD_SV,"2025-05-18 21:51:56",1182,590,490,100,0,575,15,1299,709,340,235
13,CLUJ,"CAMIN CULTURAL NAOIU",377,CĂMĂRAŞU,56522,1,PART,PRCNCT,PRSD,PRSD_SV,"2025-05-18 21:17:45",312,167,112,55,0,165,2,342,175,94,71
13,CLUJ,"CAMIN CULTURAL SIMBOLENI",378,CĂMĂRAŞU,56522,1,PART,PRCNCT,PRSD,PRSD_SV,"2025-05-18 21:28:42",430,219,160,59,0,215,4,464,245,141,74
13,CLUJ,"CĂMINUL CULTURAL CĂPUŞU MARE",379,"CĂPUŞU MARE",56568,1,PART,PRCNCT,PRSD,PRSD_SV,"2025-05-18 22:43:32",667,463,370,93,0,460,3,733,270,100,360
13,CLUJ,"ȘCOALA PRIMARĂ AGÂRBICIU",380,"CĂPUŞU MARE",56568,1,PART,PRCNCT,PRSD,PRSD_SV,"2025-05-18 22:05:54",363,281,210,68,3,276,5,398,117,126,150
13,CLUJ,"CENTRUL DE INFORMARE TURISTICĂ",381,"CĂPUŞU MARE",56568,1,PART,PRCNCT,PRSD,PRSD_SV,"2025-05-18 22:10:48",593,380,268,112,0,375,5,651,271,121,254
13,CLUJ,"ŞCOLA CU CLASELE I-IV DÎNGĂUL MARE",382,"CĂPUŞU MARE",56568,1,PART,PRCNCT,PRSD,PRSD_SV,"2025-05-18 21:59:23",364,208,152,55,1,207,1,399,191,99,108
13,CLUJ,"FOSTUL SEDIU CAP",383,"CĂPUŞU MARE",56568,1,PART,PRCNCT,PRSD,PRSD_SV,"2025-05-18 21:32:55",297,192,145,47,0,192,0,326,134,61,131
13,CLUJ,"CĂMINUL CLULTURAL",384,"CĂPUŞU MARE",56568,1,PART,PRCNCT,PRSD,PRSD_SV,"2025-05-18 21:38:11",219,135,95,40,0,134,1,240,105,65,69
13,CLUJ,"CĂMINUL CULTURAL",385,CĂŞEIU,56666,1,PART,PRCNCT,PRSD,PRSD_SV,"2025-05-18 21:44:41",1221,712,620,90,2,709,3,1342,630,425,284
13,CLUJ,"ŞCOALA COPLEAN",386,CĂŞEIU,56666,1,PART,PRCNCT,PRSD,PRSD_SV,"2025-05-18 21:32:50",338,225,161,64,0,223,2,371,146,113,110
13,CLUJ,"ŞCOALA GARBĂUL DEJULUI",387,CĂŞEIU,56666,1,PART,PRCNCT,PRSD,PRSD_SV,"2025-05-18 21:42:21",167,89,59,30,0,89,0,183,94,56,33
13,CLUJ,"ŞCOALA GUGA",388,CĂŞEIU,56666,1,PART,PRCNCT,PRSD,PRSD_SV,"2025-05-18 21:20:24",246,116,93,23,0,115,1,270,154,66,49
13,CLUJ,"ŞCOALA GIMNAZIALĂ RUGĂŞEŞTI",389,CĂŞEIU,56666,1,PART,PRCNCT,PRSD,PRSD_SV,"2025-05-18 21:40:57",868,465,421,44,0,462,3,954,489,283,179
13,CLUJ,"ŞCOALA SĂLĂTRUC",390,CĂŞEIU,56666,1,PART,PRCNCT,PRSD,PRSD_SV,"2025-05-18 21:23:04",106,102,56,46,0,102,0,116,14,67,35
13,CLUJ,"ŞCOALA PRIMARĂ URIŞOR",391,CĂŞEIU,56666,1,PART,PRCNCT,PRSD,PRSD_SV,"2025-05-18 21:46:14",803,465,404,61,0,464,1,882,417,238,226
13,CLUJ,"CAMIN CULTURAL CATINA",392,CĂTINA,56773,1,PART,PRCNCT,PRSD,PRSD_SV,"2025-05-18 21:38:31",840,500,373,123,4,494,6,923,423,247,247
13,CLUJ,"CĂMINUL CULTURAL COPRU",393,CĂTINA,56773,1,PART,PRCNCT,PRSD,PRSD_SV,"2025-05-18 21:24:37",76,55,36,19,0,55,0,83,28,27,28
13,CLUJ,"CAMIN CULTURAL FELDIOARA",394,CĂTINA,56773,1,PART,PRCNCT,PRSD,PRSD_SV,"2025-05-18 21:30:04",358,186,149,36,1,185,1,393,207,92,93
13,CLUJ,"SCOALA GIMNAZIALA CÎŢCĂU",395,CÂŢCĂU,57314,1,PART,PRCNCT,PRSD,PRSD_SV,"2025-05-18 21:51:23",1190,856,659,147,50,837,19,1311,455,413,424
13,CLUJ,"ŞCOAL GEN. MUNCEL",396,CÂŢCĂU,57314,1,PART,PRCNCT,PRSD,PRSD_SV,"2025-05-18 21:23:46",163,106,68,25,13,106,0,178,72,53,53
13,CLUJ,"ŞCOALA GEN. SĂLIŞCA",397,CÂŢCĂU,57314,1,PART,PRCNCT,PRSD,PRSD_SV,"2025-05-18 21:31:28",464,385,288,71,26,380,5,509,124,147,233
13,CLUJ,"CAMIN CULTURAL CEANU MARE",398,"CEANU MARE",56844,1,PART,PRCNCT,PRSD,PRSD_SV,"2025-05-18 22:07:28",1069,544,425,119,0,544,0,1175,631,321,223
13,CLUJ,"GRADINITA BOIAN",399,"CEANU MARE",56844,2,PART,PRCNCT,PRSD,PRSD_SV,"2025-05-19 01:43:46",707,372,316,56,0,366,6,777,405,243,123
13,CLUJ,"CAMIN CULTURAL BOLDUT",400,"CEANU MARE",56844,1,PART,PRCNCT,PRSD,PRSD_SV,"2025-05-18 21:42:52",669,321,275,46,0,318,3,735,414,217,101
13,CLUJ,"SCOALA DOSU NAPULUI",401,"CEANU MARE",56844,1,PART,PRCNCT,PRSD,PRSD_SV,"2025-05-18 21:21:58",90,78,35,43,0,78,0,98,20,50,28
13,CLUJ,"SCOALA PRIMARA IACOBENI",402,"CEANU MARE",56844,1,PART,PRCNCT,PRSD,PRSD_SV,"2025-05-18 21:46:52",483,271,206,65,0,271,0,531,260,193,78
13,CLUJ,"CĂMIN CULTURAL CHINTENI",403,CHINTENI,56988,1,PART,PRCNCT,PRSD,PRSD_SV,"2025-05-18 21:53:27",1194,1143,699,444,0,1132,11,1312,169,279,853
13,CLUJ,"CASA DE CULTURĂ CHINTENI",404,CHINTENI,56988,1,PART,PRCNCT,PRSD,PRSD_SV,"2025-05-18 22:03:49",1125,956,674,282,0,949,7,1233,277,247,702
13,CLUJ,"ȘCOALA CLS.I-IV DEUȘU",405,CHINTENI,56988,1,PART,PRCNCT,PRSD,PRSD_SV,"2025-05-18 21:39:14",622,429,263,166,0,427,2,684,255,155,272
13,CLUJ,"ȘCOALA PRIMARĂ FEIURDENI",406,CHINTENI,56988,1,PART,PRCNCT,PRSD,PRSD_SV,"2025-05-18 21:50:23",422,287,186,101,0,286,1,463,176,176,110
13,CLUJ,"CASA DE CULTURĂ MĂCICAȘU",407,CHINTENI,56988,1,PART,PRCNCT,PRSD,PRSD_SV,"2025-05-18 21:34:38",312,217,147,70,0,213,4,342,125,100,113
13,CLUJ,"SCOALA GIMNAZ. CHIUIESTI",408,CHIUIEŞTI,57083,1,PART,PRCNCT,PRSD,PRSD_SV,"2025-05-18 21:50:18",1150,700,605,88,7,694,6,1266,566,431,263
13,CLUJ,"SALA NUNTI",409,CHIUIEŞTI,57083,1,PART,PRCNCT,PRSD,PRSD_SV,"2025-05-18 21:12:59",89,59,47,12,0,58,1,97,38,31,27
13,CLUJ,"CENTRU DE ZI ÎNGRIJIRE BĂTRÂNI",410,CHIUIEŞTI,57083,2,PART,PRCNCT,PRSD,PRSD_SV,"2025-05-19 01:52:19",305,204,148,53,3,198,6,335,131,109,89
13,CLUJ,"CĂMIN CULTURAL SRTÂMBU",411,CHIUIEŞTI,57083,1,PART,PRCNCT,PRSD,PRSD_SV,"2025-05-18 21:20:54",309,186,149,37,0,185,1,339,153,94,91
13,CLUJ,"SCOALA CU CL. I - VIII, CIUCEA",412,CIUCEA,57163,1,PART,PRCNCT,PRSD,PRSD_SV,"2025-05-18 21:44:34",689,503,379,113,11,499,4,759,256,256,243
13,CLUJ,"SCOALA CLASELE I - IV CALEA LATA",413,CIUCEA,57163,1,PART,PRCNCT,PRSD,PRSD_SV,"2025-05-18 21:17:55",182,96,71,23,2,96,0,199,103,63,33
13,CLUJ,"SCOALA CLS.I-IV VANATORI",414,CIUCEA,57163,1,PART,PRCNCT,PRSD,PRSD_SV,"2025-05-18 21:29:25",350,223,185,38,0,222,1,384,161,145,77
13,CLUJ,"CONSILIUL LOCAL CIURILA",415,CIURILA,57225,1,PART,PRCNCT,PRSD,PRSD_SV,"2025-05-18 21:32:55",238,203,123,80,0,203,0,261,58,92,111
13,CLUJ,"SCOALA GIMNAZIALA",416,CIURILA,57225,1,PART,PRCNCT,PRSD,PRSD_SV,"2025-05-18 21:45:26",222,199,107,92,0,198,1,243,44,95,103
13,CLUJ,"CĂMINUL CULTURAL SĂLICEA",417,CIURILA,57225,1,PART,PRCNCT,PRSD,PRSD_SV,"2025-05-18 22:00:18",651,745,381,329,35,735,10,1014,269,225,510
13,CLUJ,"CAMIN CULTURAL SALISTE",418,CIURILA,57225,1,PART,PRCNCT,PRSD,PRSD_SV,"2025-05-18 21:19:44",91,94,45,49,0,93,1,99,5,53,40
13,CLUJ,"SCOALA GIMNAZIALA",419,CIURILA,57225,1,PART,PRCNCT,PRSD,PRSD_SV,"2025-05-18 21:25:20",266,154,107,47,0,152,2,292,138,75,77
13,CLUJ,"ȘCOALA GIMNAZIALĂ COJOCNA SALA NR.4",420,COJOCNA,57350,1,PART,PRCNCT,PRSD,PRSD_SV,"2025-05-18 22:06:03",1080,640,489,140,11,636,4,1187,547,314,322
13,CLUJ,"ȘCOALA GIMNAZIALĂ COJOCNA SALA NR.7",421,COJOCNA,57350,1,PART,PRCNCT,PRSD,PRSD_SV,"2025-05-18 22:26:26",883,513,403,106,4,509,4,970,457,311,198
13,CLUJ,"MAGAZIN COOPERATIST BOJU CATUN (FOSTUL)",422,COJOCNA,57350,1,PART,PRCNCT,PRSD,PRSD_SV,"2025-05-18 21:23:16",176,88,63,25,0,88,0,193,105,49,39
13,CLUJ,"ŞCOALA BOJU",423,COJOCNA,57350,1,PART,PRCNCT,PRSD,PRSD_SV,"2025-05-18 21:34:44",334,288,161,116,11,286,2,366,78,119,167
13,CLUJ,"BIROUL PRIMĂRIEI CARA",424,COJOCNA,57350,1,PART,PRCNCT,PRSD,PRSD_SV,"2025-05-18 21:29:44",698,400,300,100,0,398,2,767,367,239,159
13,CLUJ,"CĂMINUL CULTURAL IURIU DE CÎMPIE",425,COJOCNA,57350,2,PART,PRCNCT,PRSD,PRSD_SV,"2025-05-18 23:35:15",182,132,70,62,0,129,3,199,67,69,60
13,CLUJ,"ŞCOALA GIMNAZIALĂ LIA MANOLIU CORNEŞTI",426,CORNEŞTI,57449,1,PART,PRCNCT,PRSD,PRSD_SV,"2025-05-18 21:26:03",171,103,77,26,0,102,1,187,84,48,54
13,CLUJ,"CĂMIN CULTURAL BÎRLEA",427,CORNEŞTI,57449,1,PART,PRCNCT,PRSD,PRSD_SV,"2025-05-18 21:22:53",113,94,61,33,0,93,1,123,29,32,61
13,CLUJ,"CĂMIN CULTURAL IGRIŢIA",428,CORNEŞTI,57449,1,PART,PRCNCT,PRSD,PRSD_SV,"2025-05-18 21:15:34",29,47,12,35,0,47,0,55,8,17,30
13,CLUJ,"CENTRUL DE INFORMARE ŞI PROMOVARE TURISTICĂ LUJERDIU",429,CORNEŞTI,57449,2,PART,PRCNCT,PRSD,PRSD_SV,"2025-05-19 01:32:36",225,173,108,65,0,171,2,228,55,70,101
13,CLUJ,"CĂMIN CULTURAL MORĂU",430,CORNEŞTI,57449,1,PART,PRCNCT,PRSD,PRSD_SV,"2025-05-18 21:21:52",43,62,27,35,0,62,0,86,24,30,32
13,CLUJ,"COOPERATIVA VECHE- STOIANA",431,CORNEŞTI,57449,1,PART,PRCNCT,PRSD,PRSD_SV,"2025-05-18 21:31:16",162,127,79,47,1,124,3,177,50,62,62
13,CLUJ,"CĂMIN CULTURAL TIOCU DE JOS",432,CORNEŞTI,57449,1,PART,PRCNCT,PRSD,PRSD_SV,"2025-05-18 21:17:35",87,71,40,31,0,69,2,95,24,33,36
13,CLUJ,"CĂMIN CULTURAL TIOCU DE SUS",433,CORNEŞTI,57449,1,PART,PRCNCT,PRSD,PRSD_SV,"2025-05-18 21:23:20",58,59,22,36,1,58,1,83,24,21,37
13,CLUJ,"CĂMIN CULTURAL TIOLTIUR",434,CORNEŞTI,57449,1,PART,PRCNCT,PRSD,PRSD_SV,"2025-05-18 21:21:07",143,83,54,29,0,81,2,156,73,47,34
13,CLUJ,"CENTRUL MULTIFUNCȚIONAL CUZDRIOARA",435,CUZDRIOARA,55062,1,PART,PRCNCT,PRSD,PRSD_SV,"2025-05-18 22:00:02",827,493,426,66,1,487,6,910,417,228,259
13,CLUJ,"CENTRUL MULTIFUNCȚIONAL CUZDRIOARA",436,CUZDRIOARA,55062,1,PART,PRCNCT,PRSD,PRSD_SV,"2025-05-18 21:52:28",882,465,419,46,0,460,5,969,504,212,248
13,CLUJ,"CĂMINUL CULTURAL",437,CUZDRIOARA,55062,1,PART,PRCNCT,PRSD,PRSD_SV,"2025-05-18 21:33:13",755,352,312,40,0,351,1,834,482,257,94
13,CLUJ,"ŞCOALA GIMNAZIALĂ CU CLASELE I-VIII ”GELU ROMÂNUL”",438,DĂBÂCA,57546,1,PART,PRCNCT,PRSD,PRSD_SV,"2025-05-18 21:48:00",499,404,225,179,0,401,3,551,147,159,242
13,CLUJ,"ŞCOALA CU CLASELE I-IV LUNA DE JOS",439,DĂBÂCA,57546,2,PART,PRCNCT,PRSD,PRSD_SV,"2025-05-19 00:37:45",540,354,234,111,9,349,5,563,209,189,160
13,CLUJ,"CĂMINUL CULTURAL PÎGLIŞA",440,DĂBÂCA,57546,1,PART,PRCNCT,PRSD,PRSD_SV,"2025-05-18 21:25:27",73,79,23,56,0,79,0,109,30,43,36
13,CLUJ,"CAMINUL CULTURAL FELEACU DIN LOCALITATEA FELEACU",441,FELEACU,57582,1,PART,PRCNCT,PRSD,PRSD_SV,"2025-05-18 23:38:52",2111,1728,1238,488,2,1710,18,2323,595,412,1298
13,CLUJ,"CAMINUL CULTURAL DIN LOCALITATEA GHEORGHENI",442,FELEACU,57582,1,PART,PRCNCT,PRSD,PRSD_SV,"2025-05-18 21:50:22",949,839,597,239,3,830,9,1043,204,74,756
13,CLUJ,"FOSTUL SEDIU CAP VILCELE DIN LOCALITATEA VILCELE",443,FELEACU,57582,1,PART,PRCNCT,PRSD,PRSD_SV,"2025-05-18 22:30:38",915,662,471,191,0,654,8,1006,344,284,370
13,CLUJ,"CĂMIN CULTURAL FIZEȘU GHERLII",444,"FIZEŞU GHERLII",57644,1,PART,PRCNCT,PRSD,PRSD_SV,"2025-05-18 21:39:42",1106,474,403,71,0,471,3,1216,742,203,268
13,CLUJ,"CAMIN CULTURAL BONT",445,"FIZEŞU GHERLII",57644,1,PART,PRCNCT,PRSD,PRSD_SV,"2025-05-18 21:26:40",276,164,121,42,1,162,2,303,139,109,53
13,CLUJ,"SCOALA CU CLS.I-IV NICULA",446,"FIZEŞU GHERLII",57644,1,PART,PRCNCT,PRSD,PRSD_SV,"2025-05-18 21:41:54",512,336,236,100,0,333,3,562,226,205,128
13,CLUJ,"CAMIN CULTURAL SACALAIA",447,"FIZEŞU GHERLII",57644,1,PART,PRCNCT,PRSD,PRSD_SV,"2025-05-18 21:29:13",197,153,104,49,0,151,2,216,63,70,81
13,CLUJ,"PRIMĂRIA COMUNEI FLOREȘTI",448,FLOREŞTI,57706,2,PART,PRCNCT,PRSD,PRSD_SV,"2025-05-19 03:06:58",2072,1688,1018,667,3,1675,13,2183,495,609,1066
13,CLUJ,"PRIMĂRIA COMUNEI FLOREȘTI",449,FLOREŞTI,57706,1,PART,PRCNCT,PRSD,PRSD_SV,"2025-05-18 22:33:39",1802,1355,960,395,0,1342,13,1981,626,372,970
13,CLUJ,"CLĂDIRE MULTIFUNCȚIONALĂ",450,FLOREŞTI,57706,1,PART,PRCNCT,PRSD,PRSD_SV,"2025-05-18 23:06:59",1435,1277,793,483,1,1269,8,1578,301,202,1067
13,CLUJ,"CLĂDIRE MULTIFUNCȚIONALĂ",451,FLOREŞTI,57706,1,PART,PRCNCT,PRSD,PRSD_SV,"2025-05-18 23:06:17",1756,1464,927,536,1,1447,17,1931,467,280,1167
13,CLUJ,"ȘCOALA GIMNAZIALĂ ”GHEORGHE ȘINCAI” FLOREȘTI",452,FLOREŞTI,57706,1,PART,PRCNCT,PRSD,PRSD_SV,"2025-05-18 22:21:09",1549,1119,874,244,1,1108,11,1703,584,336,772
13,CLUJ,"ȘCOALA GIMNAZIALĂ ”GHEORGHE ȘINCAI” FLOREȘTI",453,FLOREŞTI,57706,1,PART,PRCNCT,PRSD,PRSD_SV,"2025-05-18 22:09:37",1057,951,626,323,2,945,6,1162,211,307,638
13,CLUJ,"ȘCOALA GIMNAZIALĂ ”GHEORGHE ȘINCAI” FLOREȘTI",454,FLOREŞTI,57706,1,PART,PRCNCT,PRSD,PRSD_SV,"2025-05-18 22:42:32",1939,1456,1095,361,0,1438,18,2133,677,415,1023
13,CLUJ,"ȘCOALA GIMNAZIALĂ ”GHEORGHE ȘINCAI” FLOREȘTI",455,FLOREŞTI,57706,1,PART,PRCNCT,PRSD,PRSD_SV,"2025-05-18 22:47:56",1945,1301,1095,206,0,1292,9,2140,839,363,929
13,CLUJ,"ȘCOALA GIMNAZIALĂ ”GHEORGHE ȘINCAI” FLOREȘTI-GRĂDINIȚA",456,FLOREŞTI,57706,1,PART,PRCNCT,PRSD,PRSD_SV,"2025-05-18 22:08:32",1319,998,715,283,0,989,9,1450,452,259,730
13,CLUJ,"ȘCOALA GIMNAZIALĂ ”GHEORGHE ȘINCAI” FLOREȘTI-GRĂDINIȚA",457,FLOREŞTI,57706,1,PART,PRCNCT,PRSD,PRSD_SV,"2025-05-18 21:48:36",1890,1199,973,226,0,1190,9,2078,879,252,938
13,CLUJ,"GRADINITA NR.2",458,FLOREŞTI,57706,1,PART,PRCNCT,PRSD,PRSD_SV,"2025-05-18 22:20:21",1682,1339,1034,305,0,1329,10,1849,510,290,1039
13,CLUJ,"GRADINITA NR.2",459,FLOREŞTI,57706,1,PART,PRCNCT,PRSD,PRSD_SV,"2025-05-18 22:02:24",1842,1163,991,170,2,1156,7,2031,868,325,831
13,CLUJ,"GRĂDINIȚA CU PROGRAM PRELUNGIT FLOREȘTI",460,FLOREŞTI,57706,1,PART,PRCNCT,PRSD,PRSD_SV,"2025-05-19 00:30:35",1898,1494,863,631,0,1480,14,2088,594,414,1066
13,CLUJ,"GRĂDINIȚA CU PROGRAM PRELUNGIT FLOREȘTI",461,FLOREŞTI,57706,1,PART,PRCNCT,PRSD,PRSD_SV,"2025-05-18 23:18:45",1815,1277,1027,249,1,1264,13,1997,720,362,902
13,CLUJ,"GRĂDINIȚA CU PROGRAM PRELUNGIT FLOREȘTI",462,FLOREŞTI,57706,1,PART,PRCNCT,PRSD,PRSD_SV,"2025-05-18 23:03:04",1811,1278,980,298,0,1268,10,1991,713,335,933
13,CLUJ,"GRĂDINIȚA CU PROGRAM PRELUNGIT FLOREȘTI",463,FLOREŞTI,57706,1,PART,PRCNCT,PRSD,PRSD_SV,"2025-05-18 23:11:05",2010,1312,1149,162,1,1296,16,2212,900,300,996
13,CLUJ,"GRĂDINIȚA CU PROGRAM PRELUNGIT FLOREȘTI",464,FLOREŞTI,57706,1,PART,PRCNCT,PRSD,PRSD_SV,"2025-05-18 23:07:26",1837,1273,959,314,0,1262,11,2021,748,461,801
13,CLUJ,"LICEUL TEORETIC „DUMITRU TĂUȚAN” FLOREȘTI",465,FLOREŞTI,57706,1,PART,PRCNCT,PRSD,PRSD_SV,"2025-05-18 22:17:49",1796,1538,998,540,0,1527,11,1975,437,472,1055
13,CLUJ,"LICEUL TEORETIC „DUMITRU TĂUȚAN” FLOREȘTI",466,FLOREŞTI,57706,1,PART,PRCNCT,PRSD,PRSD_SV,"2025-05-18 22:42:06",2070,1437,1056,381,0,1420,17,2276,839,422,998
13,CLUJ,"LICEUL TEORETIC „DUMITRU TĂUȚAN” FLOREȘTI",467,FLOREŞTI,57706,1,PART,PRCNCT,PRSD,PRSD_SV,"2025-05-18 22:06:24",2054,1418,1057,361,0,1412,6,2261,843,449,963
13,CLUJ,"LICEUL TEORETIC „DUMITRU TĂUȚAN” FLOREȘTI",468,FLOREŞTI,57706,1,PART,PRCNCT,PRSD,PRSD_SV,"2025-05-18 22:31:23",1975,1254,1034,219,1,1243,11,2174,920,416,827
13,CLUJ,"LICEUL TEORETIC „DUMITRU TĂUȚAN” FLOREȘTI",469,FLOREŞTI,57706,1,PART,PRCNCT,PRSD,PRSD_SV,"2025-05-18 22:31:07",1997,1187,1014,173,0,1178,9,2166,979,369,809
13,CLUJ,"LICEUL TEORETIC „DUMITRU TĂUȚAN” FLOREȘTI",470,FLOREŞTI,57706,1,PART,PRCNCT,PRSD,PRSD_SV,"2025-05-18 22:49:38",1584,1083,840,242,1,1073,10,1743,660,344,729
13,CLUJ,"SCOALA LUNA DE SUS",471,FLOREŞTI,57706,1,PART,PRCNCT,PRSD,PRSD_SV,"2025-05-18 21:43:43",858,645,497,140,8,644,1,943,298,215,429
13,CLUJ,"SCOALA LUNA DE SUS",472,FLOREŞTI,57706,1,PART,PRCNCT,PRSD,PRSD_SV,"2025-05-18 21:40:25",1067,757,644,110,3,749,8,1173,416,189,560
13,CLUJ,"CAMINUL CULTURAL TAUTI",473,FLOREŞTI,57706,1,PART,PRCNCT,PRSD,PRSD_SV,"2025-05-18 21:30:40",238,250,145,103,2,249,1,291,41,111,138
13,CLUJ,"CAMINUL CULTURAL FRATA",474,FRATA,57742,1,PART,PRCNCT,PRSD,PRSD_SV,"2025-05-18 21:40:00",1483,735,599,136,0,735,0,1633,898,426,309
13,CLUJ,"CAMINUL CULTURAL BERCHIESU",475,FRATA,57742,1,PART,PRCNCT,PRSD,PRSD_SV,"2025-05-18 21:25:05",448,211,156,55,0,209,2,492,281,100,109
13,CLUJ,"CAMINUL CULTURAL POIANA FRATII",476,FRATA,57742,1,PART,PRCNCT,PRSD,PRSD_SV,"2025-05-18 21:22:50",178,85,65,20,0,85,0,195,110,60,25
13,CLUJ,"CAMINUL CULTURAL SOPORU DE CIMPIE",477,FRATA,57742,1,PART,PRCNCT,PRSD,PRSD_SV,"2025-05-18 21:34:36",977,412,358,54,0,405,7,1074,662,282,123
13,CLUJ,"CAMINUL CULTURAL GARBAU",478,GÂRBĂU,57948,1,PART,PRCNCT,PRSD,PRSD_SV,"2025-05-18 21:37:12",544,383,312,71,0,380,3,547,164,191,189
13,CLUJ,"CAMINUL CULTURAL CORNESTI",479,GÂRBĂU,57948,1,PART,PRCNCT,PRSD,PRSD_SV,"2025-05-18 21:24:22",85,137,37,100,0,136,1,143,6,106,30
13,CLUJ,"CĂMINUL CULTURAL NĂDĂȘELU",480,GÂRBĂU,57948,1,PART,PRCNCT,PRSD,PRSD_SV,"2025-05-18 21:34:43",191,188,109,79,0,186,2,210,22,88,98
13,CLUJ,"CAMIN CULTURAL TUREA",481,GÂRBĂU,57948,1,PART,PRCNCT,PRSD,PRSD_SV,"2025-05-18 21:29:57",418,241,198,43,0,240,1,459,218,67,173
13,CLUJ,"CLADIRE ADMINISTRATIVA SFAT POPULAR",482,GÂRBĂU,57948,1,PART,PRCNCT,PRSD,PRSD_SV,"2025-05-18 21:49:00",557,415,342,73,0,413,2,612,197,35,378
13,CLUJ,"CAMIN CULTURAL GEACA",483,GEACA,57831,1,PART,PRCNCT,PRSD,PRSD_SV,"2025-05-18 22:00:51",392,223,133,88,2,220,3,430,207,89,131
13,CLUJ,"SCOALA CHIRIS",484,GEACA,57831,1,PART,PRCNCT,PRSD,PRSD_SV,"2025-05-18 21:24:37",64,38,16,22,0,38,0,71,33,20,18
13,CLUJ,"CAMINUL CULTURAL LACU",485,GEACA,57831,1,PART,PRCNCT,PRSD,PRSD_SV,"2025-05-18 21:34:20",219,128,88,39,1,128,0,240,112,36,92
13,CLUJ,"CAMINUL CULTURAL LEGII",486,GEACA,57831,1,PART,PRCNCT,PRSD,PRSD_SV,"2025-05-18 21:22:02",111,88,48,40,0,88,0,120,32,51,37
13,CLUJ,"CAMINUL CULTURAL PUINI",487,GEACA,57831,1,PART,PRCNCT,PRSD,PRSD_SV,"2025-05-18 21:25:20",72,50,25,25,0,50,0,78,28,26,24
13,CLUJ,"CAMINUL CULTURAL SUCUTARD",488,GEACA,57831,1,PART,PRCNCT,PRSD,PRSD_SV,"2025-05-18 21:24:32",274,159,114,45,0,159,0,300,141,64,95
13,CLUJ,"CASA DE CULTURĂ ”DUMITRU SOPON”",489,GILĂU,57902,1,PART,PRCNCT,PRSD,PRSD_SV,"2025-05-18 22:31:18",1962,1529,1142,387,0,1519,10,2152,623,602,917
13,CLUJ,"CĂMINUL CULTURAL VECHI GILĂU",490,GILĂU,57902,1,PART,PRCNCT,PRSD,PRSD_SV,"2025-05-18 23:07:34",2006,1381,1123,226,32,1370,11,2040,659,592,778
13,CLUJ,"LICEUL TEORETIC ”GELU VOIEVOD”, CLĂDIREA INTERNAT",491,GILĂU,57902,1,PART,PRCNCT,PRSD,PRSD_SV,"2025-05-18 22:09:07",1937,1154,982,165,7,1139,15,2110,956,619,520
13,CLUJ,"CĂMINUL CULTURAL SOMEȘU RECE",492,GILĂU,57902,1,PART,PRCNCT,PRSD,PRSD_SV,"2025-05-18 22:34:03",994,852,548,304,0,841,11,1092,240,404,437
13,CLUJ,"CLĂDIRE GRĂDINIŢĂ SOMEŞU RECE-UZINĂ",493,GILĂU,57902,1,PART,PRCNCT,PRSD,PRSD_SV,"2025-05-18 22:21:47",531,331,234,97,0,324,7,583,252,218,106
13,CLUJ,"ȘCOALA GIMNAZIALA CU CLASELE I-IV IARA",494,IARA,58008,1,PART,PRCNCT,PRSD,PRSD_SV,"2025-05-18 21:45:48",724,379,291,87,1,376,3,795,416,244,132
13,CLUJ,"SCOALA GIMNAZIALA CU CLASELE I-IV IARA",495,IARA,58008,1,PART,PRCNCT,PRSD,PRSD_SV,"2025-05-18 21:37:50",825,364,307,57,0,363,1,909,545,225,138
13,CLUJ,SCOALA,496,IARA,58008,1,PART,PRCNCT,PRSD,PRSD_SV,"2025-05-18 21:41:38",292,143,107,36,0,142,1,320,177,100,42
13,CLUJ,"CASA PROPRIETATE PARTICULARA",497,IARA,58008,1,PART,PRCNCT,PRSD,PRSD_SV,"2025-05-18 21:18:39",50,45,18,27,0,45,0,54,9,18,27
13,CLUJ,"CASA PROPRIETATE PARTICULARĂ",498,IARA,58008,1,PART,PRCNCT,PRSD,PRSD_SV,"2025-05-18 21:25:19",115,93,41,52,0,93,0,126,33,46,47
13,CLUJ,"CĂMIN CULTURAL-CACOVA IERII",499,IARA,58008,1,PART,PRCNCT,PRSD,PRSD_SV,"2025-05-18 21:33:56",290,210,152,54,4,210,0,318,108,114,96
13,CLUJ,SCOALA,500,IARA,58008,1,PART,PRCNCT,PRSD,PRSD_SV,"2025-05-18 21:34:21",240,133,106,27,0,133,0,243,110,86,47
13,CLUJ,"CASA PROPRIETATE PARTICULARĂ",501,IARA,58008,1,PART,PRCNCT,PRSD,PRSD_SV,"2025-05-18 21:23:33",32,37,11,26,0,35,2,54,17,18,17
13,CLUJ,SCOALA,502,IARA,58008,1,PART,PRCNCT,PRSD,PRSD_SV,"2025-05-18 21:20:50",115,70,40,29,1,69,1,126,56,38,31
13,CLUJ,"CASA PROPRIETATE PARTICULARĂ",503,IARA,58008,1,PART,PRCNCT,PRSD,PRSD_SV,"2025-05-18 21:16:18",17,36,7,29,0,36,0,40,4,18,18
13,CLUJ,SCOALA,504,IARA,58008,1,PART,PRCNCT,PRSD,PRSD_SV,"2025-05-18 21:22:14",87,51,30,21,0,51,0,95,44,20,31
13,CLUJ,SCOALA,505,IARA,58008,1,PART,PRCNCT,PRSD,PRSD_SV,"2025-05-18 21:31:48",247,151,105,46,0,150,1,271,120,99,51
13,CLUJ,SCOALA,506,IARA,58008,1,PART,PRCNCT,PRSD,PRSD_SV,"2025-05-18 21:12:16",33,40,19,21,0,40,0,60,20,22,18
13,CLUJ,"CENTRUL CULTURAL ICLOD",507,ICLOD,58142,1,PART,PRCNCT,PRSD,PRSD_SV,"2025-05-18 22:07:16",1603,895,759,135,1,885,10,1762,867,461,424
13,CLUJ,"SCOALA DIN FUNDATURA",508,ICLOD,58142,1,PART,PRCNCT,PRSD,PRSD_SV,"2025-05-18 21:37:09",566,367,290,76,1,363,4,622,255,148,215
13,CLUJ,"SCOALA DIN LIVADA",509,ICLOD,58142,1,PART,PRCNCT,PRSD,PRSD_SV,"2025-05-18 21:42:40",907,526,427,99,0,521,5,997,471,292,229
13,CLUJ,"SCOALA DIN ORMAN",510,ICLOD,58142,1,PART,PRCNCT,PRSD,PRSD_SV,"2025-05-18 21:24:27",387,196,159,37,0,194,2,425,229,134,60
13,CLUJ,"PRIMĂRIA COMUNEI",511,"IZVORU CRIŞULUI",58204,1,PART,PRCNCT,PRSD,PRSD_SV,"2025-05-18 21:48:15",750,464,388,67,9,453,11,824,360,50,403
13,CLUJ,"CĂMINUL CULTURAL",512,"IZVORU CRIŞULUI",58204,1,PART,PRCNCT,PRSD,PRSD_SV,"2025-05-18 21:26:22",179,128,88,40,0,128,0,196,68,69,59
13,CLUJ,"ŞCOALA GENERALĂ",513,"IZVORU CRIŞULUI",58204,1,PART,PRCNCT,PRSD,PRSD_SV,"2025-05-18 21:25:04",309,269,210,57,2,264,5,339,70,39,225
13,CLUJ,"CĂMINUL CULTURAL",514,"JICHIŞU DE JOS",55106,1,PART,PRCNCT,PRSD,PRSD_SV,"2025-05-18 21:21:23",338,228,169,59,0,226,2,371,143,115,111
13,CLUJ,"CĂMINUL CULTURAL",515,"JICHIŞU DE JOS",55106,1,PART,PRCNCT,PRSD,PRSD_SV,"2025-05-18 21:50:55",347,204,176,28,0,203,1,365,161,128,75
13,CLUJ,"CAMIN CULTURAL JICHISU DE SUS",516,"JICHIŞU DE JOS",55106,1,PART,PRCNCT,PRSD,PRSD_SV,"2025-05-18 21:19:22",160,81,55,26,0,80,1,175,94,41,39
13,CLUJ,"ŞCOALA GENERALĂ",517,"JICHIŞU DE JOS",55106,1,PART,PRCNCT,PRSD,PRSD_SV,"2025-05-18 21:25:00",13,29,3,26,0,29,0,50,21,22,7
13,CLUJ,"ŞCOALA GENERALĂ",518,"JICHIŞU DE JOS",55106,1,PART,PRCNCT,PRSD,PRSD_SV,"2025-05-18 21:16:13",81,67,34,33,0,67,0,88,21,33,34
13,CLUJ,"ȘCOALA GIMNAZIALĂ ”GEORGE BARIȚIU”",519,JUCU,58259,1,PART,PRCNCT,PRSD,PRSD_SV,"2025-05-18 21:42:53",1078,775,546,229,0,766,9,1185,410,298,468
13,CLUJ,"ASEZAMANTUL SOCIAL BISERICESC",520,JUCU,58259,1,PART,PRCNCT,PRSD,PRSD_SV,"2025-05-18 21:49:48",636,396,330,66,0,393,3,699,303,176,217
13,CLUJ,"CĂMIN CULTURAL GĂDĂLIN",521,JUCU,58259,1,PART,PRCNCT,PRSD,PRSD_SV,"2025-05-18 21:26:50",543,446,296,148,2,442,4,596,150,231,211
13,CLUJ,"GRĂDINIȚA CU PROGRAM NORMAL",522,JUCU,58259,1,PART,PRCNCT,PRSD,PRSD_SV,"2025-05-18 21:24:29",369,236,200,36,0,235,1,405,169,147,88
13,CLUJ,"ŞCOALA PRIMARĂ",523,JUCU,58259,1,PART,PRCNCT,PRSD,PRSD_SV,"2025-05-18 22:11:36",1364,994,737,257,0,985,9,1499,505,348,637
13,CLUJ,"CĂMIN CULTURAL VIȘEA",524,JUCU,58259,1,PART,PRCNCT,PRSD,PRSD_SV,"2025-05-18 21:31:58",435,273,199,74,0,273,0,479,206,73,200
13,CLUJ,"CĂMINUL CULTURAL ”PROF. NICOLAE MAZARE” LUNA",525,LUNA,58311,1,PART,PRCNCT,PRSD,PRSD_SV,"2025-05-18 21:49:09",1103,570,492,64,14,568,2,1212,642,292,276
13,CLUJ,"CĂMINUL CULTURAL ”PROF. NICOLAE MAZARE” LUNA",526,LUNA,58311,1,PART,PRCNCT,PRSD,PRSD_SV,"2025-05-18 21:56:22",1057,567,468,85,14,564,3,1162,595,341,223
13,CLUJ,"GRĂDINIŢA CU PROGRAM NORMAL GLIGORESTI",527,LUNA,58311,1,PART,PRCNCT,PRSD,PRSD_SV,"2025-05-18 21:26:06",479,259,224,34,1,258,1,526,267,196,62
13,CLUJ,"CAMINUL CULTURAL LUNCANI",528,LUNA,58311,1,PART,PRCNCT,PRSD,PRSD_SV,"2025-05-18 21:49:38",1186,549,494,52,3,545,4,1305,756,291,254
13,CLUJ,"PRIMARIA COMUNEI",529,MĂGURI-RĂCĂTĂU,58357,2,PART,PRCNCT,PRSD,PRSD_SV,"2025-05-18 23:25:45",711,306,243,63,0,305,1,781,475,200,105
13,CLUJ,"SCOALA GENERALA",530,MĂGURI-RĂCĂTĂU,58357,1,PART,PRCNCT,PRSD,PRSD_SV,"2025-05-18 21:31:34",716,296,251,45,0,295,1,787,491,188,107
13,CLUJ,"SCOALA GIMNAZIALA MUNTELE-RECE",531,MĂGURI-RĂCĂTĂU,58357,1,PART,PRCNCT,PRSD,PRSD_SV,"2025-05-18 21:33:04",440,260,177,83,0,259,1,483,223,188,71
13,CLUJ,"PRIMĂRIA COMUNEI",532,MĂNĂSTIRENI,58393,1,PART,PRCNCT,PRSD,PRSD_SV,"2025-05-18 21:51:51",707,493,335,155,3,489,4,777,284,204,285
13,CLUJ,"CĂMINUL CULTURAL BEDECIU",533,MĂNĂSTIRENI,58393,1,PART,PRCNCT,PRSD,PRSD_SV,"2025-05-18 21:54:01",398,278,205,73,0,276,2,437,159,153,123
13,CLUJ,"PRIMĂRIA COMUNEI MĂRGĂU",534,MĂRGĂU,58464,1,PART,PRCNCT,PRSD,PRSD_SV,"2025-05-18 21:35:05",333,251,164,87,0,251,0,365,114,116,135
13,CLUJ,"CĂMIN CULTURAL",535,MĂRGĂU,58464,1,PART,PRCNCT,PRSD,PRSD_SV,"2025-05-18 21:36:45",182,175,87,88,0,173,2,199,24,69,104
13,CLUJ,"ȘCOALA GIMNAZIALA RĂCHIȚELE",536,MĂRGĂU,58464,1,PART,PRCNCT,PRSD,PRSD_SV,"2025-05-18 21:38:03",563,378,275,103,0,377,1,618,240,185,192
13,CLUJ,"CĂMIN CULTURAL",537,MĂRGĂU,58464,1,PART,PRCNCT,PRSD,PRSD_SV,"2025-05-18 21:36:03",146,95,64,29,2,95,0,160,65,57,38
13,CLUJ,"CĂMIN CULTURAL RUSEȘTI",538,MĂRIŞEL,58534,1,PART,PRCNCT,PRSD,PRSD_SV,"2025-05-18 21:49:49",105,142,51,91,0,139,3,215,73,71,68
13,CLUJ,"ŞCOALA GENERALĂ",539,MĂRIŞEL,58534,1,PART,PRCNCT,PRSD,PRSD_SV,"2025-05-18 21:30:57",1004,549,446,103,0,544,5,1103,554,355,189
13,CLUJ,"ŞCOALA GENERALĂ",540,MĂRIŞEL,58534,1,PART,PRCNCT,PRSD,PRSD_SV,"2025-05-18 21:44:33",131,91,55,36,0,91,0,144,53,59,32
13,CLUJ,"CĂMINUL CULTURAL",541,MICA,55160,1,PART,PRCNCT,PRSD,PRSD_SV,"2025-05-18 21:50:29",523,383,288,84,11,379,4,574,191,195,184
13,CLUJ,"CĂMINUL CULTURAL",542,MICA,55160,1,PART,PRCNCT,PRSD,PRSD_SV,"2025-05-18 21:43:56",599,358,297,61,0,355,3,658,300,177,178
13,CLUJ,"FOSTUL SEDIU CAP",543,MICA,55160,1,PART,PRCNCT,PRSD,PRSD_SV,"2025-05-18 21:30:49",895,466,402,64,0,461,5,984,518,219,242
13,CLUJ,"ŞCOALA GENERALĂ",544,MICA,55160,1,PART,PRCNCT,PRSD,PRSD_SV,"2025-05-18 21:56:57",879,473,390,81,2,468,5,966,493,221,247
13,CLUJ,"SALA DE SPORT",545,"MIHAI VITEAZU",55277,1,PART,PRCNCT,PRSD,PRSD_SV,"2025-05-18 21:59:02",1476,852,746,106,0,846,6,1623,771,403,443
13,CLUJ,"SALA DE SPORT",546,"MIHAI VITEAZU",55277,1,PART,PRCNCT,PRSD,PRSD_SV,"2025-05-18 21:47:04",968,595,517,78,0,591,4,1064,469,257,334
13,CLUJ,"CASA DE CULTURĂ",547,"MIHAI VITEAZU",55277,1,PART,PRCNCT,PRSD,PRSD_SV,"2025-05-18 22:10:28",1441,793,681,112,0,786,7,1585,792,333,453
13,CLUJ,"ŞCOALA GENERALĂ",548,"MIHAI VITEAZU",55277,1,PART,PRCNCT,PRSD,PRSD_SV,"2025-05-18 21:35:41",447,259,200,59,0,256,3,490,231,113,143
13,CLUJ,"CAMIN CULTURAL",549,"MIHAI VITEAZU",55277,1,PART,PRCNCT,PRSD,PRSD_SV,"2025-05-18 21:55:59",671,415,328,83,4,414,1,737,322,181,233
13,CLUJ,"PRIMĂRIA COMUNEI",550,"MINTIU GHERLII",58552,1,PART,PRCNCT,PRSD,PRSD_SV,"2025-05-18 22:27:00",1310,697,623,74,0,690,7,1456,759,369,321
13,CLUJ,"ŞCOALA GENERALĂ",551,"MINTIU GHERLII",58552,1,PART,PRCNCT,PRSD,PRSD_SV,"2025-05-18 21:34:54",762,418,349,68,1,417,1,837,419,275,142
13,CLUJ,"ŞCOALA GENERALĂ",552,"MINTIU GHERLII",58552,1,PART,PRCNCT,PRSD,PRSD_SV,"2025-05-18 21:44:44",578,362,285,77,0,361,1,635,273,205,156
13,CLUJ,"ŞCOALA GENERALĂ",553,"MINTIU GHERLII",58552,1,PART,PRCNCT,PRSD,PRSD_SV,"2025-05-18 21:20:08",62,84,27,57,0,80,4,112,28,37,43
13,CLUJ,"ŞCOALA GENERALĂ",554,"MINTIU GHERLII",58552,1,PART,PRCNCT,PRSD,PRSD_SV,"2025-05-18 21:28:00",210,125,87,38,0,123,2,230,105,48,75
13,CLUJ,"ŞCOALA GENERALĂ",555,"MINTIU GHERLII",58552,1,PART,PRCNCT,PRSD,PRSD_SV,"2025-05-18 21:15:36",218,127,89,38,0,127,0,239,112,77,50
13,CLUJ,"CAMIN CULTURAL MOCIU - SALA MICA",556,MOCIU,58623,1,PART,PRCNCT,PRSD,PRSD_SV,"2025-05-18 21:52:30",1345,771,608,153,10,767,4,1479,708,453,314
13,CLUJ,"SALĂ MULTIFUNCŢIONALĂ",557,MOCIU,58623,1,PART,PRCNCT,PRSD,PRSD_SV,"2025-05-18 21:20:38",155,100,63,37,0,100,0,170,70,53,47
13,CLUJ,"ŞCOALA ELEMENTARA",558,MOCIU,58623,1,PART,PRCNCT,PRSD,PRSD_SV,"2025-05-18 21:36:32",227,140,91,34,15,138,2,249,109,21,117
13,CLUJ,"ŞCOALA GENERALĂ",559,MOCIU,58623,1,PART,PRCNCT,PRSD,PRSD_SV,"2025-05-18 21:23:45",201,124,73,51,0,124,0,221,97,62,62
13,CLUJ,"CAMIN CULTURAL",560,MOCIU,58623,1,PART,PRCNCT,PRSD,PRSD_SV,"2025-05-18 21:42:01",268,285,137,148,0,281,4,294,9,123,158
13,CLUJ,"CLADIRE MULTIFUNCŢIONALĂ",561,MOCIU,58623,1,PART,PRCNCT,PRSD,PRSD_SV,"2025-05-18 21:13:05",144,86,60,26,0,86,0,157,71,57,29
13,CLUJ,"CLADIRE MULTIFUNCTIONALA",562,MOCIU,58623,1,PART,PRCNCT,PRSD,PRSD_SV,"2025-05-18 21:24:05",253,163,111,52,0,163,0,276,113,91,72
13,CLUJ,"PRIMĂRIA COMUNEI",563,MOLDOVENEŞTI,58721,1,PART,PRCNCT,PRSD,PRSD_SV,"2025-05-18 21:39:11",581,338,271,64,3,335,3,638,300,139,196
13,CLUJ,"ŞCOALA CU CLASELE I-VIII",564,MOLDOVENEŞTI,58721,1,PART,PRCNCT,PRSD,PRSD_SV,"2025-05-18 21:27:56",415,228,176,51,1,228,0,456,228,73,155
13,CLUJ,"CASA SATULUI",565,MOLDOVENEŞTI,58721,1,PART,PRCNCT,PRSD,PRSD_SV,"2025-05-18 21:41:11",577,381,301,71,9,379,2,634,253,160,219
13,CLUJ,"CĂMINUL CULTURAL",566,MOLDOVENEŞTI,58721,1,PART,PRCNCT,PRSD,PRSD_SV,"2025-05-18 21:19:18",105,78,47,31,0,78,0,115,37,30,48
13,CLUJ,"CĂMIN CULTURAL PLĂIEȘTI",567,MOLDOVENEŞTI,58721,1,PART,PRCNCT,PRSD,PRSD_SV,"2025-05-18 21:38:50",529,318,267,36,15,312,6,581,263,94,218
13,CLUJ,"CĂMIN CULTURAL PODENI",568,MOLDOVENEŞTI,58721,1,PART,PRCNCT,PRSD,PRSD_SV,"2025-05-18 21:25:07",335,224,136,87,1,220,4,368,144,95,125
13,CLUJ,"CLĂDIREA PRIMĂRIEI",569,MOLDOVENEŞTI,58721,1,PART,PRCNCT,PRSD,PRSD_SV,"2025-05-18 21:19:46",155,121,76,45,0,119,2,170,49,58,61
13,CLUJ,"CĂMINUL CULTURAL",570,NEGRENI,60169,1,PART,PRCNCT,PRSD,PRSD_SV,"2025-05-18 22:14:05",1259,864,710,152,2,850,14,1384,520,500,350
13,CLUJ,"CASA DE CULTURĂ",571,NEGRENI,60169,1,PART,PRCNCT,PRSD,PRSD_SV,"2025-05-18 22:00:33",518,358,293,64,1,356,2,569,211,196,160
13,CLUJ,"SCOALA CU CLASELE I-IV",572,NEGRENI,60169,1,PART,PRCNCT,PRSD,PRSD_SV,"2025-05-18 21:26:24",88,63,50,13,0,62,1,96,33,41,21
13,CLUJ,"SCOALĂ GENERALĂ IULIU HAȚIEGANU PANTICEU",573,PANTICEU,58856,1,PART,PRCNCT,PRSD,PRSD_SV,"2025-05-18 21:34:51",506,334,221,99,14,333,1,556,222,170,163
13,CLUJ,"CAMIN CULTURAL",574,PANTICEU,58856,1,PART,PRCNCT,PRSD,PRSD_SV,"2025-05-18 21:17:27",48,48,19,29,0,48,0,52,4,18,30
13,CLUJ,"ŞCOALA CLASELE I-IV",575,PANTICEU,58856,1,PART,PRCNCT,PRSD,PRSD_SV,"2025-05-18 21:22:40",273,188,109,78,1,188,0,299,111,111,77
13,CLUJ,"CLADIRE SCOALA",576,PANTICEU,58856,1,PART,PRCNCT,PRSD,PRSD_SV,"2025-05-18 21:25:14",179,110,64,46,0,109,1,197,87,67,42
13,CLUJ,"SCOALA PRIMARĂ",577,PANTICEU,58856,1,PART,PRCNCT,PRSD,PRSD_SV,"2025-05-18 21:24:32",262,134,91,43,0,133,1,287,153,69,64
13,CLUJ,"CĂMINUL CULTURAL PĂLATCA",578,PĂLATCA,58794,1,PART,PRCNCT,PRSD,PRSD_SV,"2025-05-18 21:39:49",571,418,268,147,3,409,9,626,208,173,236
13,CLUJ,"CĂMINUL CULTURAL SAVA",579,PĂLATCA,58794,1,PART,PRCNCT,PRSD,PRSD_SV,"2025-05-18 21:27:43",227,172,95,77,0,171,1,249,77,73,98
13,CLUJ,"CĂMIN CULTURAL",580,"PETREŞTII DE JOS",58918,1,PART,PRCNCT,PRSD,PRSD_SV,"2025-05-18 21:31:04",475,299,218,76,5,296,3,502,203,157,139
13,CLUJ,"ŞCOALA GENERALĂ",581,"PETREŞTII DE JOS",58918,1,PART,PRCNCT,PRSD,PRSD_SV,"2025-05-18 21:17:33",179,116,92,24,0,115,1,196,80,78,37
13,CLUJ,"ŞCOALA GENERALĂ",582,"PETREŞTII DE JOS",58918,1,PART,PRCNCT,PRSD,PRSD_SV,"2025-05-18 21:30:51",164,154,75,79,0,154,0,199,45,89,65
13,CLUJ,"CAMIN CULTURAL LIVADA",583,"PETREŞTII DE JOS",58918,1,PART,PRCNCT,PRSD,PRSD_SV,"2025-05-18 21:17:11",161,117,69,46,2,116,1,176,59,68,48
13,CLUJ,"ŞCOALA GENERALĂ",584,"PETREŞTII DE JOS",58918,1,PART,PRCNCT,PRSD,PRSD_SV,"2025-05-18 21:20:00",91,75,39,36,0,75,0,99,24,41,34
13,CLUJ,"CAMINUL CULTURAL",585,"PETREŞTII DE JOS",58918,1,PART,PRCNCT,PRSD,PRSD_SV,"2025-05-18 21:20:15",72,57,25,28,4,57,0,78,21,34,23
13,CLUJ,"CASA PARTICULARA",586,"PETREŞTII DE JOS",58918,1,PART,PRCNCT,PRSD,PRSD_SV,"2025-05-18 21:15:48",93,65,26,39,0,65,0,101,36,27,38
13,CLUJ,"CĂMINUL CULTURAL",587,PLOSCOŞ,58990,1,PART,PRCNCT,PRSD,PRSD_SV,"2025-05-18 21:40:25",313,223,141,82,0,218,5,343,120,103,115
13,CLUJ,"ŞCOALA CU CLASELE I-IV",588,PLOSCOŞ,58990,1,PART,PRCNCT,PRSD,PRSD_SV,"2025-05-18 21:26:15",216,126,103,23,0,124,2,237,111,66,58
13,CLUJ,"PRIMĂRIA COMUNEI POIENI",589,POIENI,59041,1,PART,PRCNCT,PRSD,PRSD_SV,"2025-05-18 21:36:49",902,499,384,114,1,492,7,991,492,265,227
13,CLUJ,"CĂMIN CULTURAL BOLOGA",590,POIENI,59041,1,PART,PRCNCT,PRSD,PRSD_SV,"2025-05-18 21:48:02",465,364,273,89,2,362,2,511,147,176,186
13,CLUJ,"ŞCOALA HODIŞU",591,POIENI,59041,1,PART,PRCNCT,PRSD,PRSD_SV,"2025-05-18 21:23:12",263,158,118,40,0,158,0,288,130,89,69
13,CLUJ,"ŞCOALA LUNCA VIŞAGULUI",592,POIENI,59041,1,PART,PRCNCT,PRSD,PRSD_SV,"2025-05-18 21:36:04",170,81,61,20,0,80,1,186,105,53,27
13,CLUJ,"ŞCOALA PRIMARA MORLACA",593,POIENI,59041,1,PART,PRCNCT,PRSD,PRSD_SV,"2025-05-18 21:33:15",560,327,256,71,0,325,2,615,288,169,156
13,CLUJ,"CĂMIN CULTURAL TRANIŞU",594,POIENI,59041,2,PART,PRCNCT,PRSD,PRSD_SV,"2025-05-19 03:08:43",245,145,108,37,0,143,2,269,124,76,67
13,CLUJ,"ŞCOALA GIMNAZIALA ”AUREL MUNTEANU” VALEA DRĂGANULUI",595,POIENI,59041,1,PART,PRCNCT,PRSD,PRSD_SV,"2025-05-18 21:35:23",1268,820,667,153,0,808,12,1394,574,419,389
13,CLUJ,"ȘCOALA PRIMARĂ RECEA -CRISTUR",596,RECEA-CRISTUR,59130,1,PART,PRCNCT,PRSD,PRSD_SV,"2025-05-18 21:40:15",553,424,245,118,61,418,6,610,186,146,272
13,CLUJ,"CAMINUL CULTURAL CIUBANCA",597,RECEA-CRISTUR,59130,1,PART,PRCNCT,PRSD,PRSD_SV,"2025-05-18 21:12:02",60,62,24,31,7,61,1,69,7,26,35
13,CLUJ,ŞCOALA,598,RECEA-CRISTUR,59130,1,PART,PRCNCT,PRSD,PRSD_SV,"2025-05-18 21:26:56",133,119,79,31,9,117,2,145,26,41,76
13,CLUJ,ŞCOALA,599,RECEA-CRISTUR,59130,1,PART,PRCNCT,PRSD,PRSD_SV,"2025-05-18 21:35:29",70,128,42,84,2,127,1,156,28,36,91
13,CLUJ,ŞCOALA,600,RECEA-CRISTUR,59130,1,PART,PRCNCT,PRSD,PRSD_SV,"2025-05-18 21:21:18",69,77,33,37,7,73,4,95,18,25,48
13,CLUJ,ŞCOALA,601,RECEA-CRISTUR,59130,1,PART,PRCNCT,PRSD,PRSD_SV,"2025-05-18 21:10:58",64,77,26,37,14,77,0,99,22,24,53
13,CLUJ,"ŞCOALA GIMNAZIALĂ CU CLASELE I-VIII",602,RIŞCA,59238,1,PART,PRCNCT,PRSD,PRSD_SV,"2025-05-18 21:45:44",738,405,283,118,4,402,3,811,406,187,215
13,CLUJ,"ŞCOALA PRIMARĂ CU CLASELE I-IV",603,RIŞCA,59238,1,PART,PRCNCT,PRSD,PRSD_SV,"2025-05-18 21:34:53",301,155,126,29,0,154,1,330,175,94,60
13,CLUJ,"ŞCOALA PRIMARĂ CU CLASELE I-IV",604,RIŞCA,59238,1,PART,PRCNCT,PRSD,PRSD_SV,"2025-05-18 21:33:26",134,98,68,30,0,97,1,146,48,23,74
13,CLUJ,"CĂMINUL CULTURAL",605,SĂCUIEU,59283,1,PART,PRCNCT,PRSD,PRSD_SV,"2025-05-18 21:51:08",464,273,216,57,0,272,1,511,238,185,87
13,CLUJ,"CĂMINUL CULTURAL",606,SĂCUIEU,59283,1,PART,PRCNCT,PRSD,PRSD_SV,"2025-05-18 21:32:12",486,273,221,52,0,273,0,534,261,176,97
13,CLUJ,"CAMINUL CULTURAL",607,SĂCUIEU,59283,1,PART,PRCNCT,PRSD,PRSD_SV,"2025-05-18 21:33:59",185,105,71,34,0,105,0,203,98,64,41
13,CLUJ,ŞCOALA,608,SĂNDULEŞTI,55311,1,PART,PRCNCT,PRSD,PRSD_SV,"2025-05-18 21:52:24",643,451,329,101,21,443,8,706,255,203,240
13,CLUJ,"ŞCOALA SIMION BALINT",609,SĂNDULEŞTI,55311,1,PART,PRCNCT,PRSD,PRSD_SV,"2025-05-18 21:55:58",1192,750,622,102,26,741,9,1310,560,357,384
13,CLUJ,"CĂMINUL CULTURAL",610,SĂVĂDISLA,59327,2,PART,PRCNCT,PRSD,PRSD_SV,"2025-05-19 00:32:36",871,745,544,176,25,744,1,959,214,67,677
13,CLUJ,"ŞCOALA CU CLASELE I-VIII",611,SĂVĂDISLA,59327,1,PART,PRCNCT,PRSD,PRSD_SV,"2025-05-18 21:27:24",640,390,321,68,1,385,5,703,313,246,139
13,CLUJ,"ŞCOALA CU CLASELE I-VIII",612,SĂVĂDISLA,59327,1,PART,PRCNCT,PRSD,PRSD_SV,"2025-05-18 21:15:06",377,241,182,59,0,239,2,414,173,162,77
13,CLUJ,"CĂMINUL CULTURAL",613,SĂVĂDISLA,59327,1,PART,PRCNCT,PRSD,PRSD_SV,"2025-05-18 21:33:25",252,206,133,72,1,205,1,276,70,109,96
13,CLUJ,"ŞCOALA CU CLASELE I-IV",614,SĂVĂDISLA,59327,1,PART,PRCNCT,PRSD,PRSD_SV,"2025-05-18 21:20:15",303,225,164,55,6,223,2,332,107,33,190
13,CLUJ,"CĂMIN CULTURAL",615,SĂVĂDISLA,59327,1,PART,PRCNCT,PRSD,PRSD_SV,"2025-05-18 21:27:07",226,234,150,84,0,231,3,248,14,90,141
13,CLUJ,"CĂMINUL CULTURAL",616,SĂVĂDISLA,59327,1,PART,PRCNCT,PRSD,PRSD_SV,"2025-05-18 21:14:08",38,69,22,47,0,69,0,81,12,39,30
13,CLUJ,"CĂMINUL CULTURAL",617,SĂVĂDISLA,59327,1,PART,PRCNCT,PRSD,PRSD_SV,"2025-05-18 21:42:26",771,683,489,184,10,680,3,847,164,33,647
13,CLUJ,"ȘCOALA PROFESIONALĂ ADY ENDRE",618,SÂNCRAIU,59434,1,PART,PRCNCT,PRSD,PRSD_SV,"2025-05-18 22:08:43",911,839,614,177,48,830,9,1002,163,100,730
13,CLUJ,"ALUNISU NR.74 CAMINUL CULTURAL",619,SÂNCRAIU,59434,1,PART,PRCNCT,PRSD,PRSD_SV,"2025-05-18 21:23:11",92,99,53,44,2,96,3,125,26,27,69
13,CLUJ,"DOMOSU NR.22 CAMINUL CULTURAL",620,SÂNCRAIU,59434,1,PART,PRCNCT,PRSD,PRSD_SV,"2025-05-18 21:34:43",271,197,167,26,4,195,2,297,100,26,169
13,CLUJ,"PRIMARIA SANMARTIN",621,SÂNMĂRTIN,59498,1,PART,PRCNCT,PRSD,PRSD_SV,"2025-05-18 21:19:34",184,105,74,31,0,104,1,201,96,40,64
13,CLUJ,"SC. PRIM. CEABA",622,SÂNMĂRTIN,59498,1,PART,PRCNCT,PRSD,PRSD_SV,"2025-05-18 21:27:56",171,136,91,45,0,133,3,187,51,67,66
13,CLUJ,"SC. GIMNAZIALA CUTCA",623,SÂNMĂRTIN,59498,1,PART,PRCNCT,PRSD,PRSD_SV,"2025-05-18 21:23:20",292,233,160,44,29,230,3,320,87,103,127
13,CLUJ,"SC. PRIM. DIV-MARI",624,SÂNMĂRTIN,59498,1,PART,PRCNCT,PRSD,PRSD_SV,"2025-05-18 21:17:31",110,103,56,47,0,103,0,120,17,47,56
13,CLUJ,"SC. PRIM. DIV-MICI",625,SÂNMĂRTIN,59498,1,PART,PRCNCT,PRSD,PRSD_SV,"2025-05-18 21:15:14",49,48,17,31,0,47,1,53,5,18,29
13,CLUJ,"SC. PRIM. MAHAL",626,SÂNMĂRTIN,59498,1,PART,PRCNCT,PRSD,PRSD_SV,"2025-05-18 21:25:01",58,51,26,25,0,48,3,63,12,16,32
13,CLUJ,"CAMIN CULT. SAMBOIENI",627,SÂNMĂRTIN,59498,1,PART,PRCNCT,PRSD,PRSD_SV,"2025-05-18 21:09:04",100,89,57,32,0,89,0,109,20,27,62
13,CLUJ,"SC. PRIM. TARGUSOR",628,SÂNMĂRTIN,59498,1,PART,PRCNCT,PRSD,PRSD_SV,"2025-05-18 21:20:54",89,73,41,32,0,73,0,97,24,32,41
13,CLUJ,"SEDIUL PRIMĂRIEI",629,SÂNPAUL,59586,1,PART,PRCNCT,PRSD,PRSD_SV,"2025-05-18 22:29:25",722,456,344,106,6,452,4,793,337,232,220
13,CLUJ,"CĂMIN CULTURAL BERINDU",630,SÂNPAUL,59586,1,PART,PRCNCT,PRSD,PRSD_SV,"2025-05-18 21:21:52",338,240,173,66,1,240,0,371,131,136,104
13,CLUJ,"ȘCOALA GENERALĂ MIHĂIEȘTI",631,SÂNPAUL,59586,1,PART,PRCNCT,PRSD,PRSD_SV,"2025-05-18 21:22:17",207,143,93,50,0,142,1,227,84,62,80
13,CLUJ,"CĂMIN CULTURAL ȘARDU",632,SÂNPAUL,59586,1,PART,PRCNCT,PRSD,PRSD_SV,"2025-05-18 21:38:06",319,229,152,77,0,224,5,351,122,102,122
13,CLUJ,"MAGAZINUL COOPERAȚIEI",633,SÂNPAUL,59586,1,PART,PRCNCT,PRSD,PRSD_SV,"2025-05-18 21:19:55",167,138,74,64,0,137,1,183,45,69,68
13,CLUJ,"CAMIN CULTURAL SIC",634,SIC,59416,1,PART,PRCNCT,PRSD,PRSD_SV,"2025-05-18 21:30:45",727,427,291,108,28,424,3,798,371,41,383
13,CLUJ,"CAMIN CULTURAL SIC",635,SIC,59416,1,PART,PRCNCT,PRSD,PRSD_SV,"2025-05-18 21:21:55",1141,593,566,0,27,591,2,1255,662,33,558
13,CLUJ,"SEDIUL ADMINISTRATIV AL PRIMARIEI SUATU",636,SUATU,59657,1,PART,PRCNCT,PRSD,PRSD_SV,"2025-05-18 21:45:13",995,689,473,214,2,683,6,1095,406,201,482
13,CLUJ,"CĂMIN CULTURAL",637,SUATU,59657,1,PART,PRCNCT,PRSD,PRSD_SV,"2025-05-18 21:17:54",211,131,80,51,0,130,1,231,100,68,62
13,CLUJ,"CĂMIN CULTURAL",638,"TRITENII DE JOS",59693,1,PART,PRCNCT,PRSD,PRSD_SV,"2025-05-18 21:51:56",1248,563,518,45,0,559,4,1372,809,377,182
13,CLUJ,"CASA PARTICULARA",639,"TRITENII DE JOS",59693,1,PART,PRCNCT,PRSD,PRSD_SV,"2025-05-18 21:38:30",66,36,21,15,0,35,1,72,36,23,12
13,CLUJ,"SCOALA PRIMARA",640,"TRITENII DE JOS",59693,1,PART,PRCNCT,PRSD,PRSD_SV,"2025-05-18 21:41:32",383,227,200,27,0,226,1,420,193,82,144
13,CLUJ,"CAMIN CULTURAL",641,"TRITENII DE JOS",59693,1,PART,PRCNCT,PRSD,PRSD_SV,"2025-05-18 21:47:37",937,422,363,59,0,417,5,1031,609,267,150
13,CLUJ,"SCOALA PRIMARA",642,"TRITENII DE JOS",59693,1,PART,PRCNCT,PRSD,PRSD_SV,"2025-05-18 21:43:19",838,431,382,49,0,425,6,921,490,307,118
13,CLUJ,"CAMIN CULTURAL",643,"TRITENII DE JOS",59693,1,PART,PRCNCT,PRSD,PRSD_SV,"2025-05-18 21:51:57",227,132,113,19,0,131,1,249,117,88,43
13,CLUJ,"CĂMIN CULTURAL TURENI",644,TURENI,59764,1,PART,PRCNCT,PRSD,PRSD_SV,"2025-05-18 21:47:01",803,565,433,132,0,559,6,883,318,216,343
13,CLUJ,"CAMINUL CULTURAL CEANU MIC , NR.184",645,TURENI,59764,1,PART,PRCNCT,PRSD,PRSD_SV,"2025-05-18 21:27:31",300,155,108,47,0,153,2,329,174,65,88
13,CLUJ,"SCOALA CU CLS. I-IV COMSESTI , NR.111",646,TURENI,59764,1,PART,PRCNCT,PRSD,PRSD_SV,"2025-05-18 21:22:02",183,120,84,36,0,116,4,200,80,59,57
13,CLUJ,"SUNFISH RESTAURANT",647,TURENI,59764,1,PART,PRCNCT,PRSD,PRSD_SV,"2025-05-18 21:36:30",311,161,120,41,0,153,8,341,180,81,72
13,CLUJ,"SCOALA CU CLS. I - IV MICESTI , NR.57",648,TURENI,59764,1,PART,PRCNCT,PRSD,PRSD_SV,"2025-05-18 21:27:41",197,189,88,101,0,188,1,216,27,78,110
13,CLUJ,"PRIMĂRIA ŢAGA",649,ŢAGA,59826,1,PART,PRCNCT,PRSD,PRSD_SV,"2025-05-18 21:39:26",547,334,242,92,0,333,1,601,267,135,198
13,CLUJ,"FOSTA ŞCOALĂ I- IV NĂSAL",650,ŢAGA,59826,1,PART,PRCNCT,PRSD,PRSD_SV,"2025-05-18 21:23:04",222,167,97,70,0,167,0,243,76,113,54
13,CLUJ,"CĂMINUL CULTURAL SÎNTEJUDE",651,ŢAGA,59826,2,PART,PRCNCT,PRSD,PRSD_SV,"2025-05-19 01:23:49",193,169,92,77,0,167,2,211,42,95,72
13,CLUJ,"CĂMIN CULTURAL SÎNTIOANA",652,ŢAGA,59826,1,PART,PRCNCT,PRSD,PRSD_SV,"2025-05-18 21:24:53",443,261,197,64,0,260,1,486,225,122,138
13,CLUJ,"GRADINITA CU PROGRAM NORMAL",653,UNGURAŞ,59880,1,PART,PRCNCT,PRSD,PRSD_SV,"2025-05-18 21:50:18",734,353,325,20,8,349,4,806,453,62,287
13,CLUJ,"CAMINUL CULTURAL UNGURAS",654,UNGURAŞ,59880,1,PART,PRCNCT,PRSD,PRSD_SV,"2025-05-18 21:30:04",692,334,299,30,5,334,0,760,426,55,279
13,CLUJ,"SCOALA GIMNAZIALA BATIN",655,UNGURAŞ,59880,1,PART,PRCNCT,PRSD,PRSD_SV,"2025-05-18 21:53:49",490,258,194,64,0,258,0,538,280,126,132
13,CLUJ,"GRADINIŢA CU PROGRAM NORMAL VALEA UNGURAŞULUI",656,UNGURAŞ,59880,1,PART,PRCNCT,PRSD,PRSD_SV,"2025-05-18 21:28:02",152,91,66,25,0,88,3,166,75,60,28
13,CLUJ,"CĂMIN CULTURAL VAD",657,VAD,59942,1,PART,PRCNCT,PRSD,PRSD_SV,"2025-05-18 21:29:29",261,226,156,68,2,221,5,286,60,106,115
13,CLUJ,"CENTRU DE ZI PENTRU COPII",658,VAD,59942,1,PART,PRCNCT,PRSD,PRSD_SV,"2025-05-18 21:26:56",176,142,99,32,11,140,2,193,51,59,81
13,CLUJ,"GRĂDINIȚA BOGATA DE SUS",659,VAD,59942,1,PART,PRCNCT,PRSD,PRSD_SV,"2025-05-18 21:18:58",210,194,135,45,14,190,4,230,36,69,121
13,CLUJ,"CĂMIN CULTURAL CALNA",660,VAD,59942,1,PART,PRCNCT,PRSD,PRSD_SV,"2025-05-18 21:20:31",117,96,54,38,4,93,3,129,33,44,49
13,CLUJ,"CĂMIN CULTURAL CETAN",661,VAD,59942,1,PART,PRCNCT,PRSD,PRSD_SV,"2025-05-18 21:32:23",513,329,245,60,24,326,3,563,234,189,137
13,CLUJ,"ȘCOALA CURTUIUȘ",662,VAD,59942,1,PART,PRCNCT,PRSD,PRSD_SV,"2025-05-18 21:08:55",134,103,74,25,4,101,2,146,43,67,34
13,CLUJ,"ȘCOALA VALEA GROȘILOR",663,VAD,59942,1,PART,PRCNCT,PRSD,PRSD_SV,"2025-05-18 21:28:13",208,159,90,62,7,159,0,228,69,64,95
13,CLUJ,"ȘCOALA GIMNAZIALĂ VALEA IERII",664,"VALEA IERII",60026,1,PART,PRCNCT,PRSD,PRSD_SV,"2025-05-18 21:43:17",756,456,371,83,2,452,4,831,375,285,167
13,CLUJ,"SCOALA GEN CLS I-VIII",665,VIIŞOARA,60062,1,PART,PRCNCT,PRSD,PRSD_SV,"2025-05-18 21:47:11",1366,733,663,70,0,722,11,1503,770,214,508
13,CLUJ,"ȘCOALA GIMNAZIALA VIIȘOARA CORP II",666,VIIŞOARA,60062,1,PART,PRCNCT,PRSD,PRSD_SV,"2025-05-18 21:38:03",1378,653,600,52,1,644,9,1517,864,334,310
13,CLUJ,"ȘCOALA GIMNAZIALA VIIȘOARA CORP II",667,VIIŞOARA,60062,1,PART,PRCNCT,PRSD,PRSD_SV,"2025-05-18 21:42:58",1262,532,470,62,0,527,5,1388,856,366,161
13,CLUJ,"ȘCOALA PRIMARĂ URCA CORP I",668,VIIŞOARA,60062,1,PART,PRCNCT,PRSD,PRSD_SV,"2025-05-18 21:37:54",753,379,326,52,1,370,9,827,448,160,210
13,CLUJ,"PRIMARIA COMUNEI VULTURENI",669,VULTURENI,60099,1,PART,PRCNCT,PRSD,PRSD_SV,"2025-05-18 21:43:08",335,248,144,94,10,247,1,368,120,113,134
13,CLUJ,"CAMIN CULTURAL BABUTIU",670,VULTURENI,60099,1,PART,PRCNCT,PRSD,PRSD_SV,"2025-05-18 21:29:02",217,168,104,64,0,164,4,238,70,90,74
13,CLUJ,"CAMINUL CULTURAL BADESTI",671,VULTURENI,60099,2,PART,PRCNCT,PRSD,PRSD_SV,"2025-05-19 03:29:24",106,105,63,42,0,105,0,126,21,38,67
13,CLUJ,"FUNDATIA KIDE",672,VULTURENI,60099,1,PART,PRCNCT,PRSD,PRSD_SV,"2025-05-18 21:18:49",112,149,62,81,6,149,0,172,23,11,138
13,CLUJ,"CAMINUL CULTURAL FAURENI",673,VULTURENI,60099,1,PART,PRCNCT,PRSD,PRSD_SV,"2025-05-18 21:16:57",159,133,75,58,0,132,1,175,42,82,50
13,CLUJ,"SCOALA SOIMENI",674,VULTURENI,60099,1,PART,PRCNCT,PRSD,PRSD_SV,"2025-05-18 21:22:47",271,221,134,87,0,220,1,297,76,80,140
14,CONSTANŢA,"COLEGIUL NATIONAL ” MIHAI EMINESCU”",1,"MUNICIPIUL CONSTANŢA",60419,2,PART,PRCNCT,PRSD,PRSD_SV,"2025-05-19 00:34:08",1934,636,437,199,0,631,5,1997,1361,244,387
14,CONSTANŢA,"COLEGIUL NATIONAL ” MIHAI EMINESCU”",2,"MUNICIPIUL CONSTANŢA",60419,1,PART,PRCNCT,PRSD,PRSD_SV,"2025-05-18 21:56:55",558,471,268,203,0,466,5,700,229,141,325
14,CONSTANŢA,"COLEGIUL NAȚIONAL „MIHAI EMINESCU„",3,"MUNICIPIUL CONSTANŢA",60419,1,PART,PRCNCT,PRSD,PRSD_SV,"2025-05-18 21:51:26",767,454,371,80,3,452,2,800,346,182,270
14,CONSTANŢA,"COLEGIUL NAŢIONAL MIRCEA CEL BĂTRÂN",4,"MUNICIPIUL CONSTANŢA",60419,1,PART,PRCNCT,PRSD,PRSD_SV,"2025-05-18 21:41:22",552,638,307,331,0,627,11,900,262,183,444
14,CONSTANŢA,"COLEGIUL NAŢIONAL MIRCEA CEL BĂTRÂN",5,"MUNICIPIUL CONSTANŢA",60419,1,PART,PRCNCT,PRSD,PRSD_SV,"2025-05-18 21:49:39",547,605,314,287,4,599,6,800,195,154,445
14,CONSTANŢA,"ŞCOALA GIMNAZIALA NR.28 ” DAN BARBILIAN”",6,"MUNICIPIUL CONSTANŢA",60419,1,PART,PRCNCT,PRSD,PRSD_SV,"2025-05-18 21:25:11",398,235,206,27,2,233,2,500,265,74,159
14,CONSTANŢA,"COLEGIUL COMERCIAL ”CAROL I”",7,"MUNICIPIUL CONSTANŢA",60419,1,PART,PRCNCT,PRSD,PRSD_SV,"2025-05-18 21:40:08",1240,874,742,132,0,864,10,1300,426,211,653
14,CONSTANŢA,"COLEGIUL COMERCIAL ”CAROL I”",8,"MUNICIPIUL CONSTANŢA",60419,1,PART,PRCNCT,PRSD,PRSD_SV,"2025-05-18 21:54:19",807,546,470,75,1,539,7,900,354,153,386
14,CONSTANŢA,"COLEGIUL NATIONAL PEDAGOGIC ”CONSTANTIN BRĂTESCU”",9,"MUNICIPIUL CONSTANŢA",60419,1,PART,PRCNCT,PRSD,PRSD_SV,"2025-05-18 21:39:41",1424,864,798,65,1,853,11,1500,636,286,567
14,CONSTANŢA,"COLEGIUL NATIONAL PEDAGOGIC ”CONSTANTIN BRĂTESCU”",10,"MUNICIPIUL CONSTANŢA",60419,1,PART,PRCNCT,PRSD,PRSD_SV,"2025-05-18 21:37:39",1103,717,600,111,6,704,13,1200,483,235,469
14,CONSTANŢA,"COLEGIUL NATIONAL PEDAGOGIC ”CONSTANTIN BRĂTESCU”",11,"MUNICIPIUL CONSTANŢA",60419,1,PART,PRCNCT,PRSD,PRSD_SV,"2025-05-18 21:46:15",1141,734,639,94,1,721,13,1300,566,224,497
14,CONSTANŢA,"LICEUL TEHNOLOGIC ”IOAN N.ROMAN” (ŞCOALA NR.25)",12,"MUNICIPIUL CONSTANŢA",60419,1,PART,PRCNCT,PRSD,PRSD_SV,"2025-05-18 21:32:03",1039,636,543,92,1,630,6,1100,463,279,351
14,CONSTANŢA,"LICEUL TEHNOLOGIC ”IOAN N.ROMAN” (ŞCOALA NR.25)",13,"MUNICIPIUL CONSTANŢA",60419,1,PART,PRCNCT,PRSD,PRSD_SV,"2025-05-18 22:06:11",980,562,528,34,0,552,10,1100,538,224,328
14,CONSTANŢA,"BAROUL CONSTANȚA",14,"MUNICIPIUL CONSTANŢA",60419,1,PART,PRCNCT,PRSD,PRSD_SV,"2025-05-18 22:03:56",612,413,324,75,14,407,6,700,287,131,276
14,CONSTANŢA,"BAROUL CONSTANȚA",15,"MUNICIPIUL CONSTANŢA",60419,1,PART,PRCNCT,PRSD,PRSD_SV,"2025-05-18 22:12:54",771,485,436,47,2,476,9,800,315,162,314
14,CONSTANŢA,"LICEUL TEORETIC ”TRAIAN”",16,"MUNICIPIUL CONSTANŢA",60419,1,PART,PRCNCT,PRSD,PRSD_SV,"2025-05-18 21:58:16",745,531,434,87,10,524,7,900,369,143,381
14,CONSTANŢA,"LICEUL TEORETIC ”TRAIAN”",17,"MUNICIPIUL CONSTANŢA",60419,1,PART,PRCNCT,PRSD,PRSD_SV,"2025-05-18 21:32:51",406,344,233,96,15,338,6,600,256,102,236
14,CONSTANŢA,"LICEUL TEORETIC ”TRAIAN”",18,"MUNICIPIUL CONSTANŢA",60419,1,PART,PRCNCT,PRSD,PRSD_SV,"2025-05-18 22:14:42",1257,771,704,61,6,761,10,1400,629,229,532
14,CONSTANŢA,"ŞCOALA GIMNAZIALA NR. 24 ”ION JALEA”",19,"MUNICIPIUL CONSTANŢA",60419,1,PART,PRCNCT,PRSD,PRSD_SV,"2025-05-18 22:07:43",1204,775,646,128,1,768,7,1300,525,246,522
14,CONSTANŢA,"ŞCOALA GIMNAZIALA NR. 24 ”ION JALEA”",20,"MUNICIPIUL CONSTANŢA",60419,1,PART,PRCNCT,PRSD,PRSD_SV,"2025-05-18 21:43:13",1038,698,648,49,1,688,10,1100,402,205,483
14,CONSTANŢA,"ŞCOALA GIMNAZIALA NR. 24 ”ION JALEA”",21,"MUNICIPIUL CONSTANŢA",60419,1,PART,PRCNCT,PRSD,PRSD_SV,"2025-05-18 21:48:45",1395,836,809,26,1,825,11,1508,672,245,580
14,CONSTANŢA,"LICEUL CU PROGRAM SPORTIV ”NICOLAE ROTARU ” (ŞCOALA NR.34)",22,"MUNICIPIUL CONSTANŢA",60419,1,PART,PRCNCT,PRSD,PRSD_SV,"2025-05-18 23:20:24",1304,857,746,109,2,845,12,1400,543,270,575
14,CONSTANŢA,"LICEUL CU PROGRAM SPORTIV ”NICOLAE ROTARU ” (ŞCOALA NR.34)",23,"MUNICIPIUL CONSTANŢA",60419,1,PART,PRCNCT,PRSD,PRSD_SV,"2025-05-18 21:54:54",1028,629,561,67,1,618,11,1100,471,233,385
14,CONSTANŢA,"LICEUL CU PROGRAM SPORTIV ”NICOLAE ROTARU ” (ŞCOALA NR.34)",24,"MUNICIPIUL CONSTANŢA",60419,1,PART,PRCNCT,PRSD,PRSD_SV,"2025-05-18 21:50:24",1187,727,677,50,0,721,6,1300,573,277,444
14,CONSTANŢA,"LICEUL CU PROGRAM SPORTIV ”NICOLAE ROTARU ” (ŞCOALA NR.34)",25,"MUNICIPIUL CONSTANŢA",60419,2,PART,PRCNCT,PRSD,PRSD_SV,"2025-05-18 22:43:37",1331,868,807,61,0,857,11,1500,632,217,640
14,CONSTANŢA,"COLEGIUL NAȚIONAL DE ARTE ”REGINA MARIA” (ȘCOALA NR. 42)",26,"MUNICIPIUL CONSTANŢA",60419,1,PART,PRCNCT,PRSD,PRSD_SV,"2025-05-18 21:49:38",851,551,483,67,1,540,11,900,349,187,353
14,CONSTANŢA,"COLEGIUL NAȚIONAL DE ARTE ”REGINA MARIA” (ȘCOALA NR. 42)",27,"MUNICIPIUL CONSTANŢA",60419,2,PART,PRCNCT,PRSD,PRSD_SV,"2025-05-18 22:59:41",820,603,533,67,3,594,9,900,297,199,395
14,CONSTANŢA,"COLEGIUL NAȚIONAL DE ARTE ”REGINA MARIA” (ȘCOALA NR. 42)",28,"MUNICIPIUL CONSTANŢA",60419,1,PART,PRCNCT,PRSD,PRSD_SV,"2025-05-18 22:00:56",911,539,501,38,0,534,5,1000,461,176,358
14,CONSTANŢA,"COLEGIUL NAȚIONAL DE ARTE ”REGINA MARIA” (ȘCOALA NR. 42)",29,"MUNICIPIUL CONSTANŢA",60419,1,PART,PRCNCT,PRSD,PRSD_SV,"2025-05-18 21:50:33",506,359,306,53,0,353,6,600,241,113,240
14,CONSTANŢA,"LICEUL TEORETIC ”OVIDIUS”",30,"MUNICIPIUL CONSTANŢA",60419,1,PART,PRCNCT,PRSD,PRSD_SV,"2025-05-18 22:19:53",1478,923,791,125,7,916,7,1700,777,309,607
14,CONSTANŢA,"LICEUL TEORETIC ”OVIDIUS”",31,"MUNICIPIUL CONSTANŢA",60419,1,PART,PRCNCT,PRSD,PRSD_SV,"2025-05-18 22:22:09",1156,803,645,157,1,786,17,1300,497,305,481
14,CONSTANŢA,"ANEXĂ ŞCOALA GIMNAZIALĂ NR.8",32,"MUNICIPIUL CONSTANŢA",60419,1,PART,PRCNCT,PRSD,PRSD_SV,"2025-05-18 21:27:21",831,535,462,73,0,526,9,900,365,212,314
14,CONSTANŢA,"ANEXĂ ŞCOALA GIMNAZIALĂ NR.8",33,"MUNICIPIUL CONSTANŢA",60419,1,PART,PRCNCT,PRSD,PRSD_SV,"2025-05-18 21:32:36",1458,864,774,89,1,847,17,1600,736,320,527
14,CONSTANŢA,"ANEXĂ ŞCOALA GIMNAZIALĂ NR.8",34,"MUNICIPIUL CONSTANŢA",60419,1,PART,PRCNCT,PRSD,PRSD_SV,"2025-05-18 21:44:20",1189,610,542,68,0,602,8,1200,590,339,263
14,CONSTANŢA,"ANEXĂ ŞCOALA GIMNAZIALĂ NR.8",35,"MUNICIPIUL CONSTANŢA",60419,1,PART,PRCNCT,PRSD,PRSD_SV,"2025-05-18 21:36:18",1013,542,502,39,1,538,4,1100,558,227,311
14,CONSTANŢA,"ANEXĂ ŞCOALA GIMNAZIALĂ NR.8",36,"MUNICIPIUL CONSTANŢA",60419,1,PART,PRCNCT,PRSD,PRSD_SV,"2025-05-18 21:35:30",1059,566,548,18,0,551,15,1100,534,216,335
14,CONSTANŢA,"ANEXĂ ŞCOALA GIMNAZIALĂ NR.8",37,"MUNICIPIUL CONSTANŢA",60419,1,PART,PRCNCT,PRSD,PRSD_SV,"2025-05-18 21:58:48",1720,930,881,48,1,919,11,1800,870,395,524
14,CONSTANŢA,"LICEUL TEHNOLOGIC ”C.A.ROSETTI”",38,"MUNICIPIUL CONSTANŢA",60419,1,PART,PRCNCT,PRSD,PRSD_SV,"2025-05-18 21:46:57",982,664,596,55,13,651,13,1200,536,197,454
14,CONSTANŢA,"LICEUL TEHNOLOGIC ”C.A.ROSETTI”",39,"MUNICIPIUL CONSTANŢA",60419,1,PART,PRCNCT,PRSD,PRSD_SV,"2025-05-18 21:39:07",1026,597,534,63,0,586,11,1100,503,235,351
14,CONSTANŢA,"LICEUL TEHNOLOGIC ”C.A.ROSETTI”",40,"MUNICIPIUL CONSTANŢA",60419,1,PART,PRCNCT,PRSD,PRSD_SV,"2025-05-18 21:35:29",1175,843,674,169,0,833,10,1300,457,299,534
14,CONSTANŢA,"LICEUL TEHNOLOGIC ”C.A.ROSETTI”",41,"MUNICIPIUL CONSTANŢA",60419,1,PART,PRCNCT,PRSD,PRSD_SV,"2025-05-18 21:52:15",792,546,478,68,0,540,6,900,354,180,360
14,CONSTANŢA,"ŞCOALA GIMNAZIALA NR. 16 ”MARIN IONESCU DOBROGIANU”",42,"MUNICIPIUL CONSTANŢA",60419,1,PART,PRCNCT,PRSD,PRSD_SV,"2025-05-18 21:57:37",1515,1076,863,213,0,1059,17,1700,624,388,671
14,CONSTANŢA,"ŞCOALA GIMNAZIALA NR. 16 ”MARIN IONESCU DOBROGIANU”",43,"MUNICIPIUL CONSTANŢA",60419,1,PART,PRCNCT,PRSD,PRSD_SV,"2025-05-18 21:25:49",1458,899,772,127,0,885,14,1600,701,387,498
14,CONSTANŢA,"ŞCOALA GIMNAZIALA NR. 16 ”MARIN IONESCU DOBROGIANU”",44,"MUNICIPIUL CONSTANŢA",60419,1,PART,PRCNCT,PRSD,PRSD_SV,"2025-05-18 21:49:09",1508,935,862,73,0,915,20,1700,765,332,583
14,CONSTANŢA,"ŞCOALA GIMNAZIALA NR. 16 ”MARIN IONESCU DOBROGIANU”",45,"MUNICIPIUL CONSTANŢA",60419,1,PART,PRCNCT,PRSD,PRSD_SV,"2025-05-18 21:43:02",1385,745,681,63,1,738,7,1500,755,333,405
14,CONSTANŢA,"ŞCOALA GIMNAZIALA NR. 16 ”MARIN IONESCU DOBROGIANU”",46,"MUNICIPIUL CONSTANŢA",60419,1,PART,PRCNCT,PRSD,PRSD_SV,"2025-05-18 22:02:02",1411,849,803,46,0,831,18,1600,751,309,522
14,CONSTANŢA,"LICEUL TEORETIC ” LUCIAN BLAGA”",47,"MUNICIPIUL CONSTANŢA",60419,1,PART,PRCNCT,PRSD,PRSD_SV,"2025-05-18 22:03:17",1617,972,866,104,2,957,15,1800,828,443,514
14,CONSTANŢA,"LICEUL TEORETIC ”LUCIAN BLAGA”",48,"MUNICIPIUL CONSTANŢA",60419,1,PART,PRCNCT,PRSD,PRSD_SV,"2025-05-18 21:37:15",1664,877,801,75,1,860,17,1800,923,385,475
14,CONSTANŢA,"LICEUL TEORETIC ”LUCIAN BLAGA”",49,"MUNICIPIUL CONSTANŢA",60419,1,PART,PRCNCT,PRSD,PRSD_SV,"2025-05-18 21:58:39",1391,833,749,84,0,818,15,1500,667,321,497
14,CONSTANŢA,"LICEUL TEORETIC ”LUCIAN BLAGA”",50,"MUNICIPIUL CONSTANŢA",60419,1,PART,PRCNCT,PRSD,PRSD_SV,"2025-05-18 22:20:04",1550,904,845,59,0,893,11,1700,796,359,534
14,CONSTANŢA,"LICEUL TEORETIC ”LUCIAN BLAGA”",51,"MUNICIPIUL CONSTANŢA",60419,1,PART,PRCNCT,PRSD,PRSD_SV,"2025-05-18 21:54:16",1548,980,874,106,0,966,14,1700,720,413,553
14,CONSTANŢA,"LICEUL TEORETIC ”LUCIAN BLAGA”",52,"MUNICIPIUL CONSTANŢA",60419,1,PART,PRCNCT,PRSD,PRSD_SV,"2025-05-18 22:22:19",1374,846,794,51,1,835,11,1500,654,325,510
14,CONSTANŢA,"LICEUL TEORETIC ”LUCIAN BLAGA”",53,"MUNICIPIUL CONSTANŢA",60419,1,PART,PRCNCT,PRSD,PRSD_SV,"2025-05-18 21:23:45",1397,843,790,53,0,831,12,1500,657,324,507
14,CONSTANŢA,"SCOALA GIMNAZIALA ”GRIGORE ANTIPA” (ŞCOALA NR. 15 )",54,"MUNICIPIUL CONSTANŢA",60419,1,PART,PRCNCT,PRSD,PRSD_SV,"2025-05-18 21:31:05",1402,839,808,31,0,832,7,1500,661,395,437
14,CONSTANŢA,"SCOALA GIMNAZIALA ”GRIGORE ANTIPA” (ŞCOALA NR. 15 )",55,"MUNICIPIUL CONSTANŢA",60419,1,PART,PRCNCT,PRSD,PRSD_SV,"2025-05-18 21:57:54",1834,1092,1028,64,0,1079,13,2000,908,464,615
14,CONSTANŢA,"SCOALA GIMNAZIALA ”GRIGORE ANTIPA” (ŞCOALA NR. 15 )",56,"MUNICIPIUL CONSTANŢA",60419,1,PART,PRCNCT,PRSD,PRSD_SV,"2025-05-18 21:40:16",831,507,434,73,0,499,8,886,379,237,262
14,CONSTANŢA,"ŞCOALA GIMNAZIALA NR. 17 ”ION MINULESCU”",57,"MUNICIPIUL CONSTANŢA",60419,1,PART,PRCNCT,PRSD,PRSD_SV,"2025-05-18 22:23:51",1824,1093,1033,59,1,1081,12,2000,907,467,614
14,CONSTANŢA,"ŞCOALA GIMNAZIALA NR. 17 ”ION MINULESCU”",58,"MUNICIPIUL CONSTANŢA",60419,1,PART,PRCNCT,PRSD,PRSD_SV,"2025-05-18 21:48:29",1802,1101,1002,98,1,1078,23,2000,898,422,656
14,CONSTANŢA,"ŞCOALA GIMNAZIALA NR. 17 ”ION MINULESCU”",59,"MUNICIPIUL CONSTANŢA",60419,1,PART,PRCNCT,PRSD,PRSD_SV,"2025-05-18 21:37:36",1625,953,877,74,2,944,9,1800,847,434,510
14,CONSTANŢA,"ŞCOALA GIMNAZIALA NR. 17 ”ION MINULESCU”",60,"MUNICIPIUL CONSTANŢA",60419,1,PART,PRCNCT,PRSD,PRSD_SV,"2025-05-18 22:16:01",1574,945,885,60,0,929,16,1700,755,417,512
14,CONSTANŢA,"ŞCOALA GIMNAZIALA NR. 33 ”ANGHEL SALIGNY”",61,"MUNICIPIUL CONSTANŢA",60419,1,PART,PRCNCT,PRSD,PRSD_SV,"2025-05-18 21:48:38",1153,658,633,25,0,643,15,1300,642,292,351
14,CONSTANŢA,"ŞCOALA GIMNAZIALA NR. 33 ”ANGHEL SALIGNY”",62,"MUNICIPIUL CONSTANŢA",60419,1,PART,PRCNCT,PRSD,PRSD_SV,"2025-05-18 21:58:25",1483,868,807,60,1,854,14,1600,732,358,496
14,CONSTANŢA,"ŞCOALA GIMNAZIALA NR. 33 ”ANGHEL SALIGNY”",63,"MUNICIPIUL CONSTANŢA",60419,2,PART,PRCNCT,PRSD,PRSD_SV,"2025-05-19 02:28:24",875,559,495,64,0,553,6,998,439,213,340
14,CONSTANŢA,"ŞCOALA GIMNAZIALA NR. 33 ”ANGHEL SALIGNY”",64,"MUNICIPIUL CONSTANŢA",60419,2,PART,PRCNCT,PRSD,PRSD_SV,"2025-05-19 02:27:01",1395,893,840,53,0,878,15,1500,607,325,553
14,CONSTANŢA,"ŞCOALA GIMNAZIALA NR. 37",65,"MUNICIPIUL CONSTANŢA",60419,1,PART,PRCNCT,PRSD,PRSD_SV,"2025-05-18 22:32:43",1083,646,585,61,0,635,11,1200,554,282,353
14,CONSTANŢA,"ŞCOALA GIMNAZIALA NR. 37",66,"MUNICIPIUL CONSTANŢA",60419,1,PART,PRCNCT,PRSD,PRSD_SV,"2025-05-18 21:45:03",1143,691,612,79,0,680,11,1300,609,308,372
14,CONSTANŢA,"ŞCOALA GIMNAZIALA NR. 37",67,"MUNICIPIUL CONSTANŢA",60419,1,PART,PRCNCT,PRSD,PRSD_SV,"2025-05-18 21:55:05",1150,780,629,151,0,773,7,1300,520,309,464
14,CONSTANŢA,"ŞCOALA GIMNAZIALA NR. 18 ”JEAN BART”",68,"MUNICIPIUL CONSTANŢA",60419,1,PART,PRCNCT,PRSD,PRSD_SV,"2025-05-18 21:29:58",1117,772,645,126,1,762,10,1200,428,320,442
14,CONSTANŢA,"ŞCOALA GIMNAZIALA NR. 18 ”JEAN BART”",69,"MUNICIPIUL CONSTANŢA",60419,1,PART,PRCNCT,PRSD,PRSD_SV,"2025-05-18 21:38:22",1668,967,916,49,2,958,9,1800,833,401,557
14,CONSTANŢA,"ŞCOALA GIMNAZIALA NR. 18 ”JEAN BART”",70,"MUNICIPIUL CONSTANŢA",60419,1,PART,PRCNCT,PRSD,PRSD_SV,"2025-05-18 21:34:30",1190,708,677,29,2,703,5,1300,592,293,410
14,CONSTANŢA,"ŞCOALA GIMNAZIALA NR. 18 ”JEAN BART”",71,"MUNICIPIUL CONSTANŢA",60419,1,PART,PRCNCT,PRSD,PRSD_SV,"2025-05-18 21:30:59",999,645,607,38,0,641,4,1100,455,245,396
14,CONSTANŢA,"LICEUL TEHNOLOGIC ”GHEORGHE MIRON COSTIN” (INDUSTRIE ALIMENTARA)",72,"MUNICIPIUL CONSTANŢA",60419,1,PART,PRCNCT,PRSD,PRSD_SV,"2025-05-18 21:37:46",1172,692,620,72,0,680,12,1300,608,306,374
14,CONSTANŢA,"LICEUL TEHNOLOGIC ”GHEORGHE MIRON COSTIN” (INDUSTRIE ALIMENTARA)",73,"MUNICIPIUL CONSTANŢA",60419,1,PART,PRCNCT,PRSD,PRSD_SV,"2025-05-18 21:54:58",1514,885,801,84,0,878,7,1700,815,401,477
14,CONSTANŢA,"LICEUL TEHNOLOGIC ”DIMITRIE LEONIDA”",74,"MUNICIPIUL CONSTANŢA",60419,1,PART,PRCNCT,PRSD,PRSD_SV,"2025-05-18 21:44:54",1584,993,939,54,0,983,8,1700,707,416,567
14,CONSTANŢA,"LICEUL TEHNOLOGIC ”DIMITRIE LEONIDA”",75,"MUNICIPIUL CONSTANŢA",60419,1,PART,PRCNCT,PRSD,PRSD_SV,"2025-05-18 21:42:02",1607,984,909,74,1,967,17,1800,816,425,542
14,CONSTANŢA,"ŞCOALA GIMNAZIALA NR. 40 ”AUREL VLAICU”",76,"MUNICIPIUL CONSTANŢA",60419,1,PART,PRCNCT,PRSD,PRSD_SV,"2025-05-18 22:06:42",1487,836,726,110,0,815,21,1600,764,437,378
14,CONSTANŢA,"ŞCOALA GIMNAZIALA NR. 40 ”AUREL VLAICU”",77,"MUNICIPIUL CONSTANŢA",60419,1,PART,PRCNCT,PRSD,PRSD_SV,"2025-05-18 21:43:49",743,466,399,66,1,456,10,800,334,213,243
14,CONSTANŢA,"ŞCOALA GIMNAZIALA NR. 40 ”AUREL VLAICU”",78,"MUNICIPIUL CONSTANŢA",60419,1,PART,PRCNCT,PRSD,PRSD_SV,"2025-05-18 21:33:47",1289,799,723,76,0,784,15,1400,601,388,396
14,CONSTANŢA,"ŞCOALA GIMNAZIALA NR. 40 ”AUREL VLAICU”",79,"MUNICIPIUL CONSTANŢA",60419,1,PART,PRCNCT,PRSD,PRSD_SV,"2025-05-18 21:38:51",1458,812,760,51,1,796,16,1600,788,400,396
14,CONSTANŢA,"ŞCOALA GIMNAZIALA NR. 40 ”AUREL VLAICU”",80,"MUNICIPIUL CONSTANŢA",60419,1,PART,PRCNCT,PRSD,PRSD_SV,"2025-05-18 21:39:52",718,406,370,36,0,401,5,800,394,206,195
14,CONSTANŢA,"ŞCOALA GIMNAZIALA NR. 40 ”AUREL VLAICU”",81,"MUNICIPIUL CONSTANŢA",60419,1,PART,PRCNCT,PRSD,PRSD_SV,"2025-05-18 21:47:49",745,378,344,32,2,369,9,800,422,153,216
14,CONSTANŢA,"ŞCOALA GIMNAZIALA NR. 40 ”AUREL VLAICU”",82,"MUNICIPIUL CONSTANŢA",60419,1,PART,PRCNCT,PRSD,PRSD_SV,"2025-05-18 21:40:17",1085,464,417,47,0,456,8,1200,736,300,156
14,CONSTANŢA,"GRĂDINIȚA CU PROGRAM NORMAL NR.34",83,"MUNICIPIUL CONSTANŢA",60419,1,PART,PRCNCT,PRSD,PRSD_SV,"2025-05-18 21:45:35",1551,867,814,53,0,855,12,1700,833,471,384
14,CONSTANŢA,"GRĂDINIȚA CU PROGRAM NORMAL NR.34",84,"MUNICIPIUL CONSTANŢA",60419,1,PART,PRCNCT,PRSD,PRSD_SV,"2025-05-18 22:01:37",1208,706,657,49,0,695,11,1300,594,343,352
14,CONSTANŢA,"ŞCOALA GIMNAZIALA NR. 31",85,"MUNICIPIUL CONSTANŢA",60419,1,PART,PRCNCT,PRSD,PRSD_SV,"2025-05-18 21:51:06",1446,787,696,91,0,782,5,1600,813,457,325
14,CONSTANŢA,"ŞCOALA GIMNAZIALA NR. 31",86,"MUNICIPIUL CONSTANŢA",60419,1,PART,PRCNCT,PRSD,PRSD_SV,"2025-05-18 21:54:27",1159,618,530,88,0,607,11,1300,682,386,221
14,CONSTANŢA,"ŞCOALA GIMNAZIALA NR. 31",87,"MUNICIPIUL CONSTANŢA",60419,1,PART,PRCNCT,PRSD,PRSD_SV,"2025-05-18 22:05:48",1182,530,495,35,0,518,12,1300,770,347,171
14,CONSTANŢA,"LICEUL TEHNOLOGIC ”GHEORGHE DUCA”",88,"MUNICIPIUL CONSTANŢA",60419,1,PART,PRCNCT,PRSD,PRSD_SV,"2025-05-18 21:47:00",1628,918,824,94,0,909,9,1800,882,462,447
14,CONSTANŢA,"ŞCOALA GIMNAZIALA ”MARIN SORESCU” (SCOALA NR. 20 )",89,"MUNICIPIUL CONSTANŢA",60419,1,PART,PRCNCT,PRSD,PRSD_SV,"2025-05-18 22:01:58",773,436,395,41,0,433,3,900,464,243,190
14,CONSTANŢA,"ŞCOALA GIMNAZIALA NR. 22 ”I.C.BRATIANU”",90,"MUNICIPIUL CONSTANŢA",60419,1,PART,PRCNCT,PRSD,PRSD_SV,"2025-05-18 21:50:56",1689,919,861,57,1,909,10,1900,981,435,474
14,CONSTANŢA,"ŞCOALA GIMNAZIALA NR. 22 ”I.C.BRATIANU”",91,"MUNICIPIUL CONSTANŢA",60419,1,PART,PRCNCT,PRSD,PRSD_SV,"2025-05-18 21:49:41",1171,674,624,49,1,663,11,1300,626,354,309
14,CONSTANŢA,"CENTRUL SCOLAR PENTRU EDUCATIE INCLUZIVA”MARIA MONTESSORI” (ŞCOALA AJUTATOARE NR. 2)",92,"MUNICIPIUL CONSTANŢA",60419,1,PART,PRCNCT,PRSD,PRSD_SV,"2025-05-18 21:26:56",1513,816,792,24,0,808,8,1700,884,399,409
14,CONSTANŢA,"CENTRUL SCOLAR PENTRU EDUCATIE INCLUZIVA”MARIA MONTESSORI” (ŞCOALA AJUTATOARE NR. 2)",93,"MUNICIPIUL CONSTANŢA",60419,1,PART,PRCNCT,PRSD,PRSD_SV,"2025-05-18 21:17:04",765,469,438,31,0,465,4,800,331,160,305
14,CONSTANŢA,"CENTRUL SCOLAR PENTRU EDUCATIE INCLUZIVA”MARIA MONTESSORI” (ŞCOALA AJUTATOARE NR. 2)",94,"MUNICIPIUL CONSTANŢA",60419,1,PART,PRCNCT,PRSD,PRSD_SV,"2025-05-18 21:32:07",983,580,540,39,1,571,9,1100,520,219,352
14,CONSTANŢA,"CENTRUL SCOLAR PENTRU EDUCATIE INCLUZIVA”MARIA MONTESSORI” (ŞCOALA AJUTATOARE NR. 2)",95,"MUNICIPIUL CONSTANŢA",60419,1,PART,PRCNCT,PRSD,PRSD_SV,"2025-05-18 21:14:15",809,493,445,48,0,487,6,900,407,213,274
14,CONSTANŢA,"ŞCOALA GIMNAZIALA NR. 8",96,"MUNICIPIUL CONSTANŢA",60419,1,PART,PRCNCT,PRSD,PRSD_SV,"2025-05-18 21:49:57",1790,1168,952,216,0,1153,15,2000,832,508,645
14,CONSTANŢA,"ŞCOALA GIMNAZIALA NR. 8",97,"MUNICIPIUL CONSTANŢA",60419,1,PART,PRCNCT,PRSD,PRSD_SV,"2025-05-18 21:40:49",1452,914,813,101,0,901,13,1600,686,362,539
14,CONSTANŢA,"ŞCOALA GIMNAZIALA NR. 8",98,"MUNICIPIUL CONSTANŢA",60419,1,PART,PRCNCT,PRSD,PRSD_SV,"2025-05-18 21:50:46",1477,963,839,124,0,951,12,1600,637,372,579
14,CONSTANŢA,"ŞCOALA GIMNAZIALA NR. 8",99,"MUNICIPIUL CONSTANŢA",60419,1,PART,PRCNCT,PRSD,PRSD_SV,"2025-05-18 21:36:19",1617,1058,961,97,0,1044,14,1800,742,441,603
14,CONSTANŢA,"ŞCOALA GIMNAZIALA NR.23 ”CONSTANTIN BRÂNCOVEANU”",100,"MUNICIPIUL CONSTANŢA",60419,1,PART,PRCNCT,PRSD,PRSD_SV,"2025-05-18 22:00:36",1366,1110,765,345,0,1095,15,1500,390,362,733
14,CONSTANŢA,"ŞCOALA GIMNAZIALA NR.23 ”CONSTANTIN BRÂNCOVEANU”",101,"MUNICIPIUL CONSTANŢA",60419,1,PART,PRCNCT,PRSD,PRSD_SV,"2025-05-18 21:52:27",1597,1179,942,237,0,1165,14,1800,621,397,768
14,CONSTANŢA,"ŞCOALA GIMNAZIALA NR.23 ”CONSTANTIN BRÂNCOVEANU”",102,"MUNICIPIUL CONSTANŢA",60419,1,PART,PRCNCT,PRSD,PRSD_SV,"2025-05-18 22:08:39",1935,1353,1198,155,0,1340,13,2100,747,410,930
14,CONSTANŢA,"ȘCOALA GIMNAZIALA NR.23 ”CONSTANTIN BRÂNCOVEANU”",103,"MUNICIPIUL CONSTANŢA",60419,1,PART,PRCNCT,PRSD,PRSD_SV,"2025-05-18 22:03:41",1854,1226,1124,101,1,1210,16,2000,774,446,764
14,CONSTANŢA,"ŞCOALA GIMNAZIALA NR. 39 ”NICOLAE TONITZA”",104,"MUNICIPIUL CONSTANŢA",60419,1,PART,PRCNCT,PRSD,PRSD_SV,"2025-05-18 21:41:03",1648,1002,949,53,0,992,10,1800,798,357,635
14,CONSTANŢA,"ŞCOALA GIMNAZIALA NR. 39 ”NICOLAE TONITZA”",105,"MUNICIPIUL CONSTANŢA",60419,1,PART,PRCNCT,PRSD,PRSD_SV,"2025-05-18 21:37:44",1384,858,811,46,1,846,12,1500,642,270,576
14,CONSTANŢA,"ŞCOALA GIMNAZIALA NR. 39 ”NICOLAE TONITZA”",106,"MUNICIPIUL CONSTANŢA",60419,1,PART,PRCNCT,PRSD,PRSD_SV,"2025-05-18 22:02:19",1575,972,905,66,1,957,15,1700,728,360,597
14,CONSTANŢA,"ŞCOALA GIMNAZIALA NR. 39 ”NICOLAE TONITZA”",107,"MUNICIPIUL CONSTANŢA",60419,1,PART,PRCNCT,PRSD,PRSD_SV,"2025-05-18 21:41:49",1694,1162,1002,160,0,1139,23,1900,738,368,771
14,CONSTANŢA,"CENTRUL DE PERFECȚIONARE AL MARINEI CIVILE",108,"MUNICIPIUL CONSTANŢA",60419,2,PART,PRCNCT,PRSD,PRSD_SV,"2025-05-19 00:39:52",1915,1239,1112,127,0,1223,16,2100,861,430,793
14,CONSTANŢA,"CENTRUL DE PERFECȚIONARE AL MARINEI CIVILE",109,"MUNICIPIUL CONSTANŢA",60419,1,PART,PRCNCT,PRSD,PRSD_SV,"2025-05-18 21:51:43",1686,1082,927,155,0,1079,3,1900,818,419,660
14,CONSTANŢA,"CENTRUL DE PERFECȚIONARE AL MARINEI CIVILE",110,"MUNICIPIUL CONSTANŢA",60419,1,PART,PRCNCT,PRSD,PRSD_SV,"2025-05-18 22:04:34",1404,899,772,127,0,885,14,1500,601,322,563
14,CONSTANŢA,"ŞCOALA GIMNAZIALA NR. 10 ”MIHAIL KOICIU”",111,"MUNICIPIUL CONSTANŢA",60419,1,PART,PRCNCT,PRSD,PRSD_SV,"2025-05-18 21:35:42",1335,827,756,71,0,816,11,1500,673,353,463
14,CONSTANŢA,"ŞCOALA GIMNAZIALA NR. 10 ”MIHAIL KOICIU”",112,"MUNICIPIUL CONSTANŢA",60419,1,PART,PRCNCT,PRSD,PRSD_SV,"2025-05-18 21:52:44",1079,720,654,65,1,712,8,1200,480,228,484
14,CONSTANŢA,"ŞCOALA GIMNAZIALA NR. 10 ”MIHAIL KOICIU”",113,"MUNICIPIUL CONSTANŢA",60419,1,PART,PRCNCT,PRSD,PRSD_SV,"2025-05-18 22:19:20",1657,1033,997,35,1,1018,15,1800,767,406,612
14,CONSTANŢA,"ŞCOALA GIMNAZIALA NR. 10 ”MIHAIL KOICIU”",114,"MUNICIPIUL CONSTANŢA",60419,1,PART,PRCNCT,PRSD,PRSD_SV,"2025-05-18 21:27:16",1401,828,793,35,0,819,9,1500,672,359,460
14,CONSTANŢA,"ŞCOALA GIMNAZIALA NR. 10 ”MIHAIL KOICIU”",115,"MUNICIPIUL CONSTANŢA",60419,1,PART,PRCNCT,PRSD,PRSD_SV,"2025-05-18 21:28:57",1364,799,743,56,0,792,7,1500,701,271,521
14,CONSTANŢA,"CENTRUL ȘCOLAR ”ALBATROS”",116,"MUNICIPIUL CONSTANŢA",60419,1,PART,PRCNCT,PRSD,PRSD_SV,"2025-05-18 21:47:47",1049,721,575,145,1,713,8,1200,479,259,454
14,CONSTANŢA,"CENTRUL ȘCOLAR ”ALBATROS”",117,"MUNICIPIUL CONSTANŢA",60419,1,PART,PRCNCT,PRSD,PRSD_SV,"2025-05-18 21:47:14",1456,849,808,41,0,834,15,1600,751,296,538
14,CONSTANŢA,"CENTRUL ȘCOLAR ”ALBATROS”",118,"MUNICIPIUL CONSTANŢA",60419,1,PART,PRCNCT,PRSD,PRSD_SV,"2025-05-18 21:36:44",843,531,484,47,0,527,4,900,369,210,317
14,CONSTANŢA,"CENTRUL ȘCOLAR ”ALBATROS”",119,"MUNICIPIUL CONSTANŢA",60419,1,PART,PRCNCT,PRSD,PRSD_SV,"2025-05-18 21:44:31",957,553,522,30,1,546,7,1100,547,206,340
14,CONSTANŢA,"CENTRUL ȘCOLAR ”ALBATROS”",120,"MUNICIPIUL CONSTANŢA",60419,1,PART,PRCNCT,PRSD,PRSD_SV,"2025-05-18 21:28:08",697,389,372,17,0,380,9,800,411,139,241
14,CONSTANŢA,"CENTRUL SCOLAR PENTRU EDUCATIE INCLUZIVA ”DELFINUL” (ŞCOALA AJUTATOARE NR. 1)",121,"MUNICIPIUL CONSTANŢA",60419,1,PART,PRCNCT,PRSD,PRSD_SV,"2025-05-18 21:33:48",1481,852,800,52,0,833,19,1600,748,303,530
14,CONSTANŢA,"CENTRUL SCOLAR PENTRU EDUCATIE INCLUZIVA ”DELFINUL” (ŞCOALA AJUTATOARE NR. 1)",122,"MUNICIPIUL CONSTANŢA",60419,1,PART,PRCNCT,PRSD,PRSD_SV,"2025-05-18 21:33:46",1505,776,745,31,0,771,5,1700,924,288,483
14,CONSTANŢA,"ŞCOALA GIMNAZIALA NR. 12 ”B. P. HASDEU”",123,"MUNICIPIUL CONSTANŢA",60419,1,PART,PRCNCT,PRSD,PRSD_SV,"2025-05-18 22:05:31",1581,1064,913,150,1,1045,19,1700,636,318,727
14,CONSTANŢA,"ŞCOALA GIMNAZIALA NR. 12 ”B. P. HASDEU”",124,"MUNICIPIUL CONSTANŢA",60419,1,PART,PRCNCT,PRSD,PRSD_SV,"2025-05-18 22:02:08",1371,826,688,137,1,814,12,1500,674,288,526
14,CONSTANŢA,"ŞCOALA GIMNAZIALA ”DIMITRIE ȘTIUBEI” (ŞCOALA NR.36 )",125,"MUNICIPIUL CONSTANŢA",60419,1,PART,PRCNCT,PRSD,PRSD_SV,"2025-05-18 22:45:02",1961,1290,1147,142,1,1272,18,2200,910,388,884
14,CONSTANŢA,"SCOALA GIMNAZIALA ”DIMITRIE ȘTIUBEI” (ŞCOALA NR.36)",126,"MUNICIPIUL CONSTANŢA",60419,1,PART,PRCNCT,PRSD,PRSD_SV,"2025-05-18 22:13:47",1963,1023,890,133,0,1001,22,2200,1177,554,447
14,CONSTANŢA,"SCOALA GIMNAZIALA ”DIMITRIE ȘTIUBEI” (ŞCOALA NR.36)",127,"MUNICIPIUL CONSTANŢA",60419,1,PART,PRCNCT,PRSD,PRSD_SV,"2025-05-18 22:38:05",1758,1021,962,57,2,1010,11,1899,878,310,700
14,CONSTANŢA,"SCOALA GIMNAZIALA ”DIMITRIE ȘTIUBEI” (ŞCOALA NR.36)",128,"MUNICIPIUL CONSTANŢA",60419,1,PART,PRCNCT,PRSD,PRSD_SV,"2025-05-18 22:04:28",1711,1004,942,61,1,988,16,2000,996,306,682
14,CONSTANŢA,"SCOALA GIMNAZIALA ”DIMITRIE ȘTIUBEI” (ŞCOALA NR.36)",129,"MUNICIPIUL CONSTANŢA",60419,1,PART,PRCNCT,PRSD,PRSD_SV,"2025-05-18 22:28:39",1834,1146,1032,111,3,1136,10,2000,854,373,763
14,CONSTANŢA,"GRĂDINIŢA CU PROGRAM PRELUNGIT ”MUGUREL” (GRĂDINIŢA NR. 43)",130,"MUNICIPIUL CONSTANŢA",60419,1,PART,PRCNCT,PRSD,PRSD_SV,"2025-05-18 21:51:17",1282,786,672,114,0,772,14,1400,614,263,509
14,CONSTANŢA,"GRĂDINIŢA CU PROGRAM PRELUNGIT ”MUGUREL” (GRĂDINIŢA NR. 43)",131,"MUNICIPIUL CONSTANŢA",60419,1,PART,PRCNCT,PRSD,PRSD_SV,"2025-05-18 21:53:35",1362,881,780,98,3,864,17,1500,619,316,548
14,CONSTANŢA,"GRĂDINIŢA CU PROGRAM NORMAL NR. 51",132,"MUNICIPIUL CONSTANŢA",60419,1,PART,PRCNCT,PRSD,PRSD_SV,"2025-05-18 21:37:19",1354,897,752,143,2,880,17,1500,603,325,555
14,CONSTANŢA,"GRĂDINIŢA CU PROGRAM NORMAL NR. 51",133,"MUNICIPIUL CONSTANŢA",60419,1,PART,PRCNCT,PRSD,PRSD_SV,"2025-05-18 21:51:49",1383,884,776,108,0,869,15,1400,516,279,590
14,CONSTANŢA,"LICEUL TEORETIC ”GEORGE CĂLINESCU”",134,"MUNICIPIUL CONSTANŢA",60419,1,PART,PRCNCT,PRSD,PRSD_SV,"2025-05-18 21:58:49",1537,943,875,65,3,935,8,1600,657,255,680
14,CONSTANŢA,"LICEUL TEORETIC ”GEORGE CĂLINESCU”",135,"MUNICIPIUL CONSTANŢA",60419,1,PART,PRCNCT,PRSD,PRSD_SV,"2025-05-18 21:55:48",1333,799,737,62,0,784,15,1400,601,237,547
14,CONSTANŢA,"LICEUL TEORETIC ”GEORGE CĂLINESCU”",136,"MUNICIPIUL CONSTANŢA",60419,2,PART,PRCNCT,PRSD,PRSD_SV,"2025-05-19 01:02:53",1017,621,548,71,2,615,6,1100,479,184,431
14,CONSTANŢA,"LICEUL TEORETIC ”GEORGE CĂLINESCU”",137,"MUNICIPIUL CONSTANŢA",60419,1,PART,PRCNCT,PRSD,PRSD_SV,"2025-05-18 22:05:03",981,683,593,90,0,675,8,1100,417,220,455
14,CONSTANŢA,"LICEUL TEORETIC ”GEORGE CĂLINESCU”",138,"MUNICIPIUL CONSTANŢA",60419,1,PART,PRCNCT,PRSD,PRSD_SV,"2025-05-18 21:27:14",958,644,580,64,0,631,13,1100,456,206,425
14,CONSTANŢA,"ŞCOALA GIMNAZIALA NR.14",139,"MUNICIPIUL CONSTANŢA",60419,1,PART,PRCNCT,PRSD,PRSD_SV,"2025-05-18 22:18:07",2019,1294,1180,113,1,1280,14,2200,906,513,767
14,CONSTANŢA,"ŞCOALA GIMNAZIALA NR.14",140,"MUNICIPIUL CONSTANŢA",60419,1,PART,PRCNCT,PRSD,PRSD_SV,"2025-05-18 22:45:52",1800,1128,1013,115,0,1114,14,1900,772,511,603
14,CONSTANŢA,"ŞCOALA GIMNAZIALA NR.14",141,"MUNICIPIUL CONSTANŢA",60419,1,PART,PRCNCT,PRSD,PRSD_SV,"2025-05-18 22:30:27",1435,918,746,118,54,911,7,1800,882,461,450
14,CONSTANŢA,"ŞCOALA GIMNAZIALA NR. 38 ”DIMITRIE CANTEMIR”",142,"MUNICIPIUL CONSTANŢA",60419,1,PART,PRCNCT,PRSD,PRSD_SV,"2025-05-18 21:42:44",874,665,507,158,0,657,8,900,235,198,459
14,CONSTANŢA,"ŞCOALA GIMNAZIALA NR. 38 ”DIMITRIE CANTEMIR”",143,"MUNICIPIUL CONSTANŢA",60419,1,PART,PRCNCT,PRSD,PRSD_SV,"2025-05-18 21:30:23",844,606,442,164,0,598,8,900,294,194,404
14,CONSTANŢA,"LICEUL TEORETIC ”DECEBAL”",144,"MUNICIPIUL CONSTANŢA",60419,1,PART,PRCNCT,PRSD,PRSD_SV,"2025-05-18 21:27:31",813,557,457,99,1,550,7,900,343,174,376
14,CONSTANŢA,"LICEUL TEORETIC ”DECEBAL”",145,"MUNICIPIUL CONSTANŢA",60419,1,PART,PRCNCT,PRSD,PRSD_SV,"2025-05-18 21:27:13",512,338,239,99,0,336,2,600,262,120,216
14,CONSTANŢA,"LICEUL TEORETIC ”DECEBAL”",146,"MUNICIPIUL CONSTANŢA",60419,1,PART,PRCNCT,PRSD,PRSD_SV,"2025-05-18 21:24:37",432,329,246,83,0,323,6,500,171,114,209
14,CONSTANŢA,"LICEUL TEORETIC ”DECEBAL”",147,"MUNICIPIUL CONSTANŢA",60419,1,PART,PRCNCT,PRSD,PRSD_SV,"2025-05-18 21:33:36",763,414,341,73,0,402,12,800,386,160,242
14,CONSTANŢA,"LICEUL TEHNOLOGIC ”VIRGIL MADGEARU” (ŞCOALA NR.35)",148,"MUNICIPIUL CONSTANŢA",60419,1,PART,PRCNCT,PRSD,PRSD_SV,"2025-05-18 21:41:34",691,555,364,179,12,547,8,800,245,193,354
14,CONSTANŢA,"LICEUL TEHNOLOGIC ”VIRGIL MADGEARU” (ŞCOALA NR.35)",149,"MUNICIPIUL CONSTANŢA",60419,1,PART,PRCNCT,PRSD,PRSD_SV,"2025-05-18 22:10:48",1014,676,535,141,0,666,10,1100,424,188,478
14,CONSTANŢA,"LICEUL TEHNOLOGIC ”VIRGIL MADGEARU” (ŞCOALA NR.35)",150,"MUNICIPIUL CONSTANŢA",60419,1,PART,PRCNCT,PRSD,PRSD_SV,"2025-05-18 21:49:12",706,465,350,115,0,458,7,800,335,143,315
14,CONSTANŢA,"GRĂDINIŢA CU PROGRAM PRELUNGIT”AMICII” (GRĂDINIŢA NR.12 )",151,"MUNICIPIUL CONSTANŢA",60419,1,PART,PRCNCT,PRSD,PRSD_SV,"2025-05-18 21:53:05",1031,774,567,207,0,767,7,1100,326,297,470
14,CONSTANŢA,"ŞCOALA GIMNAZIALA NR. 29 ”MIHAI VITEAZUL”",152,"MUNICIPIUL CONSTANŢA",60419,1,PART,PRCNCT,PRSD,PRSD_SV,"2025-05-18 21:56:15",580,523,284,239,0,515,8,600,77,193,322
14,CONSTANŢA,"ŞCOALA GIMNAZIALA NR. 29 ”MIHAI VITEAZUL”",153,"MUNICIPIUL CONSTANŢA",60419,1,PART,PRCNCT,PRSD,PRSD_SV,"2025-05-18 21:58:04",692,484,371,113,0,479,5,800,316,170,309
14,CONSTANŢA,"ŞCOALA GIMNAZIALA NR. 29 ”MIHAI VITEAZUL”",154,"MUNICIPIUL CONSTANŢA",60419,1,PART,PRCNCT,PRSD,PRSD_SV,"2025-05-18 21:55:02",1129,682,613,69,0,670,12,1200,518,240,430
14,CONSTANŢA,"ŞCOALA NR. 29 ”MIHAI VITEAZU”",155,"MUNICIPIUL CONSTANŢA",60419,1,PART,PRCNCT,PRSD,PRSD_SV,"2025-05-18 21:30:17",606,419,364,55,0,414,5,700,281,116,298
14,CONSTANŢA,"ŞCOALA GIMNAZIALA NR. 7 ”REMUS OPREANU”",156,"MUNICIPIUL CONSTANŢA",60419,1,PART,PRCNCT,PRSD,PRSD_SV,"2025-05-18 22:46:38",1209,884,675,208,1,873,11,1300,416,260,613
14,CONSTANŢA,"ŞCOALA GIMNAZIALA NR. 7 ”REMUS OPREANU”",157,"MUNICIPIUL CONSTANŢA",60419,1,PART,PRCNCT,PRSD,PRSD_SV,"2025-05-18 22:22:03",697,592,370,221,1,590,2,800,208,195,395
14,CONSTANŢA,"ŞCOALA GIMNAZIALA NR. 7 ”REMUS OPREANU”",158,"MUNICIPIUL CONSTANŢA",60419,1,PART,PRCNCT,PRSD,PRSD_SV,"2025-05-18 22:22:34",1146,701,617,83,1,691,10,1300,599,204,487
14,CONSTANŢA,"ŞCOALA GIMNAZIALA NR. 7 ”REMUS OPREANU”",159,"MUNICIPIUL CONSTANŢA",60419,1,PART,PRCNCT,PRSD,PRSD_SV,"2025-05-18 22:18:30",1373,858,774,82,2,841,17,1499,641,251,590
14,CONSTANŢA,"ŞCOALA GIMNAZIALA NR. 7 ”REMUS OPREANU”",160,"MUNICIPIUL CONSTANŢA",60419,1,PART,PRCNCT,PRSD,PRSD_SV,"2025-05-18 21:56:21",1104,643,603,38,2,636,7,1200,557,178,458
14,CONSTANŢA,"ŞCOALA GIMNAZIALA NR.6 ”NICOLAE TITULESCU”",161,"MUNICIPIUL CONSTANŢA",60419,2,PART,PRCNCT,PRSD,PRSD_SV,"2025-05-18 22:19:25",835,582,508,74,0,571,11,900,318,185,386
14,CONSTANŢA,"ŞCOALA GIMNAZIALA NR.6 ”NICOLAE TITULESCU”",162,"MUNICIPIUL CONSTANŢA",60419,1,PART,PRCNCT,PRSD,PRSD_SV,"2025-05-18 21:29:17",993,611,547,64,0,601,10,1100,489,202,399
14,CONSTANŢA,"ŞCOALA GIMNAZIALA NR.6 ”NICOLAE TITULESCU”",163,"MUNICIPIUL CONSTANŢA",60419,1,PART,PRCNCT,PRSD,PRSD_SV,"2025-05-18 21:39:50",919,644,547,97,0,634,10,1000,356,190,444
14,CONSTANŢA,"ŞCOALA GIMNAZIALA NR.6 ”NICOLAE TITULESCU”",164,"MUNICIPIUL CONSTANŢA",60419,1,PART,PRCNCT,PRSD,PRSD_SV,"2025-05-18 21:48:25",1057,663,601,62,0,650,13,1200,537,187,463
14,CONSTANŢA,"GRĂDINIŢA CU PROGRAM PRELUNGIT ”NOROCEL”(GRĂDINIŢA NR.13)",165,"MUNICIPIUL CONSTANŢA",60419,1,PART,PRCNCT,PRSD,PRSD_SV,"2025-05-18 21:38:11",804,514,451,62,1,512,2,900,386,144,368
14,CONSTANŢA,"GRĂDINIŢA CU PROGRAM PRELUNGIT ”NOROCEL”(GRĂDINIŢA NR.13)",166,"MUNICIPIUL CONSTANŢA",60419,1,PART,PRCNCT,PRSD,PRSD_SV,"2025-05-18 22:04:40",922,624,523,97,4,615,9,1000,376,177,438
14,CONSTANŢA,"PALATUL COPIILOR",167,"MUNICIPIUL CONSTANŢA",60419,2,PART,PRCNCT,PRSD,PRSD_SV,"2025-05-18 22:19:07",671,400,376,22,2,395,5,700,300,90,305
14,CONSTANŢA,"PALATUL COPIILOR",168,"MUNICIPIUL CONSTANŢA",60419,1,PART,PRCNCT,PRSD,PRSD_SV,"2025-05-18 21:25:48",552,369,292,72,5,365,4,600,231,107,258
14,CONSTANŢA,"SCOALA GIMNAZIALA ”SPECTRUM” (ŞCOALA NR.27)",169,"MUNICIPIUL CONSTANŢA",60419,1,PART,PRCNCT,PRSD,PRSD_SV,"2025-05-18 21:58:50",1268,886,772,113,1,876,10,1399,513,295,581
14,CONSTANŢA,"SCOALA GIMNAZIALA ”SPECTRUM” (ŞCOALA NR.27)",170,"MUNICIPIUL CONSTANŢA",60419,1,PART,PRCNCT,PRSD,PRSD_SV,"2025-05-18 21:54:05",1444,924,816,108,0,919,5,1600,676,330,589
14,CONSTANŢA,"COLEGIUL TEHNIC ”TOMIS”",171,"MUNICIPIUL CONSTANŢA",60419,1,PART,PRCNCT,PRSD,PRSD_SV,"2025-05-18 21:58:14",924,720,565,154,1,716,4,1000,280,230,486
14,CONSTANŢA,"COLEGIUL TEHNIC ”TOMIS”",172,"MUNICIPIUL CONSTANŢA",60419,1,PART,PRCNCT,PRSD,PRSD_SV,"2025-05-18 22:18:33",880,544,476,67,1,535,9,999,455,148,387
14,CONSTANŢA,"COLEGIUL TEHNIC ”TOMIS”",173,"MUNICIPIUL CONSTANŢA",60419,1,PART,PRCNCT,PRSD,PRSD_SV,"2025-05-18 22:06:12",592,423,357,66,0,417,6,700,277,110,307
14,CONSTANŢA,"COLEGIUL TEHNIC ”TOMIS”",174,"MUNICIPIUL CONSTANŢA",60419,1,PART,PRCNCT,PRSD,PRSD_SV,"2025-05-18 21:48:08",977,623,595,23,5,617,6,1100,477,162,455
14,CONSTANŢA,"ŞCOALA GIMNAZIALA NR.30 ”GHEORGHE ŢIŢEICA”",175,"MUNICIPIUL CONSTANŢA",60419,1,PART,PRCNCT,PRSD,PRSD_SV,"2025-05-18 22:19:07",1119,652,596,56,0,643,8,1200,549,220,423
14,CONSTANŢA,"ŞCOALA GIMNAZIALA NR.30 ”GHEORGHE ŢIŢEICA”",176,"MUNICIPIUL CONSTANŢA",60419,1,PART,PRCNCT,PRSD,PRSD_SV,"2025-05-18 21:46:09",793,503,463,40,0,498,5,900,397,157,341
14,CONSTANŢA,"ŞCOALA GIMNAZIALA NR.30 ”GHEORGHE ŢIŢEICA”",177,"MUNICIPIUL CONSTANŢA",60419,1,PART,PRCNCT,PRSD,PRSD_SV,"2025-05-18 21:22:17",758,530,437,93,0,520,10,800,270,159,361
14,CONSTANŢA,"CENTRUL JUDEŢEAN DE RESURSE ŞI ASISTENŢĂ EDUCAŢIONALĂ",178,"MUNICIPIUL CONSTANŢA",60419,1,PART,PRCNCT,PRSD,PRSD_SV,"2025-05-18 22:03:58",1106,747,611,136,0,741,6,1200,453,258,483
14,CONSTANŢA,"CENTRUL JUDEŢEAN DE RESURSE ŞI ASISTENŢĂ EDUCAŢIONALĂ",179,"MUNICIPIUL CONSTANŢA",60419,1,PART,PRCNCT,PRSD,PRSD_SV,"2025-05-18 22:12:01",915,609,545,63,1,605,4,1000,391,168,437
14,CONSTANŢA,"CENTRUL JUDEŢEAN DE RESURSE ŞI ASISTENŢĂ EDUCAŢIONALĂ",180,"MUNICIPIUL CONSTANŢA",60419,1,PART,PRCNCT,PRSD,PRSD_SV,"2025-05-18 21:47:42",1014,583,563,19,1,572,11,1100,517,195,377
14,CONSTANŢA,"LICEUL ENERGETIC CONSTANȚA",181,"MUNICIPIUL CONSTANŢA",60419,1,PART,PRCNCT,PRSD,PRSD_SV,"2025-05-18 22:18:18",1089,810,613,154,43,799,11,1500,690,251,548
14,CONSTANŢA,"LICEUL ENERGETIC CONSTANȚA",182,"MUNICIPIUL CONSTANŢA",60419,1,PART,PRCNCT,PRSD,PRSD_SV,"2025-05-18 21:44:36",1523,913,815,61,37,899,14,1800,887,268,631
14,CONSTANŢA,"COLEGIUL TEHNIC ENERGETIC",183,"MUNICIPIUL CONSTANŢA",60419,1,PART,PRCNCT,PRSD,PRSD_SV,"2025-05-18 22:16:44",1230,997,732,264,1,980,17,1400,403,320,660
14,CONSTANŢA,"COLEGIUL TEHNIC ENERGETIC",184,"MUNICIPIUL CONSTANŢA",60419,1,PART,PRCNCT,PRSD,PRSD_SV,"2025-05-18 21:54:58",636,547,347,200,0,540,7,701,154,164,376
14,CONSTANŢA,"COLEGIUL TEHNIC ENERGETIC",185,"MUNICIPIUL CONSTANŢA",60419,1,PART,PRCNCT,PRSD,PRSD_SV,"2025-05-18 21:47:14",1181,735,653,80,2,727,8,1300,565,208,519
14,CONSTANŢA,"COLEGIUL TEHNIC ENERGETIC",186,"MUNICIPIUL CONSTANŢA",60419,1,PART,PRCNCT,PRSD,PRSD_SV,"2025-05-18 21:41:27",1593,1013,961,48,4,1005,8,1800,787,329,676
14,CONSTANŢA,"ŞCOALA GIMNAZIALA NR. 3 ”CIPRIAN PORUMBESCU”",187,"MUNICIPIUL CONSTANŢA",60419,1,PART,PRCNCT,PRSD,PRSD_SV,"2025-05-18 22:34:11",1287,822,757,62,3,813,9,1400,578,222,591
14,CONSTANŢA,"ŞCOALA GIMNAZIALA NR. 3 ”CIPRIAN PORUMBESCU”",188,"MUNICIPIUL CONSTANŢA",60419,1,PART,PRCNCT,PRSD,PRSD_SV,"2025-05-18 21:50:59",1145,823,687,136,0,806,17,1300,477,289,517
14,CONSTANŢA,"ŞCOALA GIMNAZIALA NR. 3 ”CIPRIAN PORUMBESCU”",189,"MUNICIPIUL CONSTANŢA",60419,1,PART,PRCNCT,PRSD,PRSD_SV,"2025-05-18 22:12:23",1041,668,616,52,0,660,8,1100,432,238,422
14,CONSTANŢA,"GRĂDINIŢA CU PROGRAM PRELUNGIT NR.45",190,"MUNICIPIUL CONSTANŢA",60419,1,PART,PRCNCT,PRSD,PRSD_SV,"2025-05-18 21:52:20",798,660,491,169,0,649,11,900,240,216,433
14,CONSTANŢA,"UNIVERSITATEA ”OVIDIUS”",191,"MUNICIPIUL CONSTANŢA",60419,1,PART,PRCNCT,PRSD,PRSD_SV,"2025-05-18 22:02:14",1567,1035,925,105,5,1023,12,1700,665,345,678
14,CONSTANŢA,"UNIVERSITATEA ”OVIDIUS”",192,"MUNICIPIUL CONSTANŢA",60419,1,PART,PRCNCT,PRSD,PRSD_SV,"2025-05-18 21:53:52",958,689,523,130,36,679,10,1200,511,222,457
14,CONSTANŢA,"UNIVERSITATEA ”OVIDIUS”",193,"MUNICIPIUL CONSTANŢA",60419,1,PART,PRCNCT,PRSD,PRSD_SV,"2025-05-18 22:13:22",1046,670,541,76,53,660,10,1200,530,318,342
14,CONSTANŢA,"UNIVERSITATEA ”OVIDIUS”",194,"MUNICIPIUL CONSTANŢA",60419,1,PART,PRCNCT,PRSD,PRSD_SV,"2025-05-18 22:09:24",1052,961,579,380,2,953,8,1300,339,260,693
14,CONSTANŢA,"ŞCOALA GIMNAZIALA NR. 43 ”FERDINAND”",195,"MUNICIPIUL CONSTANŢA",60419,1,PART,PRCNCT,PRSD,PRSD_SV,"2025-05-18 21:48:31",615,560,376,184,0,552,8,700,140,181,371
14,CONSTANŢA,"ŞCOALA GIMNAZIALA NR.5 ”NICOLAE IORGA”",196,"MUNICIPIUL CONSTANŢA",60419,1,PART,PRCNCT,PRSD,PRSD_SV,"2025-05-18 21:36:49",1357,845,775,41,29,835,10,1700,855,237,598
14,CONSTANŢA,"ŞCOALA GIMNAZIALA NR.5 ”NICOLAE IORGA”",197,"MUNICIPIUL CONSTANŢA",60419,1,PART,PRCNCT,PRSD,PRSD_SV,"2025-05-18 22:04:39",689,537,400,101,36,532,5,900,363,198,334
14,CONSTANŢA,"ŞCOALA GIMNAZIALA NR.5 ”NICOLAE IORGA”",198,"MUNICIPIUL CONSTANŢA",60419,1,PART,PRCNCT,PRSD,PRSD_SV,"2025-05-18 21:33:19",453,290,234,46,10,284,6,700,410,74,210
14,CONSTANŢA,"ANEXĂ LA COLEGIUL NAŢIONAL ”MIRCEA CEL BĂTRÂN”",199,"MUNICIPIUL CONSTANŢA",60419,1,PART,PRCNCT,PRSD,PRSD_SV,"2025-05-18 21:56:32",567,417,307,54,56,412,5,800,383,130,282
14,CONSTANŢA,"ANEXĂ LA COLEGIUL NAŢIONAL ”MIRCEA CEL BĂTRÂN”",200,"MUNICIPIUL CONSTANŢA",60419,1,PART,PRCNCT,PRSD,PRSD_SV,"2025-05-18 21:45:45",553,438,323,57,58,434,4,900,462,138,296
14,CONSTANŢA,"GRĂDINIŢA CU PROGRAM PRELUNGIT NR. 8 (TOMIS II)",201,"MUNICIPIUL CONSTANŢA",60419,1,PART,PRCNCT,PRSD,PRSD_SV,"2025-05-18 21:34:04",702,565,432,106,27,558,7,900,335,176,382
14,CONSTANŢA,"GRĂDINIȚA HENSEL ȘI GRETEL",202,"MUNICIPIUL CONSTANŢA",60419,1,PART,PRCNCT,PRSD,PRSD_SV,"2025-05-18 21:59:32",668,419,363,55,1,413,6,700,281,125,288
14,CONSTANŢA,"GRĂDINIŢA CU PROGRAM PRELUNGIT NR.6",203,"MUNICIPIUL CONSTANŢA",60419,1,PART,PRCNCT,PRSD,PRSD_SV,"2025-05-18 21:34:58",703,467,394,73,0,460,7,800,333,138,322
14,CONSTANŢA,"ŞCOALA GIMNAZIALA NR. 11 ”DR.CONSTANTIN ANGELESCU”",204,"MUNICIPIUL CONSTANŢA",60419,1,PART,PRCNCT,PRSD,PRSD_SV,"2025-05-18 21:36:27",1207,823,729,94,0,814,9,1300,477,303,511
14,CONSTANŢA,"ŞCOALA GIMNAZIALA NR. 11 ”DR.CONSTANTIN ANGELESCU”",205,"MUNICIPIUL CONSTANŢA",60419,1,PART,PRCNCT,PRSD,PRSD_SV,"2025-05-18 21:28:23",1353,896,795,100,1,890,6,1500,604,248,642
14,CONSTANŢA,"LICEUL TEHNOLOGIC DE ELECTROTEHNICA SI TELECOMUNICAȚII",206,"MUNICIPIUL CONSTANŢA",60419,1,PART,PRCNCT,PRSD,PRSD_SV,"2025-05-18 21:37:28",1167,794,692,101,1,783,11,1300,506,258,525
14,CONSTANŢA,"UNIVERSITATEA ”ANDREI ŞAGUNA”",207,"MUNICIPIUL CONSTANŢA",60419,1,PART,PRCNCT,PRSD,PRSD_SV,"2025-05-18 21:29:26",703,506,393,112,1,500,6,800,294,149,351
14,CONSTANŢA,"PRO GRUP EXCLUSIV AUTO ENB-SHOWROOM SEAT",208,"MUNICIPIUL CONSTANŢA",60419,1,PART,PRCNCT,PRSD,PRSD_SV,"2025-05-18 22:07:17",1872,1282,1107,174,1,1268,14,2100,818,386,882
14,CONSTANŢA,"TOMIS PLUS SRL",209,"MUNICIPIUL CONSTANŢA",60419,1,PART,PRCNCT,PRSD,PRSD_SV,"2025-05-18 21:40:39",2004,1678,1243,435,0,1667,11,2200,521,513,1154
14,CONSTANŢA,"CAMPUS SOCIAL ”HENRI COANDĂ”",210,"MUNICIPIUL CONSTANŢA",60419,1,PART,PRCNCT,PRSD,PRSD_SV,"2025-05-18 22:51:16",1636,755,724,31,0,733,22,1792,1037,565,168
14,CONSTANŢA,"SC MAMAIA SA",211,"MUNICIPIUL CONSTANŢA",60419,1,PART,PRCNCT,PRSD,PRSD_SV,"2025-05-18 21:57:29",705,1093,317,776,0,1082,11,1400,307,361,721
14,CONSTANŢA,"BAZA SPORTIVĂ MARINA",212,"MUNICIPIUL MANGALIA",60482,1,PART,PRCNCT,PRSD,PRSD_SV,"2025-05-18 21:26:38",696,504,455,49,0,487,17,707,203,226,261
14,CONSTANŢA,"CASA MUNICIPALĂ DE CULTURĂ",213,"MUNICIPIUL MANGALIA",60482,1,PART,PRCNCT,PRSD,PRSD_SV,"2025-05-18 21:53:03",1519,996,721,275,0,976,20,1600,604,429,547
14,CONSTANŢA,"GRUP ȘCOLAR ECONOMIC",214,"MUNICIPIUL MANGALIA",60482,1,PART,PRCNCT,PRSD,PRSD_SV,"2025-05-18 22:02:24",1291,771,666,104,1,759,12,1300,529,341,418
14,CONSTANŢA,"LICEUL TEHNOLOGIC ”ION BĂNESCU” MANGALIA",215,"MUNICIPIUL MANGALIA",60482,1,PART,PRCNCT,PRSD,PRSD_SV,"2025-05-18 21:39:04",980,540,505,34,1,537,3,1000,460,311,226
14,CONSTANŢA,"GRUP ȘCOLAR INDUSTRIAL ”ION BĂNESCU”",216,"MUNICIPIUL MANGALIA",60482,1,PART,PRCNCT,PRSD,PRSD_SV,"2025-05-18 21:46:27",1310,697,672,25,0,687,10,1400,703,398,289
14,CONSTANŢA,"LICEUL TEHNOLOGIC ”ION BĂNESCU”",217,"MUNICIPIUL MANGALIA",60482,1,PART,PRCNCT,PRSD,PRSD_SV,"2025-05-18 21:50:58",1039,615,530,85,0,601,14,1100,485,292,309
14,CONSTANŢA,"ȘCOALA GENERALĂ NR.3",218,"MUNICIPIUL MANGALIA",60482,1,PART,PRCNCT,PRSD,PRSD_SV,"2025-05-18 22:23:25",1602,925,815,98,12,909,16,1700,775,434,475
14,CONSTANŢA,"ȘCOALA GENERALĂ NR.3",219,"MUNICIPIUL MANGALIA",60482,1,PART,PRCNCT,PRSD,PRSD_SV,"2025-05-18 21:43:19",1494,795,748,47,0,787,8,1500,705,397,390
14,CONSTANŢA,"GRĂDINIȚA NR.3",220,"MUNICIPIUL MANGALIA",60482,1,PART,PRCNCT,PRSD,PRSD_SV,"2025-05-18 21:56:13",1517,823,755,68,0,811,12,1600,777,463,348
14,CONSTANŢA,"ȘCOALA GENERALĂ NR.1",221,"MUNICIPIUL MANGALIA",60482,1,PART,PRCNCT,PRSD,PRSD_SV,"2025-05-18 21:36:04",1118,656,584,70,2,644,12,1200,544,364,280
14,CONSTANŢA,"ȘCOALA GENERALĂ NR.1",222,"MUNICIPIUL MANGALIA",60482,1,PART,PRCNCT,PRSD,PRSD_SV,"2025-05-18 21:48:01",1339,721,694,27,0,706,15,1400,679,459,247
14,CONSTANŢA,"ȘCOALA GENERALĂ NR.2",223,"MUNICIPIUL MANGALIA",60482,1,PART,PRCNCT,PRSD,PRSD_SV,"2025-05-18 21:59:27",1196,685,592,93,0,677,8,1200,515,390,287
14,CONSTANŢA,"ȘCOALA GENERALĂ NR.2",224,"MUNICIPIUL MANGALIA",60482,1,PART,PRCNCT,PRSD,PRSD_SV,"2025-05-18 21:49:12",1582,790,759,31,0,781,9,1700,910,407,374
14,CONSTANŢA,"SEDIU S.C. ECO GOLD S.A.",225,"MUNICIPIUL MANGALIA",60482,1,PART,PRCNCT,PRSD,PRSD_SV,"2025-05-18 22:20:34",1536,920,860,58,2,905,15,1600,680,481,424
14,CONSTANŢA,"ŞCOALA GIMNAZIALĂ NR. 1",226,"MUNICIPIUL MANGALIA",60482,1,PART,PRCNCT,PRSD,PRSD_SV,"2025-05-18 22:03:38",1225,703,646,56,1,694,9,1300,597,401,293
14,CONSTANŢA,"ŞCOALA GIMNAZIALĂ NR. 1",227,"MUNICIPIUL MANGALIA",60482,1,PART,PRCNCT,PRSD,PRSD_SV,"2025-05-18 21:57:16",1190,560,520,40,0,556,4,1200,640,422,134
14,CONSTANŢA,"ȘCOALA GENERALĂ NR.5",228,"MUNICIPIUL MANGALIA",60482,1,PART,PRCNCT,PRSD,PRSD_SV,"2025-05-18 22:07:23",1099,696,587,80,29,683,13,1300,604,343,340
14,CONSTANŢA,"ȘCOALA GENERALĂ NR.5",229,"MUNICIPIUL MANGALIA",60482,1,PART,PRCNCT,PRSD,PRSD_SV,"2025-05-18 22:18:11",1098,749,596,145,8,738,11,1300,551,334,404
14,CONSTANŢA,"ŞCOALA GIMNAZIALĂ GALA GALACTION",230,"MUNICIPIUL MANGALIA",60482,1,PART,PRCNCT,PRSD,PRSD_SV,"2025-05-18 21:40:10",1287,772,682,85,5,755,17,1400,628,323,432
14,CONSTANŢA,"HOTEL MANGALIA",231,"MUNICIPIUL MANGALIA",60482,1,PART,PRCNCT,PRSD,PRSD_SV,"2025-05-18 22:12:45",1157,980,603,377,0,958,22,1300,320,418,540
14,CONSTANŢA,"SPAŢIU DESTINAT ACTIVITĂŢILOR CULTURALE (FOSTA BIBLIOTECĂ FRANCEZĂ ARTHUR RIMBAUD)",232,"MUNICIPIUL MANGALIA",60482,1,PART,PRCNCT,PRSD,PRSD_SV,"2025-05-18 22:08:20",1138,673,619,53,1,666,7,1300,627,302,364
14,CONSTANŢA,"CLUB SPITAL MANGALIA",233,"MUNICIPIUL MANGALIA",60482,1,PART,PRCNCT,PRSD,PRSD_SV,"2025-05-18 21:38:21",824,490,445,45,0,483,7,900,410,204,279
14,CONSTANŢA,"GRĂDINIȚA CALLATIS",234,"MUNICIPIUL MANGALIA",60482,1,PART,PRCNCT,PRSD,PRSD_SV,"2025-05-18 21:51:11",988,567,480,85,2,553,14,1200,633,308,245
14,CONSTANŢA,"LICEUL CALLATIS",235,"MUNICIPIUL MANGALIA",60482,1,PART,PRCNCT,PRSD,PRSD_SV,"2025-05-18 21:54:10",1076,757,560,174,23,749,8,1400,643,371,378
14,CONSTANŢA,"LICEUL CALLATIS",236,"MUNICIPIUL MANGALIA",60482,1,PART,PRCNCT,PRSD,PRSD_SV,"2025-05-18 22:04:35",965,596,435,122,39,591,5,1100,504,317,274
14,CONSTANŢA,"GRADINITA NR. 5 NEPTUN",237,"MUNICIPIUL MANGALIA",60482,1,PART,PRCNCT,PRSD,PRSD_SV,"2025-05-18 22:16:23",1239,851,585,266,0,843,8,1500,649,457,386
14,CONSTANŢA,"GRĂDINIȚA NR. 5 NEPTUN",238,"MUNICIPIUL MANGALIA",60482,2,PART,PRCNCT,PRSD,PRSD_SV,"2025-05-19 01:28:17",490,432,183,249,0,428,4,600,168,291,137
14,CONSTANŢA,"CASA DE CULTURĂ ”I.N.ROMAN”",239,"MUNICIPIUL MEDGIDIA",60847,1,PART,PRCNCT,PRSD,PRSD_SV,"2025-05-18 21:38:47",769,435,390,43,2,429,6,900,465,174,255
14,CONSTANŢA,"GRĂDINIŢA CU PROGRAM NORMAL NR.1 -BILINGVĂ (ROM-TURCĂ) ROMANO-TURCA",240,"MUNICIPIUL MEDGIDIA",60847,1,PART,PRCNCT,PRSD,PRSD_SV,"2025-05-18 21:38:21",742,354,330,23,1,349,5,800,446,198,151
14,CONSTANŢA,"GRĂDINIŢA CU PROGRAM NORMAL NR.1 -BILINGVĂ (ROM-TURCĂ)",241,"MUNICIPIUL MEDGIDIA",60847,1,PART,PRCNCT,PRSD,PRSD_SV,"2025-05-18 21:31:32",787,321,307,14,0,316,5,900,579,178,138
14,CONSTANŢA,"ŞCOALA GIMNAZIALĂ ”MIHAIL SADOVEANU”",242,"MUNICIPIUL MEDGIDIA",60847,1,PART,PRCNCT,PRSD,PRSD_SV,"2025-05-18 21:39:22",853,306,290,16,0,299,7,900,594,165,134
14,CONSTANŢA,"ŞCOALA GIMNAZIALĂ ”MIHAIL SADOVEANU”",243,"MUNICIPIUL MEDGIDIA",60847,1,PART,PRCNCT,PRSD,PRSD_SV,"2025-05-18 21:25:42",1345,276,253,22,1,266,10,1500,1224,199,67
14,CONSTANŢA,"ŞCOALA GIMNAZIALĂ ”MIHAIL SADOVEANU”",244,"MUNICIPIUL MEDGIDIA",60847,1,PART,PRCNCT,PRSD,PRSD_SV,"2025-05-18 21:27:14",1094,287,273,13,1,271,16,1200,913,203,68
14,CONSTANŢA,"GRĂDINIŢA CU PROGRAM NORMAL NR.8",245,"MUNICIPIUL MEDGIDIA",60847,1,PART,PRCNCT,PRSD,PRSD_SV,"2025-05-18 21:59:06",1345,506,479,26,1,499,7,1500,994,286,213
14,CONSTANŢA,"LICEUL TEHNOLOGIC ”DRAGOMIR HURMUZESCU”",246,"MUNICIPIUL MEDGIDIA",60847,1,PART,PRCNCT,PRSD,PRSD_SV,"2025-05-18 21:29:57",1276,501,456,44,1,493,8,1400,899,324,169
14,CONSTANŢA,"ŞCOALA GIMNAZIALĂ ”CONSTANTIN BRÂNCUŞI”",247,"MUNICIPIUL MEDGIDIA",60847,1,PART,PRCNCT,PRSD,PRSD_SV,"2025-05-18 21:50:30",930,465,431,34,0,459,6,1000,535,230,229
14,CONSTANŢA,"ŞCOALA GIMNAZIALĂ ”CONSTANTIN BRÂNCUŞI”",248,"MUNICIPIUL MEDGIDIA",60847,1,PART,PRCNCT,PRSD,PRSD_SV,"2025-05-18 21:45:06",909,472,428,44,0,466,6,1000,528,217,249
14,CONSTANŢA,"ŞCOALA GIMNAZIALĂ ”CONSTANTIN BRÂNCUŞI”",249,"MUNICIPIUL MEDGIDIA",60847,1,PART,PRCNCT,PRSD,PRSD_SV,"2025-05-18 21:48:08",707,378,359,19,0,373,5,800,422,172,201
14,CONSTANŢA,"LICEUL TEORETIC ”NICOLAE BĂLCESCU”",250,"MUNICIPIUL MEDGIDIA",60847,1,PART,PRCNCT,PRSD,PRSD_SV,"2025-05-18 21:30:39",766,375,344,31,0,368,7,800,425,181,187
14,CONSTANŢA,"LICEUL TEORETIC ”NICOLAE BĂLCESCU”",251,"MUNICIPIUL MEDGIDIA",60847,1,PART,PRCNCT,PRSD,PRSD_SV,"2025-05-18 21:52:27",674,358,340,18,0,353,5,700,342,149,204
14,CONSTANŢA,"LICEUL TEORETIC ”NICOLAE BĂLCESCU”",252,"MUNICIPIUL MEDGIDIA",60847,1,PART,PRCNCT,PRSD,PRSD_SV,"2025-05-18 21:35:31",827,418,387,30,1,411,7,900,482,195,216
14,CONSTANŢA,"SCOALA GIMNAZIALĂ ”MIRCEA DRAGOMIRESCU”",253,"MUNICIPIUL MEDGIDIA",60847,1,PART,PRCNCT,PRSD,PRSD_SV,"2025-05-18 21:40:36",912,443,388,48,7,429,14,1100,657,210,219
14,CONSTANŢA,"ŞCOALA GIMNAZIALĂ ”MIRCEA DRAGOMIRESCU”",254,"MUNICIPIUL MEDGIDIA",60847,1,PART,PRCNCT,PRSD,PRSD_SV,"2025-05-18 21:29:14",724,392,349,35,8,390,2,900,508,230,160
14,CONSTANŢA,"ŞCOALA GIMNAZIALĂ ”MIRCEA DRAGOMIRESCU”",255,"MUNICIPIUL MEDGIDIA",60847,1,PART,PRCNCT,PRSD,PRSD_SV,"2025-05-18 21:59:30",1112,605,571,30,4,590,15,1300,695,284,306
14,CONSTANŢA,"COLEGIUL NAȚIONAL ”KEMAL ATATURK”",256,"MUNICIPIUL MEDGIDIA",60847,1,PART,PRCNCT,PRSD,PRSD_SV,"2025-05-18 21:42:48",910,479,454,24,1,473,6,1000,521,251,222
14,CONSTANŢA,"HOTEL ”STADION”",257,"MUNICIPIUL MEDGIDIA",60847,1,PART,PRCNCT,PRSD,PRSD_SV,"2025-05-18 21:37:02",841,454,415,39,0,449,5,900,446,250,199
14,CONSTANŢA,"HOTEL ”STADION”",258,"MUNICIPIUL MEDGIDIA",60847,1,PART,PRCNCT,PRSD,PRSD_SV,"2025-05-18 21:43:40",841,439,416,23,0,431,8,900,461,242,189
14,CONSTANŢA,"HOTEL ”STADION”",259,"MUNICIPIUL MEDGIDIA",60847,1,PART,PRCNCT,PRSD,PRSD_SV,"2025-05-18 21:58:23",947,496,478,18,0,484,12,1000,504,265,219
14,CONSTANŢA,"ANEXA - COLEGIUL NAȚIONAL ”KEMAL ATATURK”",260,"MUNICIPIUL MEDGIDIA",60847,1,PART,PRCNCT,PRSD,PRSD_SV,"2025-05-18 21:28:47",801,365,325,40,0,358,6,900,536,204,154
14,CONSTANŢA,"ANEXA - COLEGIUL NAȚIONAL ”KEMAL ATATURK”",261,"MUNICIPIUL MEDGIDIA",60847,1,PART,PRCNCT,PRSD,PRSD_SV,"2025-05-18 21:25:30",714,363,350,12,1,355,8,800,437,144,211
14,CONSTANŢA,"ŞCOALA GIMNAZIALĂ ”LUCIAN GRIGORESCU”",262,"MUNICIPIUL MEDGIDIA",60847,1,PART,PRCNCT,PRSD,PRSD_SV,"2025-05-18 21:40:00",958,543,512,31,0,535,8,1100,557,268,267
14,CONSTANŢA,"ŞCOALA GIMNAZIALĂ ”LUCIAN GRIGORESCU”",263,"MUNICIPIUL MEDGIDIA",60847,1,PART,PRCNCT,PRSD,PRSD_SV,"2025-05-18 21:54:20",570,345,311,34,0,342,3,600,255,138,204
14,CONSTANŢA,"ŞCOALA GIMNAZIALĂ ”I.L.CARAGIALE” MEDGIDIA",264,"MUNICIPIUL MEDGIDIA",60847,1,PART,PRCNCT,PRSD,PRSD_SV,"2025-05-18 21:35:14",643,366,322,44,0,358,8,700,334,219,139
14,CONSTANŢA,"ŞCOALA GIMNAZIALĂ ”I.L.CARAGIALE”",265,"MUNICIPIUL MEDGIDIA",60847,1,PART,PRCNCT,PRSD,PRSD_SV,"2025-05-18 21:43:06",958,568,535,33,0,560,8,1100,532,276,284
14,CONSTANŢA,"SCOALA GIMNAZIALĂ ”I.L.CARAGIALE”",266,"MUNICIPIUL MEDGIDIA",60847,1,PART,PRCNCT,PRSD,PRSD_SV,"2025-05-18 22:06:32",938,471,445,25,1,464,7,1000,529,331,133
14,CONSTANŢA,"SCOALA GIMNAZIALĂ ”I.L.CARAGIALE”",267,"MUNICIPIUL MEDGIDIA",60847,1,PART,PRCNCT,PRSD,PRSD_SV,"2025-05-18 21:47:39",997,506,483,23,0,498,8,1100,594,309,189
14,CONSTANŢA,"COLEGIUL TEHNIC ”NICOLAE TITULESCU”",268,"MUNICIPIUL MEDGIDIA",60847,1,PART,PRCNCT,PRSD,PRSD_SV,"2025-05-18 21:33:46",916,453,417,36,0,446,7,1000,547,264,182
14,CONSTANŢA,"COLEGIUL TEHNIC ”NICOLAE TITULESCU”",269,"MUNICIPIUL MEDGIDIA",60847,1,PART,PRCNCT,PRSD,PRSD_SV,"2025-05-18 21:50:32",1082,600,571,29,0,591,9,1200,600,269,322
14,CONSTANŢA,"ŞCOALA GIMNAZIALĂ ”SPIRU HARET”",270,"MUNICIPIUL MEDGIDIA",60847,1,PART,PRCNCT,PRSD,PRSD_SV,"2025-05-18 21:43:21",970,474,436,37,1,468,6,1100,626,309,159
14,CONSTANŢA,"ŞCOALA GIMNAZIALĂ ”SPIRU HARET”",271,"MUNICIPIUL MEDGIDIA",60847,2,PART,PRCNCT,PRSD,PRSD_SV,"2025-05-19 01:31:04",1127,452,434,17,1,443,9,1200,748,318,125
14,CONSTANŢA,"ŞCOALA GIMNAZIALĂ ”SPIRU HARET”",272,"MUNICIPIUL MEDGIDIA",60847,1,PART,PRCNCT,PRSD,PRSD_SV,"2025-05-18 21:34:43",1119,548,524,21,3,542,6,1200,652,322,220
14,CONSTANŢA,"GRĂDINIŢA CU PROGRAM NORMAL NR.7",273,"MUNICIPIUL MEDGIDIA",60847,1,PART,PRCNCT,PRSD,PRSD_SV,"2025-05-18 21:47:32",1244,659,632,27,0,648,11,1400,741,318,330
14,CONSTANŢA,"S.C. ”MAXICOMP” SRL",274,"MUNICIPIUL MEDGIDIA",60847,1,PART,PRCNCT,PRSD,PRSD_SV,"2025-05-18 21:17:40",286,164,148,15,1,162,2,300,136,118,44
14,CONSTANŢA,"GRĂDINIȚA CU PROGRAM NORMAL VALEA DACILOR",275,"MUNICIPIUL MEDGIDIA",60847,1,PART,PRCNCT,PRSD,PRSD_SV,"2025-05-18 22:01:51",1293,648,607,40,1,642,6,1400,752,431,211
14,CONSTANŢA,"ȘCOALA GIMNAZIALĂ NR.1",276,"ORAŞ CERNAVODĂ",60776,1,PART,PRCNCT,PRSD,PRSD_SV,"2025-05-18 21:50:36",1502,767,713,46,8,762,5,1700,933,461,301
14,CONSTANŢA,"ŞCOALA GIMNAZIALĂ NR. 1",277,"ORAŞ CERNAVODĂ",60776,1,PART,PRCNCT,PRSD,PRSD_SV,"2025-05-18 21:36:19",1740,743,724,19,0,729,14,1900,1157,546,183
14,CONSTANŢA,"ŞCOALA GIMNAZIALĂ NR. 1",278,"ORAŞ CERNAVODĂ",60776,4,PART,PRCNCT,PRSD,PRSD_SV,"2025-05-19 02:14:21",1235,558,532,26,0,552,6,1400,842,389,163
14,CONSTANŢA,"ŞCOALA GIMNAZIALĂ NR. 2",279,"ORAŞ CERNAVODĂ",60776,1,PART,PRCNCT,PRSD,PRSD_SV,"2025-05-18 21:55:32",1329,710,669,40,1,706,4,1500,790,394,312
14,CONSTANŢA,"LICEUL TEORETIC ANGHEL SALIGNY",280,"ORAŞ CERNAVODĂ",60776,1,PART,PRCNCT,PRSD,PRSD_SV,"2025-05-18 22:42:03",1505,881,760,119,2,874,7,1700,819,453,421
14,CONSTANŢA,"LICEUL TEORETIC ANGHEL SALIGNY",281,"ORAŞ CERNAVODĂ",60776,1,PART,PRCNCT,PRSD,PRSD_SV,"2025-05-18 22:02:36",1401,871,736,135,0,859,12,1500,629,382,477
14,CONSTANŢA,"GRĂDINIŢA CU PROGRAM PRELUNGIT NR. 4",282,"ORAŞ CERNAVODĂ",60776,1,PART,PRCNCT,PRSD,PRSD_SV,"2025-05-18 21:58:26",1376,696,649,31,16,691,5,1500,804,446,245
14,CONSTANŢA,"CREŞA DIN STRADA TUDOR VLADIMIRESCU",283,"ORAŞ CERNAVODĂ",60776,1,PART,PRCNCT,PRSD,PRSD_SV,"2025-05-18 21:57:20",938,455,413,42,0,445,10,1100,645,284,161
14,CONSTANŢA,"LICEUL TEHNOLOGIC AXIOPOLIS CERNAVODĂ",284,"ORAŞ CERNAVODĂ",60776,1,PART,PRCNCT,PRSD,PRSD_SV,"2025-05-18 21:40:17",1327,691,620,69,2,684,7,1500,809,397,287
14,CONSTANŢA,"LICEUL TEHNOLOGIC AXIOPOLIS CERNAVODĂ",285,"ORAŞ CERNAVODĂ",60776,1,PART,PRCNCT,PRSD,PRSD_SV,"2025-05-18 21:34:50",1090,609,550,59,0,605,4,1200,591,243,362
14,CONSTANŢA,"ŞCOALA GIMNAZIALĂ MIRCEA ELIADE",286,"ORAŞ CERNAVODĂ",60776,1,PART,PRCNCT,PRSD,PRSD_SV,"2025-05-18 21:37:23",1035,627,519,108,0,619,8,1100,473,274,345
14,CONSTANŢA,"LICEUL TEORETIC CARMEN SILVA EFORIE",287,"ORAŞ EFORIE",60455,1,PART,PRCNCT,PRSD,PRSD_SV,"2025-05-18 22:34:56",1396,958,778,176,4,946,12,1600,642,407,539
14,CONSTANŢA,"SEDIUL POLITIEI LOCALE EFORIE SUD",288,"ORAŞ EFORIE",60455,1,PART,PRCNCT,PRSD,PRSD_SV,"2025-05-18 22:07:46",1415,915,669,244,2,894,21,1700,785,394,500
14,CONSTANŢA,"GRĂDINIȚA CU PROGRAM PRELUNGIT ”ALBATROS” EFORIE SUD",289,"ORAŞ EFORIE",60455,1,PART,PRCNCT,PRSD,PRSD_SV,"2025-05-18 22:01:35",950,645,490,137,18,631,14,1100,455,269,362
14,CONSTANŢA,"HOTEL ”TRAIAN” EFORIE NORD",290,"ORAŞ EFORIE",60455,1,PART,PRCNCT,PRSD,PRSD_SV,"2025-05-18 21:55:37",1281,963,595,366,2,948,15,1300,337,410,538
14,CONSTANŢA,"SALA DE SPORT EFORIE NORD",291,"ORAŞ EFORIE",60455,1,PART,PRCNCT,PRSD,PRSD_SV,"2025-05-18 22:34:58",1477,1241,773,406,62,1229,12,1700,459,528,701
14,CONSTANŢA,"ȘCOALA GIMNAZIALĂ NR.1 EFORIE NORD",292,"ORAŞ EFORIE",60455,1,PART,PRCNCT,PRSD,PRSD_SV,"2025-05-18 22:09:05",1565,1116,815,300,1,1098,18,1600,484,502,596
14,CONSTANŢA,"ȘCOALA GIMNAZIALĂ NR.1 EFORIE NORD",293,"ORAŞ EFORIE",60455,1,PART,PRCNCT,PRSD,PRSD_SV,"2025-05-18 22:48:13",870,908,427,481,0,893,15,1101,193,441,452
14,CONSTANŢA,"CASA DE CULTURA",294,"ORAŞ HÂRŞOVA",60801,1,PART,PRCNCT,PRSD,PRSD_SV,"2025-05-18 21:38:23",686,379,323,56,0,379,0,800,421,162,217
14,CONSTANŢA,"LICEUL TEORETIC ”IOAN COTOVU”",295,"ORAŞ HÂRŞOVA",60801,1,PART,PRCNCT,PRSD,PRSD_SV,"2025-05-18 22:00:56",1219,587,526,59,2,581,6,1400,813,333,248
14,CONSTANŢA,"LICEUL TEORETIC ”IOAN COTOVU”",296,"ORAŞ HÂRŞOVA",60801,1,PART,PRCNCT,PRSD,PRSD_SV,"2025-05-18 21:56:07",1403,623,581,40,2,621,2,1500,877,340,281
14,CONSTANŢA,"LICEUL TEORETIC ”IOAN COTOVU” HÂRȘOVA (ȘCOALA PORT HÂRȘOVA)",297,"ORAŞ HÂRŞOVA",60801,1,PART,PRCNCT,PRSD,PRSD_SV,"2025-05-18 22:16:30",1119,468,429,35,4,462,6,1200,732,250,212
14,CONSTANŢA,"ŞCOALA PORT HÂRŞOVA",298,"ORAŞ HÂRŞOVA",60801,2,PART,PRCNCT,PRSD,PRSD_SV,"2025-05-19 02:19:54",1097,442,405,37,0,432,10,1208,766,272,160
14,CONSTANŢA,"ŞCOALA GIMNAZIALĂ NR. 1",299,"ORAŞ HÂRŞOVA",60801,1,PART,PRCNCT,PRSD,PRSD_SV,"2025-05-18 21:45:55",1114,495,450,45,0,488,7,1200,705,317,171
14,CONSTANŢA,"GRADINIŢA VAROŞ",300,"ORAŞ HÂRŞOVA",60801,1,PART,PRCNCT,PRSD,PRSD_SV,"2025-05-18 21:33:14",1263,546,515,31,0,540,6,1400,854,394,146
14,CONSTANŢA,"ŞCOALA PRIMARĂ VADU OII",301,"ORAŞ HÂRŞOVA",60801,1,PART,PRCNCT,PRSD,PRSD_SV,"2025-05-18 21:26:20",288,155,134,21,0,155,0,298,143,111,44
14,CONSTANŢA,"LICEUL TEORETIC MURFATLAR",302,"ORAŞ MURFATLAR",62360,1,PART,PRCNCT,PRSD,PRSD_SV,"2025-05-18 22:37:57",1175,630,542,88,0,625,5,1300,670,374,251
14,CONSTANŢA,"LICEUL TEORETIC MURFATLAR",303,"ORAŞ MURFATLAR",62360,1,PART,PRCNCT,PRSD,PRSD_SV,"2025-05-18 21:58:22",1112,585,557,28,0,579,6,1200,615,320,259
14,CONSTANŢA,"SALA DE SPORT",304,"ORAŞ MURFATLAR",62360,1,PART,PRCNCT,PRSD,PRSD_SV,"2025-05-18 21:41:03",1135,641,600,41,0,634,7,1200,559,399,235
14,CONSTANŢA,"ȘCOALA GENERALĂ NR.2 MURFATLAR",305,"ORAŞ MURFATLAR",62360,1,PART,PRCNCT,PRSD,PRSD_SV,"2025-05-18 22:08:29",1674,977,863,113,1,964,13,1900,923,631,333
14,CONSTANŢA,"CASA DE CULTURĂ",306,"ORAŞ MURFATLAR",62360,1,PART,PRCNCT,PRSD,PRSD_SV,"2025-05-18 21:27:40",1395,800,732,67,1,786,14,1500,700,430,356
14,CONSTANŢA,"S.C.U.G S.A. MURFATLAR",307,"ORAŞ MURFATLAR",62360,2,PART,PRCNCT,PRSD,PRSD_SV,"2025-05-19 01:41:27",989,629,530,98,1,614,15,1100,471,410,204
14,CONSTANŢA,"CĂMIN CULTURAL SIMINOC",308,"ORAŞ MURFATLAR",62360,1,PART,PRCNCT,PRSD,PRSD_SV,"2025-05-18 21:42:22",1061,679,603,75,1,668,11,1200,521,431,237
14,CONSTANŢA,"GRĂDINIȚA ”PEȘTIȘORUL DE AUR”",309,"ORAŞ NĂVODARI",60507,1,PART,PRCNCT,PRSD,PRSD_SV,"2025-05-18 22:00:41",1409,707,634,73,0,697,10,1500,793,340,357
14,CONSTANŢA,"LICEUL TEHNOLOGIC „LAZĂR EDELEANU”",310,"ORAŞ NĂVODARI",60507,1,PART,PRCNCT,PRSD,PRSD_SV,"2025-05-18 21:42:13",1194,776,611,165,0,767,9,1300,524,358,409
14,CONSTANŢA,"LICEUL TEHNOLOGIC „LAZĂR EDELEANU”",311,"ORAŞ NĂVODARI",60507,1,PART,PRCNCT,PRSD,PRSD_SV,"2025-05-18 21:58:19",1050,559,510,49,0,553,6,1200,641,261,292
14,CONSTANŢA,"LICEUL TEHNOLOGIC „LAZĂR EDELEANU”",312,"ORAŞ NĂVODARI",60507,2,PART,PRCNCT,PRSD,PRSD_SV,"2025-05-18 23:46:25",1582,781,725,56,0,773,8,1700,919,435,338
14,CONSTANŢA,"LICEUL TEHNOLOGIC „LAZĂR EDELEANU”",313,"ORAŞ NĂVODARI",60507,1,PART,PRCNCT,PRSD,PRSD_SV,"2025-05-18 21:33:34",1333,664,622,42,0,653,11,1500,836,324,329
14,CONSTANŢA,"ŞCOALA GIMNAZIALĂ „GEORGE ENESCU”",314,"ORAŞ NĂVODARI",60507,1,PART,PRCNCT,PRSD,PRSD_SV,"2025-05-18 21:39:27",1389,773,663,110,0,766,7,1500,727,389,377
14,CONSTANŢA,"ŞCOALA GIMNAZIALĂ „GEORGE ENESCU”",315,"ORAŞ NĂVODARI",60507,1,PART,PRCNCT,PRSD,PRSD_SV,"2025-05-18 21:41:10",1533,905,794,111,0,892,13,1700,795,400,492
14,CONSTANŢA,"ŞCOALA GIMNAZIALĂ „GEORGE ENESCU”",316,"ORAŞ NĂVODARI",60507,1,PART,PRCNCT,PRSD,PRSD_SV,"2025-05-18 21:55:31",1496,896,821,74,1,888,8,1600,704,471,417
14,CONSTANŢA,"ŞCOALA GIMNAZIALĂ „GEORGE ENESCU”",317,"ORAŞ NĂVODARI",60507,1,PART,PRCNCT,PRSD,PRSD_SV,"2025-05-18 21:49:46",1331,776,686,90,0,767,9,1491,715,356,411
14,CONSTANŢA,"ŞCOALA GIMNAZIALĂ „GEORGE ENESCU”",318,"ORAŞ NĂVODARI",60507,1,PART,PRCNCT,PRSD,PRSD_SV,"2025-05-18 21:47:17",1635,835,770,64,1,821,14,1800,964,430,391
14,CONSTANŢA,"ŞCOALA GIMNAZIALĂ „GEORGE ENESCU”",319,"ORAŞ NĂVODARI",60507,1,PART,PRCNCT,PRSD,PRSD_SV,"2025-05-18 21:54:49",1809,1130,1001,128,1,1112,18,2000,870,563,549
14,CONSTANŢA,"ŞCOALA GIMNAZIALĂ „GEORGE ENESCU”",320,"ORAŞ NĂVODARI",60507,1,PART,PRCNCT,PRSD,PRSD_SV,"2025-05-18 21:44:14",1599,920,840,80,0,909,11,1803,883,420,489
14,CONSTANŢA,"ŞCOALA GIMNAZIALĂ „GRIGORE MOISIL”",321,"ORAŞ NĂVODARI",60507,1,PART,PRCNCT,PRSD,PRSD_SV,"2025-05-18 21:53:09",1838,1032,920,112,0,1017,15,2000,968,620,397
14,CONSTANŢA,"ŞCOALA GIMNAZIALĂ „GRIGORE MOISIL”",322,"ORAŞ NĂVODARI",60507,1,PART,PRCNCT,PRSD,PRSD_SV,"2025-05-18 22:31:41",1517,766,725,40,1,761,5,1700,934,422,339
14,CONSTANŢA,"ŞCOALA GIMNAZIALĂ „GRIGORE MOISIL”",323,"ORAŞ NĂVODARI",60507,1,PART,PRCNCT,PRSD,PRSD_SV,"2025-05-18 21:36:22",1258,694,600,94,0,685,9,1400,706,382,303
14,CONSTANŢA,"ȘCOALA GIMNAZIALĂ „GRIGORE MOISIL”",324,"ORAŞ NĂVODARI",60507,1,PART,PRCNCT,PRSD,PRSD_SV,"2025-05-18 21:58:48",929,466,416,49,1,462,4,1000,534,247,215
14,CONSTANŢA,"GRĂDINIȚA CU PROGRAM PRELUNGIT „VESELIEI”",325,"ORAŞ NĂVODARI",60507,1,PART,PRCNCT,PRSD,PRSD_SV,"2025-05-18 22:07:39",1722,934,836,98,0,920,14,1900,966,554,366
14,CONSTANŢA,"CLUBUL SINDICATULUI „PETROCHIMISTUL”",326,"ORAŞ NĂVODARI",60507,1,PART,PRCNCT,PRSD,PRSD_SV,"2025-05-18 21:51:50",1190,685,581,104,0,677,8,1300,615,360,317
14,CONSTANŢA,"ŞCOALA GIMNAZIALĂ „TUDOR ARGHEZI”",327,"ORAŞ NĂVODARI",60507,1,PART,PRCNCT,PRSD,PRSD_SV,"2025-05-18 21:48:05",1120,740,614,126,0,729,11,1200,460,323,406
14,CONSTANŢA,"ŞCOALA GIMNAZIALĂ „TUDOR ARGHEZI”",328,"ORAŞ NĂVODARI",60507,1,PART,PRCNCT,PRSD,PRSD_SV,"2025-05-18 21:41:58",770,353,298,55,0,347,6,900,547,193,154
14,CONSTANŢA,"CASA CĂSĂTORIILOR",329,"ORAŞ NĂVODARI",60507,1,PART,PRCNCT,PRSD,PRSD_SV,"2025-05-18 22:01:39",1349,768,622,146,0,754,14,1500,732,426,328
14,CONSTANŢA,"CREȘA NR. 20 NĂVODARI",330,"ORAŞ NĂVODARI",60507,1,PART,PRCNCT,PRSD,PRSD_SV,"2025-05-18 21:57:50",1467,669,530,138,1,666,3,1600,931,406,260
14,CONSTANŢA,"SALA DE SPORT CU NIVEL DE PRACTICĂ ȘCOLARĂ COMPETIȚIONALĂ LOCALĂ",331,"ORAŞ NĂVODARI",60507,1,PART,PRCNCT,PRSD,PRSD_SV,"2025-05-18 22:14:43",1575,905,811,93,1,896,9,1600,695,506,390
14,CONSTANŢA,"CENTRUL DE AFACERI NĂVODARI",332,"ORAŞ NĂVODARI",60507,1,PART,PRCNCT,PRSD,PRSD_SV,"2025-05-18 23:34:38",1769,1162,698,463,1,1156,6,2000,838,475,681
14,CONSTANŢA,"CENTRUL DE AFACERI NĂVODARI",333,"ORAŞ NĂVODARI",60507,1,PART,PRCNCT,PRSD,PRSD_SV,"2025-05-19 01:39:33",1769,1335,977,358,0,1323,12,1900,565,515,808
14,CONSTANŢA,"ȘCOALA PRIMARĂ NR.1 PENINSULA NĂVODARI",334,"ORAŞ NĂVODARI",60507,1,PART,PRCNCT,PRSD,PRSD_SV,"2025-05-18 21:53:09",592,267,228,39,0,264,3,700,433,197,67
14,CONSTANŢA,"CASA DE CULTURĂ",335,"ORAŞ NEGRU VODĂ",62397,1,PART,PRCNCT,PRSD,PRSD_SV,"2025-05-18 22:03:38",1183,608,555,52,1,606,2,1300,692,398,208
14,CONSTANŢA,"CLUB PENSIONARI",336,"ORAŞ NEGRU VODĂ",62397,1,PART,PRCNCT,PRSD,PRSD_SV,"2025-05-18 21:38:11",1199,591,516,71,4,585,6,1300,709,377,208
14,CONSTANŢA,"ŞCOALA GENERALĂ",337,"ORAŞ NEGRU VODĂ",62397,1,PART,PRCNCT,PRSD,PRSD_SV,"2025-05-18 21:35:04",1039,488,435,53,0,483,5,1100,612,346,137
14,CONSTANŢA,"SEDIU ADMINISTRATIV",338,"ORAŞ NEGRU VODĂ",62397,1,PART,PRCNCT,PRSD,PRSD_SV,"2025-05-18 21:12:39",128,95,80,15,0,95,0,200,105,80,15
14,CONSTANŢA,"SEDIU ADMINISTRATIV AL PRIMARIEI",339,"ORAŞ NEGRU VODĂ",62397,1,PART,PRCNCT,PRSD,PRSD_SV,"2025-05-18 21:37:26",561,238,211,27,0,238,0,600,362,207,31
14,CONSTANŢA,"SCOALA GENERALĂ CLASELE I-IV",340,"ORAŞ NEGRU VODĂ",62397,1,PART,PRCNCT,PRSD,PRSD_SV,"2025-05-18 21:22:04",196,103,81,22,0,102,1,200,97,90,12
14,CONSTANŢA,"LICEUL TEHNOLOGIC ”ION PODARU” OVIDIU",341,"ORAŞ OVIDIU",60687,1,PART,PRCNCT,PRSD,PRSD_SV,"2025-05-18 22:13:41",1821,1066,897,169,0,1060,6,2000,934,664,396
14,CONSTANŢA,"LICEUL TEHNOLOGIC ”ION PODARU” OVIDIU",342,"ORAŞ OVIDIU",60687,1,PART,PRCNCT,PRSD,PRSD_SV,"2025-05-18 22:52:33",1786,960,877,82,1,952,8,2000,1040,605,347
14,CONSTANŢA,"ŞCOALA GIMNAZIALĂ NR. 2 OVIDIU",343,"ORAŞ OVIDIU",60687,1,PART,PRCNCT,PRSD,PRSD_SV,"2025-05-18 22:18:02",1814,1172,992,180,0,1163,9,2100,928,545,618
14,CONSTANŢA,"ŞCOALA GIMNAZIALĂ NR. 2 OVIDIU",344,"ORAŞ OVIDIU",60687,1,PART,PRCNCT,PRSD,PRSD_SV,"2025-05-18 22:43:07",1906,1058,967,89,2,1041,17,2100,1042,593,448
14,CONSTANŢA,"ŞCOALA GIMNAZIALĂ NR. 2 OVIDIU (SALA DE SPORT)",345,"ORAŞ OVIDIU",60687,1,PART,PRCNCT,PRSD,PRSD_SV,"2025-05-18 22:26:36",2006,1340,1146,166,28,1319,21,2200,860,495,824
14,CONSTANŢA,"CENTRUL CULTURAL OVIDIU",346,"ORAŞ OVIDIU",60687,2,PART,PRCNCT,PRSD,PRSD_SV,"2025-05-19 01:29:42",1794,1131,996,131,4,1114,17,2000,869,543,571
14,CONSTANŢA,"SCOALA GIMNAZIALĂ NR. 3 CULMEA",347,"ORAŞ OVIDIU",60687,1,PART,PRCNCT,PRSD,PRSD_SV,"2025-05-18 21:53:42",1111,576,519,57,0,571,5,1200,624,452,119
14,CONSTANŢA,"CENTRUL CULTURAL ”GABRIEL COTABIȚĂ” POIANA",348,"ORAŞ OVIDIU",60687,1,PART,PRCNCT,PRSD,PRSD_SV,"2025-05-18 21:58:59",1069,778,636,141,1,771,7,1200,422,489,282
14,CONSTANŢA,"SALA DE SPORT",349,"ORAŞ TECHIRGHIOL",60534,1,PART,PRCNCT,PRSD,PRSD_SV,"2025-05-18 22:42:25",1816,1592,976,590,26,1568,24,2397,805,713,855
14,CONSTANŢA,"GRĂDINIȚA NR.1",350,"ORAŞ TECHIRGHIOL",60534,1,PART,PRCNCT,PRSD,PRSD_SV,"2025-05-18 22:02:41",1816,1196,966,227,3,1180,16,2400,1204,564,616
14,CONSTANŢA,"GRĂDINIȚA NR.2",351,"ORAŞ TECHIRGHIOL",60534,1,PART,PRCNCT,PRSD,PRSD_SV,"2025-05-18 22:22:32",1978,1211,1071,139,1,1197,14,2400,1189,738,459
14,CONSTANŢA,"LICEUL ”EMIL RACOVIȚĂ”",352,"ORAŞ TECHIRGHIOL",60534,1,PART,PRCNCT,PRSD,PRSD_SV,"2025-05-18 22:39:48",1697,1021,858,159,4,1010,11,2000,979,471,539
14,CONSTANŢA,"ŞCOALA GIMNAZIALĂ ”GEORGE COŞBUC”",353,"23 AUGUST",60598,1,PART,PRCNCT,PRSD,PRSD_SV,"2025-05-18 21:29:37",1278,778,641,137,0,772,6,1400,622,449,323
14,CONSTANŢA,"ŞCOALA GIMNAZIALĂ ”GEORGE COŞBUC”",354,"23 AUGUST",60598,1,PART,PRCNCT,PRSD,PRSD_SV,"2025-05-18 21:41:41",1310,774,658,116,0,768,6,1400,626,426,342
14,CONSTANŢA,"ŞCOALA GIMNAZIALĂ ”TITU MAIORESCU”",355,"23 AUGUST",60598,1,PART,PRCNCT,PRSD,PRSD_SV,"2025-05-18 21:45:36",1178,638,580,58,0,635,3,1300,662,409,226
14,CONSTANŢA,"ŞCOALA GIMNAZIALĂ ”NICOLAE IORGA”",356,"23 AUGUST",60598,1,PART,PRCNCT,PRSD,PRSD_SV,"2025-05-18 21:47:04",1063,567,502,65,0,557,10,1200,633,418,139
14,CONSTANŢA,"CĂMIN CULTURAL ADAMCLISI",357,ADAMCLISI,60883,1,PART,PRCNCT,PRSD,PRSD_SV,"2025-05-18 21:59:36",905,470,408,62,0,461,9,1001,531,295,166
14,CONSTANŢA,"ȘCOALA GENERALĂ ABRUD",358,ADAMCLISI,60883,1,PART,PRCNCT,PRSD,PRSD_SV,"2025-05-18 21:28:11",104,56,49,7,0,55,1,200,144,40,15
14,CONSTANŢA,"ȘCOALA GENERALĂ URLUIA",359,ADAMCLISI,60883,1,PART,PRCNCT,PRSD,PRSD_SV,"2025-05-18 21:40:14",283,159,128,31,0,157,2,300,141,133,24
14,CONSTANŢA,"ŞCOALA ZORILE",360,ADAMCLISI,60883,1,PART,PRCNCT,PRSD,PRSD_SV,"2025-05-18 21:45:57",451,226,202,24,0,225,1,500,274,168,57
14,CONSTANŢA,"ȘCOALA GIMNAZIALĂ ION BORCEA - CLASA 8",361,AGIGEA,60570,1,PART,PRCNCT,PRSD,PRSD_SV,"2025-05-18 22:03:18",1262,863,690,172,1,855,8,1400,537,432,423
14,CONSTANŢA,"ȘCOALA GIMNAZIALĂ ION BORCEA - SALA DE MESE",362,AGIGEA,60570,1,PART,PRCNCT,PRSD,PRSD_SV,"2025-05-18 22:11:10",1573,1195,1028,167,0,1180,15,1700,505,565,615
14,CONSTANŢA,"GRĂDINIȚA CU ORAR PRELUNGIT RIȚA GĂRGĂRIȚA - GRUPA FLUTURAȘILOR",363,AGIGEA,60570,1,PART,PRCNCT,PRSD,PRSD_SV,"2025-05-18 21:36:56",1261,856,731,125,0,842,14,1400,544,424,418
14,CONSTANŢA,"GRĂDINIȚA CU ORAR PRELUNGIT RIȚA GĂRGĂRIȚA - GRUPA RĂȚUȘTELOR",364,AGIGEA,60570,1,PART,PRCNCT,PRSD,PRSD_SV,"2025-05-18 21:31:15",1088,713,619,94,0,708,5,1400,687,405,303
14,CONSTANŢA,"GRĂDINIȚA CU ORAR NORMAL NR. 2",365,AGIGEA,60570,1,PART,PRCNCT,PRSD,PRSD_SV,"2025-05-18 21:39:59",773,584,404,123,57,578,6,900,316,324,254
14,CONSTANŢA,"GRĂDINIȚA CU ORAR NORMAL STRUCTURA LAZU",366,AGIGEA,60570,1,PART,PRCNCT,PRSD,PRSD_SV,"2025-05-18 22:03:45",1048,746,629,117,0,732,14,1200,454,296,436
14,CONSTANŢA,"GRĂDINIȚA CU ORAR NORMAL STRUCTURA LAZU",367,AGIGEA,60570,1,PART,PRCNCT,PRSD,PRSD_SV,"2025-05-18 22:02:14",1109,872,716,156,0,859,13,1200,328,383,476
14,CONSTANŢA,"GRĂDINIȚA CU PROGRAM NORMAL ALBEȘTI",368,ALBEŞTI,60945,1,PART,PRCNCT,PRSD,PRSD_SV,"2025-05-18 21:58:14",1297,743,670,73,0,741,2,1400,657,514,227
14,CONSTANŢA,"ȘCOALA PRIMARĂ NR. 2 ARSA",369,ALBEŞTI,60945,1,PART,PRCNCT,PRSD,PRSD_SV,"2025-05-18 21:39:41",525,317,280,37,0,317,0,600,283,242,75
14,CONSTANŢA,"SCOALA PRIMARĂ COROANA",370,ALBEŞTI,60945,1,PART,PRCNCT,PRSD,PRSD_SV,"2025-05-18 21:19:09",90,68,45,23,0,68,0,100,32,54,14
14,CONSTANŢA,"SCOALA GIMNAZIALĂ NR. 1 COTU-VAII",371,ALBEŞTI,60945,1,PART,PRCNCT,PRSD,PRSD_SV,"2025-05-18 21:54:03",889,454,413,41,0,452,2,1001,547,374,78
14,CONSTANŢA,"ȘCOALA PRIMARĂ NR.3 VÎRTOP",372,ALBEŞTI,60945,1,PART,PRCNCT,PRSD,PRSD_SV,"2025-05-18 21:25:15",238,129,109,20,0,126,3,301,172,90,36
14,CONSTANŢA,"SCOALA GIMNAZIALA ”DAN SPATARU” ALIMAN",373,ALIMAN,61005,1,PART,PRCNCT,PRSD,PRSD_SV,"2025-05-18 21:38:22",622,303,263,40,0,302,1,700,397,239,63
14,CONSTANŢA,"GRĂDINIŢA CU PROGRAM NORMAL ALIMAN",374,ALIMAN,61005,1,PART,PRCNCT,PRSD,PRSD_SV,"2025-05-18 21:34:10",410,163,149,14,0,162,1,500,337,129,33
14,CONSTANŢA,"SCOALA GIMNAZIALA NR. 1 DUNARENI",375,ALIMAN,61005,1,PART,PRCNCT,PRSD,PRSD_SV,"2025-05-18 22:03:41",1070,448,415,33,0,442,6,1200,752,309,133
14,CONSTANŢA,"ȘCOALA AMZACEA",376,AMZACEA,63198,1,PART,PRCNCT,PRSD,PRSD_SV,"2025-05-18 21:33:36",1147,563,501,61,1,560,3,1300,737,406,154
14,CONSTANŢA,"ȘCOALA GENERALĂ CASICEA",377,AMZACEA,63198,1,PART,PRCNCT,PRSD,PRSD_SV,"2025-05-18 21:27:52",332,129,117,12,0,128,1,400,271,107,21
14,CONSTANŢA,"ȘCOALA GENERALĂ GENERAL SCĂRIȘOREANU",378,AMZACEA,63198,1,PART,PRCNCT,PRSD,PRSD_SV,"2025-05-18 21:23:41",791,360,308,52,0,360,0,900,540,277,83
14,CONSTANŢA,"LICEUL TEORETOC BĂNEASA CORP B",379,BĂNEASA,61069,1,PART,PRCNCT,PRSD,PRSD_SV,"2025-05-18 21:33:49",1030,464,410,53,1,459,5,1100,636,329,130
14,CONSTANŢA,"LICEUL TEORETIC BĂNEASA CORP A",380,BĂNEASA,61069,1,PART,PRCNCT,PRSD,PRSD_SV,"2025-05-18 21:46:46",1583,835,750,82,3,831,4,1700,865,534,297
14,CONSTANŢA,"ȘCOALA GIMNAZIALĂ NR.1 FĂUREI",381,BĂNEASA,61069,1,PART,PRCNCT,PRSD,PRSD_SV,"2025-05-18 21:35:16",1119,271,247,24,0,262,9,1200,929,205,57
14,CONSTANŢA,"ȘCOALA PRIMARĂ NR.2 NEGURENI",382,BĂNEASA,61069,1,PART,PRCNCT,PRSD,PRSD_SV,"2025-05-18 21:43:05",535,272,241,30,1,266,6,600,328,181,85
14,CONSTANŢA,"ȘCOALA GIMNAZIALĂ ”EMIL GÂRLEANU” BĂRĂGANU",383,BĂRĂGANU,63294,1,PART,PRCNCT,PRSD,PRSD_SV,"2025-05-18 21:34:47",942,455,408,47,0,452,3,1000,545,340,112
14,CONSTANŢA,"ȘCOALA GIMNAZIALĂ ”EMIL GÂRLEANU” BĂRĂGANU - ȘCOALA PRIMARĂ NR. 1 LANURILE",384,BĂRĂGANU,63294,1,PART,PRCNCT,PRSD,PRSD_SV,"2025-05-18 22:00:46",728,387,325,62,0,381,6,800,413,281,100
14,CONSTANŢA,"ANEXA SEDIUL ADMINISTRATIV PRIMĂRIA COMUNEI CASTELU-SALA DE FESTIVITĂȚI 1",385,CASTELU,61121,1,PART,PRCNCT,PRSD,PRSD_SV,"2025-05-18 22:02:56",1191,580,528,52,0,568,12,1300,720,424,144
14,CONSTANŢA,"ANEXA SEDIUL ADMINISTRATIV PRIMĂRIA COMUNEI CASTELU-SALA DE FESTIVITĂȚI 2",386,CASTELU,61121,1,PART,PRCNCT,PRSD,PRSD_SV,"2025-05-18 22:08:14",1469,650,600,50,0,628,22,1600,950,437,191
14,CONSTANŢA,"CĂMINUL CULTURAL NISIPARI-SALA DE SPECTACOLE",387,CASTELU,61121,1,PART,PRCNCT,PRSD,PRSD_SV,"2025-05-18 21:51:45",1584,933,871,61,1,927,6,1700,767,718,209
14,CONSTANŢA,"CĂMINUL CULTURAL CERCHEZU",388,CERCHEZU,61167,1,PART,PRCNCT,PRSD,PRSD_SV,"2025-05-18 21:42:18",386,182,163,19,0,180,2,400,218,108,72
14,CONSTANŢA,"CĂMINUL CULTURAL CĂSCIOARELE",389,CERCHEZU,61167,1,PART,PRCNCT,PRSD,PRSD_SV,"2025-05-18 21:26:33",221,122,105,17,0,118,4,300,178,89,29
14,CONSTANŢA,"CASA AGRONOMULUI MĂGURA",390,CERCHEZU,61167,1,PART,PRCNCT,PRSD,PRSD_SV,"2025-05-18 21:22:33",68,40,27,13,0,40,0,100,60,26,14
14,CONSTANŢA,"CĂMINUL CULTURAL VIROAGA",391,CERCHEZU,61167,1,PART,PRCNCT,PRSD,PRSD_SV,"2025-05-18 21:41:08",337,164,137,27,0,163,1,400,236,99,64
14,CONSTANŢA,"ȘCOALA GIMNAZIALĂ NR.1 CHIRNOGENI",392,CHIRNOGENI,61210,1,PART,PRCNCT,PRSD,PRSD_SV,"2025-05-18 22:02:19",1416,730,634,95,1,727,3,1600,870,509,218
14,CONSTANŢA,"ŞCOALA PRIMARĂ NR.3 CREDINŢA",393,CHIRNOGENI,61210,1,PART,PRCNCT,PRSD,PRSD_SV,"2025-05-18 21:23:05",243,139,118,21,0,139,0,300,161,113,26
14,CONSTANŢA,"ȘCOALA GIMNAZIALĂ NR.2 PLOPENI",394,CHIRNOGENI,61210,1,PART,PRCNCT,PRSD,PRSD_SV,"2025-05-18 21:23:03",835,407,331,68,8,406,1,900,493,265,141
14,CONSTANŢA,"ȘCOALA PROFESIONALĂ CIOBANU",395,CIOBANU,61256,1,PART,PRCNCT,PRSD,PRSD_SV,"2025-05-18 21:51:21",1254,685,636,49,0,682,3,1300,615,502,180
14,CONSTANŢA,"ȘCOALA PROFESIONALĂ CIOBANU",396,CIOBANU,61256,1,PART,PRCNCT,PRSD,PRSD_SV,"2025-05-18 22:05:05",1277,592,565,27,0,590,2,1300,708,453,137
14,CONSTANŢA,"GRĂDINIȚA CU PROGRAM NORMAL MIORIȚA",397,CIOBANU,61256,1,PART,PRCNCT,PRSD,PRSD_SV,"2025-05-18 21:34:21",222,113,86,27,0,111,2,300,187,77,34
14,CONSTANŢA,"CĂMIN CULTURAL SAT CIOCÎRLIA",398,CIOCÂRLIA,61283,1,PART,PRCNCT,PRSD,PRSD_SV,"2025-05-18 21:55:15",1281,701,616,84,1,691,10,1300,599,458,233
14,CONSTANŢA,"CĂMIN CULTURAL SAT CIOCÎRLIA DE SUS",399,CIOCÂRLIA,61283,1,PART,PRCNCT,PRSD,PRSD_SV,"2025-05-18 22:10:57",1231,671,576,95,0,667,4,1300,629,451,216
14,CONSTANŢA,"CĂMIN CULTURAL COBADIN",400,COBADIN,61318,1,PART,PRCNCT,PRSD,PRSD_SV,"2025-05-18 21:47:33",1916,968,840,128,0,964,4,2000,1032,640,324
14,CONSTANŢA,"ȘCOALA TĂTARĂ COBADIN",401,COBADIN,61318,1,PART,PRCNCT,PRSD,PRSD_SV,"2025-05-18 21:32:54",1809,898,820,78,0,888,10,1900,1002,607,281
14,CONSTANŢA,"GRĂDINIȚA CU PROGRAM NORMAL COBADIN",402,COBADIN,61318,1,PART,PRCNCT,PRSD,PRSD_SV,"2025-05-18 22:04:11",1777,824,766,58,0,819,5,1800,976,558,261
14,CONSTANŢA,"ȘCOALA GENERALĂ CONACU",403,COBADIN,61318,1,PART,PRCNCT,PRSD,PRSD_SV,"2025-05-18 21:28:53",266,93,78,15,0,92,1,300,207,69,23
14,CONSTANŢA,"CĂMIN CULTURAL NEGREȘTI",404,COBADIN,61318,1,PART,PRCNCT,PRSD,PRSD_SV,"2025-05-18 21:33:26",337,257,152,105,0,251,6,400,143,170,81
14,CONSTANŢA,"GRĂDINIȚA VIIȘOARA",405,COBADIN,61318,1,PART,PRCNCT,PRSD,PRSD_SV,"2025-05-18 21:51:40",1291,706,619,87,0,701,5,1300,594,547,154
14,CONSTANŢA,"GRĂDINIȚA CU ORAR NORMAL COGEALAC",406,COGEALAC,61372,1,PART,PRCNCT,PRSD,PRSD_SV,"2025-05-18 22:07:35",1522,717,649,65,3,708,9,1600,883,548,160
14,CONSTANŢA,"SCOALA GIMNAZIALA ” CRISTEA CARAMAN” COGEALAC",407,COGEALAC,61372,1,PART,PRCNCT,PRSD,PRSD_SV,"2025-05-18 21:34:39",1261,670,590,79,1,663,7,1300,630,482,181
14,CONSTANŢA,"ȘCOALA GIMNAZIALA NUMARUL 1 RÂMNICU DE JOS",408,COGEALAC,61372,1,PART,PRCNCT,PRSD,PRSD_SV,"2025-05-18 21:33:26",642,272,236,36,0,271,1,700,428,211,60
14,CONSTANŢA,"ȘCOALA GIMNAZIALA NUMARUL 2 TARIVERDE",409,COGEALAC,61372,2,PART,PRCNCT,PRSD,PRSD_SV,"2025-05-19 00:43:21",837,424,360,64,0,418,6,900,476,333,85
14,CONSTANŢA,"SCOALA CU CLASELE I-VIII COMANA",410,COMANA,61452,1,PART,PRCNCT,PRSD,PRSD_SV,"2025-05-18 21:37:16",787,367,325,42,0,366,1,800,433,246,120
14,CONSTANŢA,"ŞCOALA CU CLS. I - IV PELINU",411,COMANA,61452,1,PART,PRCNCT,PRSD,PRSD_SV,"2025-05-18 21:14:21",208,93,75,18,0,93,0,300,207,59,34
14,CONSTANŢA,"CĂMIN CULTURAL TĂTARU",412,COMANA,61452,1,PART,PRCNCT,PRSD,PRSD_SV,"2025-05-18 21:18:15",524,216,191,24,1,212,4,600,384,142,70
14,CONSTANŢA,"ȘCOALA GIMNAZIALĂ ”GHEORGHE LAZĂR”",413,CORBU,61513,1,PART,PRCNCT,PRSD,PRSD_SV,"2025-05-18 22:13:05",1536,1120,761,359,0,1108,12,1600,480,674,434
14,CONSTANŢA,"GRĂDINIȚA CU PROGRAM NORMAL NR. 1",414,CORBU,61513,1,PART,PRCNCT,PRSD,PRSD_SV,"2025-05-18 22:05:37",1494,780,704,76,0,774,6,1500,720,523,251
14,CONSTANŢA,"CĂMIN CULTURAL CORBU DE SUS",415,CORBU,61513,1,PART,PRCNCT,PRSD,PRSD_SV,"2025-05-18 21:53:21",1807,916,830,85,1,910,6,1900,984,603,307
14,CONSTANŢA,"SCOALA PRIMARA VADU",416,CORBU,61513,1,PART,PRCNCT,PRSD,PRSD_SV,"2025-05-18 21:26:22",551,412,268,142,2,408,4,600,188,240,168
14,CONSTANŢA,"ŞCOALA GIMNAZIALĂ ”MIHAI EMINESCU” COSTINEŞTI",417,COSTINEŞTI,63286,1,PART,PRCNCT,PRSD,PRSD_SV,"2025-05-18 22:42:06",989,1068,550,514,4,1061,7,1200,132,547,514
14,CONSTANŢA,"ŞCOALA PRIMARA” ION CREANGA” SCHITU",418,COSTINEŞTI,63286,1,PART,PRCNCT,PRSD,PRSD_SV,"2025-05-18 22:12:09",1964,1327,1065,261,1,1320,7,2000,673,777,543
14,CONSTANŢA,"CAMIN CULTURAL CRUCEA",419,CRUCEA,61559,1,PART,PRCNCT,PRSD,PRSD_SV,"2025-05-18 21:42:40",874,415,360,55,0,411,4,899,484,272,139
14,CONSTANŢA,"ŞCOALA PRIMARĂ NR.1 BĂLTĂGEŞTI",420,CRUCEA,61559,1,PART,PRCNCT,PRSD,PRSD_SV,"2025-05-18 21:48:19",329,160,147,13,0,157,3,400,240,111,46
14,CONSTANŢA,"GRĂDINIŢA CU PROGRAM NORMAL CRIŞAN",421,CRUCEA,61559,1,PART,PRCNCT,PRSD,PRSD_SV,"2025-05-18 21:22:34",280,122,105,17,0,118,4,300,178,80,38
14,CONSTANŢA,"GRĂDINIȚA CU PROGRAM NORMAL GĂLBIORI",422,CRUCEA,61559,1,PART,PRCNCT,PRSD,PRSD_SV,"2025-05-18 21:27:30",250,142,129,13,0,141,1,300,158,88,53
14,CONSTANŢA,"ŞCOALA PRIMARĂ NR.4 STUPINA",423,CRUCEA,61559,1,PART,PRCNCT,PRSD,PRSD_SV,"2025-05-18 21:29:53",532,228,192,17,19,228,0,600,372,143,85
14,CONSTANŢA,"ŞCOALA PRIMARĂ NR.3 ŞIRIU",424,CRUCEA,61559,1,PART,PRCNCT,PRSD,PRSD_SV,"2025-05-18 21:15:35",171,86,74,12,0,86,0,200,114,57,29
14,CONSTANŢA,"LICEUL TEHNOLOGIC ”NICOLAE DUMITRESCU”",425,CUMPĂNA,61620,1,PART,PRCNCT,PRSD,PRSD_SV,"2025-05-18 21:51:16",1754,1131,896,234,1,1115,16,1800,669,539,576
14,CONSTANŢA,"LICEUL TEHNOLOGIC ”NICOLAE DUMITRESCU”",426,CUMPĂNA,61620,1,PART,PRCNCT,PRSD,PRSD_SV,"2025-05-18 22:03:14",1889,1110,1039,69,2,1101,9,1900,790,605,496
14,CONSTANŢA,"LICEUL TEHNOLOGIC ”NICOLAE DUMITRESCU”",427,CUMPĂNA,61620,1,PART,PRCNCT,PRSD,PRSD_SV,"2025-05-18 22:01:32",1758,1032,957,74,1,1019,13,1800,768,499,520
14,CONSTANŢA,"SALA DE SPORT 1",428,CUMPĂNA,61620,1,PART,PRCNCT,PRSD,PRSD_SV,"2025-05-18 22:18:07",1992,1215,1130,85,0,1198,17,2000,785,618,580
14,CONSTANŢA,"SALA DE SPORT 1",429,CUMPĂNA,61620,1,PART,PRCNCT,PRSD,PRSD_SV,"2025-05-18 22:26:36",2038,1174,1066,108,0,1160,14,2100,926,675,485
14,CONSTANŢA,"GRĂDINIȚA ”FLORILOR”",430,CUMPĂNA,61620,1,PART,PRCNCT,PRSD,PRSD_SV,"2025-05-18 22:03:36",1934,1198,1068,130,0,1187,11,2000,802,602,585
14,CONSTANŢA,"ANEXA LICEULUI TEHNOLOGIC ”NICOLAE DUMITRESCU”",431,CUMPĂNA,61620,1,PART,PRCNCT,PRSD,PRSD_SV,"2025-05-18 22:22:39",1946,1226,1059,163,4,1209,17,2000,774,561,648
14,CONSTANŢA,"ȘCOALA GIMNAZIALĂ NR. 1",432,"CUZA VODĂ",63300,1,PART,PRCNCT,PRSD,PRSD_SV,"2025-05-18 21:32:55",1591,702,664,38,0,696,6,1600,898,595,101
14,CONSTANŢA,"ŞCOALA GIMNAZIALĂ NR. 1",433,"CUZA VODĂ",63300,1,PART,PRCNCT,PRSD,PRSD_SV,"2025-05-18 21:35:22",1728,636,600,36,0,622,14,1800,1164,473,149
14,CONSTANŢA,"LICEUL NICOLAE ISTRATOIU",434,DELENI,61675,1,PART,PRCNCT,PRSD,PRSD_SV,"2025-05-18 21:23:40",286,176,154,22,0,169,7,302,126,133,36
14,CONSTANŢA,"FOST SEDIU C.A.P. PETROŞANI",435,DELENI,61675,1,PART,PRCNCT,PRSD,PRSD_SV,"2025-05-18 21:23:36",413,221,183,37,1,220,1,500,279,149,71
14,CONSTANŢA,"FOST SEDIU C.A.P. PIETRENI",436,DELENI,61675,1,PART,PRCNCT,PRSD,PRSD_SV,"2025-05-18 21:32:13",689,364,331,33,0,361,3,700,336,281,80
14,CONSTANŢA,"SCOALA GENERALA ȘIPOTELE",437,DELENI,61675,1,PART,PRCNCT,PRSD,PRSD_SV,"2025-05-18 21:27:24",421,216,186,30,0,215,1,500,284,145,70
14,CONSTANŢA,"CĂMINUL CULTURAL DOBROMIR -",438,DOBROMIR,61737,2,PART,PRCNCT,PRSD,PRSD_SV,"2025-05-19 01:02:21",800,309,294,15,0,298,11,900,591,118,180
14,CONSTANŢA,"SCOALA GENERALA SAT CETATEA",439,DOBROMIR,61737,1,PART,PRCNCT,PRSD,PRSD_SV,"2025-05-18 21:21:19",188,115,95,20,0,114,1,200,85,71,43
14,CONSTANŢA,"SCOALA PRIMARA NR 2 DOBROMIR DEAL",440,DOBROMIR,61737,1,PART,PRCNCT,PRSD,PRSD_SV,"2025-05-18 21:15:13",270,155,132,22,1,152,3,300,145,80,72
14,CONSTANŢA,"ȘCOALA PRIMARA NR 3 LESPEZI",441,DOBROMIR,61737,1,PART,PRCNCT,PRSD,PRSD_SV,"2025-05-18 21:31:19",436,234,216,18,0,233,1,500,266,42,191
14,CONSTANŢA,"ȘCOALA GEN CU CLS. I - IV PĂDURENI",442,DOBROMIR,61737,1,PART,PRCNCT,PRSD,PRSD_SV,"2025-05-18 21:08:00",112,55,43,12,0,54,1,200,145,40,14
14,CONSTANŢA,"ȘCOALA PRIMARA NR 1 VALENI",443,DOBROMIR,61737,1,PART,PRCNCT,PRSD,PRSD_SV,"2025-05-18 21:27:16",777,298,288,10,0,296,2,900,602,203,93
14,CONSTANŢA,"CĂMINUL CULTURAL DUMBRĂVENI",444,DUMBRĂVENI,63161,1,PART,PRCNCT,PRSD,PRSD_SV,"2025-05-18 21:25:17",352,173,147,26,0,172,1,400,227,123,49
14,CONSTANŢA,"GRĂDINIȚA DE COPII FURNICA",445,DUMBRĂVENI,63161,1,PART,PRCNCT,PRSD,PRSD_SV,"2025-05-18 21:18:13",46,44,19,25,0,44,0,100,56,32,12
14,CONSTANŢA,"GRĂDINIȚA CU PROGRAM NORMAL FÂNTÂNELE",446,FÂNTÂNELE,63334,1,PART,PRCNCT,PRSD,PRSD_SV,"2025-05-18 21:54:23",1290,584,554,26,4,581,3,1300,716,427,154
14,CONSTANŢA,"GRĂDINIȚA CU PROGRAM NORMAL",447,GÂRLICIU,61808,1,PART,PRCNCT,PRSD,PRSD_SV,"2025-05-18 21:55:06",1169,590,508,82,0,587,3,1200,610,445,142
14,CONSTANŢA,"SCOALA GIMNAZIALA ”SA ESENIN” GHINDARESTI",448,GHINDĂREŞTI,61826,1,PART,PRCNCT,PRSD,PRSD_SV,"2025-05-18 21:29:19",1092,442,394,47,1,438,4,1100,658,320,118
14,CONSTANŢA,"SCOALA GIMNAZIALA ”SA ESENIN” GHINDARESTI",449,GHINDĂREŞTI,61826,1,PART,PRCNCT,PRSD,PRSD_SV,"2025-05-18 21:40:19",1040,412,384,28,0,409,3,1100,688,294,115
14,CONSTANŢA,"GRĂDINIȚA CU PROGRAM NORMAL GRĂDINA",450,GRĂDINA,63326,1,PART,PRCNCT,PRSD,PRSD_SV,"2025-05-18 21:47:48",560,355,267,88,0,344,11,600,245,205,139
14,CONSTANŢA,"GRĂDINIȚA CU PROGRAM NORMAL CHEIA",451,GRĂDINA,63326,1,PART,PRCNCT,PRSD,PRSD_SV,"2025-05-18 21:28:31",284,207,165,42,0,202,5,300,93,134,68
14,CONSTANŢA,"GRADINITA NR.FN",452,HORIA,63278,1,PART,PRCNCT,PRSD,PRSD_SV,"2025-05-18 21:37:33",629,318,273,45,0,316,2,700,382,215,101
14,CONSTANŢA,"CĂMINUL CULTURAL TICHILEȘTI",453,HORIA,63278,1,PART,PRCNCT,PRSD,PRSD_SV,"2025-05-18 21:20:21",236,116,91,24,1,116,0,300,184,75,41
14,CONSTANŢA,"LICEUL TEHNOLOGIC",454,INDEPENDENŢA,61871,1,PART,PRCNCT,PRSD,PRSD_SV,"2025-05-18 21:28:46",950,438,407,31,0,436,2,1000,562,313,123
14,CONSTANŢA,"CĂMIN CULTURAL",455,INDEPENDENŢA,61871,1,PART,PRCNCT,PRSD,PRSD_SV,"2025-05-18 21:36:01",296,134,123,11,0,132,2,300,166,101,31
14,CONSTANŢA,"SCOALA GENERALĂ",456,INDEPENDENŢA,61871,1,PART,PRCNCT,PRSD,PRSD_SV,"2025-05-18 21:39:06",493,264,226,38,0,260,4,500,236,191,69
14,CONSTANŢA,"SCOALA GENERALĂ",457,INDEPENDENŢA,61871,1,PART,PRCNCT,PRSD,PRSD_SV,"2025-05-18 21:27:07",292,145,121,24,0,144,1,302,157,104,40
14,CONSTANŢA,"SCOALA GENERALĂ",458,INDEPENDENŢA,61871,2,PART,PRCNCT,PRSD,PRSD_SV,"2025-05-19 00:16:13",238,126,117,9,0,126,0,300,174,104,22
14,CONSTANŢA,"ŞCOALA GIMNAZIALĂ NR.1 ION CORVIN, LOC. ION CORVIN",459,"ION CORVIN",61951,1,PART,PRCNCT,PRSD,PRSD_SV,"2025-05-18 21:31:04",479,225,189,36,0,219,6,500,275,147,72
14,CONSTANŢA,"ŞCOALA CRÎNGU",460,"ION CORVIN",61951,1,PART,PRCNCT,PRSD,PRSD_SV,"2025-05-18 21:16:57",75,62,29,33,0,62,0,100,38,38,24
14,CONSTANŢA,"GRĂDINIȚA CU PROGRAM NORMAL RARIȘTEA, LOC. RARIȘTEA",461,"ION CORVIN",61951,1,PART,PRCNCT,PRSD,PRSD_SV,"2025-05-18 21:18:06",187,98,72,26,0,98,0,205,107,71,27
14,CONSTANŢA,"ȘCOALA GIMNAZIALĂ NR. 2 VIILE",462,"ION CORVIN",61951,1,PART,PRCNCT,PRSD,PRSD_SV,"2025-05-18 21:37:22",750,357,321,36,0,355,2,800,443,266,89
14,CONSTANŢA,"ȘCOALA GIMNAZIALĂ NR. 1 ISTRIA",463,ISTRIA,62020,1,PART,PRCNCT,PRSD,PRSD_SV,"2025-05-18 21:41:12",1041,544,467,77,0,535,9,1100,556,384,151
14,CONSTANŢA,"ȘCOALA GIMNAZIALĂ NR. 2 NUNTAȘI",464,ISTRIA,62020,1,PART,PRCNCT,PRSD,PRSD_SV,"2025-05-18 21:42:45",865,496,427,69,0,491,5,900,404,373,118
14,CONSTANŢA,"SCOALA GIMNAZIALA NR. 1 LIMANU",465,LIMANU,60632,1,PART,PRCNCT,PRSD,PRSD_SV,"2025-05-18 22:41:07",1859,1124,995,122,7,1113,11,1900,776,735,378
14,CONSTANŢA,"SCOALA GIMNAZIALA NR. 1 LIMANU",466,LIMANU,60632,1,PART,PRCNCT,PRSD,PRSD_SV,"2025-05-18 21:59:23",1114,683,611,68,4,676,7,1200,517,412,264
14,CONSTANŢA,"SCOALA GIMNAZIALA NR. 2 -2 MAI",467,LIMANU,60632,1,PART,PRCNCT,PRSD,PRSD_SV,"2025-05-18 22:37:53",1188,965,701,264,0,954,11,1200,235,504,450
14,CONSTANŢA,"SCOALA GIMNAZIALA NR.2- 2 MAI",468,LIMANU,60632,1,PART,PRCNCT,PRSD,PRSD_SV,"2025-05-18 21:52:24",1207,807,629,177,1,800,7,1301,494,387,413
14,CONSTANŢA,"CENTRU FUNCȚIONAL VAMA VECHE",469,LIMANU,60632,1,PART,PRCNCT,PRSD,PRSD_SV,"2025-05-18 22:36:34",328,907,200,707,0,895,12,1600,693,296,599
14,CONSTANŢA,"CAMIN CULTURAL LIPNITA",470,LIPNIŢA,62057,1,PART,PRCNCT,PRSD,PRSD_SV,"2025-05-18 21:25:04",730,376,328,48,0,370,6,800,424,251,119
14,CONSTANŢA,"CĂMINUL CULTURAL CANLIA",471,LIPNIŢA,62057,1,PART,PRCNCT,PRSD,PRSD_SV,"2025-05-18 21:32:51",395,241,184,57,0,240,1,400,159,189,51
14,CONSTANŢA,"ȘCOALA GIMNAZIALĂ NR.2 CARVĂN",472,LIPNIŢA,62057,1,PART,PRCNCT,PRSD,PRSD_SV,"2025-05-18 21:17:44",327,122,100,22,0,121,1,400,278,93,28
14,CONSTANŢA,"ȘCOALA GIMNAZIALĂ NR.3 COSLUGEA",473,LIPNIŢA,62057,1,PART,PRCNCT,PRSD,PRSD_SV,"2025-05-18 21:27:31",562,257,233,24,0,256,1,600,343,199,57
14,CONSTANŢA,"ȘCOALA GENERALĂ CU CLASELE I - IV CUIUGIUC",474,LIPNIŢA,62057,1,PART,PRCNCT,PRSD,PRSD_SV,"2025-05-18 21:17:03",143,42,33,9,0,41,1,200,158,32,9
14,CONSTANŢA,"ȘCOALA GENERALĂ CU CLASELE I - IV GORUNI",475,LIPNIŢA,62057,1,PART,PRCNCT,PRSD,PRSD_SV,"2025-05-18 21:10:08",75,57,34,23,0,57,0,100,43,44,13
14,CONSTANŢA,"ȘCOALA GENERALĂ CU CLASELE I - IV IZVOARELE",476,LIPNIŢA,62057,1,PART,PRCNCT,PRSD,PRSD_SV,"2025-05-18 21:31:32",79,65,32,33,0,63,2,101,36,30,33
14,CONSTANŢA,"ȘCOALA VECHE LUMINA",477,LUMINA,63152,1,PART,PRCNCT,PRSD,PRSD_SV,"2025-05-18 22:04:41",1659,984,839,143,2,972,12,1700,716,542,430
14,CONSTANŢA,"ȘCOALA NOUĂ LUMINA",478,LUMINA,63152,1,PART,PRCNCT,PRSD,PRSD_SV,"2025-05-18 23:11:32",1959,1228,1051,176,1,1215,13,2000,772,679,536
14,CONSTANŢA,"GRĂDINIȚA LUMINA",479,LUMINA,63152,1,PART,PRCNCT,PRSD,PRSD_SV,"2025-05-18 22:18:27",1921,1132,1037,95,0,1116,16,2000,868,631,485
14,CONSTANŢA,"CĂMINUL CULTURAL LUMINA",480,LUMINA,63152,2,PART,PRCNCT,PRSD,PRSD_SV,"2025-05-19 02:23:18",1706,1092,897,195,0,1081,11,1800,708,597,484
14,CONSTANŢA,"ȘCOALA GIMNAZIALĂ NR.1 LUMINA - CLĂDIREA C8",481,LUMINA,63152,1,PART,PRCNCT,PRSD,PRSD_SV,"2025-05-18 22:26:33",2025,1227,1090,137,0,1209,18,2100,873,670,539
14,CONSTANŢA,"ȘCOALA OITUZ",482,LUMINA,63152,1,PART,PRCNCT,PRSD,PRSD_SV,"2025-05-18 21:52:42",692,444,388,56,0,437,7,701,257,286,151
14,CONSTANŢA,"ȘCOALA SIBIOARA",483,LUMINA,63152,1,PART,PRCNCT,PRSD,PRSD_SV,"2025-05-18 21:36:12",376,240,195,45,0,238,2,400,160,158,80
14,CONSTANŢA,"SCOALA GIMNAZIALA NICHITA STANESCU",484,MERENI,62137,1,PART,PRCNCT,PRSD,PRSD_SV,"2025-05-18 21:51:11",1152,591,496,93,2,583,8,1200,609,410,173
14,CONSTANŢA,"ŞCOALA CU CLASELE I -IV",485,MERENI,62137,1,PART,PRCNCT,PRSD,PRSD_SV,"2025-05-18 21:29:06",227,139,113,26,0,137,2,300,161,93,44
14,CONSTANŢA,"ŞCOALA CU CLASELE I - VIII",486,MERENI,62137,1,PART,PRCNCT,PRSD,PRSD_SV,"2025-05-18 21:17:44",475,232,206,26,0,230,2,500,268,164,66
14,CONSTANŢA,"GRĂDINIŢA DOMINO",487,"MIHAIL KOGĂLNICEANU",62191,1,PART,PRCNCT,PRSD,PRSD_SV,"2025-05-18 21:39:26",1254,826,731,95,0,822,4,1300,474,498,324
14,CONSTANŢA,"GRĂDINIŢA PINOCHIO",488,"MIHAIL KOGĂLNICEANU",62191,1,PART,PRCNCT,PRSD,PRSD_SV,"2025-05-18 21:43:24",1236,791,703,88,0,790,1,1300,509,440,350
14,CONSTANŢA,"ȘCOALA GENERALĂ NR.2",489,"MIHAIL KOGĂLNICEANU",62191,1,PART,PRCNCT,PRSD,PRSD_SV,"2025-05-18 21:41:41",1165,747,656,90,1,737,10,1200,453,391,346
14,CONSTANŢA,"CENTRUL PENTRU TINERET",490,"MIHAIL KOGĂLNICEANU",62191,1,PART,PRCNCT,PRSD,PRSD_SV,"2025-05-18 21:27:44",1345,753,629,124,0,743,10,1400,647,417,326
14,CONSTANŢA,"GRĂDINIŢA PITICOT",491,"MIHAIL KOGĂLNICEANU",62191,1,PART,PRCNCT,PRSD,PRSD_SV,"2025-05-18 21:27:05",665,378,320,58,0,376,2,700,322,215,161
14,CONSTANŢA,"GRĂDINIŢA PITICOT",492,"MIHAIL KOGĂLNICEANU",62191,1,PART,PRCNCT,PRSD,PRSD_SV,"2025-05-18 21:45:15",840,477,446,31,0,467,10,900,423,247,220
14,CONSTANŢA,"ŞCOALA GENERALĂ CERES",493,"MIHAIL KOGĂLNICEANU",62191,1,PART,PRCNCT,PRSD,PRSD_SV,"2025-05-18 21:35:27",371,198,173,25,0,197,1,400,202,140,57
14,CONSTANŢA,"ŞCOALA GENERALĂ",494,"MIHAIL KOGĂLNICEANU",62191,1,PART,PRCNCT,PRSD,PRSD_SV,"2025-05-18 21:42:19",261,193,137,56,0,192,1,290,97,100,92
14,CONSTANŢA,"UNITATEA AGRICOLĂ SIBIOARA, CENTRUL PENTRU TINERET",495,"MIHAIL KOGĂLNICEANU",62191,1,PART,PRCNCT,PRSD,PRSD_SV,"2025-05-18 21:31:04",353,202,179,23,0,201,1,400,198,120,81
14,CONSTANŢA,"CĂMINUL CULTURAL",496,"MIHAIL KOGĂLNICEANU",62191,1,PART,PRCNCT,PRSD,PRSD_SV,"2025-05-18 21:40:37",668,416,339,77,0,411,5,700,284,253,158
14,CONSTANŢA,"LICEUL TEHNOLOGIC ” MIHAI VITEAZUL”",497,"MIHAI VITEAZU",62253,1,PART,PRCNCT,PRSD,PRSD_SV,"2025-05-18 21:54:46",1580,626,579,47,0,620,6,1600,974,481,139
14,CONSTANŢA,"SCOALA GIMNAZIALĂ NR. 1 SINOE",498,"MIHAI VITEAZU",62253,1,PART,PRCNCT,PRSD,PRSD_SV,"2025-05-18 21:49:13",1233,514,477,37,0,508,6,1300,786,451,57
14,CONSTANŢA,"ŞCOALA GIMNAZIALĂ NR.1 MIRCEA VODĂ",499,"MIRCEA VODĂ",62280,1,PART,PRCNCT,PRSD,PRSD_SV,"2025-05-18 21:38:26",1769,811,728,83,0,802,9,1800,989,631,171
14,CONSTANŢA,"ȘCOALA GIMNAZIALĂ NR.2 SATU NOU",500,"MIRCEA VODĂ",62280,1,PART,PRCNCT,PRSD,PRSD_SV,"2025-05-18 21:31:35",1073,470,446,24,0,463,7,1100,630,358,105
14,CONSTANŢA,"ȘCOALA GIMNAZIALĂ NR.2 SATU NOU",501,"MIRCEA VODĂ",62280,1,PART,PRCNCT,PRSD,PRSD_SV,"2025-05-18 21:37:07",1369,646,619,27,0,638,8,1400,754,481,157
14,CONSTANŢA,"LICEUL TEHNOLOGIC ”I.C. BRĂTIANU” NICOLAE BĂLCESCU",502,"NICOLAE BĂLCESCU",62440,1,PART,PRCNCT,PRSD,PRSD_SV,"2025-05-18 21:53:58",1358,687,611,75,1,684,3,1400,713,456,228
14,CONSTANŢA,"LICEUL TEHNOLOGIC ”I.C. BRĂTIANU” NICOLAE BĂLCESCU",503,"NICOLAE BĂLCESCU",62440,1,PART,PRCNCT,PRSD,PRSD_SV,"2025-05-18 21:55:17",1451,725,659,65,1,720,5,1500,775,484,236
14,CONSTANŢA,"ȘCOALA GIMNAZIALA NR. 1 DOROBANȚU",504,"NICOLAE BĂLCESCU",62440,1,PART,PRCNCT,PRSD,PRSD_SV,"2025-05-18 21:45:20",1522,780,714,65,1,774,6,1600,820,606,168
14,CONSTANŢA,"ȘCOALA GIMNAZIALĂ NR. 1 OLTINA",505,OLTINA,62486,1,PART,PRCNCT,PRSD,PRSD_SV,"2025-05-18 21:46:30",1273,626,527,95,4,616,10,1300,674,386,230
14,CONSTANŢA,"ȘCOALA GIMNAZIALĂ NR. 2 RĂZOARELE",506,OLTINA,62486,1,PART,PRCNCT,PRSD,PRSD_SV,"2025-05-18 21:24:47",465,279,236,43,0,278,1,500,221,221,57
14,CONSTANŢA,"ȘCOALA CU CLS. I - IV SATU NOU",507,OLTINA,62486,1,PART,PRCNCT,PRSD,PRSD_SV,"2025-05-18 21:18:47",134,76,54,22,0,76,0,200,124,41,35
14,CONSTANŢA,"CĂMIN CULTURAL OSTROV",508,OSTROV,62538,1,PART,PRCNCT,PRSD,PRSD_SV,"2025-05-18 21:30:22",842,431,368,63,0,425,6,900,469,253,172
14,CONSTANŢA,"CĂMIN CULTURAL OSTROV",509,OSTROV,62538,1,PART,PRCNCT,PRSD,PRSD_SV,"2025-05-18 21:39:20",1138,582,516,66,0,578,4,1200,618,368,210
14,CONSTANŢA,"CĂMIN CULTURAL ALMĂLĂU",510,OSTROV,62538,1,PART,PRCNCT,PRSD,PRSD_SV,"2025-05-18 21:33:41",627,330,291,39,0,328,2,700,370,243,85
14,CONSTANŢA,"CAMIN CULTURAL BUGEAC",511,OSTROV,62538,1,PART,PRCNCT,PRSD,PRSD_SV,"2025-05-18 21:20:16",140,94,65,29,0,93,1,200,106,62,31
14,CONSTANŢA,"CĂMIN CULTURAL ESECHIOI",512,OSTROV,62538,1,PART,PRCNCT,PRSD,PRSD_SV,"2025-05-18 21:20:09",187,119,92,27,0,118,1,200,81,71,47
14,CONSTANŢA,"CĂMIN CULTURAL GALIȚA",513,OSTROV,62538,1,PART,PRCNCT,PRSD,PRSD_SV,"2025-05-18 21:26:05",609,242,220,22,0,239,3,700,458,210,29
14,CONSTANŢA,"CĂMIN CULTURAL GÎRLIȚA",514,OSTROV,62538,1,PART,PRCNCT,PRSD,PRSD_SV,"2025-05-18 21:40:51",218,135,118,17,0,134,1,300,165,101,33
14,CONSTANŢA,"ȘCOALA GIMNAZIALĂ NR.1 PANTELIMON",515,PANTELIMON,62609,1,PART,PRCNCT,PRSD,PRSD_SV,"2025-05-18 21:51:03",631,332,285,47,0,330,2,700,368,244,86
14,CONSTANŢA,"ȘCOALA CU CLS. I - IV NISTOREȘTI",516,PANTELIMON,62609,1,PART,PRCNCT,PRSD,PRSD_SV,"2025-05-18 21:20:41",209,95,84,11,0,94,1,300,205,76,18
14,CONSTANŢA,"ȘCOALA PRIMARĂ NR. 3 PANTELIMON DE JOS",517,PANTELIMON,62609,1,PART,PRCNCT,PRSD,PRSD_SV,"2025-05-18 21:28:19",226,107,96,11,0,106,1,301,194,80,26
14,CONSTANŢA,"ȘCOALA PRIMARĂ NR. 4 RUNCU",518,PANTELIMON,62609,1,PART,PRCNCT,PRSD,PRSD_SV,"2025-05-18 21:23:33",380,191,171,20,0,189,2,400,209,142,47
14,CONSTANŢA,"CĂMIN CULTURAL PECINEAGA",519,PECINEAGA,62672,1,PART,PRCNCT,PRSD,PRSD_SV,"2025-05-18 22:04:23",1340,735,656,76,3,727,8,1400,665,493,234
14,CONSTANŢA,"ŞCOALA GIMNAZIALĂ NR.1 PECINEAGA",520,PECINEAGA,62672,1,PART,PRCNCT,PRSD,PRSD_SV,"2025-05-18 21:54:42",1438,739,666,72,1,734,5,1500,761,512,222
14,CONSTANŢA,"CĂMIN CULTURAL PEŞTERA",521,PEŞTERA,62707,1,PART,PRCNCT,PRSD,PRSD_SV,"2025-05-18 21:41:15",1508,658,600,58,0,654,4,1600,942,498,156
14,CONSTANŢA,"CAMIN CULTURAL IVRINEZU MARE",522,PEŞTERA,62707,1,PART,PRCNCT,PRSD,PRSD_SV,"2025-05-18 21:24:09",706,375,321,54,0,374,1,800,425,284,90
14,CONSTANŢA,"SCOALA PRIMARA NR.3",523,PEŞTERA,62707,1,PART,PRCNCT,PRSD,PRSD_SV,"2025-05-18 21:22:20",586,260,233,27,0,260,0,600,340,215,45
14,CONSTANŢA,"CENTRU PENTRU TINERET",524,"POARTA ALBĂ",62761,1,PART,PRCNCT,PRSD,PRSD_SV,"2025-05-18 22:09:12",1697,1077,849,58,170,1064,13,1900,823,749,315
14,CONSTANŢA,"CENTRU PENTRU TINERET",525,"POARTA ALBĂ",62761,1,PART,PRCNCT,PRSD,PRSD_SV,"2025-05-18 22:07:12",1498,1035,749,83,203,1018,17,1700,665,723,295
14,CONSTANŢA,"GRĂDINIŢA CU PROGRAM NORMAL NR. 2 POARTA ALBĂ",526,"POARTA ALBĂ",62761,1,PART,PRCNCT,PRSD,PRSD_SV,"2025-05-18 21:39:41",1030,626,503,41,82,620,6,1200,574,463,157
14,CONSTANŢA,"GRĂDINIŢA CU PROGRAM NORMAL NAZARCEA",527,"POARTA ALBĂ",62761,1,PART,PRCNCT,PRSD,PRSD_SV,"2025-05-18 21:52:01",484,441,243,54,144,433,8,700,259,323,110
14,CONSTANŢA,"SCOALA GIMNAZIALA NR.2 RASOVA",528,RASOVA,62798,1,PART,PRCNCT,PRSD,PRSD_SV,"2025-05-18 21:17:51",1067,424,392,32,0,421,3,1100,676,310,111
14,CONSTANŢA,"SCOALA GIMNAZIALA NR.2 RASOVA",529,RASOVA,62798,1,PART,PRCNCT,PRSD,PRSD_SV,"2025-05-18 21:31:26",915,402,363,39,0,398,4,1000,598,301,97
14,CONSTANŢA,"GRĂDINIȚA CU PROGRAM NORMAL COCHIRLENI",530,RASOVA,62798,1,PART,PRCNCT,PRSD,PRSD_SV,"2025-05-18 21:46:22",864,419,354,65,0,415,4,900,481,294,121
14,CONSTANŢA,"ȘCOALA GIMNAZIALA NR 1 SALIGNY",531,SALIGNY,63318,1,PART,PRCNCT,PRSD,PRSD_SV,"2025-05-18 21:26:18",688,406,373,33,0,405,1,700,294,272,133
14,CONSTANŢA,"SCOALA PRIMARA NR 2 FACLIA",532,SALIGNY,63318,1,PART,PRCNCT,PRSD,PRSD_SV,"2025-05-18 21:16:32",715,371,324,47,0,370,1,800,429,278,92
14,CONSTANŢA,"ȘCOALA PRIMARA NR 3 STEFAN CEL MARE",533,SALIGNY,63318,1,PART,PRCNCT,PRSD,PRSD_SV,"2025-05-18 21:22:25",462,244,203,41,0,241,3,500,256,181,60
14,CONSTANŢA,"ȘCOALA GIMNAZIALĂ ”NICOLAE MARALOI” SARAIU",534,SARAIU,62823,1,PART,PRCNCT,PRSD,PRSD_SV,"2025-05-18 21:24:55",568,338,293,45,0,334,4,600,262,226,108
14,CONSTANŢA,"ȘCOALA PRIMARĂ NR. 1 DULGHERU",535,SARAIU,62823,1,PART,PRCNCT,PRSD,PRSD_SV,"2025-05-18 21:39:14",423,219,191,28,0,213,6,500,281,161,52
14,CONSTANŢA,"ȘCOALA GIMNAZIALĂ ”A.GHENCEA”",536,SĂCELE,62878,1,PART,PRCNCT,PRSD,PRSD_SV,"2025-05-18 22:02:53",1928,991,844,147,0,981,10,2000,1009,741,240
14,CONSTANŢA,"ŞCOALA CU CLS I-VIII SEIMENI",537,SEIMENI,62903,1,PART,PRCNCT,PRSD,PRSD_SV,"2025-05-18 21:38:04",439,234,196,37,1,233,1,500,266,144,89
14,CONSTANŢA,"GRĂDINIŢA CU PROGRAM NORMAL DUNĂREA",538,SEIMENI,62903,1,PART,PRCNCT,PRSD,PRSD_SV,"2025-05-18 21:56:07",533,237,193,44,0,234,3,600,363,162,72
14,CONSTANŢA,"GRĂDINITĂ CU PROGRAM NORMAL SEIMENII MICI",539,SEIMENI,62903,1,PART,PRCNCT,PRSD,PRSD_SV,"2025-05-18 21:50:09",718,335,308,27,0,330,5,800,465,235,95
14,CONSTANŢA,"SCOALA GIMNAZIALA NR. 1",540,SILIŞTEA,62949,1,PART,PRCNCT,PRSD,PRSD_SV,"2025-05-18 21:47:56",553,289,254,33,2,284,5,600,311,197,87
14,CONSTANŢA,"ANEXĂ A ȘCOLII GIMNAZIALE NR.1 SILIȘTEA-SALA 9",541,SILIŞTEA,62949,1,PART,PRCNCT,PRSD,PRSD_SV,"2025-05-18 21:41:09",603,303,265,38,0,301,2,700,397,235,66
14,CONSTANŢA,"CONSILIULUI LOCAL TÎRGUȘOR",542,TÂRGUŞOR,62985,1,PART,PRCNCT,PRSD,PRSD_SV,"2025-05-18 21:38:23",1044,575,510,64,1,567,8,1100,525,402,165
14,CONSTANŢA,"ȘCOALA PRIMARĂ NR.2 MIREASA",543,TÂRGUŞOR,62985,1,PART,PRCNCT,PRSD,PRSD_SV,"2025-05-18 21:20:28",261,130,110,20,0,124,6,301,171,104,20
14,CONSTANŢA,"ȘCOALA GENERALĂ TOPALU",544,TOPALU,63045,1,PART,PRCNCT,PRSD,PRSD_SV,"2025-05-18 21:59:29",1351,699,614,84,1,696,3,1400,701,412,284
14,CONSTANŢA,"GRĂDINIȚA CU PROGRAM NORMAL TOPRAISAR",545,TOPRAISAR,63072,1,PART,PRCNCT,PRSD,PRSD_SV,"2025-05-18 21:42:28",1392,752,641,111,0,738,14,1400,648,448,290
14,CONSTANŢA,"ȘCOALA VECHE TOPRAISAR",546,TOPRAISAR,63072,1,PART,PRCNCT,PRSD,PRSD_SV,"2025-05-18 21:43:41",1664,975,764,211,0,963,12,1700,725,658,305
14,CONSTANŢA,"ȘCOALA I-VIII BIRUINȚA",547,TOPRAISAR,63072,1,PART,PRCNCT,PRSD,PRSD_SV,"2025-05-18 21:38:14",675,359,320,39,0,358,1,700,341,283,75
14,CONSTANŢA,"CĂMIN CULTURAL",548,TOPRAISAR,63072,1,PART,PRCNCT,PRSD,PRSD_SV,"2025-05-18 21:35:23",1000,623,542,81,0,615,8,1100,477,412,203
14,CONSTANŢA,"ȘCOALA I-IV POTÂRNICHEA",549,TOPRAISAR,63072,1,PART,PRCNCT,PRSD,PRSD_SV,"2025-05-18 21:32:43",395,242,178,64,0,239,3,400,158,183,56
14,CONSTANŢA,"SCOALA GIMNAZIALA ”ION GHICA” TORTOMAN",550,TORTOMAN,63189,1,PART,PRCNCT,PRSD,PRSD_SV,"2025-05-18 22:23:39",1469,701,649,52,0,694,7,1501,800,539,155
14,CONSTANŢA,"GRADINITA VECHE",551,TUZLA,60721,2,PART,PRCNCT,PRSD,PRSD_SV,"2025-05-19 01:14:05",1130,737,579,158,0,734,3,1200,463,398,336
14,CONSTANŢA,"ŞCOALA MICĂ TUZLA",552,TUZLA,60721,1,PART,PRCNCT,PRSD,PRSD_SV,"2025-05-18 22:24:17",1704,1043,851,192,0,1030,13,1800,757,574,456
14,CONSTANŢA,"ŞCOALA MARE TUZLA",553,TUZLA,60721,1,PART,PRCNCT,PRSD,PRSD_SV,"2025-05-18 22:30:57",1808,1065,948,115,2,1055,10,1900,835,655,400
14,CONSTANŢA,"GRĂDINIŢĂ NOUĂ",554,TUZLA,60721,1,PART,PRCNCT,PRSD,PRSD_SV,"2025-05-18 22:06:46",1330,842,753,89,0,833,9,1400,558,460,373
14,CONSTANŢA,"SALA DE SPORT",555,"VALU LUI TRAIAN",63125,1,PART,PRCNCT,PRSD,PRSD_SV,"2025-05-18 22:26:52",1842,1108,972,136,0,1093,15,1900,792,532,561
14,CONSTANŢA,"ŞCOALA GIMNAZIALĂ NR.1",556,"VALU LUI TRAIAN",63125,1,PART,PRCNCT,PRSD,PRSD_SV,"2025-05-18 22:04:07",1700,1144,963,179,2,1127,17,1800,656,536,591
14,CONSTANŢA,"GRĂDINIŢA CU PROGRAM PRELUNGIT NR.3",557,"VALU LUI TRAIAN",63125,1,PART,PRCNCT,PRSD,PRSD_SV,"2025-05-18 22:07:55",1982,1427,1167,259,1,1410,17,2000,573,645,765
14,CONSTANŢA,"CLĂDIRE VESTIARE TEREN FOTBAL (STADION)",558,"VALU LUI TRAIAN",63125,1,PART,PRCNCT,PRSD,PRSD_SV,"2025-05-18 21:43:44",1937,1227,1010,98,119,1206,21,2100,873,749,457
14,CONSTANŢA,"PIAŢA AGROALIMENTARĂ-CENTRUL TRANSFRONTALIER DE AFACERI",559,"VALU LUI TRAIAN",63125,1,PART,PRCNCT,PRSD,PRSD_SV,"2025-05-18 22:23:15",1667,1081,957,124,0,1064,17,1700,619,505,559
14,CONSTANŢA,"ŞCOALA GIMNAZIALĂ ”VICEAMIRAL IOAN MURGESCU”",560,"VALU LUI TRAIAN",63125,1,PART,PRCNCT,PRSD,PRSD_SV,"2025-05-18 22:00:54",1821,1296,1039,137,120,1278,18,2000,704,723,555
14,CONSTANŢA,"CENTRU DE TINERET",561,"VALU LUI TRAIAN",63125,1,PART,PRCNCT,PRSD,PRSD_SV,"2025-05-18 22:12:57",2006,1288,1144,144,0,1277,11,2100,812,695,582
14,CONSTANŢA,"GRĂDINIŢA CU PROGRAM NORMAL NR.2",562,"VALU LUI TRAIAN",63125,1,PART,PRCNCT,PRSD,PRSD_SV,"2025-05-18 21:56:05",1839,1237,990,128,119,1220,17,2100,863,669,551
14,CONSTANŢA,"CAMIN CULTURAL VULTURU",563,VULTURU,63170,1,PART,PRCNCT,PRSD,PRSD_SV,"2025-05-18 21:25:25",558,260,220,35,5,258,2,600,340,149,109
15,COVASNA,"CASA DE CULTURĂ ”KÓNYA ÁDÁM”",1,"MUNICIPIUL SFÂNTU GHEORGHE",63394,1,PART,PRCNCT,PRSD,PRSD_SV,"2025-05-18 22:51:42",1362,767,702,60,5,758,9,1482,715,61,697
15,COVASNA,"CENTRUL MULTICULTURAL ”NÉRI SZENT FÜLÖP”",2,"MUNICIPIUL SFÂNTU GHEORGHE",63394,3,PART,PRCNCT,PRSD,PRSD_SV,"2025-05-19 03:00:51",1101,496,471,25,0,465,31,1200,704,61,404
15,COVASNA,"COLEGIUL NAȚIONAL ”SZÉKELY MIKÓ”",3,"MUNICIPIUL SFÂNTU GHEORGHE",63394,1,PART,PRCNCT,PRSD,PRSD_SV,"2025-05-18 21:48:38",1059,679,554,119,6,673,6,1100,421,54,619
15,COVASNA,"CENTRUL DE ARTE PLASTICE",4,"MUNICIPIUL SFÂNTU GHEORGHE",63394,2,PART,PRCNCT,PRSD,PRSD_SV,"2025-05-19 01:54:36",802,455,418,33,4,453,2,900,445,35,418
15,COVASNA,"DIRECŢIA GENERALĂ ECONOMICĂ ȘI FISCALĂ",5,"MUNICIPIUL SFÂNTU GHEORGHE",63394,1,PART,PRCNCT,PRSD,PRSD_SV,"2025-05-18 21:40:32",783,435,401,29,5,433,2,908,473,36,397
15,COVASNA,"LICEUL TEHNOLOGIC ECONOMIC, ADMINISTRATIV ”BERDE ÁRON”",6,"MUNICIPIUL SFÂNTU GHEORGHE",63394,1,PART,PRCNCT,PRSD,PRSD_SV,"2025-05-18 22:00:47",812,434,385,49,0,430,4,900,466,54,376
15,COVASNA,"LICEUL TEHNOLOGIC ECONOMIC, ADMINISTRATIV ”BERDE ÁRON”",7,"MUNICIPIUL SFÂNTU GHEORGHE",63394,1,PART,PRCNCT,PRSD,PRSD_SV,"2025-05-18 21:58:39",998,620,546,52,22,613,7,1100,480,97,516
15,COVASNA,"LICEUL TEHNOLOGIC ECONOMIC, ADMINISTRATIV ”BERDE ÁRON”",8,"MUNICIPIUL SFÂNTU GHEORGHE",63394,1,PART,PRCNCT,PRSD,PRSD_SV,"2025-05-18 22:05:35",1007,585,562,23,0,577,8,1100,515,67,510
15,COVASNA,"LICEUL TEORETIC ”MIKES KELEMEN”",9,"MUNICIPIUL SFÂNTU GHEORGHE",63394,1,PART,PRCNCT,PRSD,PRSD_SV,"2025-05-18 21:59:32",1246,689,626,54,9,685,4,1300,611,69,616
15,COVASNA,"GRĂDINIŢA CU PROGRAM PRELUNGIT ”GULLIVER”",10,"MUNICIPIUL SFÂNTU GHEORGHE",63394,1,PART,PRCNCT,PRSD,PRSD_SV,"2025-05-18 22:46:42",1617,1003,944,56,3,991,12,1700,697,70,921
15,COVASNA,"GRĂDINIŢA CU PROGRAM PRELUNGIT ”GULLIVER”",11,"MUNICIPIUL SFÂNTU GHEORGHE",63394,1,PART,PRCNCT,PRSD,PRSD_SV,"2025-05-18 22:01:13",1397,719,674,37,8,709,10,1500,781,43,666
15,COVASNA,"GRĂDINIŢA CU PROGRAM PRELUNGIT ”GULLIVER”",12,"MUNICIPIUL SFÂNTU GHEORGHE",63394,1,PART,PRCNCT,PRSD,PRSD_SV,"2025-05-18 22:26:47",925,494,452,36,6,491,3,1000,506,32,459
15,COVASNA,"GRĂDINIŢA CU PROGRAM PRELUNGIT ”GULLIVER”",13,"MUNICIPIUL SFÂNTU GHEORGHE",63394,1,PART,PRCNCT,PRSD,PRSD_SV,"2025-05-18 21:41:26",848,467,435,28,4,464,3,900,433,32,432
15,COVASNA,"GRĂDINIȚA CU PROGRAM PRELUNGIT ”GULLIVER”",14,"MUNICIPIUL SFÂNTU GHEORGHE",63394,1,PART,PRCNCT,PRSD,PRSD_SV,"2025-05-18 21:54:18",918,494,453,35,6,493,1,1000,506,50,443
15,COVASNA,"MUZEUL NAȚIONAL SECUIESC",15,"MUNICIPIUL SFÂNTU GHEORGHE",63394,1,PART,PRCNCT,PRSD,PRSD_SV,"2025-05-18 21:26:40",1204,654,585,50,19,649,5,1300,646,39,610
15,COVASNA,"STADIONUL MIC, CORP C",16,"MUNICIPIUL SFÂNTU GHEORGHE",63394,1,PART,PRCNCT,PRSD,PRSD_SV,"2025-05-18 21:41:43",944,565,500,59,6,563,2,1000,435,47,516
15,COVASNA,"SALA DE SPORT",17,"MUNICIPIUL SFÂNTU GHEORGHE",63394,1,PART,PRCNCT,PRSD,PRSD_SV,"2025-05-18 22:06:56",1345,935,867,60,8,932,3,1400,465,39,893
15,COVASNA,"GRADINIŢA CU PROGRAM PRELUNGIT ”HÓFEHÉRKE”",18,"MUNICIPIUL SFÂNTU GHEORGHE",63394,1,PART,PRCNCT,PRSD,PRSD_SV,"2025-05-18 21:37:11",623,457,354,37,66,455,2,700,243,23,432
15,COVASNA,"ŞCOALA GIMNAZIALĂ ”VÁRADI JÓZSEF”",19,"MUNICIPIUL SFÂNTU GHEORGHE",63394,1,PART,PRCNCT,PRSD,PRSD_SV,"2025-05-18 22:13:13",998,622,543,43,36,617,5,1100,478,50,567
15,COVASNA,"ŞCOALA GIMNAZIALĂ ”VÁRADI JÓZSEF”",20,"MUNICIPIUL SFÂNTU GHEORGHE",63394,1,PART,PRCNCT,PRSD,PRSD_SV,"2025-05-18 21:51:02",1313,786,724,39,23,773,13,1400,614,57,716
15,COVASNA,"LICEUL DE ARTE ”PLUGOR SÁNDOR”",21,"MUNICIPIUL SFÂNTU GHEORGHE",63394,1,PART,PRCNCT,PRSD,PRSD_SV,"2025-05-18 22:04:44",1240,763,688,64,11,751,12,1398,635,48,703
15,COVASNA,"LICEUL DE ARTE ”PLUGOR SÁNDOR”",22,"MUNICIPIUL SFÂNTU GHEORGHE",63394,1,PART,PRCNCT,PRSD,PRSD_SV,"2025-05-18 21:39:22",742,432,396,31,5,429,3,800,368,37,392
15,COVASNA,"GRĂDINIŢA CU PROGRAM PRELUNGIT ”ÁRVÁCSKA”",23,"MUNICIPIUL SFÂNTU GHEORGHE",63394,1,PART,PRCNCT,PRSD,PRSD_SV,"2025-05-18 22:17:51",1235,567,537,25,5,558,9,1300,733,81,477
15,COVASNA,"GRĂDINIŢA CU PROGRAM PRELUNGIT ”ÁRVÁCSKA”",24,"MUNICIPIUL SFÂNTU GHEORGHE",63394,1,PART,PRCNCT,PRSD,PRSD_SV,"2025-05-18 21:44:40",794,368,345,22,1,362,6,900,532,53,309
15,COVASNA,"GRĂDINIȚA CU PROGRAM PRELUNGIT ”ÁRVÁCSKA”",25,"MUNICIPIUL SFÂNTU GHEORGHE",63394,1,PART,PRCNCT,PRSD,PRSD_SV,"2025-05-18 22:10:09",1152,548,507,34,7,544,4,1200,652,50,494
15,COVASNA,"ŞCOALA GIMNAZIALĂ ”GÖDRI FERENC”",26,"MUNICIPIUL SFÂNTU GHEORGHE",63394,1,PART,PRCNCT,PRSD,PRSD_SV,"2025-05-18 21:31:46",1217,581,536,41,4,574,7,1300,719,62,512
15,COVASNA,"UNIVERSITATEA ”SAPIENTIA” SFANTU GHEORGHE",27,"MUNICIPIUL SFÂNTU GHEORGHE",63394,1,PART,PRCNCT,PRSD,PRSD_SV,"2025-05-18 21:26:18",1460,826,749,42,35,821,5,1600,774,71,750
15,COVASNA,"UNIVERSITATEA ”SAPIENTIA” SFANTU GHEORGHE",28,"MUNICIPIUL SFÂNTU GHEORGHE",63394,1,PART,PRCNCT,PRSD,PRSD_SV,"2025-05-18 21:34:51",829,453,417,31,5,451,2,900,447,46,405
15,COVASNA,"LICEUL TEHNOLOGIC ”PUSKÁS TIVADAR”",29,"MUNICIPIUL SFÂNTU GHEORGHE",63394,1,PART,PRCNCT,PRSD,PRSD_SV,"2025-05-18 22:19:02",1435,798,734,60,4,795,3,1500,702,96,699
15,COVASNA,"LICEUL TEHNOLOGIC ”PUSKÁS TIVADAR”",30,"MUNICIPIUL SFÂNTU GHEORGHE",63394,1,PART,PRCNCT,PRSD,PRSD_SV,"2025-05-18 21:43:59",1102,586,534,49,3,585,1,1200,614,58,527
15,COVASNA,"LICEUL TEHNOLOGIC ”PUSKÁS TIVADAR”",31,"MUNICIPIUL SFÂNTU GHEORGHE",63394,1,PART,PRCNCT,PRSD,PRSD_SV,"2025-05-18 21:33:03",1208,635,581,51,3,629,6,1300,665,64,565
15,COVASNA,"LICEUL TEHNOLOGIC ”PUSKÁS TIVADAR”",32,"MUNICIPIUL SFÂNTU GHEORGHE",63394,1,PART,PRCNCT,PRSD,PRSD_SV,"2025-05-18 21:55:19",1394,746,707,34,5,740,6,1500,754,89,651
15,COVASNA,"ȘCOALA GIMNAZIALĂ ”NICOLAE COLAN”",33,"MUNICIPIUL SFÂNTU GHEORGHE",63394,1,PART,PRCNCT,PRSD,PRSD_SV,"2025-05-18 21:59:18",1031,604,543,31,30,600,4,1100,496,95,505
15,COVASNA,"ŞCOALA GIMNAZIALĂ ”NICOLAE COLAN”",34,"MUNICIPIUL SFÂNTU GHEORGHE",63394,1,PART,PRCNCT,PRSD,PRSD_SV,"2025-05-18 21:43:53",958,512,472,33,7,508,4,1000,488,60,448
15,COVASNA,"ŞCOALA GIMNAZIALĂ ”NICOLAE COLAN”",35,"MUNICIPIUL SFÂNTU GHEORGHE",63394,2,PART,PRCNCT,PRSD,PRSD_SV,"2025-05-18 22:28:43",794,437,382,49,6,429,8,900,463,37,392
15,COVASNA,"ŞCOALA GIMNAZIALĂ ”NICOLAE COLAN”",36,"MUNICIPIUL SFÂNTU GHEORGHE",63394,1,PART,PRCNCT,PRSD,PRSD_SV,"2025-05-18 22:12:35",660,319,293,21,5,318,1,700,381,38,280
15,COVASNA,"GRĂDINIŢA CU PROGRAM PRELUNGIT ”PINOCCHIO”",37,"MUNICIPIUL SFÂNTU GHEORGHE",63394,1,PART,PRCNCT,PRSD,PRSD_SV,"2025-05-18 22:15:09",775,384,364,19,1,380,4,800,416,45,335
15,COVASNA,"GRĂDINIŢA CU PROGRAM PRELUNGIT ”PINOCCHIO”",38,"MUNICIPIUL SFÂNTU GHEORGHE",63394,1,PART,PRCNCT,PRSD,PRSD_SV,"2025-05-18 22:13:00",1231,575,534,39,2,573,2,1300,725,83,490
15,COVASNA,"GRĂDINIŢA CU PROGRAM PRELUNGIT ”BENEDEK ELEK”",39,"MUNICIPIUL SFÂNTU GHEORGHE",63394,1,PART,PRCNCT,PRSD,PRSD_SV,"2025-05-18 21:41:28",897,554,500,51,3,549,5,1000,446,55,494
15,COVASNA,"ŞTRAND MUNICIPAL SFÂNTU GHEORGHE",40,"MUNICIPIUL SFÂNTU GHEORGHE",63394,1,PART,PRCNCT,PRSD,PRSD_SV,"2025-05-18 21:48:34",1284,714,622,90,2,704,10,1400,686,90,614
15,COVASNA,"ŞTRAND MUNICIPAL SFÂNTU GHEORGHE",41,"MUNICIPIUL SFÂNTU GHEORGHE",63394,1,PART,PRCNCT,PRSD,PRSD_SV,"2025-05-18 21:38:36",1569,884,806,74,4,875,9,1600,716,143,732
15,COVASNA,"ŞCOALA GIMNAZIALĂ ”ADY ENDRE”",42,"MUNICIPIUL SFÂNTU GHEORGHE",63394,1,PART,PRCNCT,PRSD,PRSD_SV,"2025-05-18 21:29:17",720,369,325,41,3,368,1,800,431,74,294
15,COVASNA,"ŞCOALA GIMNAZIALĂ ”ADY ENDRE”",43,"MUNICIPIUL SFÂNTU GHEORGHE",63394,1,PART,PRCNCT,PRSD,PRSD_SV,"2025-05-18 21:33:22",825,409,376,29,4,405,4,900,491,60,345
15,COVASNA,"ŞCOALA GIMNAZIALĂ ”ADY ENDRE”",44,"MUNICIPIUL SFÂNTU GHEORGHE",63394,1,PART,PRCNCT,PRSD,PRSD_SV,"2025-05-18 22:07:27",1306,676,654,20,2,671,5,1400,724,98,573
15,COVASNA,"GRĂDINIŢA CU PROGRAM PRELUNGIT ”NAPSUGÁR”",45,"MUNICIPIUL SFÂNTU GHEORGHE",63394,1,PART,PRCNCT,PRSD,PRSD_SV,"2025-05-18 21:42:19",991,532,469,61,2,524,8,1100,568,75,449
15,COVASNA,"GRĂDINIŢA CU PROGRAM PRELUNGIT ”NAPSUGÁR”",46,"MUNICIPIUL SFÂNTU GHEORGHE",63394,1,PART,PRCNCT,PRSD,PRSD_SV,"2025-05-18 21:56:07",1092,536,500,35,1,533,3,1200,664,108,425
15,COVASNA,"STADIONUL SEPSI OSK",47,"MUNICIPIUL SFÂNTU GHEORGHE",63394,1,PART,PRCNCT,PRSD,PRSD_SV,"2025-05-18 21:23:33",120,129,86,40,3,126,3,200,71,6,120
15,COVASNA,"PARCUL INDUSTRIAL",48,"MUNICIPIUL SFÂNTU GHEORGHE",63394,1,PART,PRCNCT,PRSD,PRSD_SV,"2025-05-18 21:28:09",316,178,166,12,0,178,0,400,222,41,137
15,COVASNA,"CĂMIN CULTURAL",49,"MUNICIPIUL SFÂNTU GHEORGHE",63394,1,PART,PRCNCT,PRSD,PRSD_SV,"2025-05-18 21:22:08",719,423,397,20,6,419,4,800,377,29,390
15,COVASNA,"CĂMIN CULTURAL",50,"MUNICIPIUL SFÂNTU GHEORGHE",63394,1,PART,PRCNCT,PRSD,PRSD_SV,"2025-05-18 21:41:49",392,254,236,17,1,253,1,500,246,23,230
15,COVASNA,"CASA MUNICIPALĂ DE CULTURĂ ”VIGADÓ” TÂRGU SECUIESC",51,"MUNICIPIUL TÂRGU SECUIESC",63740,1,PART,PRCNCT,PRSD,PRSD_SV,"2025-05-18 21:50:39",1271,718,650,64,4,713,5,1401,683,35,678
15,COVASNA,"COLEGIUL NAȚIONAL ”NAGY MÓZES” TÂRGU SECUIESC",52,"MUNICIPIUL TÂRGU SECUIESC",63740,1,PART,PRCNCT,PRSD,PRSD_SV,"2025-05-18 21:31:40",1101,613,580,26,7,600,13,1200,587,45,555
15,COVASNA,"LICEUL PEDAGOGIC ”BOD PÉTER” TÂRGU SECUIESC",53,"MUNICIPIUL TÂRGU SECUIESC",63740,1,PART,PRCNCT,PRSD,PRSD_SV,"2025-05-18 21:54:40",1140,655,565,43,47,651,4,1200,545,35,616
15,COVASNA,"” LICEUL TEOLOGIC REFORMAT DR.CSIHA KÁLMÁN ” TÂRGU SECUIESC",54,"MUNICIPIUL TÂRGU SECUIESC",63740,1,PART,PRCNCT,PRSD,PRSD_SV,"2025-05-18 22:07:21",1155,611,574,33,4,609,2,1200,589,27,582
15,COVASNA,"GRĂDINIŢA CU PROGRAM NORMAL ”BENEDEK ELEK” TÂRGU SECUIESC",55,"MUNICIPIUL TÂRGU SECUIESC",63740,1,PART,PRCNCT,PRSD,PRSD_SV,"2025-05-18 21:47:32",1232,618,568,48,2,615,3,1300,682,52,563
15,COVASNA,"ŞCOALA GIMNAZIALĂ ”PETŐFI SÁNDOR” TÂRGU SECUIESC",56,"MUNICIPIUL TÂRGU SECUIESC",63740,2,PART,PRCNCT,PRSD,PRSD_SV,"2025-05-19 01:58:39",1204,675,632,41,2,674,1,1300,625,32,642
15,COVASNA,"GRĂDINIȚA CU PROGRAM PRELUNGIT ” CSIPKERÓZSIKA”",57,"MUNICIPIUL TÂRGU SECUIESC",63740,1,PART,PRCNCT,PRSD,PRSD_SV,"2025-05-18 21:22:38",1288,615,588,24,3,607,8,1400,785,30,577
15,COVASNA,"ŞCOALA GIMNAZIALĂ ”TUROCZI MÓZES” TÂRGU SECUIESC",58,"MUNICIPIUL TÂRGU SECUIESC",63740,1,PART,PRCNCT,PRSD,PRSD_SV,"2025-05-18 21:11:17",1209,579,545,34,0,577,2,1300,721,44,533
15,COVASNA,"ȘCOALA GIMNAZIALĂ ”TUROCZI MÓZES” TÂRGU SECUIESC",59,"MUNICIPIUL TÂRGU SECUIESC",63740,1,PART,PRCNCT,PRSD,PRSD_SV,"2025-05-18 21:35:09",1214,634,596,37,1,632,2,1300,666,33,599
15,COVASNA,"GRĂDINIŢA CU PROGRAM NORMAL NR. 3 TÂRGU SECUIESC",60,"MUNICIPIUL TÂRGU SECUIESC",63740,1,PART,PRCNCT,PRSD,PRSD_SV,"2025-05-18 21:17:05",921,515,478,35,2,513,2,1000,485,31,482
15,COVASNA,"LICEUL TEHNOLOGIC ”GÁBOR ÁRON” TÂRGU SECUIESC",61,"MUNICIPIUL TÂRGU SECUIESC",63740,1,PART,PRCNCT,PRSD,PRSD_SV,"2025-05-18 22:04:09",1029,611,504,78,29,603,8,1200,589,40,563
15,COVASNA,"ŞCOALA GIMNAZIALĂ ”MOLNÁR JOZSIÁS” TÂRGU SECUIESC",62,"MUNICIPIUL TÂRGU SECUIESC",63740,2,PART,PRCNCT,PRSD,PRSD_SV,"2025-05-19 01:57:15",1108,636,603,28,5,628,8,1200,564,30,598
15,COVASNA,"ŞCOALA PRIMARĂ RUSENI, TÂRGU SECUIESC",63,"MUNICIPIUL TÂRGU SECUIESC",63740,1,PART,PRCNCT,PRSD,PRSD_SV,"2025-05-18 21:33:56",629,405,381,24,0,401,4,700,295,20,381
15,COVASNA,"CĂMINUL CULTURAL TINOASA",64,"MUNICIPIUL TÂRGU SECUIESC",63740,1,PART,PRCNCT,PRSD,PRSD_SV,"2025-05-18 21:31:04",346,210,184,26,0,208,2,400,190,11,197
15,COVASNA,"CĂMINUL CULTURAL LUNGA",65,"MUNICIPIUL TÂRGU SECUIESC",63740,1,PART,PRCNCT,PRSD,PRSD_SV,"2025-05-18 21:48:08",984,528,490,16,22,525,3,1100,572,14,511
15,COVASNA,"PRIMĂRIA ORAŞULUI BARAOLT",66,"ORAŞ BARAOLT",63447,1,PART,PRCNCT,PRSD,PRSD_SV,"2025-05-18 21:52:06",1089,565,525,34,6,563,2,1200,635,51,512
15,COVASNA,"CASA DE CULTURĂ BARAOLT",67,"ORAŞ BARAOLT",63447,1,PART,PRCNCT,PRSD,PRSD_SV,"2025-05-18 22:13:36",1178,644,590,36,18,636,8,1400,756,44,592
15,COVASNA,"ŞCOALA GIMNAZIALĂ GAÁL MÓZES BARAOLT",68,"ORAŞ BARAOLT",63447,1,PART,PRCNCT,PRSD,PRSD_SV,"2025-05-18 21:39:36",1167,612,578,27,7,610,2,1200,588,59,551
15,COVASNA,"GRĂDINIŢA CU PROGRAM PRELUNGIT ”CIMBORA”",69,"ORAŞ BARAOLT",63447,1,PART,PRCNCT,PRSD,PRSD_SV,"2025-05-18 21:52:52",1117,622,576,45,1,621,1,1200,578,23,598
15,COVASNA,"ȘCOALA PRIMARĂ ”BARTALIS FERENC” BIBORȚENI",70,"ORAŞ BARAOLT",63447,1,PART,PRCNCT,PRSD,PRSD_SV,"2025-05-18 21:26:28",566,395,365,24,6,393,2,600,205,2,391
15,COVASNA,"ȘCOALA PRIMARĂ ”BUDAI JÓZSEF” BODOȘ",71,"ORAŞ BARAOLT",63447,2,PART,PRCNCT,PRSD,PRSD_SV,"2025-05-19 01:36:43",346,207,192,11,4,207,0,400,193,4,203
15,COVASNA,"CĂMINUL CULTURAL CĂPENI",72,"ORAŞ BARAOLT",63447,1,PART,PRCNCT,PRSD,PRSD_SV,"2025-05-18 21:42:29",807,451,413,31,7,447,4,900,449,14,433
15,COVASNA,"ȘCOALA PRIMARĂ MICLOŞOARA",73,"ORAŞ BARAOLT",63447,1,PART,PRCNCT,PRSD,PRSD_SV,"2025-05-18 21:31:30",322,222,182,32,8,222,0,400,178,4,218
15,COVASNA,"CĂMIN CULTURAL RACOŞUL DE SUS",74,"ORAŞ BARAOLT",63447,1,PART,PRCNCT,PRSD,PRSD_SV,"2025-05-18 21:51:04",725,408,376,30,2,407,1,800,392,25,382
15,COVASNA,"GRĂDINIŢA CU PROGRAM PRELUNGIT NR.1 COVASNA",75,"ORAŞ COVASNA",63526,1,PART,PRCNCT,PRSD,PRSD_SV,"2025-05-18 21:22:18",1305,768,646,103,19,758,10,1500,732,95,663
15,COVASNA,"CLUBUL ORĂȘENESC - COVASNA - SALA MARE",76,"ORAŞ COVASNA",63526,1,PART,PRCNCT,PRSD,PRSD_SV,"2025-05-18 22:17:37",1271,1106,617,484,5,1092,14,1400,294,215,877
15,COVASNA,"LICEUL ”KŐRÖSI CSOMA SÁNDOR” -CORP A- COVASNA",77,"ORAŞ COVASNA",63526,1,PART,PRCNCT,PRSD,PRSD_SV,"2025-05-18 21:41:55",1050,823,515,307,1,810,13,1100,277,98,712
15,COVASNA,"LICEUL ”KŐRÖSI CSOMA SÁNDOR” -CORP A- COVASNA",78,"ORAŞ COVASNA",63526,1,PART,PRCNCT,PRSD,PRSD_SV,"2025-05-18 21:37:30",1143,776,581,191,4,769,7,1300,524,111,658
15,COVASNA,"GRĂDINIŢA CU PROGRAM PRELUNGIT NR. 2 COVASNA",79,"ORAŞ COVASNA",63526,1,PART,PRCNCT,PRSD,PRSD_SV,"2025-05-18 22:08:54",1463,785,714,67,4,780,5,1600,815,98,682
15,COVASNA,"ȘCOALA GIMNAZIALĂ ”AVRAM IANCU”- COVASNA -GIM",80,"ORAŞ COVASNA",63526,1,PART,PRCNCT,PRSD,PRSD_SV,"2025-05-18 21:49:27",1265,852,639,211,2,838,14,1400,548,269,569
15,COVASNA,"ȘCOALA GIMNAZIALĂ ”AVRAM IANCU”-COVASNA- GIM",81,"ORAŞ COVASNA",63526,1,PART,PRCNCT,PRSD,PRSD_SV,"2025-05-18 22:34:50",1069,911,569,310,32,897,14,1284,373,415,482
15,COVASNA,"CASA DE CULTURĂ-CHIURUŞ",82,"ORAŞ COVASNA",63526,1,PART,PRCNCT,PRSD,PRSD_SV,"2025-05-18 21:43:46",419,284,253,31,0,281,3,500,216,43,238
15,COVASNA,"ŞCOALA GIMNAZIALĂ ”MIHAIL SADOVEANU” ÎNTORSURA BUZĂULUI",83,"ORAŞ ÎNTORSURA BUZĂULUI",63580,1,PART,PRCNCT,PRSD,PRSD_SV,"2025-05-18 22:04:33",1101,642,553,88,1,633,9,1200,558,236,397
15,COVASNA,"ŞCOALA GIMNAZIALĂ ”MIHAIL SADOVEANU” ÎNTORSURA BUZĂULUI",84,"ORAŞ ÎNTORSURA BUZĂULUI",63580,1,PART,PRCNCT,PRSD,PRSD_SV,"2025-05-18 21:54:45",1205,600,551,49,0,587,13,1300,700,236,351
15,COVASNA,"LICEUL TEORETIC ”MIRCEA ELIADE” ÎNTORSURA BUZĂULUI",85,"ORAŞ ÎNTORSURA BUZĂULUI",63580,1,PART,PRCNCT,PRSD,PRSD_SV,"2025-05-18 22:05:28",877,411,374,34,3,407,4,1000,589,179,228
15,COVASNA,"CASA DE CULTURĂ ÎNTORSURA BUZĂULUI",86,"ORAŞ ÎNTORSURA BUZĂULUI",63580,1,PART,PRCNCT,PRSD,PRSD_SV,"2025-05-18 21:46:18",1194,685,604,79,2,678,7,1300,615,345,333
15,COVASNA,"ȘCOALA PRIMARĂ ÎNTORSURA BUZĂULUI",87,"ORAŞ ÎNTORSURA BUZĂULUI",63580,1,PART,PRCNCT,PRSD,PRSD_SV,"2025-05-18 21:51:10",817,460,441,19,0,452,8,900,440,204,248
15,COVASNA,"CĂMINUL CULTURAL BRĂDET",88,"ORAŞ ÎNTORSURA BUZĂULUI",63580,1,PART,PRCNCT,PRSD,PRSD_SV,"2025-05-18 21:53:18",973,535,478,57,0,531,4,1100,565,313,218
15,COVASNA,"CĂMIN CULTURAL FLOROAIA",89,"ORAŞ ÎNTORSURA BUZĂULUI",63580,1,PART,PRCNCT,PRSD,PRSD_SV,"2025-05-18 21:42:13",1173,673,637,36,0,672,1,1300,627,328,344
15,COVASNA,"SEDIUL PRIMĂRIEI COMUNEI AITA MARE",90,"AITA MARE",63777,1,PART,PRCNCT,PRSD,PRSD_SV,"2025-05-18 21:59:14",697,418,349,57,12,417,1,800,382,27,390
15,COVASNA,"CASA COMPOSESORATULUI AITA MEDIE",91,"AITA MARE",63777,1,PART,PRCNCT,PRSD,PRSD_SV,"2025-05-18 21:32:28",621,327,258,45,24,323,4,700,373,40,283
15,COVASNA,"SEDIUL CONSILIULUI LOCAL ARCUŞ",92,ARCUŞ,65113,1,PART,PRCNCT,PRSD,PRSD_SV,"2025-05-18 23:02:35",1451,1056,939,88,29,1052,4,1500,444,25,1027
15,COVASNA,"ȘCOALA GIMNAZIALĂ ”ANDREI ȘAGUNA” BARCANI",93,BARCANI,63633,1,PART,PRCNCT,PRSD,PRSD_SV,"2025-05-18 21:52:10",987,579,533,46,0,576,3,1100,521,280,296
15,COVASNA,"ȘCOALA GIMNAZIALĂ ”ANDREI ȘAGUNA” BARCANI",94,BARCANI,63633,1,PART,PRCNCT,PRSD,PRSD_SV,"2025-05-18 21:52:20",997,506,471,35,0,502,4,1100,594,335,167
15,COVASNA,"ŞCOALA GIMNAZIALĂ LĂDĂUŢI",95,BARCANI,63633,1,PART,PRCNCT,PRSD,PRSD_SV,"2025-05-18 21:43:53",556,270,244,26,0,267,3,600,330,134,133
15,COVASNA,"ŞCOALA GIMNAZIALĂ SĂRĂMAŞ",96,BARCANI,63633,1,PART,PRCNCT,PRSD,PRSD_SV,"2025-05-18 21:40:21",547,324,266,58,0,321,3,600,276,208,113
15,COVASNA,"CLĂDIRE PRIMARIEI CĂMINUL CULTURAL BAŢANII MARI",97,BĂŢANI,63802,1,PART,PRCNCT,PRSD,PRSD_SV,"2025-05-18 21:54:23",1664,863,782,60,21,855,8,1700,837,52,803
15,COVASNA,"SEDIUL DE DEPLASARE AL PRIMARIEI ÎN AITA SEACĂ",98,BĂŢANI,63802,1,PART,PRCNCT,PRSD,PRSD_SV,"2025-05-18 21:25:33",562,315,266,37,12,313,2,600,285,19,294
15,COVASNA,"CĂMINUL CULTURAL BAŢANII MICI",99,BĂŢANI,63802,1,PART,PRCNCT,PRSD,PRSD_SV,"2025-05-18 21:53:27",448,292,248,29,15,289,3,500,208,14,275
15,COVASNA,"SEDIUL DE DEPLASARE AL PRIMARIEI ÎN SATUL HERCULIAN",100,BĂŢANI,63802,1,PART,PRCNCT,PRSD,PRSD_SV,"2025-05-18 21:54:28",940,469,430,23,16,462,7,1000,531,133,329
15,COVASNA,"GRĂDINIȚA CU PROGRAM NORMAL BELIN",101,BELIN,63866,1,PART,PRCNCT,PRSD,PRSD_SV,"2025-05-18 21:36:06",1067,547,474,73,0,545,2,1200,653,109,436
15,COVASNA,"CENTRUL MULTIFUNCŢIONAL BELIN VALE",102,BELIN,63866,1,PART,PRCNCT,PRSD,PRSD_SV,"2025-05-18 21:39:02",1199,343,329,14,0,339,4,1300,957,280,59
15,COVASNA,"CĂMINUL CULTURAL BIXAD",103,BIXAD,65121,1,PART,PRCNCT,PRSD,PRSD_SV,"2025-05-18 22:14:09",1386,759,646,86,27,751,8,1500,741,37,714
15,COVASNA,"CĂMINUL CULTURAL DIN BODOC",104,BODOC,63893,1,PART,PRCNCT,PRSD,PRSD_SV,"2025-05-18 22:17:43",933,665,589,56,20,664,1,1000,335,30,634
15,COVASNA,"PAROHIA REFORMATĂ OLTENI",105,BODOC,63893,1,PART,PRCNCT,PRSD,PRSD_SV,"2025-05-18 21:54:09",532,360,309,42,9,353,7,599,239,17,336
15,COVASNA,"CĂMIN CULTURAL ZĂLAN",106,BODOC,63893,1,PART,PRCNCT,PRSD,PRSD_SV,"2025-05-18 21:52:14",530,345,299,43,3,343,2,600,255,18,325
15,COVASNA,"ȘCOALA GIMNAZIALĂ ”BARTHA KÁROLY”",107,"BOROŞNEU MARE",63937,1,PART,PRCNCT,PRSD,PRSD_SV,"2025-05-18 21:18:35",1270,329,293,32,4,324,5,1300,971,37,287
15,COVASNA,"ŞCOALA PRIMARĂ BOROŞNEU MIC",108,"BOROŞNEU MARE",63937,1,PART,PRCNCT,PRSD,PRSD_SV,"2025-05-18 21:26:24",367,171,127,43,1,167,4,400,229,27,140
15,COVASNA,"SCOLA PRIMARĂ DOBOLII DE SUS",109,"BOROŞNEU MARE",63937,1,PART,PRCNCT,PRSD,PRSD_SV,"2025-05-18 21:22:30",184,114,74,38,2,112,2,300,186,9,103
15,COVASNA,"ŞCOALA PRIMARĂ LEŢ",110,"BOROŞNEU MARE",63937,1,PART,PRCNCT,PRSD,PRSD_SV,"2025-05-18 21:21:49",503,288,222,40,26,286,2,600,312,15,271
15,COVASNA,"CĂMINUL CULTURAL ŢUFALAU",111,"BOROŞNEU MARE",63937,1,PART,PRCNCT,PRSD,PRSD_SV,"2025-05-18 21:17:03",188,136,92,33,11,136,0,300,164,12,124
15,COVASNA,"SALA DE ȘEDINȚĂ A CONSILIULUI LOCAL BRATEȘ",112,BRATEŞ,64005,1,PART,PRCNCT,PRSD,PRSD_SV,"2025-05-18 21:28:50",465,353,296,45,12,353,0,500,147,9,344
15,COVASNA,"ȘCOALA PRIMARĂ ” VIDA ANDRÁS” PACHIA",113,BRATEŞ,64005,1,PART,PRCNCT,PRSD,PRSD_SV,"2025-05-18 21:23:26",259,183,144,33,6,180,3,300,117,23,157
15,COVASNA,"ȘCOALA PRIMARĂ ” HORVÁTH KÁROLY” TELECHIA",114,BRATEŞ,64005,1,PART,PRCNCT,PRSD,PRSD_SV,"2025-05-18 21:29:07",440,287,225,45,17,285,2,500,213,20,265
15,COVASNA,"CLUBUL CĂMINULUI CULTURAL BRĂDUŢ",115,BRĂDUŢ,64041,1,PART,PRCNCT,PRSD,PRSD_SV,"2025-05-18 21:42:55",666,478,433,20,25,477,1,800,322,16,461
15,COVASNA,"CLUBUL CĂMINULUI CULTURAL DOBOŞENI",116,BRĂDUŢ,64041,1,PART,PRCNCT,PRSD,PRSD_SV,"2025-05-18 21:57:13",1596,714,650,25,39,694,20,1700,986,220,474
15,COVASNA,"CLUBUL CĂMINULUI CULTURAL FILIA",117,BRĂDUŢ,64041,1,PART,PRCNCT,PRSD,PRSD_SV,"2025-05-18 21:45:39",950,657,568,31,58,657,0,1000,343,13,644
15,COVASNA,"CĂMINUL CULTURAL TĂLIŞOARA",118,BRĂDUŢ,64041,1,PART,PRCNCT,PRSD,PRSD_SV,"2025-05-18 21:35:48",599,436,381,21,34,434,2,700,264,13,421
15,COVASNA,"CENTRUL CULTURAL BREŢCU",119,BREŢCU,64096,1,PART,PRCNCT,PRSD,PRSD_SV,"2025-05-18 21:46:08",1089,582,502,32,48,579,3,1200,618,62,517
15,COVASNA,"CENTRUL CULTURAL BREŢCU",120,BREŢCU,64096,1,PART,PRCNCT,PRSD,PRSD_SV,"2025-05-18 21:57:20",857,391,338,34,19,380,11,900,509,107,273
15,COVASNA,"ŞCOALA PRIMARĂ MĂRTĂNUŞ",121,BREŢCU,64096,1,PART,PRCNCT,PRSD,PRSD_SV,"2025-05-18 21:36:25",595,290,244,34,12,285,5,700,410,61,224
15,COVASNA,"ŞCOALA GIMNAZIALĂ OITUZ",122,BREŢCU,64096,1,PART,PRCNCT,PRSD,PRSD_SV,"2025-05-18 21:51:23",248,155,120,25,10,154,1,300,145,36,118
15,COVASNA,"CĂMINUL CULTURAL CATALINA",123,CATALINA,64130,1,PART,PRCNCT,PRSD,PRSD_SV,"2025-05-18 21:31:05",1077,590,557,33,0,586,4,1200,610,54,532
15,COVASNA,"CĂMINUL CULTURAL HĂTUICA",124,CATALINA,64130,1,PART,PRCNCT,PRSD,PRSD_SV,"2025-05-18 21:29:32",372,261,242,18,1,261,0,400,139,10,251
15,COVASNA,"CĂMINUL CULTURAL IMENI",125,CATALINA,64130,1,PART,PRCNCT,PRSD,PRSD_SV,"2025-05-18 21:29:02",239,141,121,20,0,137,4,300,159,14,123
15,COVASNA,"CĂMINUL CULTURAL MĂRCUŞA",126,CATALINA,64130,1,PART,PRCNCT,PRSD,PRSD_SV,"2025-05-18 21:24:52",498,259,237,21,1,259,0,600,341,19,240
15,COVASNA,"CASA COMUNALA MĂRTINENI",127,CATALINA,64130,1,PART,PRCNCT,PRSD,PRSD_SV,"2025-05-18 21:27:48",473,259,241,18,0,259,0,500,241,12,247
15,COVASNA,"CASA MULTIFUNCȚIONALĂ ”CONACUL FARKAS”",128,CERNAT,64194,1,PART,PRCNCT,PRSD,PRSD_SV,"2025-05-18 21:46:27",655,423,363,26,34,420,3,700,277,32,388
15,COVASNA,"ŞCOALA GIMNAZIALĂ ”VÉGH ANTAL” CERNAT",129,CERNAT,64194,1,PART,PRCNCT,PRSD,PRSD_SV,"2025-05-18 22:08:42",1187,735,655,31,49,735,0,1300,565,33,702
15,COVASNA,"GRĂDINIȚA CU PROGRAM NORMAL NR.2 CERNAT",130,CERNAT,64194,1,PART,PRCNCT,PRSD,PRSD_SV,"2025-05-18 21:37:40",894,630,558,41,31,622,8,1000,370,32,590
15,COVASNA,"CLĂDIREA CONSILIULUI LOCAL CERNAT, ALBIŞ",131,CERNAT,64194,2,PART,PRCNCT,PRSD,PRSD_SV,"2025-05-19 01:56:01",331,236,204,14,18,236,0,400,164,19,217
15,COVASNA,"CASA MULTIFUNCȚIONALĂ ICAFĂLĂU",132,CERNAT,64194,1,PART,PRCNCT,PRSD,PRSD_SV,"2025-05-18 21:37:19",222,141,113,20,8,141,0,300,159,7,134
15,COVASNA,"CĂMINUL CULTURAL CHICHIŞ",133,CHICHIŞ,64238,1,PART,PRCNCT,PRSD,PRSD_SV,"2025-05-18 21:37:15",854,644,497,114,33,639,5,900,256,62,577
15,COVASNA,"ŞCOALA GIMNAZIALĂ BĂCEL",134,CHICHIŞ,64238,1,PART,PRCNCT,PRSD,PRSD_SV,"2025-05-18 21:27:17",426,256,192,64,0,256,0,500,244,125,131
15,COVASNA,"SEDIUL PRIMARIEI COMANDĂU",135,COMANDĂU,63553,1,PART,PRCNCT,PRSD,PRSD_SV,"2025-05-18 22:00:37",800,488,389,77,22,484,4,900,412,52,432
15,COVASNA,"CĂMINUL CULTURAL DALNIC",136,DALNIC,65147,1,PART,PRCNCT,PRSD,PRSD_SV,"2025-05-18 21:51:08",770,368,342,26,0,364,4,800,432,18,346
15,COVASNA,"GRĂDINȚA CU PROGRAM NORMAL DOBÂRLĂU",137,DOBÂRLĂU,64265,1,PART,PRCNCT,PRSD,PRSD_SV,"2025-05-18 21:36:46",918,488,422,64,2,486,2,1000,512,301,185
15,COVASNA,"ȘCOALA PRIMARĂ LUNCA MĂRCUȘULUI",138,DOBÂRLĂU,64265,1,PART,PRCNCT,PRSD,PRSD_SV,"2025-05-18 22:14:29",293,174,133,41,0,174,0,400,226,90,84
15,COVASNA,"ŞCOALA PRIMARĂ MĂRCUŞ",139,DOBÂRLĂU,64265,2,PART,PRCNCT,PRSD,PRSD_SV,"2025-05-19 01:51:03",350,261,187,74,0,254,7,400,139,154,100
15,COVASNA,"ŞCOALA PRIMARĂ VALEA DOBÂRLĂULUI",140,DOBÂRLĂU,64265,1,PART,PRCNCT,PRSD,PRSD_SV,"2025-05-18 21:35:53",266,160,119,41,0,159,1,300,140,100,59
15,COVASNA,"CĂMINUL CULTURAL ESTELNIC",141,ESTELNIC,65154,1,PART,PRCNCT,PRSD,PRSD_SV,"2025-05-18 21:23:00",693,464,404,37,23,459,5,800,336,27,432
15,COVASNA,"CĂMINUL CULTURAL VALEA SCURTĂ",142,ESTELNIC,65154,1,PART,PRCNCT,PRSD,PRSD_SV,"2025-05-18 21:19:27",205,172,130,33,9,172,0,300,128,10,162
15,COVASNA,"ŞCOALA GIMNAZIALĂ ”JANCSÓ BENEDEK” GHELINŢA",143,GHELINŢA,64318,1,PART,PRCNCT,PRSD,PRSD_SV,"2025-05-18 22:13:13",1452,848,772,35,41,842,6,1500,652,74,768
15,COVASNA,"ŞCOALA GIMNAZIALĂ ”JANCSÓ BENEDEK” GHELINŢA",144,GHELINŢA,64318,1,PART,PRCNCT,PRSD,PRSD_SV,"2025-05-18 22:36:07",1411,579,542,23,14,562,17,1400,821,65,497
15,COVASNA,"ŞCOALA PRIMARĂ NR.2 GHELINŢA",145,GHELINŢA,64318,1,PART,PRCNCT,PRSD,PRSD_SV,"2025-05-18 21:53:15",1103,681,618,21,42,677,4,1200,519,33,644
15,COVASNA,"ŞCOALA PRIMARĂ HARALE",146,GHELINŢA,64318,1,PART,PRCNCT,PRSD,PRSD_SV,"2025-05-18 21:32:57",196,116,88,23,5,111,5,300,184,11,100
15,COVASNA,"CĂMINUL CULTURAL DIN SATUL GHIDFALĂU",147,GHIDFALĂU,64345,1,PART,PRCNCT,PRSD,PRSD_SV,"2025-05-18 21:19:36",947,493,408,63,22,486,7,1000,507,27,459
15,COVASNA,"ȘCOALA PRIMARĂ ”FORRÓ ELEK”",148,GHIDFALĂU,64345,1,PART,PRCNCT,PRSD,PRSD_SV,"2025-05-18 21:16:35",554,335,285,39,11,335,0,600,265,12,323
15,COVASNA,"CĂMINUL CULTURAL DIN SATUL FOTOŞ",149,GHIDFALĂU,64345,1,PART,PRCNCT,PRSD,PRSD_SV,"2025-05-18 21:44:46",297,223,185,32,6,222,1,400,177,26,196
15,COVASNA,"CLĂDIREA POPICĂRIEI ZOLTAN",150,GHIDFALĂU,64345,1,PART,PRCNCT,PRSD,PRSD_SV,"2025-05-18 21:24:20",355,252,211,28,13,249,3,400,148,14,235
15,COVASNA,"CĂMINUL CULTURAL HĂGHIG",151,HĂGHIG,64390,1,PART,PRCNCT,PRSD,PRSD_SV,"2025-05-18 22:13:56",1456,629,516,92,21,622,7,1600,971,316,306
15,COVASNA,"CENTRUL DE ZI PENTRU COPII IARĂȘ",152,HĂGHIG,64390,1,PART,PRCNCT,PRSD,PRSD_SV,"2025-05-18 21:57:11",401,209,156,53,0,207,2,500,291,135,72
15,COVASNA,"CĂMINUL CULTURAL ILIENI",153,ILIENI,64425,1,PART,PRCNCT,PRSD,PRSD_SV,"2025-05-18 22:08:08",890,641,548,80,13,639,2,1000,359,24,615
15,COVASNA,"ŞCOALA PRIMARĂ ”BODA-POPOVICI” DOBOLII DE JOS",154,ILIENI,64425,1,PART,PRCNCT,PRSD,PRSD_SV,"2025-05-18 21:42:30",429,291,227,58,6,287,4,500,209,67,220
15,COVASNA,"GRĂDINIŢA CU PROGRAM NORMAL SÂNCRAIU",155,ILIENI,64425,1,PART,PRCNCT,PRSD,PRSD_SV,"2025-05-18 21:50:02",479,347,281,55,11,340,7,500,153,41,299
15,COVASNA,"SEDIUL PRIMĂRIEI LEMNIA",156,LEMNIA,64461,1,PART,PRCNCT,PRSD,PRSD_SV,"2025-05-18 21:32:22",663,445,371,33,41,443,2,800,355,22,421
15,COVASNA,"ŞCOALA PRIMARĂ NR.2 LEMNIA DE SUS",157,LEMNIA,64461,1,PART,PRCNCT,PRSD,PRSD_SV,"2025-05-18 21:34:37",825,488,413,50,25,484,4,900,412,30,454
15,COVASNA,"SEDIUL PRIMĂRIEI",158,MALNAŞ,64504,3,PART,PRCNCT,PRSD,PRSD_SV,"2025-05-19 01:47:10",405,280,228,41,11,276,4,500,220,21,255
15,COVASNA,"ŞCOALA PRIMARĂ MALNAŞ BĂI",159,MALNAŞ,64504,1,PART,PRCNCT,PRSD,PRSD_SV,"2025-05-18 21:27:57",353,220,178,41,1,216,4,400,180,26,190
15,COVASNA,"ŞCOALA PRIMARĂ VALEA ZĂLANULUI",160,MALNAŞ,64504,1,PART,PRCNCT,PRSD,PRSD_SV,"2025-05-18 21:21:10",90,73,47,26,0,73,0,200,127,6,67
15,COVASNA,"CASA COMUNALĂ (FOSTĂ CLĂDIRE- ȘCOALA VECHE)",161,MERENI,65105,1,PART,PRCNCT,PRSD,PRSD_SV,"2025-05-18 21:37:03",682,404,356,37,11,399,5,800,396,35,364
15,COVASNA,"CĂMINUL CULTURAL LUTOASA",162,MERENI,65105,1,PART,PRCNCT,PRSD,PRSD_SV,"2025-05-18 21:28:42",323,204,178,21,5,204,0,400,196,11,193
15,COVASNA,"PRIMĂRIA MICFALĂU (CONSILIUL LOCAL MICFALĂU)",163,MICFALĂU,65139,1,PART,PRCNCT,PRSD,PRSD_SV,"2025-05-18 21:55:46",1423,819,749,60,10,814,5,1500,681,39,775
15,COVASNA,"ŞCOALA GIMNAZIALĂ ”ORBAN BALAZS” MOACŞA",164,MOACŞA,64568,1,PART,PRCNCT,PRSD,PRSD_SV,"2025-05-18 21:35:37",559,294,244,50,0,291,3,600,306,19,272
15,COVASNA,"CLĂDIREA FOSTEI ŞCOLI GENERALE CU CLASELE I-IV ERESTEGHIN",165,MOACŞA,64568,1,PART,PRCNCT,PRSD,PRSD_SV,"2025-05-18 21:33:28",176,121,97,24,0,121,0,300,179,9,112
15,COVASNA,"GRĂDINIȚA CU PROGRAM NORMAL PĂDURENI",166,MOACŞA,64568,1,PART,PRCNCT,PRSD,PRSD_SV,"2025-05-18 21:57:21",266,158,130,28,0,156,2,300,142,13,143
15,COVASNA,"CĂMINUL CULTURAL ”ZSÖGÖN ZOLTÁN” OJDULA CLUBUL TINERETULUI",167,OJDULA,64602,1,PART,PRCNCT,PRSD,PRSD_SV,"2025-05-18 22:01:13",1410,526,489,23,14,520,6,1400,874,41,479
15,COVASNA,"CĂMINUL CULTURAL ”ZSÖGÖN ZOLTÁN” OJDULA SALA MARE",168,OJDULA,64602,1,PART,PRCNCT,PRSD,PRSD_SV,"2025-05-18 22:10:27",1363,793,676,79,38,787,6,1400,607,51,736
15,COVASNA,"CĂMINUL CULTURAL HILIB",169,OJDULA,64602,1,PART,PRCNCT,PRSD,PRSD_SV,"2025-05-18 21:33:02",202,144,118,26,0,144,0,300,156,9,135
15,COVASNA,"CĂMINUL CULTURAL OZUN",170,OZUN,64639,1,PART,PRCNCT,PRSD,PRSD_SV,"2025-05-18 22:00:01",956,523,448,66,9,518,5,1000,477,58,460
15,COVASNA,"CLĂDIREA FOSTEI BIBLIOTECI (CONACUL PÜNKÖSTI)",171,OZUN,64639,1,PART,PRCNCT,PRSD,PRSD_SV,"2025-05-18 21:45:38",1177,745,662,80,3,741,4,1300,555,71,670
15,COVASNA,"CLĂDIREA CĂMINULUI CULTURAL BICFALĂU",172,OZUN,64639,1,PART,PRCNCT,PRSD,PRSD_SV,"2025-05-18 21:25:48",321,218,163,48,7,210,8,398,180,31,179
15,COVASNA,"CĂMINUL CULTURAL LISNĂU",173,OZUN,64639,1,PART,PRCNCT,PRSD,PRSD_SV,"2025-05-18 21:23:28",439,280,210,67,3,276,4,500,220,35,241
15,COVASNA,"CLĂDIRE ADMINISTRATIVĂ (FOSTUL SEDIU AL ŞCOLII) LUNCA OZUNULUI",174,OZUN,64639,1,PART,PRCNCT,PRSD,PRSD_SV,"2025-05-18 21:45:37",151,126,86,40,0,124,2,200,74,36,88
15,COVASNA,"CLĂDIREA ȘCOLII ELEMENTARE",175,OZUN,64639,1,PART,PRCNCT,PRSD,PRSD_SV,"2025-05-18 21:19:31",93,68,40,28,0,67,1,200,132,5,62
15,COVASNA,"ŞCOALA PRIMARĂ ”BERDE MOZSA” SÎNTIONLUNCA",176,OZUN,64639,1,PART,PRCNCT,PRSD,PRSD_SV,"2025-05-18 21:30:35",619,414,349,52,13,412,2,700,286,25,387
15,COVASNA,"ȘCOALA GIMNAZIALĂ ”TREFÁN LEONÁRD” POIAN",177,POIAN,64719,1,PART,PRCNCT,PRSD,PRSD_SV,"2025-05-18 21:50:17",996,599,529,42,28,593,6,1100,501,48,545
15,COVASNA,"ŞCOALA PRIMARĂ ”TUZSON JÁNOS” BELANI",178,POIAN,64719,1,PART,PRCNCT,PRSD,PRSD_SV,"2025-05-18 21:23:54",395,255,215,33,7,254,1,500,245,12,242
15,COVASNA,"CĂMINUL CULTURAL RECI",179,RECI,64773,1,PART,PRCNCT,PRSD,PRSD_SV,"2025-05-18 21:48:17",1206,752,610,114,28,748,4,1300,548,59,689
15,COVASNA,"CASA PAROHIALĂ-ANINOASA",180,RECI,64773,1,PART,PRCNCT,PRSD,PRSD_SV,"2025-05-18 21:28:35",338,191,154,31,6,189,2,400,209,19,170
15,COVASNA,"ŞCOALA PRIMARĂ BITA",181,RECI,64773,1,PART,PRCNCT,PRSD,PRSD_SV,"2025-05-18 21:22:32",213,160,119,29,12,160,0,300,140,12,148
15,COVASNA,"CĂMINUL CULTURAL SACIOVA",182,RECI,64773,1,PART,PRCNCT,PRSD,PRSD_SV,"2025-05-18 21:29:01",108,102,57,37,8,102,0,200,98,11,91
15,COVASNA,"BIROUL INFOTURISM",183,SÂNZIENI,64826,1,PART,PRCNCT,PRSD,PRSD_SV,"2025-05-18 21:24:37",1184,746,685,32,29,739,7,1300,554,23,716
15,COVASNA,"CLUBUL CĂMINULUI CULTURAL SÂNZIENI",184,SÂNZIENI,64826,1,PART,PRCNCT,PRSD,PRSD_SV,"2025-05-18 21:19:38",999,576,540,24,12,569,7,1100,524,36,533
15,COVASNA,"CASA COMUNITARĂ - PARTER",185,SÂNZIENI,64826,1,PART,PRCNCT,PRSD,PRSD_SV,"2025-05-18 21:18:21",215,130,118,12,0,130,0,300,170,8,122
15,COVASNA,"CĂMINUL CULTURAL PETRICENI",186,SÂNZIENI,64826,2,PART,PRCNCT,PRSD,PRSD_SV,"2025-05-19 01:42:41",686,340,320,20,0,335,5,800,460,22,313
15,COVASNA,"GRĂDINIȚA DE COPII (PARTER)",187,SÂNZIENI,64826,1,PART,PRCNCT,PRSD,PRSD_SV,"2025-05-18 21:37:08",488,302,271,24,7,298,4,500,198,23,275
15,COVASNA,"PRIMĂRIA SITA BUZĂULUI",188,"SITA BUZĂULUI",63688,1,PART,PRCNCT,PRSD,PRSD_SV,"2025-05-18 21:50:46",1220,752,668,81,3,746,6,1300,548,331,415
15,COVASNA,"ŞCOALA GIMNAZIALĂ NR.2 SITA BUZĂULUI",189,"SITA BUZĂULUI",63688,1,PART,PRCNCT,PRSD,PRSD_SV,"2025-05-18 21:37:54",822,416,387,29,0,410,6,900,484,218,192
15,COVASNA,"GRĂDINIȚA CU PROGRAM NORMAL NR.3 SITA BUZĂULUI",190,"SITA BUZĂULUI",63688,1,PART,PRCNCT,PRSD,PRSD_SV,"2025-05-18 21:36:18",872,465,430,34,1,458,7,1000,535,296,162
15,COVASNA,"GRĂDINIȚA CU PROGRAM NORMAL CRASNA",191,"SITA BUZĂULUI",63688,1,PART,PRCNCT,PRSD,PRSD_SV,"2025-05-18 21:28:46",452,244,218,26,0,244,0,500,256,178,66
15,COVASNA,"ŞCOALA GIMNAZIALĂ ZĂBRĂTĂU",192,"SITA BUZĂULUI",63688,1,PART,PRCNCT,PRSD,PRSD_SV,"2025-05-18 21:46:30",424,252,211,41,0,250,2,500,248,146,104
15,COVASNA,"CĂMINUL CULTURAL TURIA",193,TURIA,64871,1,PART,PRCNCT,PRSD,PRSD_SV,"2025-05-18 21:42:31",965,627,565,33,29,624,3,1100,473,36,588
15,COVASNA,"ŞCOALA PRIMARĂ ”JÓKAI MÓR” TURIA",194,TURIA,64871,1,PART,PRCNCT,PRSD,PRSD_SV,"2025-05-18 21:33:57",673,444,378,27,39,443,1,700,256,28,415
15,COVASNA,"ŞCOALA PRIMARĂ NR.3 TURIA",195,TURIA,64871,1,PART,PRCNCT,PRSD,PRSD_SV,"2025-05-18 21:50:07",1173,681,577,70,34,668,13,1300,619,44,624
15,COVASNA,"ŞCOALA PRIMARĂ ”REMÉNYIK SÁNDOR” ALUNGENI",196,TURIA,64871,1,PART,PRCNCT,PRSD,PRSD_SV,"2025-05-18 21:24:57",248,189,135,32,22,188,1,300,111,15,173
15,COVASNA,"PRIMĂRIA COMUNEI VALEA CRIŞULUI",197,"VALEA CRIŞULUI",64906,1,PART,PRCNCT,PRSD,PRSD_SV,"2025-05-18 21:46:29",1509,848,755,58,35,844,4,1600,752,39,805
15,COVASNA,"CĂMIN CULTURAL CALNIC",198,"VALEA CRIŞULUI",64906,1,PART,PRCNCT,PRSD,PRSD_SV,"2025-05-18 21:40:17",438,314,258,33,23,313,1,500,186,13,300
15,COVASNA,"CLĂDIREA CĂMINULUI CULTURAL VALEA MARE",199,"VALEA MARE",65099,1,PART,PRCNCT,PRSD,PRSD_SV,"2025-05-18 21:54:49",898,412,358,53,1,408,4,1000,588,238,170
15,COVASNA,"SEDIUL PRIMĂRIEI ÎN SATUL ARACI-CORPUL A",200,VÂLCELE,64942,1,PART,PRCNCT,PRSD,PRSD_SV,"2025-05-18 21:19:11",620,215,183,32,0,214,1,700,485,154,60
15,COVASNA,"SEDIUL PRIMĂRIEI ÎN SATUL ARACI-CORPUL B",201,VÂLCELE,64942,1,PART,PRCNCT,PRSD,PRSD_SV,"2025-05-18 21:40:10",1021,354,321,32,1,351,3,1100,746,259,92
15,COVASNA,"ŞCOALA PRIMARĂ ARIUŞD",202,VÂLCELE,64942,1,PART,PRCNCT,PRSD,PRSD_SV,"2025-05-18 21:35:13",367,190,136,54,0,189,1,400,210,69,120
15,COVASNA,"ŞCOALA PRIMARĂ HETEA",203,VÂLCELE,64942,1,PART,PRCNCT,PRSD,PRSD_SV,"2025-05-18 21:34:53",305,142,131,11,0,138,4,400,258,124,14
15,COVASNA,"ŞCOALA GIMNAZIALĂ VÂLCELE",204,VÂLCELE,64942,2,PART,PRCNCT,PRSD,PRSD_SV,"2025-05-19 02:39:21",1147,501,407,93,1,493,8,1200,699,336,157
15,COVASNA,"CĂMINUL CULTURAL VÎRGHIŞ",205,VÂRGHIŞ,64997,1,PART,PRCNCT,PRSD,PRSD_SV,"2025-05-18 21:36:15",1450,878,781,53,44,873,5,1500,622,40,833
15,COVASNA,"CĂMINUL CULTURAL NR.1 ZAGON",206,ZAGON,65011,1,PART,PRCNCT,PRSD,PRSD_SV,"2025-05-18 22:22:33",1628,1073,928,89,56,1065,8,1700,627,99,966
15,COVASNA,"ŞCOALA PRIMARĂ ”GEORGE COŞBUC” ZAGON",207,ZAGON,65011,1,PART,PRCNCT,PRSD,PRSD_SV,"2025-05-18 21:35:27",1415,654,610,43,1,651,3,1500,846,432,219
15,COVASNA,"CĂMINUL CULTURAL PĂPĂUŢI",208,ZAGON,65011,1,PART,PRCNCT,PRSD,PRSD_SV,"2025-05-18 21:41:11",983,576,507,49,20,571,5,1100,524,229,342
15,COVASNA,"CĂMINUL CULTURAL ZĂBALA",209,ZĂBALA,65048,1,PART,PRCNCT,PRSD,PRSD_SV,"2025-05-18 21:49:35",1233,670,588,63,19,664,6,1300,630,38,626
15,COVASNA,"CLUBUL NR. 2 ZĂBALA",210,ZĂBALA,65048,1,PART,PRCNCT,PRSD,PRSD_SV,"2025-05-18 21:36:52",816,406,374,30,2,404,2,900,494,125,279
15,COVASNA,"CĂMINUL CULTURAL ZĂBALA (PAVA)",211,ZĂBALA,65048,1,PART,PRCNCT,PRSD,PRSD_SV,"2025-05-18 21:28:01",699,312,271,34,7,309,3,800,488,45,264
15,COVASNA,"CĂMINUL CULTURAL PETENI",212,ZĂBALA,65048,1,PART,PRCNCT,PRSD,PRSD_SV,"2025-05-18 21:33:37",133,95,64,26,5,90,5,200,105,13,77
15,COVASNA,"CĂMINUL CULTURAL SURCEA",213,ZĂBALA,65048,1,PART,PRCNCT,PRSD,PRSD_SV,"2025-05-18 21:38:43",485,314,253,36,25,310,4,500,186,26,284
15,COVASNA,"CĂMINUL CULTURAL TAMAŞFALĂU",214,ZĂBALA,65048,1,PART,PRCNCT,PRSD,PRSD_SV,"2025-05-18 21:36:17",380,284,218,48,18,283,1,399,115,9,274
16,DÂMBOVIŢA,"CASA CORPULUI DIDACTIC",1,"MUNICIPIUL TÂRGOVIŞTE",65342,2,PART,PRCNCT,PRSD,PRSD_SV,"2025-05-19 01:37:50",1508,870,766,104,0,859,11,1640,770,313,546
16,DÂMBOVIŢA,"CASA CORPULUI DIDACTIC",2,"MUNICIPIUL TÂRGOVIŞTE",65342,1,PART,PRCNCT,PRSD,PRSD_SV,"2025-05-18 21:47:29",1522,944,861,81,2,936,8,1660,716,323,613
16,DÂMBOVIŢA,"GRĂDINIȚA CU PROGRAM PRELUNGIT NR. 2",3,"MUNICIPIUL TÂRGOVIŞTE",65342,1,PART,PRCNCT,PRSD,PRSD_SV,"2025-05-18 21:56:41",1454,754,716,38,0,742,12,1572,818,302,440
16,DÂMBOVIŢA,"ȘCOALA GIMNAZIALĂ ”RADU CEL MARE”",4,"MUNICIPIUL TÂRGOVIŞTE",65342,2,PART,PRCNCT,PRSD,PRSD_SV,"2025-05-18 23:02:29",1072,569,470,99,0,555,14,1170,601,258,297
16,DÂMBOVIŢA,"ȘCOALA GIMNAZIALĂ ”RADU CEL MARE”",5,"MUNICIPIUL TÂRGOVIŞTE",65342,1,PART,PRCNCT,PRSD,PRSD_SV,"2025-05-18 21:34:17",1188,619,546,73,0,607,12,1300,681,257,350
16,DÂMBOVIŢA,"ȘCOALA GIMNAZIALĂ ”RADU CEL MARE”",6,"MUNICIPIUL TÂRGOVIŞTE",65342,2,PART,PRCNCT,PRSD,PRSD_SV,"2025-05-18 23:48:21",1208,586,544,42,0,572,14,1320,734,193,379
16,DÂMBOVIŢA,"ȘCOALA GIMNAZIALĂ ”RADU CEL MARE”",7,"MUNICIPIUL TÂRGOVIŞTE",65342,1,PART,PRCNCT,PRSD,PRSD_SV,"2025-05-18 21:27:50",1224,616,575,41,0,611,5,1330,714,230,381
16,DÂMBOVIŢA,"LICEUL TEHNOLOGIC ”SPIRU HARET”",8,"MUNICIPIUL TÂRGOVIŞTE",65342,1,PART,PRCNCT,PRSD,PRSD_SV,"2025-05-18 21:38:51",1086,527,476,51,0,521,6,1190,663,181,340
16,DÂMBOVIŢA,"LICEUL TEHNOLOGIC ”SPIRU HARET”",9,"MUNICIPIUL TÂRGOVIŞTE",65342,1,PART,PRCNCT,PRSD,PRSD_SV,"2025-05-18 21:52:07",939,477,442,34,1,469,8,1030,553,218,251
16,DÂMBOVIŢA,"LICEUL TEHNOLOGIC ”SPIRU HARET”",10,"MUNICIPIUL TÂRGOVIŞTE",65342,1,PART,PRCNCT,PRSD,PRSD_SV,"2025-05-18 21:26:33",1159,597,573,24,0,592,5,1270,673,197,395
16,DÂMBOVIŢA,"LICEUL DE ARTE ”BĂLAȘA DOAMNA”",11,"MUNICIPIUL TÂRGOVIŞTE",65342,1,PART,PRCNCT,PRSD,PRSD_SV,"2025-05-18 21:59:50",960,512,426,86,0,502,10,1050,538,193,309
16,DÂMBOVIŢA,"LICEUL TEORETIC ”PETRU CERCEL”",12,"MUNICIPIUL TÂRGOVIŞTE",65342,2,PART,PRCNCT,PRSD,PRSD_SV,"2025-05-19 02:29:53",1843,1023,934,89,0,998,25,2010,987,484,514
16,DÂMBOVIŢA,"COLEGIUL NAȚIONAL ”CONSTANTIN CARABELLA”",13,"MUNICIPIUL TÂRGOVIŞTE",65342,1,PART,PRCNCT,PRSD,PRSD_SV,"2025-05-18 22:17:51",978,643,549,93,1,635,8,1070,427,191,444
16,DÂMBOVIŢA,"ȘCOALA GIMNAZIALĂ ”MATEI BASARAB”",14,"MUNICIPIUL TÂRGOVIŞTE",65342,1,PART,PRCNCT,PRSD,PRSD_SV,"2025-05-18 21:44:04",891,575,469,105,1,571,4,980,405,177,394
16,DÂMBOVIŢA,"ȘCOALA GIMNAZIALĂ ”MATEI BASARAB”",15,"MUNICIPIUL TÂRGOVIŞTE",65342,1,PART,PRCNCT,PRSD,PRSD_SV,"2025-05-18 21:47:28",865,536,454,82,0,520,16,950,414,191,329
16,DÂMBOVIŢA,"ȘCOALA GIMNAZIALĂ ”MATEI BASARAB”",16,"MUNICIPIUL TÂRGOVIŞTE",65342,1,PART,PRCNCT,PRSD,PRSD_SV,"2025-05-18 21:45:07",1377,732,677,55,0,720,12,1500,768,246,474
16,DÂMBOVIŢA,"GRĂDINIȚA CU PROGRAM PRELUNGIT NR. 13",17,"MUNICIPIUL TÂRGOVIŞTE",65342,1,PART,PRCNCT,PRSD,PRSD_SV,"2025-05-18 21:56:14",1365,700,622,78,0,685,15,1480,780,331,354
16,DÂMBOVIŢA,"GRĂDINIȚA CU PROGRAM PRELUNGIT NR. 13",18,"MUNICIPIUL TÂRGOVIŞTE",65342,1,PART,PRCNCT,PRSD,PRSD_SV,"2025-05-18 21:49:54",1149,696,604,92,0,674,22,1260,564,255,419
16,DÂMBOVIŢA,"LICEUL TEHNOLOGIC ”CONSTANTIN BRÂNCOVEANU”",19,"MUNICIPIUL TÂRGOVIŞTE",65342,1,PART,PRCNCT,PRSD,PRSD_SV,"2025-05-18 21:31:24",755,429,320,109,0,423,6,830,401,197,226
16,DÂMBOVIŢA,"LICEUL TEHNOLOGIC ”CONSTANTIN BRÂNCOVEANU”",20,"MUNICIPIUL TÂRGOVIŞTE",65342,1,PART,PRCNCT,PRSD,PRSD_SV,"2025-05-18 21:31:46",839,363,321,42,0,360,3,930,567,221,139
16,DÂMBOVIŢA,"LICEUL TEHNOLOGIC ”CONSTANTIN BRÂNCOVEANU”",21,"MUNICIPIUL TÂRGOVIŞTE",65342,1,PART,PRCNCT,PRSD,PRSD_SV,"2025-05-18 21:45:00",1306,587,555,32,0,582,5,1410,823,281,301
16,DÂMBOVIŢA,"LICEUL TEHNOLOGIC ”CONSTANTIN BRÂNCOVEANU”",22,"MUNICIPIUL TÂRGOVIŞTE",65342,1,PART,PRCNCT,PRSD,PRSD_SV,"2025-05-18 21:55:51",793,365,336,29,0,355,10,870,505,186,169
16,DÂMBOVIŢA,"LICEUL TEHNOLOGIC ”CONSTANTIN BRÂNCOVEANU”",23,"MUNICIPIUL TÂRGOVIŞTE",65342,1,PART,PRCNCT,PRSD,PRSD_SV,"2025-05-18 21:35:11",656,329,249,80,0,322,7,720,391,184,138
16,DÂMBOVIŢA,"CANTINA DE AJUTOR SOCIAL",24,"MUNICIPIUL TÂRGOVIŞTE",65342,1,PART,PRCNCT,PRSD,PRSD_SV,"2025-05-18 21:41:29",910,478,426,50,2,470,8,1160,682,177,293
16,DÂMBOVIŢA,"ȘCOALA GIMNAZIALĂ ”PROF. PAUL BANICĂ”",25,"MUNICIPIUL TÂRGOVIŞTE",65342,2,PART,PRCNCT,PRSD,PRSD_SV,"2025-05-19 02:24:21",1042,592,482,110,0,581,11,1150,558,237,344
16,DÂMBOVIŢA,"ȘCOALA GIMNAZIALĂ ”PROF. PAUL BANICĂ”",26,"MUNICIPIUL TÂRGOVIŞTE",65342,1,PART,PRCNCT,PRSD,PRSD_SV,"2025-05-18 22:16:43",973,578,406,42,130,566,12,1220,642,270,296
16,DÂMBOVIŢA,"LICEUL TEORETIC ”ION HELIADE RĂDULESCU”",27,"MUNICIPIUL TÂRGOVIŞTE",65342,1,PART,PRCNCT,PRSD,PRSD_SV,"2025-05-18 21:51:27",810,510,388,122,0,501,9,900,390,185,316
16,DÂMBOVIŢA,"LICEUL TEORETIC ”ION HELIADE RĂDULESCU”",28,"MUNICIPIUL TÂRGOVIŞTE",65342,1,PART,PRCNCT,PRSD,PRSD_SV,"2025-05-18 21:44:16",1021,581,538,42,1,572,9,1120,539,191,381
16,DÂMBOVIŢA,"BIROURI PRIMĂRIE - SERVICIUL TAXE ȘI IMPOZITE, BLOC E4",29,"MUNICIPIUL TÂRGOVIŞTE",65342,1,PART,PRCNCT,PRSD,PRSD_SV,"2025-05-18 21:44:28",771,513,417,96,0,507,6,850,337,147,360
16,DÂMBOVIŢA,"BIROURI PRIMĂRIE - SERVICIUL TAXE ȘI IMPOZITE (PUNCT TERMIC)",30,"MUNICIPIUL TÂRGOVIŞTE",65342,2,PART,PRCNCT,PRSD,PRSD_SV,"2025-05-18 23:51:32",779,510,443,67,0,496,14,860,350,164,332
16,DÂMBOVIŢA,"BIROURI PRIMĂRIE - CORP B (SALA CĂSĂTORII)",31,"MUNICIPIUL TÂRGOVIŞTE",65342,1,PART,PRCNCT,PRSD,PRSD_SV,"2025-05-18 21:54:42",1028,719,564,155,0,710,9,1120,401,200,510
16,DÂMBOVIŢA,"COLEGIUL ECONOMIC ”ION GHICA”",32,"MUNICIPIUL TÂRGOVIŞTE",65342,1,PART,PRCNCT,PRSD,PRSD_SV,"2025-05-18 22:06:32",931,619,507,112,0,606,13,1030,411,146,460
16,DÂMBOVIŢA,"COLEGIUL ECONOMIC ”ION GHICA”",33,"MUNICIPIUL TÂRGOVIŞTE",65342,1,PART,PRCNCT,PRSD,PRSD_SV,"2025-05-18 21:43:37",1184,727,644,82,1,722,5,1290,563,193,529
16,DÂMBOVIŢA,"COLEGIUL NAȚIONAL ”IENĂCHIȚĂ VĂCĂRESCU”",34,"MUNICIPIUL TÂRGOVIŞTE",65342,1,PART,PRCNCT,PRSD,PRSD_SV,"2025-05-18 22:22:48",1475,986,861,124,1,981,5,1610,624,279,702
16,DÂMBOVIŢA,"ȘCOALA GIMNAZIALĂ ”IOAN ALEXANDRU BRĂTESCU-VOINEȘTI”",35,"MUNICIPIUL TÂRGOVIŞTE",65342,1,PART,PRCNCT,PRSD,PRSD_SV,"2025-05-18 22:04:40",1020,609,515,94,0,600,9,1110,501,188,412
16,DÂMBOVIŢA,"ȘCOALA GIMNAZIALĂ ”IOAN ALEXANDRU BRĂTESCU-VOINEȘTI”",36,"MUNICIPIUL TÂRGOVIŞTE",65342,1,PART,PRCNCT,PRSD,PRSD_SV,"2025-05-18 21:37:24",811,522,424,98,0,515,7,890,368,129,386
16,DÂMBOVIŢA,"ȘCOALA GIMNAZIALĂ ”IOAN ALEXANDRU BRĂTESCU-VOINEȘTI”",37,"MUNICIPIUL TÂRGOVIŞTE",65342,1,PART,PRCNCT,PRSD,PRSD_SV,"2025-05-18 21:54:09",846,360,294,66,0,355,5,930,570,217,138
16,DÂMBOVIŢA,"LICEUL ”VOIEVODUL MIRCEA”",38,"MUNICIPIUL TÂRGOVIŞTE",65342,1,PART,PRCNCT,PRSD,PRSD_SV,"2025-05-18 22:00:56",1396,731,629,74,28,717,14,1530,799,277,440
16,DÂMBOVIŢA,"ȘCOALA GIMNAZIALĂ ”CORESI”",39,"MUNICIPIUL TÂRGOVIŞTE",65342,1,PART,PRCNCT,PRSD,PRSD_SV,"2025-05-18 21:47:38",1049,697,514,142,41,685,12,1260,563,228,457
16,DÂMBOVIŢA,"LICEUL TEHNOLOGIC DE TRANSPORTURI AUTO",40,"MUNICIPIUL TÂRGOVIŞTE",65342,1,PART,PRCNCT,PRSD,PRSD_SV,"2025-05-18 21:55:48",1412,734,668,66,0,722,12,1540,806,271,451
16,DÂMBOVIŢA,"LICEUL TEHNOLOGIC DE TRANSPORTURI AUTO",41,"MUNICIPIUL TÂRGOVIŞTE",65342,1,PART,PRCNCT,PRSD,PRSD_SV,"2025-05-18 21:28:40",1607,579,519,60,0,571,8,1760,1181,246,325
16,DÂMBOVIŢA,"LICEUL TEHNOLOGIC DE TRANSPORTURI AUTO",42,"MUNICIPIUL TÂRGOVIŞTE",65342,1,PART,PRCNCT,PRSD,PRSD_SV,"2025-05-18 22:00:37",1244,652,611,41,0,638,14,1360,708,224,414
16,DÂMBOVIŢA,"LICEUL TEHNOLOGIC DE TRANSPORTURI AUTO",43,"MUNICIPIUL TÂRGOVIŞTE",65342,1,PART,PRCNCT,PRSD,PRSD_SV,"2025-05-18 21:50:43",1230,630,593,36,1,618,12,1335,705,255,363
16,DÂMBOVIŢA,"LICEUL TEHNOLOGIC DE TRANSPORTURI AUTO",44,"MUNICIPIUL TÂRGOVIŞTE",65342,1,PART,PRCNCT,PRSD,PRSD_SV,"2025-05-18 21:58:40",1206,561,541,20,0,558,3,1320,759,223,335
16,DÂMBOVIŢA,"LICEUL TEHNOLOGIC ”NICOLAE CIORĂNESCU”",45,"MUNICIPIUL TÂRGOVIŞTE",65342,1,PART,PRCNCT,PRSD,PRSD_SV,"2025-05-18 21:17:44",1223,566,493,73,0,559,7,1340,774,249,310
16,DÂMBOVIŢA,"LICEUL TEHNOLOGIC ”NICOLAE CIORĂNESCU”",46,"MUNICIPIUL TÂRGOVIŞTE",65342,1,PART,PRCNCT,PRSD,PRSD_SV,"2025-05-18 22:27:23",1084,656,594,60,2,648,8,1208,552,180,468
16,DÂMBOVIŢA,"LICEUL TEHNOLOGIC ”NICOLAE CIORĂNESCU”",47,"MUNICIPIUL TÂRGOVIŞTE",65342,1,PART,PRCNCT,PRSD,PRSD_SV,"2025-05-18 21:47:05",763,387,344,43,0,378,9,840,453,125,253
16,DÂMBOVIŢA,"LICEUL TEHNOLOGIC ”NICOLAE CIORĂNESCU”",48,"MUNICIPIUL TÂRGOVIŞTE",65342,1,PART,PRCNCT,PRSD,PRSD_SV,"2025-05-18 21:59:12",729,402,340,62,0,394,8,800,398,150,244
16,DÂMBOVIŢA,"ȘCOALA GIMNAZIALĂ ”MIHAI VITEAZUL”",49,"MUNICIPIUL TÂRGOVIŞTE",65342,1,PART,PRCNCT,PRSD,PRSD_SV,"2025-05-18 21:36:44",1472,608,502,106,0,599,9,1610,1002,249,350
16,DÂMBOVIŢA,"ȘCOALA GIMNAZIALĂ ”MIHAI VITEAZUL”",50,"MUNICIPIUL TÂRGOVIŞTE",65342,1,PART,PRCNCT,PRSD,PRSD_SV,"2025-05-18 21:21:41",1100,570,524,45,1,563,7,1200,630,238,325
16,DÂMBOVIŢA,"COLEGIUL NAȚIONAL PEDAGOGIC ”CONSTANTIN CANTACUZINO”",51,"MUNICIPIUL TÂRGOVIŞTE",65342,1,PART,PRCNCT,PRSD,PRSD_SV,"2025-05-18 21:42:55",1228,526,478,48,0,513,13,1350,824,299,214
16,DÂMBOVIŢA,"COLEGIUL NAȚIONAL PEDAGOGIC ”CONSTANTIN CANTACUZINO”",52,"MUNICIPIUL TÂRGOVIŞTE",65342,1,PART,PRCNCT,PRSD,PRSD_SV,"2025-05-18 22:04:04",1367,736,656,80,0,722,14,1490,754,297,425
16,DÂMBOVIŢA,"COLEGIUL NAȚIONAL PEDAGOGIC ”CONSTANTIN CANTACUZINO”",53,"MUNICIPIUL TÂRGOVIŞTE",65342,1,PART,PRCNCT,PRSD,PRSD_SV,"2025-05-18 21:47:49",656,336,286,50,0,327,9,720,384,150,177
16,DÂMBOVIŢA,"COLEGIUL NAȚIONAL PEDAGOGIC ”CONSTANTIN CANTACUZINO”",54,"MUNICIPIUL TÂRGOVIŞTE",65342,1,PART,PRCNCT,PRSD,PRSD_SV,"2025-05-18 21:39:56",728,372,344,28,0,365,7,800,428,167,198
16,DÂMBOVIŢA,"ȘCOALA GIMNAZIALĂ ”GRIGORE ALEXANDRESCU”",55,"MUNICIPIUL TÂRGOVIŞTE",65342,1,PART,PRCNCT,PRSD,PRSD_SV,"2025-05-18 21:35:31",1298,570,511,59,0,562,8,1410,840,292,270
16,DÂMBOVIŢA,"ȘCOALA GIMNAZIALĂ ”GRIGORE ALEXANDRESCU”",56,"MUNICIPIUL TÂRGOVIŞTE",65342,1,PART,PRCNCT,PRSD,PRSD_SV,"2025-05-18 22:06:02",1202,580,533,47,0,568,12,1310,730,269,299
16,DÂMBOVIŢA,"ȘCOALA GIMNAZIALĂ ”GRIGORE ALEXANDRESCU”",57,"MUNICIPIUL TÂRGOVIŞTE",65342,1,PART,PRCNCT,PRSD,PRSD_SV,"2025-05-18 21:30:16",742,361,346,15,0,353,8,810,449,153,200
16,DÂMBOVIŢA,"ȘCOALA GIMNAZIALĂ ”GRIGORE ALEXANDRESCU”",58,"MUNICIPIUL TÂRGOVIŞTE",65342,1,PART,PRCNCT,PRSD,PRSD_SV,"2025-05-18 21:26:43",714,373,349,24,0,368,5,790,417,161,207
16,DÂMBOVIŢA,"GRĂDINIȚA CU PROGRAM PRELUNGIT ”ALEXANDRINA SIMIONESCU-GHICA”",59,"MUNICIPIUL TÂRGOVIŞTE",65342,1,PART,PRCNCT,PRSD,PRSD_SV,"2025-05-18 21:55:55",427,280,246,34,0,275,5,470,190,117,158
16,DÂMBOVIŢA,"ȘCOALA GIMNAZIALĂ ”SMARANDA GHEORGHIU”",60,"MUNICIPIUL TÂRGOVIŞTE",65342,1,PART,PRCNCT,PRSD,PRSD_SV,"2025-05-18 21:47:28",1414,778,681,97,0,754,24,1550,772,316,438
16,DÂMBOVIŢA,"ȘCOALA GIMNAZIALĂ ”SMARANDA GHEORGHIU”",61,"MUNICIPIUL TÂRGOVIŞTE",65342,1,PART,PRCNCT,PRSD,PRSD_SV,"2025-05-18 21:53:14",1239,714,615,99,0,697,17,1360,646,303,394
16,DÂMBOVIŢA,"ȘCOALA GIMNAZIALĂ ”SMARANDA GHEORGHIU”",62,"MUNICIPIUL TÂRGOVIŞTE",65342,1,PART,PRCNCT,PRSD,PRSD_SV,"2025-05-18 21:59:03",1476,788,727,61,0,779,9,1590,802,329,450
16,DÂMBOVIŢA,"ȘCOALA GIMNAZIALĂ ”SMARANDA GHEORGHIU”",63,"MUNICIPIUL TÂRGOVIŞTE",65342,1,PART,PRCNCT,PRSD,PRSD_SV,"2025-05-18 22:42:50",1671,862,816,44,2,845,17,1820,958,478,367
16,DÂMBOVIŢA,"CĂMINUL CULTURAL ”MATEI VOIEVOD”",64,"MUNICIPIUL TÂRGOVIŞTE",65342,1,PART,PRCNCT,PRSD,PRSD_SV,"2025-05-18 21:44:52",1395,758,720,38,0,746,12,1520,762,344,402
16,DÂMBOVIŢA,"GRĂDINIȚA CU PROGRAM NORMAL NR. 11 ”PRISEACA”",65,"MUNICIPIUL TÂRGOVIŞTE",65342,1,PART,PRCNCT,PRSD,PRSD_SV,"2025-05-18 22:05:18",1202,716,658,58,0,708,8,1310,594,309,399
16,DÂMBOVIŢA,"ŞCOALA GIMNAZIALĂ NR.2",66,"MUNICIPIUL MORENI",65841,1,PART,PRCNCT,PRSD,PRSD_SV,"2025-05-18 21:47:32",1028,519,480,39,0,516,3,1130,611,334,182
16,DÂMBOVIŢA,"CLUB CRISTIAN ( UZINA AUTOMECANICĂ MORENI )",67,"MUNICIPIUL MORENI",65841,2,PART,PRCNCT,PRSD,PRSD_SV,"2025-05-18 23:50:08",651,347,320,27,0,341,6,720,373,173,168
16,DÂMBOVIŢA,"GRĂDINIŢA CU PROGRAM NORMAL NR.7 ŢUICANI",68,"MUNICIPIUL MORENI",65841,1,PART,PRCNCT,PRSD,PRSD_SV,"2025-05-18 21:19:39",365,180,167,13,0,175,5,400,220,95,80
16,DÂMBOVIŢA,"GRĂDINIŢA CU PROGRAM NORMAL NR.2",69,"MUNICIPIUL MORENI",65841,1,PART,PRCNCT,PRSD,PRSD_SV,"2025-05-18 21:33:00",696,404,357,47,0,402,2,770,366,130,272
16,DÂMBOVIŢA,"CLUB FLACĂRA NR.2",70,"MUNICIPIUL MORENI",65841,1,PART,PRCNCT,PRSD,PRSD_SV,"2025-05-18 21:44:38",774,464,415,49,0,456,8,850,386,154,302
16,DÂMBOVIŢA,"GRĂDINIŢA CU PROGRAM NORMAL TISA",71,"MUNICIPIUL MORENI",65841,1,PART,PRCNCT,PRSD,PRSD_SV,"2025-05-18 21:42:19",517,342,304,37,1,340,2,570,228,116,224
16,DÂMBOVIŢA,"ŞCOALA GIMNAZIALĂ NR.3",72,"MUNICIPIUL MORENI",65841,1,PART,PRCNCT,PRSD,PRSD_SV,"2025-05-18 21:53:05",1225,679,653,26,0,670,9,1340,661,229,441
16,DÂMBOVIŢA,"ŞCOALA GIMNAZIALĂ NR.3",73,"MUNICIPIUL MORENI",65841,1,PART,PRCNCT,PRSD,PRSD_SV,"2025-05-18 21:21:58",713,366,310,56,0,359,7,780,414,123,236
16,DÂMBOVIŢA,"ŞCOALA GIMNAZIALĂ NR.3",74,"MUNICIPIUL MORENI",65841,1,PART,PRCNCT,PRSD,PRSD_SV,"2025-05-18 21:25:04",675,359,332,25,2,354,5,740,381,107,247
16,DÂMBOVIŢA,"ŞCOALA GIMNAZIALĂ NR.3",75,"MUNICIPIUL MORENI",65841,1,PART,PRCNCT,PRSD,PRSD_SV,"2025-05-18 21:44:01",918,467,441,15,11,464,3,1010,543,169,295
16,DÂMBOVIŢA,"ŞCOALA GIMNAZIALĂ NR.3",76,"MUNICIPIUL MORENI",65841,1,PART,PRCNCT,PRSD,PRSD_SV,"2025-05-18 21:42:26",920,456,445,10,1,450,6,1030,574,163,287
16,DÂMBOVIŢA,"ŞCOALA GIMNAZIALĂ NR.4",77,"MUNICIPIUL MORENI",65841,1,PART,PRCNCT,PRSD,PRSD_SV,"2025-05-18 21:29:25",884,441,423,18,0,425,16,970,529,161,264
16,DÂMBOVIŢA,"ŞCOALA GIMNAZIALĂ NR.4",78,"MUNICIPIUL MORENI",65841,1,PART,PRCNCT,PRSD,PRSD_SV,"2025-05-18 21:49:52",604,285,267,18,0,281,4,670,385,131,150
16,DÂMBOVIŢA,"ŞCOALA GIMNAZIALĂ NR.4",79,"MUNICIPIUL MORENI",65841,1,PART,PRCNCT,PRSD,PRSD_SV,"2025-05-18 21:26:38",816,432,386,46,0,421,11,900,468,207,214
16,DÂMBOVIŢA,"ŞCOALA GIMNAZIALĂ NR.4",80,"MUNICIPIUL MORENI",65841,1,PART,PRCNCT,PRSD,PRSD_SV,"2025-05-18 21:25:49",861,468,415,53,0,458,10,950,482,159,299
16,DÂMBOVIŢA,"ŞCOALA GIMNAZIALĂ NR.4",81,"MUNICIPIUL MORENI",65841,1,PART,PRCNCT,PRSD,PRSD_SV,"2025-05-18 21:32:08",779,387,366,21,0,386,1,860,473,141,245
16,DÂMBOVIŢA,"SALA DE SPORT",82,"MUNICIPIUL MORENI",65841,1,PART,PRCNCT,PRSD,PRSD_SV,"2025-05-18 21:33:28",676,373,338,34,1,367,6,740,367,173,194
16,DÂMBOVIŢA,"SALA DE SPORT",83,"MUNICIPIUL MORENI",65841,1,PART,PRCNCT,PRSD,PRSD_SV,"2025-05-18 21:36:17",638,334,308,26,0,329,5,700,366,168,161
16,DÂMBOVIŢA,"LICEUL TEORETIC ”ION LUCA CARAGIALE”",84,"MUNICIPIUL MORENI",65841,1,PART,PRCNCT,PRSD,PRSD_SV,"2025-05-18 21:51:41",650,423,326,64,33,409,14,720,297,177,232
16,DÂMBOVIŢA,"LICEUL TEHNOLOGIC DE PETROL",85,"MUNICIPIUL MORENI",65841,1,PART,PRCNCT,PRSD,PRSD_SV,"2025-05-18 21:42:29",1355,679,619,60,0,667,12,1470,791,350,317
16,DÂMBOVIŢA,"CENTRUL DE CULTURĂ ING. ”MIHAIL LUPESCU”",86,"ORAŞ FIENI",65609,1,PART,PRCNCT,PRSD,PRSD_SV,"2025-05-18 21:47:56",1512,790,698,91,1,782,8,1640,850,388,394
16,DÂMBOVIŢA,"GRUP ŞCOLAR INDUSTRIAL ”INGINER AUREL RAINU” FIENI",87,"ORAŞ FIENI",65609,1,PART,PRCNCT,PRSD,PRSD_SV,"2025-05-18 21:49:06",1355,576,535,41,0,569,7,1480,904,247,322
16,DÂMBOVIŢA,"GRUP ȘCOLAR INDUSTRIAL ”INGINER AUREL RAINU” FIENI",88,"ORAŞ FIENI",65609,1,PART,PRCNCT,PRSD,PRSD_SV,"2025-05-18 21:48:12",1465,742,662,78,2,732,10,1590,848,306,426
16,DÂMBOVIŢA,"GRĂDINIŢA ”DUMBRAVA MINUNATĂ” FIENI",89,"ORAŞ FIENI",65609,1,PART,PRCNCT,PRSD,PRSD_SV,"2025-05-18 21:21:22",555,222,195,26,1,221,1,600,378,112,109
16,DÂMBOVIŢA,"GRĂDINIȚA ”PITICII” BEREVOIEȘTI",90,"ORAŞ FIENI",65609,1,PART,PRCNCT,PRSD,PRSD_SV,"2025-05-18 21:35:42",526,295,248,46,1,293,2,580,285,144,149
16,DÂMBOVIŢA,"GRĂDINIȚA ”PINOCHIO” COSTEȘTI",91,"ORAŞ FIENI",65609,1,PART,PRCNCT,PRSD,PRSD_SV,"2025-05-18 21:37:33",625,332,290,42,0,323,9,680,348,147,176
16,DÂMBOVIŢA,"ȘCOALA GIMNAZIALĂ NR.1",92,"ORAŞ GĂEŞTI",65681,1,PART,PRCNCT,PRSD,PRSD_SV,"2025-05-18 22:21:46",897,686,481,105,100,677,9,1120,434,387,290
16,DÂMBOVIŢA,"ȘCOALA GIMNAZIALĂ NR.1",93,"ORAŞ GĂEŞTI",65681,1,PART,PRCNCT,PRSD,PRSD_SV,"2025-05-18 22:07:00",868,604,458,45,101,596,8,1080,476,305,291
16,DÂMBOVIŢA,"LICEUL TEHNOLOGIC ” DOCTOR CONSTANTIN ANGELESCU”",94,"ORAŞ GĂEŞTI",65681,2,PART,PRCNCT,PRSD,PRSD_SV,"2025-05-19 01:59:28",1146,790,604,87,99,775,15,1390,600,375,400
16,DÂMBOVIŢA,"COLEGIUL NAȚIONAL ” VLADIMIR STREINU”",95,"ORAŞ GĂEŞTI",65681,1,PART,PRCNCT,PRSD,PRSD_SV,"2025-05-18 22:31:45",1474,909,777,132,0,899,10,1610,701,413,486
16,DÂMBOVIŢA,"ȘCOALA GIMNAZIALĂ ”ȘERBAN CIOCULESCU”",96,"ORAŞ GĂEŞTI",65681,1,PART,PRCNCT,PRSD,PRSD_SV,"2025-05-18 21:58:16",1218,720,594,126,0,709,11,1330,610,338,371
16,DÂMBOVIŢA,"ȘCOALA GIMNAZIALĂ ”ȘERBAN CIOCULESCU”",97,"ORAŞ GĂEŞTI",65681,1,PART,PRCNCT,PRSD,PRSD_SV,"2025-05-18 21:44:07",774,424,379,45,0,417,7,850,426,233,184
16,DÂMBOVIŢA,"ȘCOALA GIMNAZIALĂ ”ȘERBAN CIOCULESCU”",98,"ORAŞ GĂEŞTI",65681,1,PART,PRCNCT,PRSD,PRSD_SV,"2025-05-18 21:51:06",1051,513,480,30,3,502,11,1160,647,260,242
16,DÂMBOVIŢA,"ȘCOALA GIMNAZIALĂ ”ȘERBAN CIOCULESCU”",99,"ORAŞ GĂEŞTI",65681,1,PART,PRCNCT,PRSD,PRSD_SV,"2025-05-18 21:47:58",1188,620,590,30,0,602,18,1300,680,264,338
16,DÂMBOVIŢA,"ȘCOALA GIMNAZIALĂ ”RADU CEL MARE”",100,"ORAŞ GĂEŞTI",65681,1,PART,PRCNCT,PRSD,PRSD_SV,"2025-05-18 21:52:24",581,429,290,139,0,426,3,640,211,201,225
16,DÂMBOVIŢA,"ȘCOALA GIMNAZIALĂ ”RADU CEL MARE”",101,"ORAŞ GĂEŞTI",65681,1,PART,PRCNCT,PRSD,PRSD_SV,"2025-05-18 22:11:53",1143,671,626,45,0,650,21,1250,579,263,387
16,DÂMBOVIŢA,"ȘCOALA GIMNAZIALĂ ”RADU CEL MARE”",102,"ORAŞ GĂEŞTI",65681,1,PART,PRCNCT,PRSD,PRSD_SV,"2025-05-18 22:31:49",1552,908,852,56,0,889,19,1690,782,390,499
16,DÂMBOVIŢA,"ȘCOALA GENERALĂ NR.2 PUCIOASA",103,"ORAŞ PUCIOASA",65921,1,PART,PRCNCT,PRSD,PRSD_SV,"2025-05-18 21:43:32",1233,702,620,77,5,692,10,1350,648,238,454
16,DÂMBOVIŢA,"ȘCOALA GIMNAZIALĂ ”MIHAI VITEAZUL” PUCIOASA",104,"ORAŞ PUCIOASA",65921,1,PART,PRCNCT,PRSD,PRSD_SV,"2025-05-18 21:48:01",968,723,497,223,3,707,16,1070,347,229,478
16,DÂMBOVIŢA,"ȘCOALA GIMNAZIALĂ ”MIHAI VITEAZUL” PUCIOASA",105,"ORAŞ PUCIOASA",65921,1,PART,PRCNCT,PRSD,PRSD_SV,"2025-05-18 21:52:58",1158,750,560,190,0,740,10,1260,510,374,366
16,DÂMBOVIŢA,"ȘCOALA GIMNAZIALĂ NR. 1 „MIHAI VITEAZUL” PUCIOASA",106,"ORAŞ PUCIOASA",65921,1,PART,PRCNCT,PRSD,PRSD_SV,"2025-05-18 21:42:38",798,507,379,127,1,497,10,880,373,153,344
16,DÂMBOVIŢA,"ȘCOALA GIMNAZIALĂ ”DONICI ELENA CANTACUZINO” PUCIOASA",107,"ORAŞ PUCIOASA",65921,1,PART,PRCNCT,PRSD,PRSD_SV,"2025-05-18 21:50:48",1227,694,565,96,33,681,13,1340,646,257,424
16,DÂMBOVIŢA,"COLEGIUL NAȚIONAL ”NICOLAE TITULESCU””",108,"ORAŞ PUCIOASA",65921,1,PART,PRCNCT,PRSD,PRSD_SV,"2025-05-18 22:05:54",1123,651,557,62,32,641,10,1230,579,253,388
16,DÂMBOVIŢA,"COLEGIUL NATIONAL „NICOLAE TITULESCU”",109,"ORAŞ PUCIOASA",65921,1,PART,PRCNCT,PRSD,PRSD_SV,"2025-05-18 21:59:19",1031,568,498,66,4,561,7,1140,572,176,385
16,DÂMBOVIŢA,"CENTRUL DE ZI DE SOCIALIZARE ȘI PETRECERE A TIMPULUI LIBER - TIP CLUB",110,"ORAŞ PUCIOASA",65921,1,PART,PRCNCT,PRSD,PRSD_SV,"2025-05-18 21:29:47",1090,556,514,41,1,543,13,1200,644,231,312
16,DÂMBOVIŢA,"ȘCOALA GIMNAZIALĂ NR. 3 PUCIOASA",111,"ORAŞ PUCIOASA",65921,1,PART,PRCNCT,PRSD,PRSD_SV,"2025-05-18 21:29:21",1176,580,541,39,0,568,12,1290,710,256,312
16,DÂMBOVIŢA,"GRĂDINIȚA DIACONEȘTI NR.9",112,"ORAŞ PUCIOASA",65921,1,PART,PRCNCT,PRSD,PRSD_SV,"2025-05-18 21:33:25",815,478,431,46,1,471,7,900,422,177,294
16,DÂMBOVIŢA,"GRADINITA DE COPII CU PROGRAM PRELUNGIT NR.5 ”PARADISUL PITICILOR”",113,"ORAŞ PUCIOASA",65921,1,PART,PRCNCT,PRSD,PRSD_SV,"2025-05-18 21:37:53",1050,564,508,56,0,555,9,1160,596,268,287
16,DÂMBOVIŢA,"ȘCOALA GIMNAZIALĂ MALURI",114,"ORAŞ PUCIOASA",65921,1,PART,PRCNCT,PRSD,PRSD_SV,"2025-05-18 21:17:03",89,72,50,22,0,72,0,100,28,41,31
16,DÂMBOVIŢA,"ȘCOALA GIMNAZIALĂ PUCIOASA-SAT",115,"ORAŞ PUCIOASA",65921,1,PART,PRCNCT,PRSD,PRSD_SV,"2025-05-18 21:41:54",332,197,173,24,0,194,3,370,173,94,100
16,DÂMBOVIŢA,"LICEUL TEORETIC ”ION GHICA” RĂCARI",116,"ORAŞ RĂCARI",68627,1,PART,PRCNCT,PRSD,PRSD_SV,"2025-05-18 21:41:34",792,618,448,159,11,611,7,870,252,323,288
16,DÂMBOVIŢA,"LICEUL TEORETIC” ION GHICA” RACARI",117,"ORAŞ RĂCARI",68627,1,PART,PRCNCT,PRSD,PRSD_SV,"2025-05-18 21:58:36",813,562,453,101,8,554,8,900,338,309,245
16,DÂMBOVIŢA,"GRĂDINȚA CU PROGRAM NORMAL COLACU",118,"ORAŞ RĂCARI",68627,2,PART,PRCNCT,PRSD,PRSD_SV,"2025-05-19 02:21:01",692,454,336,115,3,450,4,760,306,293,157
16,DÂMBOVIŢA,"ȘCOALA GENERALĂ GHERGANI",119,"ORAŞ RĂCARI",68627,2,PART,PRCNCT,PRSD,PRSD_SV,"2025-05-19 02:22:49",557,403,290,96,17,399,4,610,207,206,193
16,DÂMBOVIŢA,"CĂMINUL CULTURAL GHIMPAȚI",120,"ORAŞ RĂCARI",68627,1,PART,PRCNCT,PRSD,PRSD_SV,"2025-05-18 21:48:56",620,530,364,161,5,523,7,680,150,289,234
16,DÂMBOVIŢA,"GRĂDINIȚA MAVRODIN",121,"ORAŞ RĂCARI",68627,1,PART,PRCNCT,PRSD,PRSD_SV,"2025-05-18 21:38:22",803,469,379,87,3,467,2,880,411,306,161
16,DÂMBOVIŢA,"GRĂDINIȚA SĂBIEȘTI",122,"ORAŞ RĂCARI",68627,1,PART,PRCNCT,PRSD,PRSD_SV,"2025-05-18 21:34:35",573,405,282,111,12,398,7,630,225,235,163
16,DÂMBOVIŢA,"ȘCOALA GIMNAZIALA NR. 2 TITU",123,"ORAŞ TITU",66081,3,PART,PRCNCT,PRSD,PRSD_SV,"2025-05-19 02:14:23",1214,732,590,140,2,725,7,1330,598,450,275
16,DÂMBOVIŢA,"ȘCOALA GIMNAZIALA NR. 2 TITU",124,"ORAŞ TITU",66081,1,PART,PRCNCT,PRSD,PRSD_SV,"2025-05-18 21:41:29",1004,530,482,47,1,521,9,1110,580,361,160
16,DÂMBOVIŢA,"ȘCOALA SĂLCUȚA",125,"ORAŞ TITU",66081,1,PART,PRCNCT,PRSD,PRSD_SV,"2025-05-18 21:42:03",1044,608,530,78,0,606,2,1150,542,419,187
16,DÂMBOVIŢA,"ȘCOALA GIMNAZIALA PICTOR NICOLAE GRIGORESCU",126,"ORAŞ TITU",66081,1,PART,PRCNCT,PRSD,PRSD_SV,"2025-05-18 21:48:07",1260,868,713,153,2,860,8,1370,502,384,476
16,DÂMBOVIŢA,"LICEUL TEORETIC IANCU C.VISARION",127,"ORAŞ TITU",66081,1,PART,PRCNCT,PRSD,PRSD_SV,"2025-05-18 21:53:30",1044,630,560,70,0,626,4,1150,520,326,300
16,DÂMBOVIŢA,"LICEUL TEORETIC IANCU .C.VISARION",128,"ORAŞ TITU",66081,1,PART,PRCNCT,PRSD,PRSD_SV,"2025-05-18 21:45:26",1169,667,594,73,0,662,5,1270,603,337,325
16,DÂMBOVIŢA,"LICEUL TEORETIC IANCU .C.VISARION",129,"ORAŞ TITU",66081,1,PART,PRCNCT,PRSD,PRSD_SV,"2025-05-18 21:58:42",1382,851,796,54,1,839,12,1500,649,410,429
16,DÂMBOVIŢA,"ŞCOALA ANINOASA",130,ANINOASA,65379,1,PART,PRCNCT,PRSD,PRSD_SV,"2025-05-18 21:50:07",1080,667,587,80,0,656,11,1190,523,267,389
16,DÂMBOVIŢA,"ŞCOALA ANINOASA",131,ANINOASA,65379,1,PART,PRCNCT,PRSD,PRSD_SV,"2025-05-18 21:41:06",1005,577,502,75,0,568,9,1100,523,252,316
16,DÂMBOVIŢA,"ŞCOALA SĂTENI",132,ANINOASA,65379,1,PART,PRCNCT,PRSD,PRSD_SV,"2025-05-18 21:54:45",1257,682,611,69,2,672,10,1370,688,305,367
16,DÂMBOVIŢA,"ŞCOALA NOUĂ VIFORÂTA",133,ANINOASA,65379,1,PART,PRCNCT,PRSD,PRSD_SV,"2025-05-18 21:37:42",1031,651,559,90,2,643,8,1140,489,280,363
16,DÂMBOVIŢA,"ŞCOALA NOUĂ VIFORÂTA",134,ANINOASA,65379,1,PART,PRCNCT,PRSD,PRSD_SV,"2025-05-18 21:58:06",1184,751,661,90,0,743,8,1300,549,337,406
16,DÂMBOVIŢA,"ŞCOALA PROFESIONALĂ BĂLENI",135,BĂLENI,66198,1,PART,PRCNCT,PRSD,PRSD_SV,"2025-05-18 22:38:10",1468,819,754,65,0,814,5,1590,771,460,354
16,DÂMBOVIŢA,"LICEUL TEHNOLOGIC UDREA BĂLEANU",136,BĂLENI,66198,1,PART,PRCNCT,PRSD,PRSD_SV,"2025-05-18 21:37:44",1502,652,610,42,0,642,10,1630,978,465,177
16,DÂMBOVIŢA,"LICEUL TEHNOLOGIC UDREA BĂLEANU",137,BĂLENI,66198,1,PART,PRCNCT,PRSD,PRSD_SV,"2025-05-18 21:36:57",890,489,452,37,0,486,3,990,501,293,193
16,DÂMBOVIŢA,"GĂDINIȚA CU PROGRAM NORMAL BĂLENI",138,BĂLENI,66198,1,PART,PRCNCT,PRSD,PRSD_SV,"2025-05-18 21:51:42",1393,708,681,27,0,703,5,1520,812,494,209
16,DÂMBOVIŢA,"GRĂDINIȚA CU PROGRAM NORMAL BĂLENI",139,BĂLENI,66198,1,PART,PRCNCT,PRSD,PRSD_SV,"2025-05-18 21:44:25",1498,699,677,22,0,690,9,1630,931,536,154
16,DÂMBOVIŢA,"AFTER SCHOOL BĂRBULEŢU",140,BĂRBULEŢU,66223,1,PART,PRCNCT,PRSD,PRSD_SV,"2025-05-18 21:42:14",1231,618,566,52,0,608,10,1350,732,391,217
16,DÂMBOVIŢA,"ŞCOALA GIMNAZIALĂ CU CLASELE I-VIII GURA BĂRBULEȚULUI",141,BĂRBULEŢU,66223,1,PART,PRCNCT,PRSD,PRSD_SV,"2025-05-18 21:45:01",465,334,256,77,1,326,8,510,176,201,125
16,DÂMBOVIŢA,"ȘCOALA GIMNAZIALĂ ”GRIGORE RĂDULESCU” BEZDEAD",142,BEZDEAD,66330,1,PART,PRCNCT,PRSD,PRSD_SV,"2025-05-18 21:37:25",1404,814,678,128,8,804,10,1530,716,347,457
16,DÂMBOVIŢA,"GRĂDINIȚA NR. 2 BEZDEAD",143,BEZDEAD,66330,1,PART,PRCNCT,PRSD,PRSD_SV,"2025-05-18 21:38:41",1304,676,598,77,1,667,9,1420,744,365,302
16,DÂMBOVIŢA,"GRĂDINIŢA MĂGURA",144,BEZDEAD,66330,1,PART,PRCNCT,PRSD,PRSD_SV,"2025-05-18 21:44:20",798,459,353,106,0,456,3,880,421,185,271
16,DÂMBOVIŢA,"CĂMINUL CULTURAL",145,BILCIUREŞTI,66401,1,PART,PRCNCT,PRSD,PRSD_SV,"2025-05-18 21:44:01",1478,985,795,189,1,976,9,1600,615,621,355
16,DÂMBOVIŢA,"ŞCOALA ”SPIRU HARET” BRANISTEA CLASELE I-VIII, SALA DE CLASA NR. 1",146,BRANIŞTEA,66152,1,PART,PRCNCT,PRSD,PRSD_SV,"2025-05-18 22:44:20",1169,665,591,74,0,661,4,1263,598,387,274
16,DÂMBOVIŢA,"ŞCOALA ”SPIRU HARET” BRANISTEA CLASELE I-VIII, SALA DE CLASA NR. 2",147,BRANIŞTEA,66152,1,PART,PRCNCT,PRSD,PRSD_SV,"2025-05-18 21:45:30",1019,583,514,69,0,578,5,1120,537,328,250
16,DÂMBOVIŢA,"GRĂDINIȚA DÂMBOVICIOARA",148,BRANIŞTEA,66152,1,PART,PRCNCT,PRSD,PRSD_SV,"2025-05-18 21:46:48",895,527,468,59,0,526,1,990,463,399,127
16,DÂMBOVIŢA,"CLĂDIREA ADMINISTRATIVĂ A CONSILIULUI LOCAL BRANIŞTEA",149,BRANIŞTEA,66152,1,PART,PRCNCT,PRSD,PRSD_SV,"2025-05-18 21:14:58",124,87,58,29,0,85,2,140,53,68,17
16,DÂMBOVIŢA,"CENTRUL DE CULTURĂ ŞI TRADIŢIE POPULARĂ BRĂNEŞTI",150,BRĂNEŞTI,66009,1,PART,PRCNCT,PRSD,PRSD_SV,"2025-05-18 21:49:57",1240,776,687,88,1,764,12,1350,574,291,473
16,DÂMBOVIŢA,"ŞCOALA GIMNAZIALĂ BRĂNEŞTI",151,BRĂNEŞTI,66009,1,PART,PRCNCT,PRSD,PRSD_SV,"2025-05-18 22:08:46",1406,757,683,74,0,749,8,1530,773,321,428
16,DÂMBOVIŢA,"GRĂDINIŢA CU PROGRAM NORMAL PRIBOIU",152,BRĂNEŞTI,66009,1,PART,PRCNCT,PRSD,PRSD_SV,"2025-05-18 22:23:29",781,495,441,54,0,486,9,860,365,192,294
16,DÂMBOVIŢA,"ȘCOALA GIMNAZIALĂ BREZOAELE",153,BREZOAELE,101341,1,PART,PRCNCT,PRSD,PRSD_SV,"2025-05-18 21:32:02",1051,780,608,172,0,769,11,1160,380,462,307
16,DÂMBOVIŢA,"ȘCOALA GIMNAZIALĂ BREZOAIA",154,BREZOAELE,101341,1,PART,PRCNCT,PRSD,PRSD_SV,"2025-05-18 21:30:10",773,496,432,64,0,490,6,850,354,296,194
16,DÂMBOVIŢA,"ȘCOALA GIMNAZIALĂ BREZOAIA",155,BREZOAELE,101341,1,PART,PRCNCT,PRSD,PRSD_SV,"2025-05-18 21:30:28",979,639,533,106,0,636,3,1080,441,407,229
16,DÂMBOVIŢA,"CAMIN CULTURAL",156,BUCIUMENI,66438,1,PART,PRCNCT,PRSD,PRSD_SV,"2025-05-18 21:50:53",1428,798,738,59,1,793,5,1560,762,359,434
16,DÂMBOVIŢA,"ṢCOALA GENERALĂ",157,BUCIUMENI,66438,3,PART,PRCNCT,PRSD,PRSD_SV,"2025-05-19 02:31:39",1087,563,512,51,0,556,7,1200,637,239,317
16,DÂMBOVIŢA,"CAMIN CULTURAL",158,BUCIUMENI,66438,1,PART,PRCNCT,PRSD,PRSD_SV,"2025-05-18 21:32:35",937,449,421,28,0,443,6,1030,581,326,117
16,DÂMBOVIŢA,"ȘCOALA GIMNAZIALĂ ”DORA DALLES” BUCȘANI",159,BUCŞANI,66474,1,PART,PRCNCT,PRSD,PRSD_SV,"2025-05-18 21:31:51",1441,868,769,83,16,859,9,1570,702,520,339
16,DÂMBOVIŢA,"ȘCOALA GIMNAZIALĂ ”DORA DALLES” BUCȘANI",160,BUCŞANI,66474,1,PART,PRCNCT,PRSD,PRSD_SV,"2025-05-18 21:38:55",1409,839,772,59,8,837,2,1530,691,499,338
16,DÂMBOVIŢA,"ȘCOALA GENERALĂ HĂBENI",161,BUCŞANI,66474,1,PART,PRCNCT,PRSD,PRSD_SV,"2025-05-18 21:52:06",1083,640,596,43,1,631,9,1200,560,349,282
16,DÂMBOVIŢA,"ȘCOALA GENERALĂ RACOVIȚA",162,BUCŞANI,66474,1,PART,PRCNCT,PRSD,PRSD_SV,"2025-05-18 21:38:43",1043,568,485,83,0,562,6,1150,582,334,228
16,DÂMBOVIŢA,"ȘCOALA GENERALĂ RĂȚOAIA",163,BUCŞANI,66474,1,PART,PRCNCT,PRSD,PRSD_SV,"2025-05-18 21:33:32",378,251,219,32,0,248,3,420,169,126,122
16,DÂMBOVIŢA,"GRĂDINIȚA CU PROGRAM NORMAL NUMĂRUL 1 BUTIMANU",164,BUTIMANU,101564,1,PART,PRCNCT,PRSD,PRSD_SV,"2025-05-18 21:44:13",1433,884,673,211,0,878,6,1540,656,560,318
16,DÂMBOVIŢA,"ȘCOALA GIMNAZIALĂ LUCIANCA",165,BUTIMANU,101564,1,PART,PRCNCT,PRSD,PRSD_SV,"2025-05-18 21:27:45",412,358,236,122,0,353,5,460,102,222,131
16,DÂMBOVIŢA,"CĂMIN CULTURAL CÎNDEȘTI VALE",166,CÂNDEŞTI,66526,1,PART,PRCNCT,PRSD,PRSD_SV,"2025-05-18 21:48:11",962,597,529,65,3,595,2,1040,443,301,294
16,DÂMBOVIŢA,"CĂMIN CULTURAL CÎNDEȘTI DEAL",167,CÂNDEŞTI,66526,1,PART,PRCNCT,PRSD,PRSD_SV,"2025-05-18 21:25:39",145,132,88,43,1,129,3,136,4,59,70
16,DÂMBOVIŢA,"CĂMINUL CULTURAL DRAGODĂNEȘTI",168,CÂNDEŞTI,66526,1,PART,PRCNCT,PRSD,PRSD_SV,"2025-05-18 21:41:04",641,331,298,32,1,330,1,700,369,163,167
16,DÂMBOVIŢA,"ȘCOALA CU CLASELE I-IV STURZENI",169,CÂNDEŞTI,66526,1,PART,PRCNCT,PRSD,PRSD_SV,"2025-05-18 21:29:24",360,271,192,79,0,268,3,400,129,137,131
16,DÂMBOVIŢA,"ȘCOALA CU CLASELE I-IV VALEA MARE",170,CÂNDEŞTI,66526,1,PART,PRCNCT,PRSD,PRSD_SV,"2025-05-18 21:18:48",87,90,59,31,0,88,2,100,10,44,44
16,DÂMBOVIŢA,"ȘCOALA CU CLASELE I-VIII CIOCĂNEȘTI",171,CIOCĂNEŞTI,101840,1,PART,PRCNCT,PRSD,PRSD_SV,"2025-05-18 21:35:58",779,484,365,119,0,480,4,850,366,343,137
16,DÂMBOVIŢA,"ȘCOALA CU CLASELE I - VIII CIOCĂNEȘTI",172,CIOCĂNEŞTI,101840,2,PART,PRCNCT,PRSD,PRSD_SV,"2025-05-19 02:15:38",953,543,445,98,0,539,4,1050,507,381,158
16,DÂMBOVIŢA,"GRĂDINIȚA DE COPII",173,CIOCĂNEŞTI,101840,1,PART,PRCNCT,PRSD,PRSD_SV,"2025-05-18 21:28:35",375,277,214,63,0,276,1,410,133,168,108
16,DÂMBOVIŢA,"ȘCOALA CU CLASELE I-VIII URZICEANCA",174,CIOCĂNEŞTI,101840,1,PART,PRCNCT,PRSD,PRSD_SV,"2025-05-18 21:39:27",1139,651,535,116,0,641,10,1240,589,441,200
16,DÂMBOVIŢA,"ȘCOALA CU CLASELE I-VIII VIZUREȘTI",175,CIOCĂNEŞTI,101840,1,PART,PRCNCT,PRSD,PRSD_SV,"2025-05-18 21:41:10",908,479,401,78,0,468,11,1000,521,384,84
16,DÂMBOVIŢA,"GRADINITA CU PROGRAM NORMAL GHERGHIŢEŞTI",176,COBIA,66580,1,PART,PRCNCT,PRSD,PRSD_SV,"2025-05-18 21:58:09",911,624,525,79,20,616,8,1010,386,330,286
16,DÂMBOVIŢA,"ŞCOALA FRASIN DEAL",177,COBIA,66580,1,PART,PRCNCT,PRSD,PRSD_SV,"2025-05-18 21:44:29",517,357,282,65,10,352,5,570,213,143,209
16,DÂMBOVIŢA,"ŞCOALA MĂNĂSTIREA",178,COBIA,66580,1,PART,PRCNCT,PRSD,PRSD_SV,"2025-05-18 21:26:16",399,256,221,25,10,251,5,440,184,156,95
16,DÂMBOVIŢA,"GRĂDINIŢA MISLEA",179,COBIA,66580,1,PART,PRCNCT,PRSD,PRSD_SV,"2025-05-18 21:26:26",606,388,318,63,7,374,14,670,282,206,168
16,DÂMBOVIŢA,"ŞCOALA GIMNAZIALĂ COJASCA",180,COJASCA,66697,1,PART,PRCNCT,PRSD,PRSD_SV,"2025-05-18 21:36:56",956,647,495,152,0,642,5,1050,403,455,187
16,DÂMBOVIŢA,"ŞCOALA GIMNAZIALĂ COJASCA",181,COJASCA,66697,1,PART,PRCNCT,PRSD,PRSD_SV,"2025-05-18 21:31:55",773,489,430,59,0,481,8,850,361,309,172
16,DÂMBOVIŢA,"ŞCOALA GIMNAZIALĂ FÎNTÎNELE",182,COJASCA,66697,1,PART,PRCNCT,PRSD,PRSD_SV,"2025-05-18 21:34:46",1099,249,200,49,0,246,3,1200,951,228,18
16,DÂMBOVIŢA,"ŞCOALA GIMNAZIALĂ FÎNTÎNELE",183,COJASCA,66697,1,PART,PRCNCT,PRSD,PRSD_SV,"2025-05-18 21:19:26",1016,184,162,22,0,180,4,1110,926,167,13
16,DÂMBOVIŢA,"ŞCOALA CU CLASELE I-IV IAZU",184,COJASCA,66697,1,PART,PRCNCT,PRSD,PRSD_SV,"2025-05-18 21:27:51",1127,545,520,25,0,535,10,1230,685,498,37
16,DÂMBOVIŢA,"ŞCOALA CU CLASELE I-IV IAZU",185,COJASCA,66697,1,PART,PRCNCT,PRSD,PRSD_SV,"2025-05-18 21:32:24",1084,570,559,11,0,562,8,1190,620,525,37
16,DÂMBOVIŢA,"CAMINUL CULTURAL COMISANI",186,COMIŞANI,66731,1,PART,PRCNCT,PRSD,PRSD_SV,"2025-05-18 21:39:51",1345,767,694,73,0,760,7,1460,693,395,365
16,DÂMBOVIŢA,"SCOALA GENERALA I-IV COMISANI(STR.HELESTEULUI NR.2)",187,COMIŞANI,66731,1,PART,PRCNCT,PRSD,PRSD_SV,"2025-05-18 22:02:01",1387,711,672,39,0,702,9,1510,799,446,256
16,DÂMBOVIŢA,"CAMINUL CULTURAL",188,COMIŞANI,66731,1,PART,PRCNCT,PRSD,PRSD_SV,"2025-05-18 22:00:49",1494,897,827,70,0,890,7,1630,733,451,439
16,DÂMBOVIŢA,"ŞCOALA CU CLASELE I-IV CONŢEŞTI, LOCALITATEA CONŢEŞTI, STRADA PRIMĂRIEI, NR. 444",189,CONŢEŞTI,66768,1,PART,PRCNCT,PRSD,PRSD_SV,"2025-05-18 21:24:44",694,435,324,111,0,430,5,770,335,284,146
16,DÂMBOVIŢA,"ŞCOALA CONŢEŞTI, LOCALITATEA CONŢEŞTI, STRADA GĂRII, NR. 192",190,CONŢEŞTI,66768,1,PART,PRCNCT,PRSD,PRSD_SV,"2025-05-18 21:21:11",442,323,199,124,0,322,1,490,167,196,126
16,DÂMBOVIŢA,"CĂMIN CULTURAL BĂLTENI, LOCALITATEA BĂLTENI, STRADA EROILOR, NR. 66",191,CONŢEŞTI,66768,1,PART,PRCNCT,PRSD,PRSD_SV,"2025-05-18 21:14:54",717,325,303,22,0,313,12,790,465,187,126
16,DÂMBOVIŢA,"GRĂDINIŢA BĂLTENI, LOCALITATEA BĂLTENI, STRADA EROILOR, NR. 235",192,CONŢEŞTI,66768,1,PART,PRCNCT,PRSD,PRSD_SV,"2025-05-18 21:25:51",762,443,336,107,0,437,6,840,397,297,140
16,DÂMBOVIŢA,"ŞCOALA CU CLASELE I-IV BOTENI, LOCALITATEA BOTENI, STRADA AEROPORTULUI, NR. 308G",193,CONŢEŞTI,66768,1,PART,PRCNCT,PRSD,PRSD_SV,"2025-05-18 21:17:05",716,429,344,85,0,426,3,790,361,348,78
16,DÂMBOVIŢA,"ŞCOALA GIMNAZIALĂ CORBII MARI",194,"CORBII MARI",66857,1,PART,PRCNCT,PRSD,PRSD_SV,"2025-05-18 22:08:46",1421,891,722,169,0,886,5,1550,659,534,352
16,DÂMBOVIŢA,"GRĂDINIŢA CU PROGRAM NORMAL BĂRĂCENI",195,"CORBII MARI",66857,1,PART,PRCNCT,PRSD,PRSD_SV,"2025-05-18 21:37:11",393,275,218,57,0,273,2,430,155,173,100
16,DÂMBOVIŢA,"ŞCOALA GIMNAZIALĂ GROZĂVEŞTI I",196,"CORBII MARI",66857,2,PART,PRCNCT,PRSD,PRSD_SV,"2025-05-19 02:10:28",650,271,233,38,0,265,6,720,449,196,69
16,DÂMBOVIŢA,"ŞCOALA PRIMARĂ NR. 2 GROZĂVEŞTI",197,"CORBII MARI",66857,1,PART,PRCNCT,PRSD,PRSD_SV,"2025-05-18 21:42:46",1087,623,522,101,0,613,10,1190,567,514,99
16,DÂMBOVIŢA,"ŞCOALA GIMNAZIALĂ PETREŞTI",198,"CORBII MARI",66857,1,PART,PRCNCT,PRSD,PRSD_SV,"2025-05-18 21:51:50",487,326,247,79,0,319,7,540,214,211,108
16,DÂMBOVIŢA,"ŞCOALA PRIMARĂ SATU NOU",199,"CORBII MARI",66857,1,PART,PRCNCT,PRSD,PRSD_SV,"2025-05-18 21:37:43",366,244,205,39,0,240,4,400,156,184,56
16,DÂMBOVIŢA,"GRĂDINIŢA CU PROGRAM NORMAL UNGURENI",200,"CORBII MARI",66857,1,PART,PRCNCT,PRSD,PRSD_SV,"2025-05-18 21:33:08",878,513,465,48,0,503,10,970,457,347,156
16,DÂMBOVIŢA,"ŞCOALA GIMNAZIALĂ NR. 1 UNGURENI",201,"CORBII MARI",66857,1,PART,PRCNCT,PRSD,PRSD_SV,"2025-05-18 21:52:35",656,428,340,88,0,425,3,720,292,240,185
16,DÂMBOVIŢA,"ŞCOALA PRIMARĂ VADU STANCHII",202,"CORBII MARI",66857,1,PART,PRCNCT,PRSD,PRSD_SV,"2025-05-18 21:50:07",363,264,192,72,0,260,4,400,136,192,68
16,DÂMBOVIŢA,"ŞCOALA CU CLASELE I - VIII CORNĂŢELU",203,CORNĂŢELU,66955,1,PART,PRCNCT,PRSD,PRSD_SV,"2025-05-18 21:22:19",282,286,154,132,0,282,4,310,24,132,150
16,DÂMBOVIŢA,"ŞCOALA CU CLASELE I - IV ALUNIŞU",204,CORNĂŢELU,66955,1,PART,PRCNCT,PRSD,PRSD_SV,"2025-05-18 21:13:10",290,150,123,27,0,149,1,320,170,109,40
16,DÂMBOVIŢA,"ŞCOALA CU CLASELE I - IV BOLOVANI",205,CORNĂŢELU,66955,1,PART,PRCNCT,PRSD,PRSD_SV,"2025-05-18 21:42:27",512,412,273,139,0,407,5,570,158,193,214
16,DÂMBOVIŢA,"ŞCOALA GIMNAZIALĂ CORNEŞTI",206,CORNEŞTI,67014,1,PART,PRCNCT,PRSD,PRSD_SV,"2025-05-18 22:18:59",1306,864,641,223,0,857,7,1420,556,506,351
16,DÂMBOVIŢA,"ŞCOALA PRIMARĂ BUJOREANCA",207,CORNEŞTI,67014,1,PART,PRCNCT,PRSD,PRSD_SV,"2025-05-18 21:29:47",355,300,185,115,0,300,0,390,90,174,126
16,DÂMBOVIŢA,"ŞCOALA GIMNAZIALĂ CĂTUNU",208,CORNEŞTI,67014,1,PART,PRCNCT,PRSD,PRSD_SV,"2025-05-18 21:42:34",658,514,329,185,0,504,10,730,216,278,226
16,DÂMBOVIŢA,"ŞCOALA PRIMARĂ CRIVĂŢU",209,CORNEŞTI,67014,1,PART,PRCNCT,PRSD,PRSD_SV,"2025-05-18 21:25:06",193,173,98,74,1,169,4,220,47,106,63
16,DÂMBOVIŢA,"ŞCOALA GIMNAZIALĂ FRASINU",210,CORNEŞTI,67014,1,PART,PRCNCT,PRSD,PRSD_SV,"2025-05-18 21:31:19",459,282,196,86,0,278,4,510,228,164,114
16,DÂMBOVIŢA,"ŞCOALA PRIMARĂ IBRIANU",211,CORNEŞTI,67014,1,PART,PRCNCT,PRSD,PRSD_SV,"2025-05-18 21:23:16",592,380,303,77,0,378,2,650,270,211,167
16,DÂMBOVIŢA,"ŞCOALA PRIMARĂ ”GRIGORE STĂNESCU” POSTÂRNACU",212,CORNEŞTI,67014,1,PART,PRCNCT,PRSD,PRSD_SV,"2025-05-18 21:32:41",637,430,330,100,0,426,4,700,270,214,212
16,DÂMBOVIŢA,"ŞCOALA PRIMARĂ UNGURENI",213,CORNEŞTI,67014,1,PART,PRCNCT,PRSD,PRSD_SV,"2025-05-18 21:54:26",661,453,369,84,0,448,5,730,277,265,183
16,DÂMBOVIŢA,"GRĂDINIȚA CU PROGRAM NORMAL NR. 1 COSTEȘTII DIN VALE",214,"COSTEŞTII DIN VALE",67121,1,PART,PRCNCT,PRSD,PRSD_SV,"2025-05-18 21:36:50",403,247,215,32,0,244,3,450,203,176,68
16,DÂMBOVIŢA,"CĂMIN CULTURAL",215,"COSTEŞTII DIN VALE",67121,1,PART,PRCNCT,PRSD,PRSD_SV,"2025-05-18 22:30:24",1248,635,577,58,0,634,1,1360,725,532,102
16,DÂMBOVIŢA,"ȘCOALA GIMNAZIALĂ TOMȘANI",216,"COSTEŞTII DIN VALE",67121,1,PART,PRCNCT,PRSD,PRSD_SV,"2025-05-18 22:26:48",956,534,460,73,1,527,7,1050,516,336,191
16,DÂMBOVIŢA,"ŞCOALA GENERALĂ BĂDULEŞTI",217,CRÂNGURILE,67167,1,PART,PRCNCT,PRSD,PRSD_SV,"2025-05-18 21:43:57",1125,738,583,155,0,732,6,1230,492,427,305
16,DÂMBOVIŢA,"ŞCOALA GIMNAZIALĂ PĂTROAIA VALE",218,CRÂNGURILE,67167,1,PART,PRCNCT,PRSD,PRSD_SV,"2025-05-18 21:31:26",906,442,356,86,0,440,2,1000,558,291,149
16,DÂMBOVIŢA,"ŞCOALA PRIMARĂ VOIA",219,CRÂNGURILE,67167,1,PART,PRCNCT,PRSD,PRSD_SV,"2025-05-18 21:29:57",682,294,271,23,0,292,2,750,456,277,15
16,DÂMBOVIŢA,"ŞCOALA GENERALĂ CREVEDIA",220,CREVEDIA,102286,1,PART,PRCNCT,PRSD,PRSD_SV,"2025-05-18 21:42:27",1286,1023,713,310,0,1010,13,1400,377,591,419
16,DÂMBOVIŢA,"CĂMIN CULTURAL",221,CREVEDIA,102286,1,PART,PRCNCT,PRSD,PRSD_SV,"2025-05-18 21:48:00",682,661,383,278,0,644,17,740,79,292,352
16,DÂMBOVIŢA,"ŞCOALA CU CLASELE I-IV",222,CREVEDIA,102286,1,PART,PRCNCT,PRSD,PRSD_SV,"2025-05-18 21:36:03",409,353,207,146,0,349,4,450,97,238,111
16,DÂMBOVIŢA,"ŞCOALA GIMNAZIALĂ DÂRZA",223,CREVEDIA,102286,1,PART,PRCNCT,PRSD,PRSD_SV,"2025-05-18 22:36:31",1571,1571,939,632,0,1550,21,1710,139,667,883
16,DÂMBOVIŢA,"GRĂDINIŢA CU PROGRAM NORMAL",224,CREVEDIA,102286,1,PART,PRCNCT,PRSD,PRSD_SV,"2025-05-18 23:19:42",1458,1503,859,644,0,1490,13,1680,177,713,777
16,DÂMBOVIŢA,"ȘCOALA DĂRMĂNEȘTI",225,DĂRMĂNEŞTI,67256,1,PART,PRCNCT,PRSD,PRSD_SV,"2025-05-18 22:36:52",1324,790,698,92,0,778,12,1440,650,445,333
16,DÂMBOVIŢA,"ȘCOALA GIMNAZIALĂ DĂRMĂNEȘTI",226,DĂRMĂNEŞTI,67256,1,PART,PRCNCT,PRSD,PRSD_SV,"2025-05-18 22:13:29",1535,855,800,55,0,841,14,1670,815,497,344
16,DÂMBOVIŢA,"ȘCOALA MĂRGINENII DE SUS",227,DĂRMĂNEŞTI,67256,1,PART,PRCNCT,PRSD,PRSD_SV,"2025-05-18 21:43:46",880,603,508,95,0,594,9,970,367,368,226
16,DÂMBOVIŢA,"ȘCOALA PREOT PANAIT GEORGESCU",228,DOBRA,67292,1,PART,PRCNCT,PRSD,PRSD_SV,"2025-05-18 21:59:51",1423,904,794,107,3,893,11,1550,646,473,420
16,DÂMBOVIŢA,"ȘCOALA ÎNVĂȚĂTOR IULIAN RUSU",229,DOBRA,67292,1,PART,PRCNCT,PRSD,PRSD_SV,"2025-05-18 21:33:10",1452,857,763,94,0,850,7,1580,723,476,374
16,DÂMBOVIŢA,"GRĂDINIȚA CU PROGRAM NORMAL, NR.1",230,DOICEŞTI,65413,1,PART,PRCNCT,PRSD,PRSD_SV,"2025-05-18 21:58:52",1519,754,687,67,0,742,12,1650,896,430,312
16,DÂMBOVIŢA,"GRĂDINIŢA CU PROGRAM NORMAL NR.2",231,DOICEŞTI,65413,1,PART,PRCNCT,PRSD,PRSD_SV,"2025-05-18 22:02:27",1542,828,764,64,0,820,8,1680,852,413,407
16,DÂMBOVIŢA,"GRĂDINIȚA CU PROGRAM NORMAL NR. 3 DOICEȘTI",232,DOICEŞTI,65413,1,PART,PRCNCT,PRSD,PRSD_SV,"2025-05-18 21:36:55",814,443,392,51,0,437,6,900,457,209,228
16,DÂMBOVIŢA,"ȘCOALA DRAGODANA",233,DRAGODANA,67327,1,PART,PRCNCT,PRSD,PRSD_SV,"2025-05-18 23:00:58",1268,656,559,97,0,645,11,1370,714,360,285
16,DÂMBOVIŢA,"ȘCOALA BURDUCA",234,DRAGODANA,67327,1,PART,PRCNCT,PRSD,PRSD_SV,"2025-05-18 21:33:12",958,541,473,68,0,533,8,1060,519,299,234
16,DÂMBOVIŢA,"GRĂDINIȚA PICIOR DE MUNTE",235,DRAGODANA,67327,1,PART,PRCNCT,PRSD,PRSD_SV,"2025-05-18 21:40:28",1413,766,725,41,0,757,9,1540,774,510,247
16,DÂMBOVIŢA,"ȘCOALA NR.2 PICIOR DE MUNTE - BOBOCI",236,DRAGODANA,67327,1,PART,PRCNCT,PRSD,PRSD_SV,"2025-05-18 21:35:24",1060,589,552,37,0,580,9,1170,581,385,195
16,DÂMBOVIŢA,"ȘCOALA NR.2 PICIOR DE MUNTE - BOBOCI",237,DRAGODANA,67327,1,PART,PRCNCT,PRSD,PRSD_SV,"2025-05-18 21:26:53",709,383,328,55,0,377,6,780,397,207,170
16,DÂMBOVIŢA,"ŞCOALA GIMNAZIALĂ DRAGOMIREŞTI",238,DRAGOMIREŞTI,67407,1,PART,PRCNCT,PRSD,PRSD_SV,"2025-05-18 22:21:05",1798,1007,914,93,0,995,12,1960,953,581,414
16,DÂMBOVIŢA,"ŞCOALA GIMNAZIALĂ DECINDENI –DRAGOMIREŞTI",239,DRAGOMIREŞTI,67407,1,PART,PRCNCT,PRSD,PRSD_SV,"2025-05-18 21:41:03",1036,613,590,22,1,610,3,1140,527,375,235
16,DÂMBOVIŢA,"ŞCOALA GIMNAZIALĂ DECINDENI-DRAGOMIREŞTI",240,DRAGOMIREŞTI,67407,1,PART,PRCNCT,PRSD,PRSD_SV,"2025-05-18 21:42:53",1068,619,589,30,0,613,6,1160,541,383,230
16,DÂMBOVIŢA,"GRĂDINIŢA GEANGOEŞTI-DRAGOMIREŞTI",241,DRAGOMIREŞTI,67407,1,PART,PRCNCT,PRSD,PRSD_SV,"2025-05-18 21:17:22",292,156,137,19,0,153,3,320,164,101,52
16,DÂMBOVIŢA,"CĂMINUL CULTURAL MOGOŞEŞTI",242,DRAGOMIREŞTI,67407,1,PART,PRCNCT,PRSD,PRSD_SV,"2025-05-18 21:42:54",466,287,263,24,0,284,3,520,233,180,104
16,DÂMBOVIŢA,"ŞCOALA GIMNAZIALĂ RȊNCĂCIOV-DRAGOMIREŞTI",243,DRAGOMIREŞTI,67407,1,PART,PRCNCT,PRSD,PRSD_SV,"2025-05-18 21:31:29",863,451,407,44,0,442,9,950,499,289,153
16,DÂMBOVIŢA,"ŞCOALA GIMNAZIALĂ RȊNCĂCIOV-DRAGOMIREŞTI",244,DRAGOMIREŞTI,67407,1,PART,PRCNCT,PRSD,PRSD_SV,"2025-05-18 21:31:10",739,369,346,23,0,365,4,810,441,217,148
16,DÂMBOVIŢA,"ŞCOALA GIMNAZIALĂ UNGURENI-DRAGOMIREŞTI",245,DRAGOMIREŞTI,67407,1,PART,PRCNCT,PRSD,PRSD_SV,"2025-05-18 21:33:22",1091,507,456,51,0,501,6,1200,693,348,153
16,DÂMBOVIŢA,"ŞCOALA GIMNAZIALĂ FINTA",246,FINTA,67470,1,PART,PRCNCT,PRSD,PRSD_SV,"2025-05-18 21:35:50",961,609,517,92,0,607,2,1060,451,333,274
16,DÂMBOVIŢA,"ŞCOALA BECHINEŞTI",247,FINTA,67470,1,PART,PRCNCT,PRSD,PRSD_SV,"2025-05-18 21:36:51",630,393,318,75,0,391,2,700,307,228,163
16,DÂMBOVIŢA,"ȘCOALA GIMNAZIALĂ GHEBOAIA",248,FINTA,67470,1,PART,PRCNCT,PRSD,PRSD_SV,"2025-05-18 21:30:38",863,524,481,41,2,520,4,950,426,275,245
16,DÂMBOVIŢA,"ȘCOALA GIMNAZIALĂ GHEBOAIA",249,FINTA,67470,1,PART,PRCNCT,PRSD,PRSD_SV,"2025-05-18 21:40:57",775,400,356,43,1,398,2,850,450,255,143
16,DÂMBOVIŢA,"ȘCOALA ”BUICĂ IONESCU”",250,GLODENI,67522,1,PART,PRCNCT,PRSD,PRSD_SV,"2025-05-18 21:54:39",1478,794,753,41,0,782,12,1590,796,385,397
16,DÂMBOVIŢA,"ȘCOALA ”BUICĂ IONESCU”",251,GLODENI,67522,1,PART,PRCNCT,PRSD,PRSD_SV,"2025-05-18 21:38:50",1122,631,598,33,0,624,7,1230,598,400,224
16,DÂMBOVIŢA,"GRĂDINȚA LĂCULEȚE",252,GLODENI,67522,1,PART,PRCNCT,PRSD,PRSD_SV,"2025-05-18 21:22:18",712,378,350,28,0,377,1,780,402,242,135
16,DÂMBOVIŢA,"ŞCOALA GIMNAZIALĂ GURA FOII",253,"GURA FOII",65707,1,PART,PRCNCT,PRSD,PRSD_SV,"2025-05-18 21:51:58",1177,741,641,98,2,732,9,1310,569,386,346
16,DÂMBOVIŢA,"GRĂDINIŢA BUMBUIA",254,"GURA FOII",65707,1,PART,PRCNCT,PRSD,PRSD_SV,"2025-05-18 21:31:25",336,243,203,40,0,238,5,370,127,153,85
16,DÂMBOVIŢA,"SALA DE FESTIVITĂŢI FĂGETU",255,"GURA FOII",65707,1,PART,PRCNCT,PRSD,PRSD_SV,"2025-05-18 21:49:59",293,213,175,38,0,209,4,320,107,132,77
16,DÂMBOVIŢA,"CĂMINUL CULTURAL GURA OCNIȚEI",256,"GURA OCNIŢEI",67595,1,PART,PRCNCT,PRSD,PRSD_SV,"2025-05-18 21:38:44",1368,664,591,63,10,660,4,1490,826,407,253
16,DÂMBOVIŢA,"CĂMINUL CULTURAL GURA OCNIȚEI",257,"GURA OCNIŢEI",67595,1,PART,PRCNCT,PRSD,PRSD_SV,"2025-05-18 21:43:28",1499,857,721,71,65,836,21,1640,783,407,429
16,DÂMBOVIŢA,"ȘCOALA CU CLASELE. I-VIII ADÂNCA",258,"GURA OCNIŢEI",67595,2,PART,PRCNCT,PRSD,PRSD_SV,"2025-05-19 01:35:37",1473,841,767,74,0,825,16,1600,759,425,400
16,DÂMBOVIŢA,"CĂMINUL CULTURAL SĂCUENI",259,"GURA OCNIŢEI",67595,1,PART,PRCNCT,PRSD,PRSD_SV,"2025-05-18 22:13:49",1530,895,791,104,0,875,20,1670,775,440,435
16,DÂMBOVIŢA,"ȘCOALA GIMNAZIALӐ GURA ȘUȚII",260,"GURA ŞUŢII",67648,1,PART,PRCNCT,PRSD,PRSD_SV,"2025-05-18 21:43:28",875,485,421,62,2,483,2,960,475,284,199
16,DÂMBOVIŢA,"ȘCOALA GIMNAZIALӐ GURA ȘUȚII",261,"GURA ŞUŢII",67648,1,PART,PRCNCT,PRSD,PRSD_SV,"2025-05-18 21:54:39",869,398,369,28,1,393,5,960,562,236,157
16,DÂMBOVIŢA,"GRӐDINIȚA CU PROGRAM NORMAL GURA ȘUȚII,CORPUL B",262,"GURA ŞUŢII",67648,1,PART,PRCNCT,PRSD,PRSD_SV,"2025-05-18 21:47:50",990,540,483,57,0,534,6,1100,560,340,194
16,DÂMBOVIŢA,"ȘCOALA GIMNAZIALӐ SPERIEȚENI",263,"GURA ŞUŢII",67648,1,PART,PRCNCT,PRSD,PRSD_SV,"2025-05-18 21:26:39",1444,615,538,77,0,608,7,1570,955,344,264
16,DÂMBOVIŢA,"ȘCOALA GIMNAZIALĂ NR. 1 HULUBEȘTI",264,HULUBEŞTI,67675,1,PART,PRCNCT,PRSD,PRSD_SV,"2025-05-18 21:43:34",648,383,311,72,0,378,5,720,337,208,170
16,DÂMBOVIŢA,"ŞCOALA GIMNAZIALĂ BUTOIU DE JOS",265,HULUBEŞTI,67675,1,PART,PRCNCT,PRSD,PRSD_SV,"2025-05-18 21:34:38",775,317,294,23,0,308,9,850,533,221,87
16,DÂMBOVIŢA,"GRĂDINIŢA CU PROGRAM NORMAL BUTOIU DE SUS",266,HULUBEŞTI,67675,1,PART,PRCNCT,PRSD,PRSD_SV,"2025-05-18 21:50:39",605,354,319,35,0,352,2,670,316,271,81
16,DÂMBOVIŢA,"GRĂDINIŢA CU PROGRAM NORMAL MĂGURA",267,HULUBEŞTI,67675,1,PART,PRCNCT,PRSD,PRSD_SV,"2025-05-18 21:40:54",512,344,295,49,0,342,2,560,216,212,130
16,DÂMBOVIŢA,"ȘCOALA GIMNAZIALĂ IEDERA DE JOS",268,IEDERA,65869,1,PART,PRCNCT,PRSD,PRSD_SV,"2025-05-18 21:16:41",312,166,138,28,0,164,2,340,174,84,80
16,DÂMBOVIŢA,"ȘCOALA GIMNAZIALĂ IEDERA DE JOS",269,IEDERA,65869,1,PART,PRCNCT,PRSD,PRSD_SV,"2025-05-18 22:04:49",1185,670,619,51,0,660,10,1290,620,295,365
16,DÂMBOVIŢA,"GRĂDINIȚA CU PROGRAM NORMAL COLIBAȘI",270,IEDERA,65869,1,PART,PRCNCT,PRSD,PRSD_SV,"2025-05-18 21:34:47",410,268,240,28,0,266,2,450,182,135,131
16,DÂMBOVIŢA,"ȘCOALA CU CLASELE I-IV IEDERA DE SUS",271,IEDERA,65869,1,PART,PRCNCT,PRSD,PRSD_SV,"2025-05-18 21:48:59",1186,628,587,41,0,624,4,1290,662,400,224
16,DÂMBOVIŢA,"ȘCOALA GIMNAZIALĂ NR. 1 GHIRDOVENI",272,"I. L. CARAGIALE",67737,1,PART,PRCNCT,PRSD,PRSD_SV,"2025-05-18 21:36:45",1481,856,792,64,0,846,10,1610,754,401,445
16,DÂMBOVIŢA,"ȘCOALA GIMNAZIALĂ NR. 2 GHIRDOVENI",273,"I. L. CARAGIALE",67737,1,PART,PRCNCT,PRSD,PRSD_SV,"2025-05-18 23:41:06",1187,843,650,64,129,833,10,1430,587,457,376
16,DÂMBOVIŢA,"GRĂDINIȚA CU PROGRAM NORMAL I.L. CARAGIALE",274,"I. L. CARAGIALE",67737,1,PART,PRCNCT,PRSD,PRSD_SV,"2025-05-18 21:40:14",619,513,322,41,150,505,8,903,390,309,196
16,DÂMBOVIŢA,"CĂMINUL CULTURAL I.L.CARAGIALE",275,"I. L. CARAGIALE",67737,1,PART,PRCNCT,PRSD,PRSD_SV,"2025-05-18 21:54:07",1481,830,678,48,104,819,11,1750,920,614,205
16,DÂMBOVIŢA,"ȘCOALA PRIMARĂ MIJA",276,"I. L. CARAGIALE",67737,1,PART,PRCNCT,PRSD,PRSD_SV,"2025-05-18 21:46:32",573,417,244,25,148,409,8,760,343,281,128
16,DÂMBOVIŢA,"ŞCOALA LUCIENI",277,LUCIENI,67773,2,PART,PRCNCT,PRSD,PRSD_SV,"2025-05-19 02:26:28",989,582,525,57,0,575,7,1100,518,318,257
16,DÂMBOVIŢA,"ŞCOALA LUCIENI",278,LUCIENI,67773,1,PART,PRCNCT,PRSD,PRSD_SV,"2025-05-18 21:33:42",1060,511,485,26,0,508,3,1180,669,294,214
16,DÂMBOVIŢA,"ŞCOALA OLTENI",279,LUCIENI,67773,1,PART,PRCNCT,PRSD,PRSD_SV,"2025-05-18 21:25:59",467,282,228,54,0,281,1,520,238,171,110
16,DÂMBOVIŢA,"ȘCOALA PRIMARĂ POTOCELU",280,LUDEŞTI,67835,1,PART,PRCNCT,PRSD,PRSD_SV,"2025-05-18 21:28:47",1020,401,384,17,0,399,2,1130,729,368,31
16,DÂMBOVIŢA,"ȘCOALA GIMNAZIALA SCHEIU DE JOS",281,LUDEŞTI,67835,1,PART,PRCNCT,PRSD,PRSD_SV,"2025-05-18 21:30:49",776,391,344,47,0,384,7,850,459,234,150
16,DÂMBOVIŢA,"ȘCOALA PRIMARĂ SCHEIU DE SUS",282,LUDEŞTI,67835,1,PART,PRCNCT,PRSD,PRSD_SV,"2025-05-18 21:26:18",741,352,328,24,0,345,7,820,468,237,108
16,DÂMBOVIŢA,"ȘCOALA GIMNAZIALĂ TELEȘTI",283,LUDEŞTI,67835,1,PART,PRCNCT,PRSD,PRSD_SV,"2025-05-18 21:26:26",1350,667,584,81,2,660,7,1470,803,476,184
16,DÂMBOVIŢA,"ŞCOALA GIMNAZIALĂ NR. 2 LUNGULEŢU",284,LUNGULEŢU,67906,1,PART,PRCNCT,PRSD,PRSD_SV,"2025-05-18 21:51:37",1006,604,540,64,0,597,7,1110,506,460,137
16,DÂMBOVIŢA,"ŞCOALA GIMNAZIALĂ NR. 2 LUNGULEŢU",285,LUNGULEŢU,67906,1,PART,PRCNCT,PRSD,PRSD_SV,"2025-05-18 21:31:20",846,515,456,59,0,515,0,930,415,367,148
16,DÂMBOVIŢA,"ŞCOALA GIMNAZIALĂ NR. 1 LUNGULEŢU",286,LUNGULEŢU,67906,1,PART,PRCNCT,PRSD,PRSD_SV,"2025-05-18 21:59:50",1386,805,729,76,0,802,3,1510,705,599,203
16,DÂMBOVIŢA,"ŞCOALA GIMNAZIALĂ SERDANU",287,LUNGULEŢU,67906,1,PART,PRCNCT,PRSD,PRSD_SV,"2025-05-18 21:36:11",1069,620,522,98,0,616,4,1170,550,449,167
16,DÂMBOVIŢA,"ȘCOALA GIMNAZIALĂ MALU CU FLORI, NR. 139BIS",288,"MALU CU FLORI",67942,1,PART,PRCNCT,PRSD,PRSD_SV,"2025-05-18 21:50:00",1116,690,587,100,3,686,4,1230,540,420,266
16,DÂMBOVIŢA,"ȘCOALA GENERALĂ CU CLASELE I-IV MICLOȘANII MICI",289,"MALU CU FLORI",67942,1,PART,PRCNCT,PRSD,PRSD_SV,"2025-05-18 21:33:13",683,428,376,52,0,420,8,770,342,271,149
16,DÂMBOVIŢA,"ȘCOALA GIMNAZIALĂ MĂNEȘTI",290,MĂNEŞTI,68002,1,PART,PRCNCT,PRSD,PRSD_SV,"2025-05-18 21:38:37",1083,622,561,61,0,605,17,1190,568,354,251
16,DÂMBOVIŢA,"ŞCOALA GIMNAZIALĂ DRĂGĂEŞTI-PĂMÂNTENI",291,MĂNEŞTI,68002,1,PART,PRCNCT,PRSD,PRSD_SV,"2025-05-18 21:49:34",1960,829,785,44,0,817,12,2140,1311,553,264
16,DÂMBOVIŢA,"ŞCOALA GIMNAZIALĂ DRĂGĂEŞTI-UNGURENI",292,MĂNEŞTI,68002,1,PART,PRCNCT,PRSD,PRSD_SV,"2025-05-18 21:44:03",1096,586,535,51,0,580,6,1200,614,308,272
16,DÂMBOVIŢA,"GRĂDINIŢA TEŢCOIU",293,MĂTĂSARU,68048,1,PART,PRCNCT,PRSD,PRSD_SV,"2025-05-18 22:19:43",1036,486,416,70,0,475,11,1140,654,287,188
16,DÂMBOVIŢA,"ŞCOALA GENERALĂ MĂTĂSARU",294,MĂTĂSARU,68048,1,PART,PRCNCT,PRSD,PRSD_SV,"2025-05-18 22:05:39",744,415,353,62,0,414,1,821,406,269,145
16,DÂMBOVIŢA,"GRĂDINIȚA CREȚULEȘTI",295,MĂTĂSARU,68048,1,PART,PRCNCT,PRSD,PRSD_SV,"2025-05-18 21:46:26",825,486,411,74,1,482,4,910,424,257,225
16,DÂMBOVIŢA,"GRĂDINIȚA NOUĂ POROINICA",296,MĂTĂSARU,68048,1,PART,PRCNCT,PRSD,PRSD_SV,"2025-05-18 21:31:39",617,352,307,44,1,349,3,680,328,217,132
16,DÂMBOVIŢA,"GRĂDINIȚA PUŢU CU SALCIE",297,MĂTĂSARU,68048,1,PART,PRCNCT,PRSD,PRSD_SV,"2025-05-18 21:40:55",729,366,317,49,0,362,4,800,434,243,119
16,DÂMBOVIŢA,"ȘCOALA GENERALĂ MOGOȘANI",298,MOGOŞANI,68128,1,PART,PRCNCT,PRSD,PRSD_SV,"2025-05-18 22:21:38",1326,809,706,93,10,803,6,1440,631,468,335
16,DÂMBOVIŢA,"ȘCOALA COJOCARU",299,MOGOŞANI,68128,1,PART,PRCNCT,PRSD,PRSD_SV,"2025-05-18 21:46:31",636,399,346,50,3,395,4,700,301,228,167
16,DÂMBOVIŢA,"ȘCOALA MERII",300,MOGOŞANI,68128,1,PART,PRCNCT,PRSD,PRSD_SV,"2025-05-18 21:51:11",752,510,457,53,0,509,1,830,320,332,177
16,DÂMBOVIŢA,"ȘCOALA ZĂVOIU",301,MOGOŞANI,68128,1,PART,PRCNCT,PRSD,PRSD_SV,"2025-05-18 21:48:15",715,499,418,72,9,498,1,790,291,293,205
16,DÂMBOVIŢA,"ȘCOALA GIMNAZIALĂ „ION CIORĂNESCU”",302,MOROENI,68182,1,PART,PRCNCT,PRSD,PRSD_SV,"2025-05-18 21:43:32",1136,674,550,106,18,664,10,1240,566,332,332
16,DÂMBOVIŢA,"GRĂDINIȚA GLOD",303,MOROENI,68182,1,PART,PRCNCT,PRSD,PRSD_SV,"2025-05-18 21:48:51",1425,743,701,31,11,725,18,1550,807,658,67
16,DÂMBOVIŢA,"SCOALA VECHE - GRĂDINIȚA MOROENI",304,MOROENI,68182,1,PART,PRCNCT,PRSD,PRSD_SV,"2025-05-18 21:32:43",945,565,496,63,6,555,10,1020,455,245,310
16,DÂMBOVIŢA,"SCOALA MUSCEL",305,MOROENI,68182,1,PART,PRCNCT,PRSD,PRSD_SV,"2025-05-18 21:10:56",61,35,24,11,0,35,0,70,35,27,8
16,DÂMBOVIŢA,"SALĂ DE FESTIVITĂȚI",306,MOROENI,68182,1,PART,PRCNCT,PRSD,PRSD_SV,"2025-05-18 21:38:21",474,326,262,64,0,324,2,520,194,151,173
16,DÂMBOVIŢA,"GRĂDINIȚA MORTENI CENTRU",307,MORTENI,68253,1,PART,PRCNCT,PRSD,PRSD_SV,"2025-05-18 21:33:28",1117,650,581,69,0,644,6,1220,570,470,174
16,DÂMBOVIŢA,"GRĂDINIȚA MORTENI CENTRU",308,MORTENI,68253,1,PART,PRCNCT,PRSD,PRSD_SV,"2025-05-18 21:36:30",1071,647,571,76,0,643,4,1180,533,431,212
16,DÂMBOVIŢA,"CĂMIN CULTURAL MOŢĂIENI",309,MOŢĂIENI,65645,1,PART,PRCNCT,PRSD,PRSD_SV,"2025-05-18 21:44:12",1298,714,640,72,2,709,5,1410,696,317,392
16,DÂMBOVIŢA,"ŞCOALA CUCUTENI",310,MOŢĂIENI,65645,1,PART,PRCNCT,PRSD,PRSD_SV,"2025-05-18 21:27:47",335,175,142,31,2,174,1,380,205,88,86
16,DÂMBOVIŢA,"ȘCOALA CU CLASELE I - VIII NICULEȘTI",311,NICULEŞTI,104387,1,PART,PRCNCT,PRSD,PRSD_SV,"2025-05-18 21:34:14",1022,582,503,79,0,570,12,1130,548,438,132
16,DÂMBOVIŢA,"ȘCOALA CU CLASELE I - VIII NICULEȘTI",312,NICULEŞTI,104387,1,PART,PRCNCT,PRSD,PRSD_SV,"2025-05-18 21:33:09",827,464,378,86,0,453,11,910,446,326,127
16,DÂMBOVIŢA,"ȘCOALA CU CLASELE I-VIII CIOCĂNARI",313,NICULEŞTI,104387,1,PART,PRCNCT,PRSD,PRSD_SV,"2025-05-18 22:05:19",1022,623,530,93,0,618,5,1120,497,527,91
16,DÂMBOVIŢA,"ȘCOALA CU CLASELE I-IV MOVILA",314,NICULEŞTI,104387,1,PART,PRCNCT,PRSD,PRSD_SV,"2025-05-18 21:46:05",500,456,276,180,0,449,7,550,94,282,167
16,DÂMBOVIŢA,"ȘCOALA GIMNAZIALĂ ” NUCET ”",315,NUCET,68280,1,PART,PRCNCT,PRSD,PRSD_SV,"2025-05-18 21:45:37",949,515,446,69,0,508,7,1050,535,293,215
16,DÂMBOVIŢA,"ȘCOALA GIMNAZIALĂ ”NUCET”",316,NUCET,68280,1,PART,PRCNCT,PRSD,PRSD_SV,"2025-05-18 21:26:13",890,498,453,45,0,490,8,980,482,306,184
16,DÂMBOVIŢA,"ȘCOALA GIMNAZIALĂ ” CAZACI ”",317,NUCET,68280,1,PART,PRCNCT,PRSD,PRSD_SV,"2025-05-18 21:53:15",1156,652,584,68,0,644,8,1260,608,390,254
16,DÂMBOVIŢA,"ȘCOALA PRIMARĂ ” ILFOVENI ”",318,NUCET,68280,1,PART,PRCNCT,PRSD,PRSD_SV,"2025-05-18 21:26:51",446,256,213,43,0,252,4,490,234,164,88
16,DÂMBOVIŢA,"GRĂDINIȚA CU PROGRAM NORMAL NR 1 OCNIȚA",319,OCNIŢA,68324,1,PART,PRCNCT,PRSD,PRSD_SV,"2025-05-18 21:49:45",1270,694,639,55,0,688,6,1380,686,446,242
16,DÂMBOVIŢA,"GRADINIȚA CU PROGRAM NORMAL NR 2 FUNDU OCNEI",320,OCNIŢA,68324,1,PART,PRCNCT,PRSD,PRSD_SV,"2025-05-18 21:38:33",974,477,436,41,0,471,6,1070,593,301,170
16,DÂMBOVIŢA,"GRĂDINIȚA CU PROGRAM NORMAL NR. 1",321,OCNIŢA,68324,1,PART,PRCNCT,PRSD,PRSD_SV,"2025-05-18 22:14:26",1273,715,669,46,0,713,2,1380,665,487,226
16,DÂMBOVIŢA,"ȘCOALA GIMNAZIALĂ ODOBEȘTI",322,ODOBEŞTI,68342,1,PART,PRCNCT,PRSD,PRSD_SV,"2025-05-18 21:48:53",1238,795,691,104,0,785,10,1360,565,531,254
16,DÂMBOVIŢA,"GRĂDINIȚA BRÂNCOVEANU",323,ODOBEŞTI,68342,1,PART,PRCNCT,PRSD,PRSD_SV,"2025-05-18 21:30:17",486,284,241,43,0,281,3,540,256,171,110
16,DÂMBOVIŢA,"ȘCOALA GIMNAZIALĂ CROVU",324,ODOBEŞTI,68342,1,PART,PRCNCT,PRSD,PRSD_SV,"2025-05-18 21:27:14",1109,649,574,75,0,637,12,1210,561,490,147
16,DÂMBOVIŢA,"ȘCOALA PRIMARĂ MIULEȘTI",325,ODOBEŞTI,68342,1,PART,PRCNCT,PRSD,PRSD_SV,"2025-05-18 21:45:18",447,230,208,22,0,228,2,490,260,187,41
16,DÂMBOVIŢA,"ȘCOALA PRIMARĂ ZIDURILE",326,ODOBEŞTI,68342,1,PART,PRCNCT,PRSD,PRSD_SV,"2025-05-18 21:38:56",645,429,351,78,0,422,7,710,281,236,186
16,DÂMBOVIŢA,"ŞCOALA GIMNAZIALĂ PERŞINARI",327,PERŞINARI,179935,1,PART,PRCNCT,PRSD,PRSD_SV,"2025-05-18 21:34:20",1138,439,406,33,0,434,5,1250,811,254,180
16,DÂMBOVIŢA,"ŞCOALA GIMNAZIALĂ PERȘINARI",328,PERŞINARI,179935,1,PART,PRCNCT,PRSD,PRSD_SV,"2025-05-18 21:35:22",1142,492,467,22,3,490,2,1250,758,285,205
16,DÂMBOVIŢA,"CĂMIN CULTURAL PETREȘTI",329,PETREŞTI,65752,1,PART,PRCNCT,PRSD,PRSD_SV,"2025-05-18 21:39:08",1110,635,559,76,0,632,3,1210,575,432,200
16,DÂMBOVIŢA,"ȘCOALA GIMNAZIALĂ GRECI",330,PETREŞTI,65752,1,PART,PRCNCT,PRSD,PRSD_SV,"2025-05-18 21:59:51",1212,807,711,96,0,800,7,1330,523,508,292
16,DÂMBOVIŢA,"GRADINITA IONESTI",331,PETREŞTI,65752,1,PART,PRCNCT,PRSD,PRSD_SV,"2025-05-18 22:16:04",1430,883,796,87,0,873,10,1560,677,553,320
16,DÂMBOVIŢA,"GRADINITA POTLOGENI DEAL",332,PETREŞTI,65752,1,PART,PRCNCT,PRSD,PRSD_SV,"2025-05-18 21:33:31",157,114,94,20,0,112,2,170,56,66,46
16,DÂMBOVIŢA,"CENTRU DE ZI PENTRU ”BUNICII COMUNITĂȚII PETREȘTI””",333,PETREŞTI,65752,1,PART,PRCNCT,PRSD,PRSD_SV,"2025-05-18 22:01:08",568,368,321,47,0,358,10,620,252,166,192
16,DÂMBOVIŢA,"CAMINUL CULTURAL PIETRARI",334,PIETRARI,179908,1,PART,PRCNCT,PRSD,PRSD_SV,"2025-05-18 21:40:07",1392,759,686,72,1,754,5,1510,751,414,340
16,DÂMBOVIŢA,"GRĂDINIȚA CU PROGRAM NORMAL VALEA",335,PIETRARI,179908,1,PART,PRCNCT,PRSD,PRSD_SV,"2025-05-18 21:30:33",524,230,202,28,0,230,0,580,350,170,60
16,DÂMBOVIŢA,"GRĂDINIŢA PIETROŞIŢA,NR.327 B",336,PIETROŞIŢA,68404,1,PART,PRCNCT,PRSD,PRSD_SV,"2025-05-18 21:34:38",847,457,380,74,3,453,4,930,473,190,263
16,DÂMBOVIŢA,"GRĂDINIŢA PIETROŞIŢA,NR 327 B",337,PIETROŞIŢA,68404,1,PART,PRCNCT,PRSD,PRSD_SV,"2025-05-18 21:55:18",803,448,404,42,2,443,5,890,442,216,227
16,DÂMBOVIŢA,"GRĂDINIȚA CU PROGRAM NORMAL ”VĂCĂRESCU NATALIA”",338,PIETROŞIŢA,68404,1,PART,PRCNCT,PRSD,PRSD_SV,"2025-05-18 21:26:26",843,471,409,62,0,469,2,930,459,288,181
16,DÂMBOVIŢA,"ȘCOALA NR.1 POIANA, SAT POIANA",339,POIANA,68431,1,PART,PRCNCT,PRSD,PRSD_SV,"2025-05-18 22:00:42",840,504,417,87,0,496,8,920,416,323,173
16,DÂMBOVIŢA,"ȘCOALA NR.1 POIANA",340,POIANA,68431,1,PART,PRCNCT,PRSD,PRSD_SV,"2025-05-18 21:43:20",1071,623,558,65,0,617,6,1170,547,475,142
16,DÂMBOVIŢA,"ȘCOALA NR.2 POIANA",341,POIANA,68431,1,PART,PRCNCT,PRSD,PRSD_SV,"2025-05-18 21:25:28",829,505,397,108,0,501,4,910,405,343,158
16,DÂMBOVIŢA,"ŞCOALA POTLOGI",342,POTLOGI,68468,1,PART,PRCNCT,PRSD,PRSD_SV,"2025-05-18 21:45:07",1187,755,576,179,0,741,14,1300,545,463,278
16,DÂMBOVIŢA,"ŞCOALA POTLOGI",343,POTLOGI,68468,1,PART,PRCNCT,PRSD,PRSD_SV,"2025-05-18 21:38:26",1225,671,586,85,0,665,6,1340,669,405,260
16,DÂMBOVIŢA,"ŞCOALA PITARU",344,POTLOGI,68468,1,PART,PRCNCT,PRSD,PRSD_SV,"2025-05-18 21:57:47",682,421,325,96,0,409,12,750,329,226,183
16,DÂMBOVIŢA,"ŞCOALA ROMÂNEŞTI",345,POTLOGI,68468,2,PART,PRCNCT,PRSD,PRSD_SV,"2025-05-19 02:25:57",1319,532,472,60,0,523,9,1430,898,469,54
16,DÂMBOVIŢA,"ŞCOALA ROMÂNEŞTI",346,POTLOGI,68468,1,PART,PRCNCT,PRSD,PRSD_SV,"2025-05-18 21:49:50",1902,751,700,51,0,746,5,2070,1319,640,106
16,DÂMBOVIŢA,"ŞCOALA VLĂSCENI",347,POTLOGI,68468,1,PART,PRCNCT,PRSD,PRSD_SV,"2025-05-18 21:29:17",557,388,257,131,0,385,3,620,232,253,132
16,DÂMBOVIŢA,"CĂMIN CULTURAL",348,PRODULEŞTI,68529,1,PART,PRCNCT,PRSD,PRSD_SV,"2025-05-18 21:41:26",1398,817,716,98,3,813,4,1520,703,492,321
16,DÂMBOVIŢA,"ȘCOALA PRIMARĂ BROȘTENI",349,PRODULEŞTI,68529,1,PART,PRCNCT,PRSD,PRSD_SV,"2025-05-18 21:36:43",508,287,251,36,0,283,4,560,273,165,118
16,DÂMBOVIŢA,"ȘCOALA PRIMARĂ COSTEȘTII DIN DEAL",350,PRODULEŞTI,68529,1,PART,PRCNCT,PRSD,PRSD_SV,"2025-05-18 21:37:15",730,432,357,75,0,429,3,810,378,241,188
16,DÂMBOVIŢA,"ȘCOALA GIMNAZIALĂ „ NICOLAE VLAD „",351,PUCHENI,68565,1,PART,PRCNCT,PRSD,PRSD_SV,"2025-05-18 21:41:09",1200,701,624,73,4,697,4,1320,619,346,351
16,DÂMBOVIŢA,"SCOALA VALEA LARGA",352,PUCHENI,68565,1,PART,PRCNCT,PRSD,PRSD_SV,"2025-05-18 21:30:35",195,123,95,28,0,122,1,220,97,77,45
16,DÂMBOVIŢA,"ȘCOALA GIMNAZIALĂ RACIU",353,RACIU,179891,1,PART,PRCNCT,PRSD,PRSD_SV,"2025-05-18 21:39:26",1250,690,622,68,0,686,4,1370,680,325,361
16,DÂMBOVIŢA,"ȘCOALA PRIMARĂ SILIȘTEA - RACIU",354,RACIU,179891,1,PART,PRCNCT,PRSD,PRSD_SV,"2025-05-18 21:47:19",718,389,354,35,0,386,3,800,411,238,148
16,DÂMBOVIŢA,"ȘCOALA GIMNAZIALĂ ȘUȚA SEACĂ - RACIU",355,RACIU,179891,1,PART,PRCNCT,PRSD,PRSD_SV,"2025-05-18 21:40:39",698,416,364,52,0,414,2,770,354,245,169
16,DÂMBOVIŢA,"ŞCOALA PRIMARĂ DRĂGHINEASCA",356,RĂSCĂEŢI,179926,1,PART,PRCNCT,PRSD,PRSD_SV,"2025-05-18 21:38:00",793,469,419,50,0,463,6,870,401,374,89
16,DÂMBOVIŢA,"PRIMĂRIA RĂSCĂEȚI",357,RĂSCĂEŢI,179926,2,PART,PRCNCT,PRSD,PRSD_SV,"2025-05-19 02:06:10",956,531,481,50,0,525,6,1060,529,360,165
16,DÂMBOVIŢA,"BIBLIOTECA COMUNALĂ",358,RĂZVAD,65431,1,PART,PRCNCT,PRSD,PRSD_SV,"2025-05-18 21:47:17",1384,831,760,70,1,819,12,1500,669,370,449
16,DÂMBOVIŢA,"ȘCOALA GIMNAZIALĂ RĂZVAD",359,RĂZVAD,65431,1,PART,PRCNCT,PRSD,PRSD_SV,"2025-05-18 21:29:39",1082,679,603,74,2,675,4,1200,521,318,357
16,DÂMBOVIŢA,"CENTRUL EDUCATIV PENTRU COPII SĂRACI RĂZVAD",360,RĂZVAD,65431,1,PART,PRCNCT,PRSD,PRSD_SV,"2025-05-18 21:36:18",1143,741,637,104,0,731,10,1240,499,308,423
16,DÂMBOVIŢA,"ȘCOALA GIMNAZIALĂ GORGOTA",361,RĂZVAD,65431,1,PART,PRCNCT,PRSD,PRSD_SV,"2025-05-18 21:38:17",1047,564,473,91,0,560,4,1160,596,349,211
16,DÂMBOVIŢA,"ȘCOALA GIMNAZIALĂ VALEA VOIEVOZILOR",362,RĂZVAD,65431,1,PART,PRCNCT,PRSD,PRSD_SV,"2025-05-18 22:17:02",1562,1066,920,145,1,1059,7,1700,634,417,642
16,DÂMBOVIŢA,"ȘCOALA GIMNAZIALĂ VALEA VOIEVOZILOR",363,RĂZVAD,65431,1,PART,PRCNCT,PRSD,PRSD_SV,"2025-05-18 21:33:00",1472,993,857,136,0,985,8,1600,607,392,593
16,DÂMBOVIŢA,"ȘCOALA GIMNAZIALĂ RÂU ALB DE JOS",364,"RÂU ALB",179917,1,PART,PRCNCT,PRSD,PRSD_SV,"2025-05-18 21:52:34",1124,579,495,84,0,575,4,1200,621,380,195
16,DÂMBOVIŢA,"GRÃDINIŢA CU PROGRAM NORMAL RUNCU",365,RUNCU,68716,1,PART,PRCNCT,PRSD,PRSD_SV,"2025-05-18 21:41:23",1154,572,521,51,0,570,2,1260,688,297,273
16,DÂMBOVIŢA,"ŞCOALA GIMNAZIALÃ ”CONSTANTIN SECÃREANU” RUNCU",366,RUNCU,68716,1,PART,PRCNCT,PRSD,PRSD_SV,"2025-05-18 21:35:58",1026,533,489,44,0,526,7,1130,597,279,247
16,DÂMBOVIŢA,"GRÃDINIŢA CU PROGRAM NORMAL BÃDENI",367,RUNCU,68716,1,PART,PRCNCT,PRSD,PRSD_SV,"2025-05-18 22:00:44",810,377,335,41,1,373,4,891,514,232,141
16,DÂMBOVIŢA,"GRÃDINIŢA CU PROGRAM NORMAL BREBU",368,RUNCU,68716,1,PART,PRCNCT,PRSD,PRSD_SV,"2025-05-18 21:21:21",531,272,237,35,0,272,0,580,308,138,134
16,DÂMBOVIŢA,"ȘCOALA GENERALĂ BĂNEȘTI",369,SĂLCIOARA,68789,1,PART,PRCNCT,PRSD,PRSD_SV,"2025-05-18 21:38:11",331,236,177,59,0,233,3,370,134,136,97
16,DÂMBOVIŢA,"ȘCOALA GENERALĂ CUZA-VODĂ",370,SĂLCIOARA,68789,1,PART,PRCNCT,PRSD,PRSD_SV,"2025-05-18 21:37:11",306,209,156,51,2,208,1,340,131,125,83
16,DÂMBOVIŢA,"ȘCOALA GENERALĂ GHINEȘTI SALA1",371,SĂLCIOARA,68789,1,PART,PRCNCT,PRSD,PRSD_SV,"2025-05-18 22:02:46",988,505,432,73,0,502,3,1090,585,326,176
16,DÂMBOVIŢA,"ȘCOALA GENERALĂ MIRCEA-VODĂ SALA 1",372,SĂLCIOARA,68789,1,PART,PRCNCT,PRSD,PRSD_SV,"2025-05-18 21:42:12",898,507,412,95,0,501,6,990,483,301,200
16,DÂMBOVIŢA,"ȘCOALA GENERALĂ PODU-RIZII",373,SĂLCIOARA,68789,1,PART,PRCNCT,PRSD,PRSD_SV,"2025-05-18 22:06:05",554,364,298,66,0,360,4,610,246,235,125
16,DÂMBOVIŢA,"ȘCOALA GIMNAZIALĂ SLOBOZIA MOARĂ",374,"SLOBOZIA MOARĂ",105142,1,PART,PRCNCT,PRSD,PRSD_SV,"2025-05-18 21:43:16",838,536,447,89,0,533,3,910,374,361,172
16,DÂMBOVIŢA,"ȘCOALA GIMNAZIALĂ SLOBOZIA MOARĂ",375,"SLOBOZIA MOARĂ",105142,1,PART,PRCNCT,PRSD,PRSD_SV,"2025-05-18 21:33:45",812,536,458,77,1,529,7,890,354,350,179
16,DÂMBOVIŢA,"GRĂDINIȚA CU PROGRAM NORMAL ȘELARU",376,ŞELARU,68887,1,PART,PRCNCT,PRSD,PRSD_SV,"2025-05-18 21:36:45",617,431,281,150,0,428,3,680,249,253,175
16,DÂMBOVIŢA,"ȘCOALA GIMNAZIALĂ FIERBINȚI",377,ŞELARU,68887,1,PART,PRCNCT,PRSD,PRSD_SV,"2025-05-18 22:12:44",1153,594,504,90,0,590,4,1260,666,424,166
16,DÂMBOVIŢA,"GRĂDINIȚA CU PROGRAM NORMAL GLOGOVEANU",378,ŞELARU,68887,1,PART,PRCNCT,PRSD,PRSD_SV,"2025-05-18 21:22:18",518,362,238,124,0,356,6,570,208,226,130
16,DÂMBOVIŢA,"ȘCOALA GIMNAZIALĂ ”PROFESOR ILIE POPESCU”",379,ŞOTÂNGA,65477,1,PART,PRCNCT,PRSD,PRSD_SV,"2025-05-18 21:40:46",1441,753,667,86,0,743,10,1570,817,347,396
16,DÂMBOVIŢA,"CĂMIN CULTURAL ŞOTÂNGA",380,ŞOTÂNGA,65477,1,PART,PRCNCT,PRSD,PRSD_SV,"2025-05-18 21:41:55",1086,550,510,40,0,537,13,1200,650,246,291
16,DÂMBOVIŢA,"ȘCOALA GIMNAZIALĂ NR. 2",381,ŞOTÂNGA,65477,1,PART,PRCNCT,PRSD,PRSD_SV,"2025-05-18 21:30:45",1076,490,448,42,0,485,5,1190,700,355,130
16,DÂMBOVIŢA,"ȘCOALA GIMNAZIALĂ ”TEIUL DOAMNEI” - CORP B",382,ŞOTÂNGA,65477,1,PART,PRCNCT,PRSD,PRSD_SV,"2025-05-18 21:48:25",811,462,425,37,0,461,1,890,428,208,253
16,DÂMBOVIŢA,"CĂMIN CULTURAL TEIŞ",383,ŞOTÂNGA,65477,1,PART,PRCNCT,PRSD,PRSD_SV,"2025-05-18 21:32:12",1193,672,615,57,0,663,9,1300,628,319,344
16,DÂMBOVIŢA,"ŞCOALA GIMNAZIALĂ TĂRTĂŞEŞTI",384,TĂRTĂŞEŞTI,105534,1,PART,PRCNCT,PRSD,PRSD_SV,"2025-05-18 21:47:51",838,648,415,228,5,642,6,920,272,335,307
16,DÂMBOVIŢA,"LICEUL TEHNOLOGIC ”MARIN GRIGORE NĂSTASE” TĂRTĂȘEȘTI,",385,TĂRTĂŞEŞTI,105534,1,PART,PRCNCT,PRSD,PRSD_SV,"2025-05-18 22:00:23",978,846,511,335,0,839,7,1070,224,433,406
16,DÂMBOVIŢA,"ŞCOALA GIMNAZIALĂ BÂLDANA - TĂRTĂŞEŞTI,",386,TĂRTĂŞEŞTI,105534,1,PART,PRCNCT,PRSD,PRSD_SV,"2025-05-18 21:48:02",1406,933,698,235,0,920,13,1540,607,541,379
16,DÂMBOVIŢA,"DISPENSAR UMAN GULIA",387,TĂRTĂŞEŞTI,105534,1,PART,PRCNCT,PRSD,PRSD_SV,"2025-05-18 22:23:50",1098,1050,647,403,0,1035,15,1200,150,494,541
16,DÂMBOVIŢA,"SALA DE FESTIVITĂŢI A PRIMĂRIEI TĂTĂRANI",388,TĂTĂRANI,68921,1,PART,PRCNCT,PRSD,PRSD_SV,"2025-05-18 21:33:45",819,519,453,65,1,517,2,900,381,293,224
16,DÂMBOVIŢA,"CĂMIN CULTURAL CĂPRIORU",389,TĂTĂRANI,68921,1,PART,PRCNCT,PRSD,PRSD_SV,"2025-05-18 21:30:27",1327,730,675,55,0,724,6,1460,730,388,336
16,DÂMBOVIŢA,"GRĂDINIŢA DE COPII GHEBOIENI",390,TĂTĂRANI,68921,1,PART,PRCNCT,PRSD,PRSD_SV,"2025-05-18 21:30:36",1211,648,563,85,0,644,4,1330,682,352,292
16,DÂMBOVIŢA,"CĂMIN CULTURAL PRIBOIU",391,TĂTĂRANI,68921,1,PART,PRCNCT,PRSD,PRSD_SV,"2025-05-18 21:33:40",716,505,445,58,2,499,6,790,285,300,199
16,DÂMBOVIŢA,"ŞCOALA GIMNAZIALĂ ULIEŞTI",392,ULIEŞTI,68976,1,PART,PRCNCT,PRSD,PRSD_SV,"2025-05-18 21:33:32",1013,650,535,115,0,644,6,1120,470,440,204
16,DÂMBOVIŢA,"GRĂDINIȚA CROITORI",393,ULIEŞTI,68976,1,PART,PRCNCT,PRSD,PRSD_SV,"2025-05-18 21:20:55",649,367,312,55,0,363,4,720,353,255,108
16,DÂMBOVIŢA,"ŞCOALA PRIMARĂ HANU LUI PALĂ",394,ULIEŞTI,68976,1,PART,PRCNCT,PRSD,PRSD_SV,"2025-05-18 21:18:48",274,166,124,42,0,165,1,300,134,121,44
16,DÂMBOVIŢA,"ŞCOALA GIMNAZIALĂ JUGURENI",395,ULIEŞTI,68976,1,PART,PRCNCT,PRSD,PRSD_SV,"2025-05-18 21:43:03",1208,707,581,126,0,705,2,1320,613,469,236
16,DÂMBOVIŢA,"SCOALA GIMNAZIALA ULMI",396,ULMI,65501,1,PART,PRCNCT,PRSD,PRSD_SV,"2025-05-18 22:00:53",1180,684,575,109,0,676,8,1290,606,328,348
16,DÂMBOVIŢA,"GRADINITA DUMBRAVA",397,ULMI,65501,1,PART,PRCNCT,PRSD,PRSD_SV,"2025-05-18 21:59:10",1021,660,566,94,0,648,12,1120,460,354,294
16,DÂMBOVIŢA,"GRADINITA MATRACA",398,ULMI,65501,1,PART,PRCNCT,PRSD,PRSD_SV,"2025-05-18 21:30:33",701,433,367,66,0,429,4,770,337,225,204
16,DÂMBOVIŢA,"SCOALA GIMNAZIALA ION CONSTANTINESCU VIISOARA",399,ULMI,65501,1,PART,PRCNCT,PRSD,PRSD_SV,"2025-05-18 21:50:53",1169,700,636,64,0,692,8,1280,580,387,305
16,DÂMBOVIŢA,"CAMINUL CULTURAL VALEA LUNGA CRICOV",400,"VALEA LUNGĂ",69063,2,PART,PRCNCT,PRSD,PRSD_SV,"2025-05-19 02:18:25",1020,661,502,158,1,656,5,1130,469,247,409
16,DÂMBOVIŢA,"GRADINIŢA CU PROGRAM NORMAL ŞTUBEIE TISA",401,"VALEA LUNGĂ",69063,1,PART,PRCNCT,PRSD,PRSD_SV,"2025-05-18 21:20:49",329,200,175,25,0,195,5,360,160,95,100
16,DÂMBOVIŢA,"ŞCOALA GIMNAZIALĂ ION HARALMBIE VALEA LUNGĂ GORGOTA",402,"VALEA LUNGĂ",69063,1,PART,PRCNCT,PRSD,PRSD_SV,"2025-05-18 21:39:10",989,544,495,49,0,538,6,1090,546,281,257
16,DÂMBOVIŢA,"CENTRU DE ASISTENȚĂ DUPĂ PROGRAM ȘCOLAR",403,"VALEA LUNGĂ",69063,1,PART,PRCNCT,PRSD,PRSD_SV,"2025-05-18 21:33:56",1037,636,570,66,0,631,5,1140,504,270,361
16,DÂMBOVIŢA,"GRĂDINIȚA DE COPII VALEA MARE",404,"VALEA LUNGĂ",69063,1,PART,PRCNCT,PRSD,PRSD_SV,"2025-05-18 21:16:45",432,244,216,28,0,242,2,480,236,108,134
16,DÂMBOVIŢA,"ŞCOALA GIMNAZIALĂ VALEA MARE",405,"VALEA MARE",69170,1,PART,PRCNCT,PRSD,PRSD_SV,"2025-05-18 21:47:47",1134,716,608,108,0,705,11,1260,544,427,278
16,DÂMBOVIŢA,"GRĂDINIŢA CU PROGRAM NORMAL VALEA CASELOR",406,"VALEA MARE",69170,1,PART,PRCNCT,PRSD,PRSD_SV,"2025-05-18 21:34:57",558,353,302,51,0,350,3,618,265,196,154
16,DÂMBOVIŢA,"ȘCOALA GIMNAZIALĂ ”IANCU VĂCĂRESCU” - VĂCĂREȘTI",407,VĂCĂREŞTI,69250,1,PART,PRCNCT,PRSD,PRSD_SV,"2025-05-18 21:49:17",1393,714,652,62,0,709,5,1520,806,457,252
16,DÂMBOVIŢA,"ȘCOALA GIMNAZIALĂ ”IANCU VĂCĂRESCU” - VĂCĂREȘTI",408,VĂCĂREŞTI,69250,1,PART,PRCNCT,PRSD,PRSD_SV,"2025-05-18 21:46:50",1134,554,503,51,0,550,4,1240,686,354,196
16,DÂMBOVIŢA,"GRĂDINIȚA CU PROGRAM NORMAL BRĂTEȘTII DE JOS",409,VĂCĂREŞTI,69250,1,PART,PRCNCT,PRSD,PRSD_SV,"2025-05-18 22:04:24",549,328,291,37,0,324,4,600,272,231,93
16,DÂMBOVIŢA,"ȘCOALA GIMNAZIALĂ BUNGETU",410,VĂCĂREŞTI,69250,1,PART,PRCNCT,PRSD,PRSD_SV,"2025-05-18 21:47:12",1120,669,594,75,0,662,7,1230,561,363,299
16,DÂMBOVIŢA,"SCOALA GENERALA VALENI DIMBOVITA, PARTER SALA A DOUA",411,VĂLENI-DÂMBOVIŢA,69303,1,PART,PRCNCT,PRSD,PRSD_SV,"2025-05-18 21:46:00",859,447,397,48,2,445,2,950,503,215,230
16,DÂMBOVIŢA,"SCOALA GENERALA VALENI DIMBOVITA, PARTER SALA PATRU",412,VĂLENI-DÂMBOVIŢA,69303,1,PART,PRCNCT,PRSD,PRSD_SV,"2025-05-18 21:52:41",907,498,448,50,0,497,1,1000,502,231,266
16,DÂMBOVIŢA,"SCOALA NOUA GENERALA MESTEACAN",413,VĂLENI-DÂMBOVIŢA,69303,1,PART,PRCNCT,PRSD,PRSD_SV,"2025-05-18 21:31:00",209,146,119,27,0,144,2,230,84,78,66
16,DÂMBOVIŢA,"AFTER- SCHOOL",414,VÂRFURI,69447,1,PART,PRCNCT,PRSD,PRSD_SV,"2025-05-18 21:33:37",651,375,314,61,0,371,4,720,345,184,187
16,DÂMBOVIŢA,"CĂMIN CULTURAL",415,VÂRFURI,69447,1,PART,PRCNCT,PRSD,PRSD_SV,"2025-05-18 21:34:33",751,488,411,77,0,484,4,830,342,242,242
16,DÂMBOVIŢA,"CĂMIN CULTURAL",416,VIŞINA,69330,1,PART,PRCNCT,PRSD,PRSD_SV,"2025-05-18 21:47:19",1269,701,609,92,0,695,6,1380,679,460,235
16,DÂMBOVIŢA,"GRĂDINIŢA NR. 1 VISINA",417,VIŞINA,69330,1,PART,PRCNCT,PRSD,PRSD_SV,"2025-05-18 21:44:51",924,544,473,71,0,538,6,1020,476,376,162
16,DÂMBOVIŢA,"GRĂDINIŢA BROŞTENI",418,VIŞINA,69330,1,PART,PRCNCT,PRSD,PRSD_SV,"2025-05-18 21:38:56",924,478,420,58,0,476,2,1020,542,318,158
16,DÂMBOVIŢA,"CĂMINUL CULTURAL VIȘINEȘTI",419,VIŞINEŞTI,69394,1,PART,PRCNCT,PRSD,PRSD_SV,"2025-05-18 21:30:37",700,449,358,88,3,444,5,770,321,180,264
16,DÂMBOVIŢA,"CĂMIN CULTURAL SULTANU",420,VIŞINEŞTI,69394,1,PART,PRCNCT,PRSD,PRSD_SV,"2025-05-18 21:21:53",217,142,91,51,0,140,2,240,98,69,71
16,DÂMBOVIŢA,"ȘCOALA URSEIU",421,VIŞINEŞTI,69394,1,PART,PRCNCT,PRSD,PRSD_SV,"2025-05-18 21:29:20",466,278,207,71,0,272,6,520,242,124,148
16,DÂMBOVIŢA,"ȘCOALA GIMNAZIALĂ ”STAN ȘTEFAN”",422,VLĂDENI,179711,1,PART,PRCNCT,PRSD,PRSD_SV,"2025-05-18 22:26:39",1270,643,586,57,0,632,11,1390,747,367,265
16,DÂMBOVIŢA,"CĂMIN CULTURAL",423,VLĂDENI,179711,2,PART,PRCNCT,PRSD,PRSD_SV,"2025-05-19 01:50:13",981,515,470,45,0,505,10,1080,565,320,185
16,DÂMBOVIŢA,"ŞCOALA CU CLASELE I-VIII",424,VOINEŞTI,69526,1,PART,PRCNCT,PRSD,PRSD_SV,"2025-05-18 21:23:55",1287,817,694,111,12,804,13,1420,603,403,401
16,DÂMBOVIŢA,"CĂMINUL CULTURAL",425,VOINEŞTI,69526,1,PART,PRCNCT,PRSD,PRSD_SV,"2025-05-18 21:31:27",930,545,470,73,2,539,6,1030,485,319,220
16,DÂMBOVIŢA,"GRĂDINIŢA MANGA",426,VOINEŞTI,69526,1,PART,PRCNCT,PRSD,PRSD_SV,"2025-05-18 21:27:00",637,355,294,61,0,350,5,700,345,206,144
16,DÂMBOVIŢA,"GRĂDINIŢA DE COPII",427,VOINEŞTI,69526,1,PART,PRCNCT,PRSD,PRSD_SV,"2025-05-18 21:27:20",720,402,352,50,0,401,1,790,388,238,163
16,DÂMBOVIŢA,"GRĂDINIȚA CU PROGRAM NORMAL SUDULENI",428,VOINEŞTI,69526,1,PART,PRCNCT,PRSD,PRSD_SV,"2025-05-18 21:41:58",1264,701,600,101,0,695,6,1380,679,465,230
16,DÂMBOVIŢA,"CĂMINUL CULTURAL „ECATERINA OPROIU”",429,VULCANA-BĂI,69615,1,PART,PRCNCT,PRSD,PRSD_SV,"2025-05-18 21:32:00",1316,717,630,76,11,706,11,1440,723,356,350
16,DÂMBOVIŢA,"CĂMINUL CULTURAL „IH RĂDULESCU”",430,VULCANA-BĂI,69615,1,PART,PRCNCT,PRSD,PRSD_SV,"2025-05-18 21:41:25",1150,534,486,46,2,523,11,1260,726,289,234
16,DÂMBOVIŢA,"CĂMINUL CULTURAL ”IZVOR DE APĂ VIE”",431,VULCANA-PANDELE,179640,1,PART,PRCNCT,PRSD,PRSD_SV,"2025-05-18 22:49:32",1241,729,657,69,3,710,19,1370,641,314,396
16,DÂMBOVIŢA,"GRĂDINIȚA CU PROGRAM NORMAL, VULCANA-PANDELE",432,VULCANA-PANDELE,179640,1,PART,PRCNCT,PRSD,PRSD_SV,"2025-05-18 21:58:26",1202,458,420,38,0,454,4,1330,872,294,160
16,DÂMBOVIŢA,"ȘCOALA GIMNAZIALĂ GURA VULCANEI",433,VULCANA-PANDELE,179640,1,PART,PRCNCT,PRSD,PRSD_SV,"2025-05-18 22:06:27",904,473,450,23,0,467,6,990,517,185,282
16,DÂMBOVIŢA,"ȘCOALA GIMNAZIALĂ GURA VULCANEI",434,VULCANA-PANDELE,179640,1,PART,PRCNCT,PRSD,PRSD_SV,"2025-05-18 21:56:10",821,464,433,31,0,461,3,910,446,264,197
17,DOLJ,"COLEGIUL NAŢIONAL ”ELENA CUZA”",1,"MUNICIPIUL CRAIOVA",69900,1,PART,PRCNCT,PRSD,PRSD_SV,"2025-05-18 22:20:29",1590,787,610,175,2,781,6,1726,939,226,555
17,DOLJ,"CASA DE CULTURA A STUDENŢILOR",2,"MUNICIPIUL CRAIOVA",69900,1,PART,PRCNCT,PRSD,PRSD_SV,"2025-05-18 21:56:35",1304,729,644,84,1,722,7,1400,671,244,478
17,DOLJ,"PRIMARIA CRAIOVA- DIRECŢIA DE ASISTENŢĂ ŞI PROTECŢIE SOCIALĂ",3,"MUNICIPIUL CRAIOVA",69900,1,PART,PRCNCT,PRSD,PRSD_SV,"2025-05-18 21:46:22",1286,748,680,65,3,736,12,1400,652,222,514
17,DOLJ,"LICEUL CU PROGRAM SPORTIV ”PETRACHE TRIŞCU”",4,"MUNICIPIUL CRAIOVA",69900,1,PART,PRCNCT,PRSD,PRSD_SV,"2025-05-18 22:45:25",1612,1014,962,38,14,1000,14,1700,686,243,757
17,DOLJ,"LICEUL CU PROGRAM SPORTIV ”PETRACHE TRIȘCU”",5,"MUNICIPIUL CRAIOVA",69900,1,PART,PRCNCT,PRSD,PRSD_SV,"2025-05-18 22:25:06",1639,1074,975,98,1,1065,9,1700,626,303,762
17,DOLJ,"LICEUL TEORETIC ”TRAIAN VUIA”",6,"MUNICIPIUL CRAIOVA",69900,1,PART,PRCNCT,PRSD,PRSD_SV,"2025-05-18 21:55:04",1203,786,724,62,0,775,11,1300,514,180,595
17,DOLJ,"LICEUL TEORETIC ”TRAIAN VUIA”",7,"MUNICIPIUL CRAIOVA",69900,1,PART,PRCNCT,PRSD,PRSD_SV,"2025-05-18 21:30:12",1007,623,568,55,0,616,7,1100,477,191,425
17,DOLJ,"UNIVERSITATEA DIN CRAIOVA",8,"MUNICIPIUL CRAIOVA",69900,1,PART,PRCNCT,PRSD,PRSD_SV,"2025-05-18 21:45:57",1554,1019,856,163,0,1013,6,1700,681,240,773
17,DOLJ,"UNIVERSITATEA DIN CRAIOVA",9,"MUNICIPIUL CRAIOVA",69900,1,PART,PRCNCT,PRSD,PRSD_SV,"2025-05-18 21:36:57",900,689,484,204,1,678,11,1000,311,185,493
17,DOLJ,"UNIVERSITATEA DIN CRAIOVA",10,"MUNICIPIUL CRAIOVA",69900,1,PART,PRCNCT,PRSD,PRSD_SV,"2025-05-18 21:52:25",913,670,518,152,0,663,7,1000,330,131,532
17,DOLJ,"ŞCOALA GIMNAZIALĂ NR.22 ”MIRCEA ELIADE”",11,"MUNICIPIUL CRAIOVA",69900,1,PART,PRCNCT,PRSD,PRSD_SV,"2025-05-18 22:08:36",1078,679,579,100,0,670,9,1100,421,181,489
17,DOLJ,"ŞCOALA GIMNAZIALĂ ”MIRCEA ELIADE”",12,"MUNICIPIUL CRAIOVA",69900,1,PART,PRCNCT,PRSD,PRSD_SV,"2025-05-18 22:02:18",1365,930,835,93,2,926,4,1400,470,246,680
17,DOLJ,"GRADINIŢA CU PROGRAM PRELUNGIT ”DUMBRAVA MINUNATA” ( FOSTĂ NR.37)",13,"MUNICIPIUL CRAIOVA",69900,1,PART,PRCNCT,PRSD,PRSD_SV,"2025-05-18 22:22:02",1633,1043,882,59,102,1030,13,1800,757,307,723
17,DOLJ,"GRADINIŢA CU PROGRAM PRELUNGIT ”DUMBRAVA MINUNATA”(FOSTĂ NR.37)",14,"MUNICIPIUL CRAIOVA",69900,1,PART,PRCNCT,PRSD,PRSD_SV,"2025-05-18 21:52:53",1469,816,675,139,2,800,16,1500,684,363,437
17,DOLJ,"ŞCOALA GIMNAZIALĂ ”MIHAI EMINESCU”(FOSTA NR.37",15,"MUNICIPIUL CRAIOVA",69900,1,PART,PRCNCT,PRSD,PRSD_SV,"2025-05-18 22:16:19",1141,671,564,107,0,665,6,1200,529,211,454
17,DOLJ,"ŞCOALA GIMNAZIALĂ ”MIHAI EMINESCU”(FOSTA NR.37)",16,"MUNICIPIUL CRAIOVA",69900,1,PART,PRCNCT,PRSD,PRSD_SV,"2025-05-18 22:18:53",1239,723,613,110,0,716,7,1300,577,260,456
17,DOLJ,"ŞCOALA GIMNAZIALĂ ”MIHAI EMINESCU”(FOSTA NR. 37)",17,"MUNICIPIUL CRAIOVA",69900,1,PART,PRCNCT,PRSD,PRSD_SV,"2025-05-18 21:40:20",1064,609,500,109,0,602,7,1100,491,262,340
17,DOLJ,"GRADINIŢA CU PROGRAM NORMAL ”PRICHINDEL”(FOSTA NR. 55) – STRUCTURĂ A ŞCOLII GIMNAZIALE ”MIHAI EMINESCU” (FOSTA NR.37))",18,"MUNICIPIUL CRAIOVA",69900,1,PART,PRCNCT,PRSD,PRSD_SV,"2025-05-18 21:45:03",939,569,443,126,0,556,13,1000,431,260,296
17,DOLJ,"GRADINIŢA CU PROGRAM NORMAL ”PRICHINDEL”(FOSTA NR. 55) – STRUCTURĂ A ŞCOLII GIMNAZIALE ”MIHAI EMINESCU” (FOSTA NR.37)",19,"MUNICIPIUL CRAIOVA",69900,1,PART,PRCNCT,PRSD,PRSD_SV,"2025-05-18 21:31:09",1294,749,672,77,0,744,5,1400,651,349,395
17,DOLJ,"LICEUL TEORETIC ”HENRI COANDĂ”",20,"MUNICIPIUL CRAIOVA",69900,1,PART,PRCNCT,PRSD,PRSD_SV,"2025-05-18 21:49:23",1362,827,633,131,63,815,12,1500,673,318,497
17,DOLJ,"LICEUL TEORETIC ”HENRI COANDĂ”",21,"MUNICIPIUL CRAIOVA",69900,1,PART,PRCNCT,PRSD,PRSD_SV,"2025-05-18 21:52:50",1254,835,647,188,0,820,15,1300,465,274,546
17,DOLJ,"LICEUL TEORETIC ”HENRI COANDĂ”",22,"MUNICIPIUL CRAIOVA",69900,1,PART,PRCNCT,PRSD,PRSD_SV,"2025-05-18 22:01:29",1326,763,706,57,0,756,7,1400,637,261,495
17,DOLJ,"LICEUL TEHNOLOGIC UCECOM „SPIRU HARET”",23,"MUNICIPIUL CRAIOVA",69900,1,PART,PRCNCT,PRSD,PRSD_SV,"2025-05-18 22:27:08",1534,919,800,117,2,900,19,1600,681,322,578
17,DOLJ,"LICEUL ”VOLTAIRE”",24,"MUNICIPIUL CRAIOVA",69900,1,PART,PRCNCT,PRSD,PRSD_SV,"2025-05-18 22:12:39",1569,775,703,71,1,763,12,1700,925,311,452
17,DOLJ,"LICEUL ”VOLTAIRE”",25,"MUNICIPIUL CRAIOVA",69900,1,PART,PRCNCT,PRSD,PRSD_SV,"2025-05-18 21:51:22",1524,660,595,64,1,650,10,1600,940,329,321
17,DOLJ,"GRADINIŢA DE COPII CU PROGRAM PRELUNGIT ”ELENA FARAGO”(FOSTA NR.41)",26,"MUNICIPIUL CRAIOVA",69900,1,PART,PRCNCT,PRSD,PRSD_SV,"2025-05-18 21:30:17",768,453,376,77,0,448,5,800,347,186,262
17,DOLJ,"GRADINIŢA DE COPII CU PROGRAM PRELUNGIT ”ELENA FARAGO”(FOSTA NR. 41)",27,"MUNICIPIUL CRAIOVA",69900,1,PART,PRCNCT,PRSD,PRSD_SV,"2025-05-18 21:48:43",1191,633,550,83,0,625,8,1300,667,299,326
17,DOLJ,"ŞCOALA GIMNAZIALĂ „NICOLAE ROMANESCU”",28,"MUNICIPIUL CRAIOVA",69900,1,PART,PRCNCT,PRSD,PRSD_SV,"2025-05-18 21:39:00",1380,849,726,122,1,828,21,1500,651,298,530
17,DOLJ,"GRADINIŢA CU PROGRAM PRELUNGIT ”ION CREANGA” (FOSTA NR. 42)",29,"MUNICIPIUL CRAIOVA",69900,1,PART,PRCNCT,PRSD,PRSD_SV,"2025-05-18 21:35:13",1210,712,636,76,0,705,7,1300,588,241,464
17,DOLJ,"ŞCOALA GIMNAZIALĂ ”NICOLAE ROMANESCU” (FOSTA NR. 29)",30,"MUNICIPIUL CRAIOVA",69900,1,PART,PRCNCT,PRSD,PRSD_SV,"2025-05-18 21:39:22",1281,711,572,139,0,706,5,1400,689,364,342
17,DOLJ,"ŞCOALA GIMNAZIALĂ ”NICOLAE ROMANESCU” (FOSTA NR. 29)",31,"MUNICIPIUL CRAIOVA",69900,1,PART,PRCNCT,PRSD,PRSD_SV,"2025-05-18 21:28:57",1173,779,610,160,9,769,10,1300,521,308,461
17,DOLJ,"ŞCOALA GIMNAZIALĂ ”NICOLAE ROMANESCU” (FOSTA NR. 29)",32,"MUNICIPIUL CRAIOVA",69900,1,PART,PRCNCT,PRSD,PRSD_SV,"2025-05-18 21:47:12",1037,647,471,132,44,631,16,1100,453,304,327
17,DOLJ,"UNIVERSITATEA DE MEDICINĂ ŞI FARMACIE, (SEDIUL VECHI)",33,"MUNICIPIUL CRAIOVA",69900,1,PART,PRCNCT,PRSD,PRSD_SV,"2025-05-18 21:36:52",998,600,509,91,0,595,5,1100,500,183,412
17,DOLJ,"UNIVERSITATEA DE MEDICINĂ ŞI FARMACIE, (SEDIUL VECHI)",34,"MUNICIPIUL CRAIOVA",69900,1,PART,PRCNCT,PRSD,PRSD_SV,"2025-05-18 21:38:55",1046,666,593,73,0,664,2,1100,434,210,454
17,DOLJ,"LICEUL TEHNOLOGIC DE TRANSPORTURI AUTO",35,"MUNICIPIUL CRAIOVA",69900,1,PART,PRCNCT,PRSD,PRSD_SV,"2025-05-18 21:51:46",1992,1016,910,88,18,1005,11,2100,1084,504,501
17,DOLJ,"LICEUL TEHNOLOGIC DE TRANSPORTURI AUTO",36,"MUNICIPIUL CRAIOVA",69900,2,PART,PRCNCT,PRSD,PRSD_SV,"2025-05-19 00:44:55",1911,1026,950,68,8,1008,18,2000,974,467,541
17,DOLJ,"LICEUL TEHNOLOGIC DE TRANSPORTURI AUTO",37,"MUNICIPIUL CRAIOVA",69900,1,PART,PRCNCT,PRSD,PRSD_SV,"2025-05-18 21:46:25",1825,916,864,52,0,909,7,1900,984,463,446
17,DOLJ,"LICEUL TEHNOLOGIC DE TRANSPORTURI AUTO",38,"MUNICIPIUL CRAIOVA",69900,1,PART,PRCNCT,PRSD,PRSD_SV,"2025-05-18 21:55:04",1743,887,848,39,0,866,21,1800,913,431,435
17,DOLJ,"LICEUL TEHNOLOGIC DE TRANSPORTURI AUTO, (FOSTA ȘCOALĂ CU CLASELE I-VIII NR.25 FĂCĂI)",39,"MUNICIPIUL CRAIOVA",69900,1,PART,PRCNCT,PRSD,PRSD_SV,"2025-05-18 21:55:03",1158,600,415,80,105,593,7,1300,700,376,217
17,DOLJ,"ȘCOALA GIMNAZIALĂ ”GHEORGHE BIBESCU” STRUCTURA ȘCOALA PRIMARĂ NR. 27",40,"MUNICIPIUL CRAIOVA",69900,2,PART,PRCNCT,PRSD,PRSD_SV,"2025-05-18 22:26:37",853,482,431,51,0,472,10,900,418,219,253
17,DOLJ,"ȘCOALA GIMNAZIALA ”GHEORGHE BIBESCU” (FOSTA NR. 36)",41,"MUNICIPIUL CRAIOVA",69900,1,PART,PRCNCT,PRSD,PRSD_SV,"2025-05-18 22:11:31",1253,770,660,109,1,760,10,1300,530,274,486
17,DOLJ,"ȘCOALA GIMNAZIALA ”GHEORGHE BIBESCU” (FOSTA NR. 36)",42,"MUNICIPIUL CRAIOVA",69900,1,PART,PRCNCT,PRSD,PRSD_SV,"2025-05-18 22:14:17",1484,795,702,93,0,791,4,1600,805,312,479
17,DOLJ,"ȘCOALA GIMNAZIALA ”GHEORGHE BIBESCU” (FOSTA NR. 36)",43,"MUNICIPIUL CRAIOVA",69900,1,PART,PRCNCT,PRSD,PRSD_SV,"2025-05-18 22:03:32",1473,768,706,60,2,759,9,1600,832,274,485
17,DOLJ,"ȘCOALA GIMNAZIALA ”GHEORGHE BIBESCU” (FOSTA NR. 36)",44,"MUNICIPIUL CRAIOVA",69900,1,PART,PRCNCT,PRSD,PRSD_SV,"2025-05-18 22:01:35",1386,782,696,86,0,765,17,1500,718,308,457
17,DOLJ,"COLEGIUL NAȚIONAL ECONOMIC ”GHEORGHE CHIȚU”",45,"MUNICIPIUL CRAIOVA",69900,1,PART,PRCNCT,PRSD,PRSD_SV,"2025-05-18 22:00:09",1323,910,655,175,80,897,13,1500,590,378,519
17,DOLJ,"COLEGIUL NAȚIONAL ECONOMIC ”GHEORGHE CHIȚU”",46,"MUNICIPIUL CRAIOVA",69900,1,PART,PRCNCT,PRSD,PRSD_SV,"2025-05-18 22:18:12",1203,692,531,87,74,681,11,1400,708,303,378
17,DOLJ,"COLEGIUL NAŢIONAL ECONOMIC ”GHEORGHE CHIŢU”",47,"MUNICIPIUL CRAIOVA",69900,2,PART,PRCNCT,PRSD,PRSD_SV,"2025-05-19 00:45:38",1429,874,772,42,60,864,10,1600,726,300,564
17,DOLJ,"UNIVERSITATEA DE MEDICINA SI FARMACIE, (SEDIUL NOU)",48,"MUNICIPIUL CRAIOVA",69900,1,PART,PRCNCT,PRSD,PRSD_SV,"2025-05-18 21:58:26",1474,1134,742,297,95,1127,7,1600,466,349,778
17,DOLJ,"ŞCOALA GIMNAZIALĂ ”SFÂNTUL DUMITRU” (FOSTA NR. 18)",49,"MUNICIPIUL CRAIOVA",69900,1,PART,PRCNCT,PRSD,PRSD_SV,"2025-05-18 22:04:20",1015,708,578,128,2,699,9,1100,392,187,512
17,DOLJ,"LICEUL DE ARTE ”MARIN SORESCU”",50,"MUNICIPIUL CRAIOVA",69900,1,PART,PRCNCT,PRSD,PRSD_SV,"2025-05-18 21:50:08",1265,904,717,88,99,892,12,1400,496,267,625
17,DOLJ,"LICEUL DE ARTE ”MARIN SORESCU”",51,"MUNICIPIUL CRAIOVA",69900,1,PART,PRCNCT,PRSD,PRSD_SV,"2025-05-18 21:59:32",1340,928,732,99,97,921,7,1500,572,295,626
17,DOLJ,"COLEGIUL NATIONAL ”FRAŢII BUZEŞTI”",52,"MUNICIPIUL CRAIOVA",69900,1,PART,PRCNCT,PRSD,PRSD_SV,"2025-05-18 22:24:56",1753,1050,949,62,39,1038,12,1900,850,318,720
17,DOLJ,"COLEGIUL NATIONAL ”FRAŢII BUZEŞTI”",53,"MUNICIPIUL CRAIOVA",69900,1,PART,PRCNCT,PRSD,PRSD_SV,"2025-05-18 22:30:01",1634,1033,852,180,1,1019,14,1800,767,327,692
17,DOLJ,"ŞCOALA GIMNAZIALĂ ”LASCĂR CATARGIU” (FOSTA NR. 19)",54,"MUNICIPIUL CRAIOVA",69900,1,PART,PRCNCT,PRSD,PRSD_SV,"2025-05-18 22:33:11",1842,877,829,47,1,873,4,2000,1123,482,391
17,DOLJ,"ŞCOALA GIMNAZIALĂ ”LASCĂR CATARGIU” (FOSTA NR. 19)",55,"MUNICIPIUL CRAIOVA",69900,1,PART,PRCNCT,PRSD,PRSD_SV,"2025-05-18 22:09:13",1892,954,855,98,1,945,9,2000,1046,483,462
17,DOLJ,"ŞCOALA GIMNAZIALĂ ”LASCĂR CATARGIU” (FOSTA NR. 19)",56,"MUNICIPIUL CRAIOVA",69900,1,PART,PRCNCT,PRSD,PRSD_SV,"2025-05-18 22:13:18",1891,944,880,64,0,929,15,2000,1056,478,451
17,DOLJ,"ŞCOALA GIMNAZIALĂ ”LASCĂR CATARGIU” (FOSTA NR. 19)",57,"MUNICIPIUL CRAIOVA",69900,1,PART,PRCNCT,PRSD,PRSD_SV,"2025-05-18 22:41:08",1923,1041,976,41,24,1027,14,2000,959,473,554
17,DOLJ,"ŞCOALA GIMNAZIALA NR. 26 MOFLENI – STRUCTURĂ A ŞCOLII GIMNAZIALE ”ANTON PAN” (FOSTA NR.13 BUCOVĂŢ)",58,"MUNICIPIUL CRAIOVA",69900,1,PART,PRCNCT,PRSD,PRSD_SV,"2025-05-18 21:59:33",1314,601,546,54,1,592,9,1400,799,354,238
17,DOLJ,"ȘCOALA GIMNAZIALĂ ”ANTON PAN” (FOSTA NR.13 BUCOVĂȚ)",59,"MUNICIPIUL CRAIOVA",69900,1,PART,PRCNCT,PRSD,PRSD_SV,"2025-05-18 21:29:01",1840,438,408,30,0,429,9,1900,1462,257,172
17,DOLJ,"ŞCOALA GIMNAZIALĂ ”ANTON PAN” (FOSTA NR.13 BUCOVĂŢ)",60,"MUNICIPIUL CRAIOVA",69900,1,PART,PRCNCT,PRSD,PRSD_SV,"2025-05-18 21:43:18",1824,683,606,77,0,671,12,1900,1217,375,296
17,DOLJ,"COLEGIUL NAŢIONAL ”CAROL I”",61,"MUNICIPIUL CRAIOVA",69900,1,PART,PRCNCT,PRSD,PRSD_SV,"2025-05-18 21:49:53",827,637,479,158,0,629,8,900,263,176,453
17,DOLJ,"COLEGIUL NAȚIONAL ”CAROL I”",62,"MUNICIPIUL CRAIOVA",69900,1,PART,PRCNCT,PRSD,PRSD_SV,"2025-05-18 21:37:17",1242,662,605,56,1,654,8,1300,638,163,491
17,DOLJ,"FACULTATEA DE AGRONOMIE",63,"MUNICIPIUL CRAIOVA",69900,1,PART,PRCNCT,PRSD,PRSD_SV,"2025-05-18 22:03:11",2007,1090,884,202,4,1077,13,2100,1010,414,663
17,DOLJ,"FACULTATEA DE AGRONOMIE",64,"MUNICIPIUL CRAIOVA",69900,1,PART,PRCNCT,PRSD,PRSD_SV,"2025-05-18 22:29:28",1687,1065,906,91,68,1053,12,1800,735,317,736
17,DOLJ,"GRADINIŢA CU PROGRAM PRELUNGIT ”PARADISUL COPIILOR” (FOSTA NR. 24)",65,"MUNICIPIUL CRAIOVA",69900,1,PART,PRCNCT,PRSD,PRSD_SV,"2025-05-18 21:28:56",1188,620,567,53,0,615,5,1300,680,239,376
17,DOLJ,"GRADINIŢA CU PROGRAM PRELUNGIT ”PARADISUL COPIILOR”, (FOSTA NR. 24)",66,"MUNICIPIUL CRAIOVA",69900,1,PART,PRCNCT,PRSD,PRSD_SV,"2025-05-18 21:43:37",899,570,506,64,0,562,8,1000,430,207,355
17,DOLJ,"COLEGIUL TEHNIC DE INDUSTRIE ALIMENTARĂ",67,"MUNICIPIUL CRAIOVA",69900,1,PART,PRCNCT,PRSD,PRSD_SV,"2025-05-18 21:49:22",1713,901,839,62,0,887,14,1800,899,282,605
17,DOLJ,"COLEGIUL TEHNIC DE INDUSTRIE ALIMENTARĂ",68,"MUNICIPIUL CRAIOVA",69900,1,PART,PRCNCT,PRSD,PRSD_SV,"2025-05-18 21:28:10",1744,836,741,95,0,823,13,1900,1064,426,397
17,DOLJ,"COLEGIUL TEHNIC DE INDUSTRIE ALIMENTARĂ",69,"MUNICIPIUL CRAIOVA",69900,1,PART,PRCNCT,PRSD,PRSD_SV,"2025-05-18 21:35:15",1615,815,783,32,0,805,10,1700,885,349,456
17,DOLJ,"ŞCOALA GIMNAZIALĂ ”ION CREANGĂ” (FOSTA NR.16)",70,"MUNICIPIUL CRAIOVA",69900,1,PART,PRCNCT,PRSD,PRSD_SV,"2025-05-18 21:56:43",1784,988,883,105,0,981,7,1900,912,551,430
17,DOLJ,"ŞCOALA GIMNAZIALĂ ”ION CREANGĂ” (FOSTA NR.16)",71,"MUNICIPIUL CRAIOVA",69900,2,PART,PRCNCT,PRSD,PRSD_SV,"2025-05-19 00:17:29",1754,901,844,57,0,887,14,1800,899,468,419
17,DOLJ,"ŞCOALA GIMNAZIALĂ ”ION CREANGĂ” (FOSTA NR.16)",72,"MUNICIPIUL CRAIOVA",69900,1,PART,PRCNCT,PRSD,PRSD_SV,"2025-05-18 21:54:01",1663,774,727,47,0,758,16,1800,1026,502,256
17,DOLJ,"GRĂDINITA CU PROGRAM NORMAL ”CASA CU PITICI” (FOSTA NR. 15) – STRUCTURĂ A ŞCOLII GIMNAZIALE ”ION CREANGA” (FOSTĂ NR.16)",73,"MUNICIPIUL CRAIOVA",69900,1,PART,PRCNCT,PRSD,PRSD_SV,"2025-05-18 21:51:32",1653,896,812,84,0,889,7,1800,904,530,359
17,DOLJ,"RAT S.R.L.",74,"MUNICIPIUL CRAIOVA",69900,1,PART,PRCNCT,PRSD,PRSD_SV,"2025-05-18 21:44:53",1613,843,780,63,0,833,10,1700,857,339,494
17,DOLJ,"ȘCOALA GIMNAZIALĂ ”ELENA FARAGO” (FOSTA SCOALA GIMNAZIALA NR.34)",75,"MUNICIPIUL CRAIOVA",69900,1,PART,PRCNCT,PRSD,PRSD_SV,"2025-05-18 23:13:50",1558,893,813,80,0,881,12,1700,807,370,511
17,DOLJ,"ȘCOALA GIMNAZIALĂ ”ELENA FARAGO” (FOSTA SCOALA GIMNAZIALA NR.34)",76,"MUNICIPIUL CRAIOVA",69900,1,PART,PRCNCT,PRSD,PRSD_SV,"2025-05-18 21:46:04",1545,819,737,74,8,807,12,1600,781,351,456
17,DOLJ,"ȘCOALA GIMNAZIALĂ ”ELENA FARAGO” (FOSTA SCOALA GIMNAZIALA NR.34)",77,"MUNICIPIUL CRAIOVA",69900,1,PART,PRCNCT,PRSD,PRSD_SV,"2025-05-18 22:01:19",1616,892,808,84,0,867,25,1700,808,348,519
17,DOLJ,"ȘCOALA GIMNAZIALĂ ”ELENA FARAGO” (FOSTA SCOALA GIMNAZIALA NR.34)",78,"MUNICIPIUL CRAIOVA",69900,1,PART,PRCNCT,PRSD,PRSD_SV,"2025-05-18 21:54:26",1642,875,806,69,0,856,19,1700,825,327,529
17,DOLJ,"ȘCOALA GIMNAZIALĂ ”ELENA FARAGO” (FOSTA SCOALA GIMNAZIALA NR.33)",79,"MUNICIPIUL CRAIOVA",69900,1,PART,PRCNCT,PRSD,PRSD_SV,"2025-05-18 21:50:10",1626,846,725,121,0,838,8,1700,854,364,474
17,DOLJ,"ȘCOALA GIMNAZIALĂ ”ELENA FARAGO” (FOSTA SCOALA GIMNAZIALA NR.33)",80,"MUNICIPIUL CRAIOVA",69900,1,PART,PRCNCT,PRSD,PRSD_SV,"2025-05-18 21:42:02",1562,819,774,45,0,810,9,1700,881,328,482
17,DOLJ,"ȘCOALA GIMNAZIALĂ ”ELENA FARAGO” (FOSTA SCOALA GIMNAZIALA NR.33)",81,"MUNICIPIUL CRAIOVA",69900,1,PART,PRCNCT,PRSD,PRSD_SV,"2025-05-18 21:34:34",1407,674,642,32,0,667,7,1500,826,288,379
17,DOLJ,"GRADINIŢA CU PROGRAM PRELUNGIT ”PITICOT” (FOSTA NR.45)",82,"MUNICIPIUL CRAIOVA",69900,1,PART,PRCNCT,PRSD,PRSD_SV,"2025-05-18 22:01:41",1489,760,702,58,0,752,8,1600,840,361,391
17,DOLJ,"GRADINIŢA CU PROGRAM PRELUNGIT ”PITICOT” (FOSTA NR.45)",83,"MUNICIPIUL CRAIOVA",69900,1,PART,PRCNCT,PRSD,PRSD_SV,"2025-05-18 21:57:10",1116,587,538,48,1,578,9,1200,613,258,320
17,DOLJ,"GRADINIŢA CU PROGRAM PRELUNGIT ”PITICOT” (FOSTA NR.45)",84,"MUNICIPIUL CRAIOVA",69900,1,PART,PRCNCT,PRSD,PRSD_SV,"2025-05-18 21:40:13",942,500,466,34,0,495,5,1000,500,235,260
17,DOLJ,"GRADINIŢA CU PROGRAM PRELUNGIT ”FLOAREA SOARELUI” (FOSTA NR.51)",85,"MUNICIPIUL CRAIOVA",69900,1,PART,PRCNCT,PRSD,PRSD_SV,"2025-05-18 22:04:29",1144,631,591,40,0,625,6,1200,569,255,370
17,DOLJ,"GRADINIŢA CU PROGRAM PRELUNGIT ”FLOAREA SOARELUI” (FOSTA NR.51)",86,"MUNICIPIUL CRAIOVA",69900,1,PART,PRCNCT,PRSD,PRSD_SV,"2025-05-18 21:31:47",1208,601,557,44,0,592,9,1300,699,267,325
17,DOLJ,"GRADINIŢA CU PROGRAM PRELUNGIT ”FLOAREA SOARELUI” (FOSTA NR.51)",87,"MUNICIPIUL CRAIOVA",69900,1,PART,PRCNCT,PRSD,PRSD_SV,"2025-05-18 22:07:49",1130,590,538,52,0,584,6,1200,610,264,320
17,DOLJ,"ŞCOALA GIMNAZIALĂ ”ALEXANDRU MACEDONSKI” (FOSTA NR.32)",88,"MUNICIPIUL CRAIOVA",69900,1,PART,PRCNCT,PRSD,PRSD_SV,"2025-05-18 21:49:38",1460,871,709,162,0,858,13,1500,629,367,491
17,DOLJ,"ŞCOALA GIMNAZIALĂ ”ALEXANDRU MACEDONSKI” (FOSTA NR.32)",89,"MUNICIPIUL CRAIOVA",69900,1,PART,PRCNCT,PRSD,PRSD_SV,"2025-05-18 22:15:30",1526,803,719,84,0,788,15,1600,797,344,444
17,DOLJ,"ŞCOALA GIMNAZIALĂ ”ALEXANDRU MACEDONSKI” (FOSTA NR.32)",90,"MUNICIPIUL CRAIOVA",69900,1,PART,PRCNCT,PRSD,PRSD_SV,"2025-05-18 21:44:06",1636,763,707,55,1,758,5,1700,937,318,440
17,DOLJ,"ŞCOALA GIMNAZIALĂ ”ALEXANDRU MACEDONSKI” (FOSTA NR.32)",91,"MUNICIPIUL CRAIOVA",69900,1,PART,PRCNCT,PRSD,PRSD_SV,"2025-05-18 21:55:43",1499,779,731,47,1,765,14,1600,821,327,438
17,DOLJ,"GRĂDINIŢA CU PROGRAM PRELUNGIT ”FLOARE ALBASTRA” (FOSTA NR.40)",92,"MUNICIPIUL CRAIOVA",69900,1,PART,PRCNCT,PRSD,PRSD_SV,"2025-05-18 21:28:46",1157,620,549,71,0,611,9,1200,580,262,349
17,DOLJ,"GRĂDINIŢA CU PROGRAM PRELUNGIT ”FLOARE ALBASTRA” (FOSTA NR.40)",93,"MUNICIPIUL CRAIOVA",69900,1,PART,PRCNCT,PRSD,PRSD_SV,"2025-05-18 21:38:42",1370,681,615,66,0,668,13,1500,819,328,340
17,DOLJ,"ŞCOALA GIMNAZIALĂ ”MIHAI VITEAZU” (FOSTA NR.30)",94,"MUNICIPIUL CRAIOVA",69900,1,PART,PRCNCT,PRSD,PRSD_SV,"2025-05-18 21:54:18",1264,657,572,85,0,643,14,1300,643,327,316
17,DOLJ,"ŞCOALA GIMNAZIALĂ ”MIHAI VITEAZU” (FOSTA NR.30)",95,"MUNICIPIUL CRAIOVA",69900,1,PART,PRCNCT,PRSD,PRSD_SV,"2025-05-18 21:49:07",1411,724,616,106,2,714,10,1500,776,356,358
17,DOLJ,"ŞCOALA GIMNAZIALĂ ”MIHAI VITEAZU” (FOSTA NR.30)",96,"MUNICIPIUL CRAIOVA",69900,1,PART,PRCNCT,PRSD,PRSD_SV,"2025-05-18 21:56:23",1303,619,577,42,0,609,10,1400,781,247,362
17,DOLJ,"ŞCOALA GIMNAZIALĂ ”MIHAI VITEAZU” (FOSTA NR.30)",97,"MUNICIPIUL CRAIOVA",69900,1,PART,PRCNCT,PRSD,PRSD_SV,"2025-05-18 21:56:16",1213,613,568,44,1,605,8,1300,687,256,349
17,DOLJ,"ŞCOALA GIMNAZIALĂ ”MIHAI VITEAZU” (FOSTA NR.30)",98,"MUNICIPIUL CRAIOVA",69900,1,PART,PRCNCT,PRSD,PRSD_SV,"2025-05-18 21:56:25",1266,617,577,39,1,609,8,1300,683,293,316
17,DOLJ,"LICEUL TEHNOLOGIC ”GEORGE BIBESCU”",99,"MUNICIPIUL CRAIOVA",69900,1,PART,PRCNCT,PRSD,PRSD_SV,"2025-05-18 22:06:28",1127,675,507,168,0,672,3,1200,525,320,352
17,DOLJ,"LICEUL TEHNOLOGIC ”GEORGE BIBESCU”",100,"MUNICIPIUL CRAIOVA",69900,1,PART,PRCNCT,PRSD,PRSD_SV,"2025-05-18 21:56:06",1054,516,482,34,0,511,5,1100,584,227,284
17,DOLJ,"GRADINIŢA CU PROGRAM PRELUNGIT ”PHOENIX” (FOSTA NR.52)",101,"MUNICIPIUL CRAIOVA",69900,1,PART,PRCNCT,PRSD,PRSD_SV,"2025-05-18 22:18:19",1056,560,520,40,0,548,12,1100,540,269,279
17,DOLJ,"GRADINITA CU PROGRAM PRELUNGIT ”PHOENIX” (FOSTA NR. 52)",102,"MUNICIPIUL CRAIOVA",69900,2,PART,PRCNCT,PRSD,PRSD_SV,"2025-05-18 23:20:17",1053,604,501,103,0,594,10,1100,496,253,341
17,DOLJ,"COLEGIUL TEHNIC ”COSTIN D. NENITESCU”",103,"MUNICIPIUL CRAIOVA",69900,1,PART,PRCNCT,PRSD,PRSD_SV,"2025-05-18 21:44:56",1522,835,775,60,0,821,14,1600,765,291,530
17,DOLJ,"COLEGIUL TEHNIC ”COSTIN D. NENIŢESCU”",104,"MUNICIPIUL CRAIOVA",69900,1,PART,PRCNCT,PRSD,PRSD_SV,"2025-05-18 21:46:31",1743,1011,856,154,1,1003,8,1800,789,345,658
17,DOLJ,"COLEGIUL TEHNIC ”COSTIN D. NENIŢESCU”",105,"MUNICIPIUL CRAIOVA",69900,1,PART,PRCNCT,PRSD,PRSD_SV,"2025-05-18 21:49:53",1402,734,672,60,2,723,11,1500,766,294,429
17,DOLJ,"COLEGIUL TEHNIC ”COSTIN D. NENIŢESCU”",106,"MUNICIPIUL CRAIOVA",69900,1,PART,PRCNCT,PRSD,PRSD_SV,"2025-05-18 21:44:33",1469,790,725,65,0,784,6,1500,710,309,475
17,DOLJ,"COLEGIUL TEHNIC ”COSTIN D. NENIŢESCU”",107,"MUNICIPIUL CRAIOVA",69900,1,PART,PRCNCT,PRSD,PRSD_SV,"2025-05-18 22:04:20",1477,756,712,44,0,743,13,1500,744,311,432
17,DOLJ,"ŞCOALA GIMNAZIALĂ ”DECEBAL” (FOSTA NR. 12)",108,"MUNICIPIUL CRAIOVA",69900,1,PART,PRCNCT,PRSD,PRSD_SV,"2025-05-18 21:44:03",1277,713,624,88,1,702,11,1400,687,228,474
17,DOLJ,"ŞCOALA GIMNAZIALĂ ”DECEBAL” (FOSTA NR. 12)",109,"MUNICIPIUL CRAIOVA",69900,1,PART,PRCNCT,PRSD,PRSD_SV,"2025-05-18 22:30:36",1297,780,723,56,1,763,17,1400,620,247,516
17,DOLJ,"ŞCOALA GIMNAZIALĂ ”DECEBAL” (FOSTA NR. 12)",110,"MUNICIPIUL CRAIOVA",69900,1,PART,PRCNCT,PRSD,PRSD_SV,"2025-05-18 22:15:57",1370,835,751,84,0,817,18,1400,565,250,567
17,DOLJ,"COLEGIUL TEHNIC ENERGETIC",111,"MUNICIPIUL CRAIOVA",69900,1,PART,PRCNCT,PRSD,PRSD_SV,"2025-05-18 21:44:34",1485,918,830,87,1,907,11,1600,682,317,590
17,DOLJ,"COLEGIUL TEHNIC ENERGETIC",112,"MUNICIPIUL CRAIOVA",69900,1,PART,PRCNCT,PRSD,PRSD_SV,"2025-05-18 21:46:18",1498,965,797,150,18,954,11,1600,635,373,581
17,DOLJ,"COLEGIUL TEHNIC ENERGETIC",113,"MUNICIPIUL CRAIOVA",69900,1,PART,PRCNCT,PRSD,PRSD_SV,"2025-05-18 22:22:49",1210,711,637,74,0,704,7,1300,589,266,438
17,DOLJ,"COLEGIUL NAŢIONAL PEDAGOGIC ”ŞTEFAN VELOVAN”",114,"MUNICIPIUL CRAIOVA",69900,1,PART,PRCNCT,PRSD,PRSD_SV,"2025-05-18 22:16:43",1872,1048,936,112,0,1037,11,2000,952,427,610
17,DOLJ,"COLEGIUL NAŢIONAL PEDAGOGIC ”ŞTEFAN VELOVAN”",115,"MUNICIPIUL CRAIOVA",69900,1,PART,PRCNCT,PRSD,PRSD_SV,"2025-05-18 23:13:50",1553,941,802,137,2,926,15,1600,659,298,628
17,DOLJ,"GRĂDINIŢA CU PROGRAM PRELUNGIT ”CASUTA CU POVESTI” (FOSTA NR.43)",116,"MUNICIPIUL CRAIOVA",69900,1,PART,PRCNCT,PRSD,PRSD_SV,"2025-05-18 22:10:08",1529,813,721,92,0,800,13,1600,787,297,503
17,DOLJ,"GRADINITA CU PROGRAM PRELUNGIT ”CASUTA CU POVESTI” (FOSTA NR. 43)",117,"MUNICIPIUL CRAIOVA",69900,1,PART,PRCNCT,PRSD,PRSD_SV,"2025-05-18 21:53:56",1334,717,680,37,0,708,9,1400,683,222,486
17,DOLJ,"GRĂDINIŢA CU PROGRAM PRELUNGIT ”VOINICEII” (FOSTA NR.32)",118,"MUNICIPIUL CRAIOVA",69900,1,PART,PRCNCT,PRSD,PRSD_SV,"2025-05-18 21:42:52",1297,711,660,49,2,702,9,1400,689,209,493
17,DOLJ,"GRĂDINIŢA CU PROGRAM PRELUNGIT ”VOINICEII” (FOSTA NR.32)",119,"MUNICIPIUL CRAIOVA",69900,1,PART,PRCNCT,PRSD,PRSD_SV,"2025-05-18 21:42:37",1255,736,651,85,0,721,15,1300,564,260,461
17,DOLJ,"ŞCOALA GIMNAZIALĂ ”SFÂNTU GHEORGHE” (FOSTA NR.24)",120,"MUNICIPIUL CRAIOVA",69900,1,PART,PRCNCT,PRSD,PRSD_SV,"2025-05-18 22:28:42",1567,946,802,143,1,940,6,1700,754,294,646
17,DOLJ,"ŞCOALA GIMNAZIALĂ ”SFÂNTU GHEORGHE” (FOSTA NR.24)",121,"MUNICIPIUL CRAIOVA",69900,1,PART,PRCNCT,PRSD,PRSD_SV,"2025-05-18 22:30:50",1280,767,660,107,0,762,5,1400,633,236,526
17,DOLJ,"ŞCOALA GIMNAZIALĂ ”SFÂNTU GHEORGHE” (FOSTA NR.24)",122,"MUNICIPIUL CRAIOVA",69900,1,PART,PRCNCT,PRSD,PRSD_SV,"2025-05-18 21:53:52",1387,855,738,117,0,839,16,1500,645,333,506
17,DOLJ,"LICEUL TEHNOLOGIC TRANSPORTURI CĂI FERATE",123,"MUNICIPIUL CRAIOVA",69900,1,PART,PRCNCT,PRSD,PRSD_SV,"2025-05-18 21:41:56",943,607,528,78,1,600,7,1000,393,185,415
17,DOLJ,"LICEUL TEHNOLOGIC TRANSPORTURI CĂI FERATE",124,"MUNICIPIUL CRAIOVA",69900,1,PART,PRCNCT,PRSD,PRSD_SV,"2025-05-18 21:52:59",928,574,506,68,0,571,3,1000,426,153,418
17,DOLJ,"COLEGIUL NAȚIONAL ”NICOLAE TITULESCU”",125,"MUNICIPIUL CRAIOVA",69900,1,PART,PRCNCT,PRSD,PRSD_SV,"2025-05-18 22:21:31",1587,983,850,132,1,966,17,1700,717,290,676
17,DOLJ,"ŞCOALA GIMNAZIALĂ ”TRAIAN” (FOSTA NR. 2)",126,"MUNICIPIUL CRAIOVA",69900,1,PART,PRCNCT,PRSD,PRSD_SV,"2025-05-18 21:50:56",958,618,562,54,2,612,6,1000,382,141,471
17,DOLJ,"ŞCOALA GIMNAZIALĂ ”TRAIAN” (FOSTA NR.2)",127,"MUNICIPIUL CRAIOVA",69900,1,PART,PRCNCT,PRSD,PRSD_SV,"2025-05-18 21:49:16",1066,678,607,69,2,674,4,1100,422,156,518
17,DOLJ,"GRĂDINIŢA CU PROGRAM PRELUNGIT ”TUDOR VLADIMIRESCU” (FOSTA NR.21)",128,"MUNICIPIUL CRAIOVA",69900,2,PART,PRCNCT,PRSD,PRSD_SV,"2025-05-19 00:33:43",1600,1013,920,93,0,1001,12,1800,787,309,692
17,DOLJ,"ŞCOALA GIMNAZIALĂ „SF. GHEORGHE” (FOSTA SCOALA CU CLASELE I - VIII NR.23)",129,"MUNICIPIUL CRAIOVA",69900,1,PART,PRCNCT,PRSD,PRSD_SV,"2025-05-18 22:20:13",1578,922,833,88,1,912,10,1700,778,281,631
17,DOLJ,"ŞCOALA GIMNAZIALĂ „SF. GHEORGHE” (FOSTA SCOALA CU CLASELE I - VIII NR.23)",130,"MUNICIPIUL CRAIOVA",69900,1,PART,PRCNCT,PRSD,PRSD_SV,"2025-05-18 21:59:01",1530,863,816,47,0,852,11,1700,837,271,581
17,DOLJ,"ŞCOALA GIMNAZIALĂ „SF. GHEORGHE” (FOSTA SCOALA CU CLASELE I - VIII NR.23)",131,"MUNICIPIUL CRAIOVA",69900,1,PART,PRCNCT,PRSD,PRSD_SV,"2025-05-18 21:49:20",1481,839,797,42,0,826,13,1600,761,273,553
17,DOLJ,"ȘCOALA GIMNAZIALĂ SF. GHEORGHE (FOSTA ȘCOALĂ CU CLASELE I-VIII, NR. 23",132,"MUNICIPIUL CRAIOVA",69900,1,PART,PRCNCT,PRSD,PRSD_SV,"2025-05-18 21:36:48",1078,654,568,86,0,642,12,1200,546,255,387
17,DOLJ,"ȘCOALA GIMNAZIALĂ SF. GHEORGHE (FOSTA ȘCOALĂ CU CLASELE I-VIII, NR. 23)",133,"MUNICIPIUL CRAIOVA",69900,1,PART,PRCNCT,PRSD,PRSD_SV,"2025-05-18 22:19:04",1478,915,804,110,1,901,14,1600,685,282,619
17,DOLJ,"ŞCOALA GIMNAZIALĂ ”ION ŢUCULESCU” (FOSTA NR. 14)",134,"MUNICIPIUL CRAIOVA",69900,1,PART,PRCNCT,PRSD,PRSD_SV,"2025-05-18 22:10:44",1821,1041,953,86,2,1035,6,2000,959,439,596
17,DOLJ,"ŞCOALA GIMNAZIALĂ ”ION ŢUCULESCU” (FOSTA NR. 14)",135,"MUNICIPIUL CRAIOVA",69900,2,PART,PRCNCT,PRSD,PRSD_SV,"2025-05-19 01:51:04",1889,1227,1044,84,99,1208,19,2100,873,550,658
17,DOLJ,"GRĂDINIȚA CU PROGRAM NORMAL” ÎNGERAȘII” (FOSTĂ NR.5)",136,"MUNICIPIUL CRAIOVA",69900,1,PART,PRCNCT,PRSD,PRSD_SV,"2025-05-18 21:56:30",1608,937,863,72,2,920,17,1700,763,456,464
17,DOLJ,"CREȘA CRAIOVA,STRUCTURA 10",137,"MUNICIPIUL CRAIOVA",69900,1,PART,PRCNCT,PRSD,PRSD_SV,"2025-05-18 22:41:59",1360,909,815,94,0,898,11,1400,491,419,479
17,DOLJ,"GRĂDINIŢA CU PROGRAM NORMAL NR.16-STRUCTURĂ A ŞCOLII GIMNAZIALE ”ION ŢUCULESCU” (FOSTA NR.14)",138,"MUNICIPIUL CRAIOVA",69900,1,PART,PRCNCT,PRSD,PRSD_SV,"2025-05-18 22:30:02",1762,1144,1086,57,1,1131,13,1900,756,479,652
17,DOLJ,"GRĂDINIȚA CU PROGRAM NORMAL ”ÎNGERAȘII” ( FOSTA NR. 5)",139,"MUNICIPIUL CRAIOVA",69900,1,PART,PRCNCT,PRSD,PRSD_SV,"2025-05-18 22:05:39",1955,1141,1094,45,2,1132,9,2000,859,558,574
17,DOLJ,"SUCURSALA REGIONALĂ CF CRAIOVA",140,"MUNICIPIUL CRAIOVA",69900,1,PART,PRCNCT,PRSD,PRSD_SV,"2025-05-18 22:16:23",1251,754,650,104,0,742,12,1400,646,242,500
17,DOLJ,"SUCURSALA REGIONALĂ CF CRAIOVA",141,"MUNICIPIUL CRAIOVA",69900,1,PART,PRCNCT,PRSD,PRSD_SV,"2025-05-18 21:57:31",1343,852,681,170,1,842,10,1500,648,304,538
17,DOLJ,"GRĂDINIŢA CU PROGRAM PRELUNGIT ”SF. LUCIA” (FOSTA NR.50)",142,"MUNICIPIUL CRAIOVA",69900,1,PART,PRCNCT,PRSD,PRSD_SV,"2025-05-18 21:49:39",854,548,497,51,0,540,8,900,352,164,376
17,DOLJ,"GRĂDINIŢA CU PROGRAM PRELUNGIT ”SF. LUCIA” (FOSTA NR.50)",143,"MUNICIPIUL CRAIOVA",69900,1,PART,PRCNCT,PRSD,PRSD_SV,"2025-05-18 21:39:22",826,482,450,32,0,475,7,900,418,144,331
17,DOLJ,"GRĂDINIŢA CU PROGRAM PRELUNGIT ”PETRACHE POENARU” (FOSTA SCOALA CU CLASELE I VIII NR.9 PETRACHE POENARU)",144,"MUNICIPIUL CRAIOVA",69900,2,PART,PRCNCT,PRSD,PRSD_SV,"2025-05-18 23:43:34",1535,1156,882,69,205,1138,18,1700,544,451,687
17,DOLJ,"GRĂDINIŢA CU PROGRAM PRELUNGIT ”PETRACHE POENARU” (FOSTA SCOALA CU CLASELE I VIII NR.9 PETRACHE POENARU)",145,"MUNICIPIUL CRAIOVA",69900,1,PART,PRCNCT,PRSD,PRSD_SV,"2025-05-18 21:56:04",1062,934,565,125,244,922,12,1200,266,376,546
17,DOLJ,"ŞCOALA GIMNAZIALĂ ”GHEORGHE ŢIŢEICA” (FOSTA NR. 21)",146,"MUNICIPIUL CRAIOVA",69900,1,PART,PRCNCT,PRSD,PRSD_SV,"2025-05-18 22:21:09",1334,918,723,112,83,909,9,1400,482,247,662
17,DOLJ,"ŞCOALA GIMNAZIALĂ ”GHEORGHE ŢIŢEICA” (FOSTA NR. 21)",147,"MUNICIPIUL CRAIOVA",69900,1,PART,PRCNCT,PRSD,PRSD_SV,"2025-05-18 22:06:57",1320,890,729,160,1,881,9,1400,510,274,607
17,DOLJ,"GRĂDINIŢA CU PROGRAM PRELUNGIT ”PINOCHIO”",148,"MUNICIPIUL CRAIOVA",69900,1,PART,PRCNCT,PRSD,PRSD_SV,"2025-05-18 22:00:37",1068,676,602,74,0,669,7,1100,424,193,476
17,DOLJ,"PRIMĂRIA MUNICIPIULUI CRAIOVA, (FOSTA ŞCOALA CU CLASELE I-VIII NR.35 „I.D. SÎRBU”)”",149,"MUNICIPIUL CRAIOVA",69900,1,PART,PRCNCT,PRSD,PRSD_SV,"2025-05-18 21:23:25",988,530,494,36,0,522,8,1100,570,149,373
17,DOLJ,"PRIMĂRIA MUNICIPIULUI CRAIOVA, (FOSTA ŞCOALA CU CLASELE I-VIII NR.35 „I.D. SÎRBU”)",150,"MUNICIPIUL CRAIOVA",69900,1,PART,PRCNCT,PRSD,PRSD_SV,"2025-05-18 21:31:11",930,556,510,45,1,548,8,1000,444,182,366
17,DOLJ,"PRIMĂRIA MUNICIPIULUI CRAIOVA, (FOSTA ŞCOALA CU CLASELE I-VIII NR.35 „I.D. SÎRBU”)",151,"MUNICIPIUL CRAIOVA",69900,1,PART,PRCNCT,PRSD,PRSD_SV,"2025-05-18 21:27:40",1076,667,570,97,0,662,5,1200,533,202,460
17,DOLJ,"LICEUL ”MATEI BASARAB”",152,"MUNICIPIUL CRAIOVA",69900,1,PART,PRCNCT,PRSD,PRSD_SV,"2025-05-18 21:50:46",910,481,461,19,1,470,11,1000,519,126,344
17,DOLJ,"LICEUL ”MATEI BASARAB”",153,"MUNICIPIUL CRAIOVA",69900,2,PART,PRCNCT,PRSD,PRSD_SV,"2025-05-18 22:50:44",836,712,387,64,261,703,9,1000,288,422,281
17,DOLJ,"LICEUL TEORETIC ”TUDOR ARGHEZI”",154,"MUNICIPIUL CRAIOVA",69900,1,PART,PRCNCT,PRSD,PRSD_SV,"2025-05-18 22:04:40",1258,826,665,161,0,817,9,1300,474,295,522
17,DOLJ,"LICEUL TEORETIC ”TUDOR ARGHEZI”",155,"MUNICIPIUL CRAIOVA",69900,1,PART,PRCNCT,PRSD,PRSD_SV,"2025-05-18 21:47:30",1248,764,687,77,0,757,7,1300,536,245,512
17,DOLJ,"LICEUL TEORETIC ”TUDOR ARGHEZI”",156,"MUNICIPIUL CRAIOVA",69900,1,PART,PRCNCT,PRSD,PRSD_SV,"2025-05-18 21:44:45",1247,677,629,47,1,660,17,1400,723,223,437
17,DOLJ,"ŞCOALA GIMNAZIALĂ ”NICOLAE BĂLCESCU” (FOSTA NR.39)",157,"MUNICIPIUL CRAIOVA",69900,1,PART,PRCNCT,PRSD,PRSD_SV,"2025-05-18 21:45:23",1561,908,873,34,1,896,12,1700,792,306,590
17,DOLJ,"ŞCOALA GIMNAZIALĂ ”NICOLAE BĂLCESCU” (FOSTA NR.39)",158,"MUNICIPIUL CRAIOVA",69900,1,PART,PRCNCT,PRSD,PRSD_SV,"2025-05-18 21:56:44",1177,679,616,63,0,674,5,1300,621,225,449
17,DOLJ,"ŞCOALA GIMNAZIALĂ ”NICOLAE BĂLCESCU” (FOSTA NR.39)",159,"MUNICIPIUL CRAIOVA",69900,1,PART,PRCNCT,PRSD,PRSD_SV,"2025-05-18 22:10:02",1356,815,714,101,0,808,7,1400,585,292,516
17,DOLJ,"ŞCOALA GIMNAZIALĂ ”NICOLAE BĂLCESCU” (FOSTA NR.39)",160,"MUNICIPIUL CRAIOVA",69900,1,PART,PRCNCT,PRSD,PRSD_SV,"2025-05-18 22:09:16",1281,879,680,199,0,859,20,1400,521,306,553
17,DOLJ,"GRĂDINIŢA CU PROGRAM NORMAL NR.14 ”LUCEAFĂRUL” – STRUCTURĂ A ŞCOLII GIMNAZIALE ”NICOLAE BĂLCESCU” (FOSTA NR.39)",161,"MUNICIPIUL CRAIOVA",69900,1,PART,PRCNCT,PRSD,PRSD_SV,"2025-05-18 22:20:14",1310,798,697,99,2,791,7,1400,602,242,549
17,DOLJ,"FACULTATEA DE MECANICĂ",162,"MUNICIPIUL CRAIOVA",69900,1,PART,PRCNCT,PRSD,PRSD_SV,"2025-05-18 22:50:19",923,763,512,251,0,754,9,1000,237,204,550
17,DOLJ,"LICEUL TEHNOLOGIC AUTO",163,"MUNICIPIUL CRAIOVA",69900,1,PART,PRCNCT,PRSD,PRSD_SV,"2025-05-18 21:58:26",1529,853,772,81,0,844,9,1600,747,329,515
17,DOLJ,"LICEUL TEHNOLOGIC AUTO",164,"MUNICIPIUL CRAIOVA",69900,1,PART,PRCNCT,PRSD,PRSD_SV,"2025-05-18 21:27:50",1204,719,597,122,0,711,8,1300,581,218,493
17,DOLJ,"PUNCTUL TERMIC NR.1 LĂPUȘ (LÂNGĂ BL.23 - BLD. DECEBAL NR.66B)",165,"MUNICIPIUL CRAIOVA",69900,1,PART,PRCNCT,PRSD,PRSD_SV,"2025-05-18 21:32:39",1364,841,758,83,0,829,12,1400,559,279,550
17,DOLJ,"PUNCTUL TERMIC NR.2 LĂPUȘ (LÂNGĂ BL. 59 - BLD. DECEBAL NR.55B)",166,"MUNICIPIUL CRAIOVA",69900,1,PART,PRCNCT,PRSD,PRSD_SV,"2025-05-18 21:48:36",1608,1035,969,66,0,1024,11,1700,665,393,631
17,DOLJ,"PRIMĂRIA MUNICIPIULUI CRAIOVA DIRECŢIA DE ASISTENŢĂ ŞI PROTECŢIE SOCIALĂ",167,"MUNICIPIUL CRAIOVA",69900,1,PART,PRCNCT,PRSD,PRSD_SV,"2025-05-18 22:06:32",1303,860,721,136,3,850,10,1400,540,368,482
17,DOLJ,"PRIMĂRIA MUNICIPIULUI CRAIOVA-DIRECŢIA DE ASISTENŢĂ ŞI PROTECŢIE SOCIALĂ",168,"MUNICIPIUL CRAIOVA",69900,1,PART,PRCNCT,PRSD,PRSD_SV,"2025-05-18 22:22:23",1395,843,780,62,1,829,14,1500,657,318,511
17,DOLJ,"ŞCOALA GIMNAZIALĂ NR.38 - STRUCTURĂ A ŞCOLII GIMNAZIALE ”ION CREANGA” (FOSTĂ NR.16)",169,"MUNICIPIUL CRAIOVA",69900,1,PART,PRCNCT,PRSD,PRSD_SV,"2025-05-18 21:42:02",1500,908,816,92,0,890,18,1600,692,498,392
17,DOLJ,"ŞCOALA GIMNAZIALĂ NR.38 - STRUCTURĂ A ŞCOLII GIMNAZIALE ”ION CREANGA” (FOSTĂ NR.16)",170,"MUNICIPIUL CRAIOVA",69900,2,PART,PRCNCT,PRSD,PRSD_SV,"2025-05-18 23:19:10",1774,870,776,94,0,857,13,1900,1030,558,299
17,DOLJ,"ŞCOALA GIMNAZIALĂ NR.38 - STRUCTURĂ A ŞCOLII GIMNAZIALE ”ION CREANGA” (FOSTĂ NR.16)",171,"MUNICIPIUL CRAIOVA",69900,1,PART,PRCNCT,PRSD,PRSD_SV,"2025-05-18 21:36:08",1472,824,777,45,2,815,9,1500,676,444,371
17,DOLJ,"GRĂDINIŢA CU PROGRAM NORMAL ROVINE 2 – STRUCTURĂ A ŞCOLII GIMNAZIALE ”ION CREANGA” (FOSTĂ NR.16)",172,"MUNICIPIUL CRAIOVA",69900,1,PART,PRCNCT,PRSD,PRSD_SV,"2025-05-18 21:38:35",570,330,303,27,0,326,4,600,270,223,103
17,DOLJ,"ŞCOALA PRIMARĂ IZVORUL RECE – STRUCTURĂ A ŞCOLII GIMNAZIALE ”DECEBAL” (FOSTĂ NR.12)",173,"MUNICIPIUL CRAIOVA",69900,1,PART,PRCNCT,PRSD,PRSD_SV,"2025-05-18 21:33:49",677,398,358,40,0,395,3,800,402,220,175
17,DOLJ,"ŞCOALA GIMNAZIALĂ NR. 1 BĂILEȘTI",174,"MUNICIPIUL BĂILEŞTI",70316,2,PART,PRCNCT,PRSD,PRSD_SV,"2025-05-19 01:52:21",1373,518,485,33,0,510,8,1500,982,303,207
17,DOLJ,"ȘCOALA GIMNAZIALĂ NR. 1 BĂILEȘTI",175,"MUNICIPIUL BĂILEŞTI",70316,1,PART,PRCNCT,PRSD,PRSD_SV,"2025-05-18 21:28:09",1051,354,321,33,0,352,2,1100,746,203,149
17,DOLJ,"ŞCOALA GIMNAZIALĂ NR. 3 BĂILEȘTI",176,"MUNICIPIUL BĂILEŞTI",70316,2,PART,PRCNCT,PRSD,PRSD_SV,"2025-05-19 00:19:29",470,161,135,26,0,161,0,500,339,102,59
17,DOLJ,"ŞCOALA GIMNAZIALĂ NR. 3 BĂILEȘTI",177,"MUNICIPIUL BĂILEŞTI",70316,1,PART,PRCNCT,PRSD,PRSD_SV,"2025-05-18 21:35:29",633,238,219,19,0,236,2,700,462,154,82
17,DOLJ,"ŞCOALA GIMNAZIALĂ NR. 3 BĂILEȘTI",178,"MUNICIPIUL BĂILEŞTI",70316,1,PART,PRCNCT,PRSD,PRSD_SV,"2025-05-18 21:35:18",836,310,288,22,0,306,4,900,590,193,113
17,DOLJ,"ŞCOALA GIMNAZIALĂ NR. 5 ”AV. P. IVANOVICI” BĂILEȘTI",179,"MUNICIPIUL BĂILEŞTI",70316,1,PART,PRCNCT,PRSD,PRSD_SV,"2025-05-18 21:34:23",886,373,312,61,0,372,1,1000,627,220,152
17,DOLJ,"GRĂDINIŢA CU PROGRAM PRELUNGIT NR. 7 BĂILEȘTI",180,"MUNICIPIUL BĂILEŞTI",70316,1,PART,PRCNCT,PRSD,PRSD_SV,"2025-05-18 21:36:16",718,325,309,16,0,321,4,800,475,176,145
17,DOLJ,"LICEUL TEORETIC ”MIHAI VITEAZUL” BĂILEȘTI",181,"MUNICIPIUL BĂILEŞTI",70316,2,PART,PRCNCT,PRSD,PRSD_SV,"2025-05-19 00:35:02",899,360,336,23,1,359,1,1000,640,197,162
17,DOLJ,"ŞCOALA GIMNAZIALĂ”AMZA PELLEA” BĂILEȘTI",182,"MUNICIPIUL BĂILEŞTI",70316,1,PART,PRCNCT,PRSD,PRSD_SV,"2025-05-18 21:35:30",1435,523,488,35,0,521,2,1500,977,296,225
17,DOLJ,"ŞCOALA GIMNAZIALĂ ”AMZA PELLEA ” BĂILEȘTI",183,"MUNICIPIUL BĂILEŞTI",70316,1,PART,PRCNCT,PRSD,PRSD_SV,"2025-05-18 21:30:34",975,386,365,21,0,380,6,1000,614,205,175
17,DOLJ,"ŞCOALA GIMNAZIALĂ ”AMZA PELLEA ” BĂILEȘTI",184,"MUNICIPIUL BĂILEŞTI",70316,1,PART,PRCNCT,PRSD,PRSD_SV,"2025-05-18 21:30:41",715,305,264,41,0,302,3,800,495,164,138
17,DOLJ,"GRĂDINIŢA CU PROGRAM NORMAL NR. 8 BĂILEȘTI",185,"MUNICIPIUL BĂILEŞTI",70316,1,PART,PRCNCT,PRSD,PRSD_SV,"2025-05-18 21:42:08",1292,557,529,28,0,553,4,1400,843,285,268
17,DOLJ,"LICEUL TEHNOLOGIC” ŞTEFAN ANGHEL” BĂILEȘTI",186,"MUNICIPIUL BĂILEŞTI",70316,1,PART,PRCNCT,PRSD,PRSD_SV,"2025-05-18 21:26:39",624,266,239,26,1,266,0,700,434,143,123
17,DOLJ,"GRĂDINIŢA CU PROGRAM NORMAL NR. 2 BĂILEȘTI",187,"MUNICIPIUL BĂILEŞTI",70316,1,PART,PRCNCT,PRSD,PRSD_SV,"2025-05-18 21:27:18",991,346,322,24,0,342,4,1100,754,217,125
17,DOLJ,"ŞCOALA GIMNAZIALĂ NR. 6 BĂILEȘTI",188,"MUNICIPIUL BĂILEŞTI",70316,1,PART,PRCNCT,PRSD,PRSD_SV,"2025-05-18 21:39:15",1256,573,507,52,14,560,13,1300,727,327,233
17,DOLJ,"ŞCOALA PRIMARĂ BALASAN",189,"MUNICIPIUL BĂILEŞTI",70316,1,PART,PRCNCT,PRSD,PRSD_SV,"2025-05-18 21:30:04",467,228,212,16,0,225,3,500,272,170,55
17,DOLJ,"SC. GENERALA NR. 1 CALAFAT",190,"MUNICIPIUL CALAFAT",70352,1,PART,PRCNCT,PRSD,PRSD_SV,"2025-05-18 21:43:28",1384,792,602,126,64,779,13,1500,708,356,423
17,DOLJ,"LICEUL TEORETIC INDEPENDENȚA CORP A",191,"MUNICIPIUL CALAFAT",70352,1,PART,PRCNCT,PRSD,PRSD_SV,"2025-05-18 21:45:14",1815,932,861,71,0,917,15,1900,968,447,470
17,DOLJ,"ŞCOALA GIMNAZIALĂ GHEORGHE BRĂESCU-GRĂDINIŢA CU PROGRAM NORMAL NR. 4",192,"MUNICIPIUL CALAFAT",70352,1,PART,PRCNCT,PRSD,PRSD_SV,"2025-05-18 22:14:24",1365,630,584,46,0,625,5,1500,870,267,358
17,DOLJ,"ŞCOALA GENERALĂ CONSTANTIN GEROTĂ (NR.2)-LOCAL VECHI",193,"MUNICIPIUL CALAFAT",70352,1,PART,PRCNCT,PRSD,PRSD_SV,"2025-05-18 21:54:57",1721,771,680,91,0,760,11,1900,1129,360,400
17,DOLJ,"ŞCOALA GENERALĂ CONSTANTIN GEROTĂ (NR.2)-LOCAL VECHI",194,"MUNICIPIUL CALAFAT",70352,1,PART,PRCNCT,PRSD,PRSD_SV,"2025-05-18 21:55:06",1539,641,602,39,0,637,4,1600,959,301,336
17,DOLJ,"ŞCOALA GENERALĂ CONSTANTIN GEROTĂ (NR. 2)-LOCAL NOU",195,"MUNICIPIUL CALAFAT",70352,1,PART,PRCNCT,PRSD,PRSD_SV,"2025-05-18 22:11:22",1513,698,630,67,1,688,10,1600,902,333,355
17,DOLJ,"ŞCOALA GENERALĂ CONSTANTIN GEROTĂ(NR. 2)-LOCAL NOU",196,"MUNICIPIUL CALAFAT",70352,1,PART,PRCNCT,PRSD,PRSD_SV,"2025-05-18 21:49:19",1578,703,647,54,2,697,6,1700,997,324,373
17,DOLJ,"CAMINUL CULTURAL BASARABI (DIN CADRUL CASEI DE CULTURA CALAFAT )",197,"MUNICIPIUL CALAFAT",70352,1,PART,PRCNCT,PRSD,PRSD_SV,"2025-05-18 21:46:45",839,497,418,79,0,491,6,900,403,229,262
17,DOLJ,"CAMINUL CULTURAL CIUPERCENII VECHII ( DIN CADRUL CASEI DE CULTURA CALAFAT )",198,"MUNICIPIUL CALAFAT",70352,1,PART,PRCNCT,PRSD,PRSD_SV,"2025-05-18 21:47:58",1711,759,709,50,0,753,6,1900,1141,432,321
17,DOLJ,"ŞCOALA GOLENŢI",199,"MUNICIPIUL CALAFAT",70352,1,PART,PRCNCT,PRSD,PRSD_SV,"2025-05-18 21:33:18",385,214,175,39,0,212,2,500,286,97,115
17,DOLJ,"LICEUL TEORETIC BECHET",200,"ORAŞ BECHET",70879,1,PART,PRCNCT,PRSD,PRSD_SV,"2025-05-18 21:54:12",1408,528,444,79,5,524,4,1500,972,313,211
17,DOLJ,"SCOALA PRIMARA BECHET VALE",201,"ORAŞ BECHET",70879,1,PART,PRCNCT,PRSD,PRSD_SV,"2025-05-18 21:49:40",619,266,232,34,0,262,4,700,434,144,118
17,DOLJ,"BIBLIOTECA ORASENEASCA BECHET",202,"ORAŞ BECHET",70879,1,PART,PRCNCT,PRSD,PRSD_SV,"2025-05-18 21:46:26",1298,422,351,52,19,408,14,1400,978,261,147
17,DOLJ,"STRUCTURA SCOLII GIMNAZIALE NR. 1 DABULENI",203,"ORAŞ DĂBULENI",72007,1,PART,PRCNCT,PRSD,PRSD_SV,"2025-05-18 22:22:30",1551,810,754,50,6,802,8,1700,890,391,411
17,DOLJ,"CLUBUL COPIILOR DABULENI",204,"ORAŞ DĂBULENI",72007,1,PART,PRCNCT,PRSD,PRSD_SV,"2025-05-18 22:18:06",1366,849,712,94,43,838,11,1500,651,375,463
17,DOLJ,"SCOALA GIMNAZIALA CU CLASELE I-VIII NR.1 DABULENI, NORD",205,"ORAŞ DĂBULENI",72007,1,PART,PRCNCT,PRSD,PRSD_SV,"2025-05-18 22:07:44",1385,847,718,115,14,835,12,1500,653,386,449
17,DOLJ,"SCOALA GIMNAZIALA CU CLASELE I-VIII NR.1 DABULENI, SUD",206,"ORAŞ DĂBULENI",72007,1,PART,PRCNCT,PRSD,PRSD_SV,"2025-05-18 21:45:07",1546,838,778,59,1,825,13,1600,762,415,410
17,DOLJ,"LICEUL TEORETIC CONSTANTIN BRANCOVEANU",207,"ORAŞ DĂBULENI",72007,1,PART,PRCNCT,PRSD,PRSD_SV,"2025-05-18 21:57:17",1033,565,509,49,7,561,4,1100,535,211,350
17,DOLJ,"LICEUL TEORETIC CONSTANTIN BRANCOVEANU (FOSTA SCOALA NR. 3, INTRARE ELEVI)",208,"ORAŞ DĂBULENI",72007,1,PART,PRCNCT,PRSD,PRSD_SV,"2025-05-18 22:12:51",1245,749,680,69,0,740,9,1300,551,358,382
17,DOLJ,"LICEUL TEORETIC CONSTANTIN BRANCOVEANU (FOSTA SCOALA NR. 3, INTRARE PROFESORI)",209,"ORAŞ DĂBULENI",72007,2,PART,PRCNCT,PRSD,PRSD_SV,"2025-05-19 01:48:23",1154,599,555,41,3,594,5,1200,601,286,308
17,DOLJ,"BIBLIOTECA ORĂȘENEASCĂ ANTON PANN",210,"ORAŞ FILIAŞI",70414,1,PART,PRCNCT,PRSD,PRSD_SV,"2025-05-18 21:29:21",1299,683,597,82,4,677,6,1400,717,378,299
17,DOLJ,"GRĂDINIŢA NR. 1 FILIAŞI",211,"ORAŞ FILIAŞI",70414,1,PART,PRCNCT,PRSD,PRSD_SV,"2025-05-18 21:43:28",1741,933,883,50,0,920,13,1900,967,559,361
17,DOLJ,"GRĂDINIŢA NR. 2 FILIAŞI",212,"ORAŞ FILIAŞI",70414,1,PART,PRCNCT,PRSD,PRSD_SV,"2025-05-18 21:38:37",1825,838,713,77,48,822,16,1900,1062,578,244
17,DOLJ,"GRĂDINIŢA NR. 3 FILIAŞI",213,"ORAŞ FILIAŞI",70414,1,PART,PRCNCT,PRSD,PRSD_SV,"2025-05-18 21:31:53",1214,627,568,59,0,624,3,1300,673,391,233
17,DOLJ,"LICEUL TEHNOLOGIC DIMITRIE FILIŞANU CORP C 2",214,"ORAŞ FILIAŞI",70414,1,PART,PRCNCT,PRSD,PRSD_SV,"2025-05-18 21:42:50",1633,763,696,67,0,750,13,1700,937,460,290
17,DOLJ,"PRIMĂRIA ORAŞULUI FILIAŞI",215,"ORAŞ FILIAŞI",70414,1,PART,PRCNCT,PRSD,PRSD_SV,"2025-05-18 21:48:59",1516,828,733,95,0,823,5,1600,772,426,397
17,DOLJ,"ŞCOALA GIMNAZIALĂ FILIAŞI",216,"ORAŞ FILIAŞI",70414,1,PART,PRCNCT,PRSD,PRSD_SV,"2025-05-18 21:50:33",1322,769,700,67,2,760,9,1400,631,414,346
17,DOLJ,"ŞCOALA BÎLTA",217,"ORAŞ FILIAŞI",70414,1,PART,PRCNCT,PRSD,PRSD_SV,"2025-05-18 21:45:56",923,481,449,32,0,473,8,1000,519,346,127
17,DOLJ,"SCOALA GIMNAZIALĂ FRATOŞTIŢA - CORP 1",218,"ORAŞ FILIAŞI",70414,1,PART,PRCNCT,PRSD,PRSD_SV,"2025-05-18 21:38:39",1260,626,601,24,1,619,7,1300,674,444,175
17,DOLJ,"ŞCOALA GIMNAZIALĂ FRATOŞTITA - CORP 2",219,"ORAŞ FILIAŞI",70414,1,PART,PRCNCT,PRSD,PRSD_SV,"2025-05-18 21:23:37",734,297,281,16,0,295,2,800,503,239,56
17,DOLJ,"ŞCOALA RĂCARII DE SUS",220,"ORAŞ FILIAŞI",70414,1,PART,PRCNCT,PRSD,PRSD_SV,"2025-05-18 21:46:34",916,507,470,37,0,505,2,1000,493,301,204
17,DOLJ,"LICEUL TEHNOLOGIC HORIA VINTILĂ",221,"ORAŞ ŞEGARCEA",70502,1,PART,PRCNCT,PRSD,PRSD_SV,"2025-05-18 22:29:01",1560,805,704,101,0,794,11,1700,895,492,302
17,DOLJ,"SCOALA CU CLASELE I-VIII",222,"ORAŞ ŞEGARCEA",70502,1,PART,PRCNCT,PRSD,PRSD_SV,"2025-05-18 22:30:24",1467,454,416,38,0,448,6,1600,1146,319,129
17,DOLJ,"BIBLIOTECA ORĂŞENEASCĂ MIRCEA RĂDINA",223,"ORAŞ ŞEGARCEA",70502,1,PART,PRCNCT,PRSD,PRSD_SV,"2025-05-18 22:46:42",1516,781,714,67,0,763,18,1600,819,500,263
17,DOLJ,"CLUBUL COPIILOR",224,"ORAŞ ŞEGARCEA",70502,1,PART,PRCNCT,PRSD,PRSD_SV,"2025-05-18 22:35:56",1661,778,720,58,0,771,7,1800,1022,443,328
17,DOLJ,"CONSILIUL LOCAL AFUMATI",225,AFUMAŢI,70520,1,PART,PRCNCT,PRSD,PRSD_SV,"2025-05-18 21:31:18",878,438,369,69,0,435,3,1000,562,253,182
17,DOLJ,"CAMINUL CULTURAL BOURENI",226,AFUMAŢI,70520,1,PART,PRCNCT,PRSD,PRSD_SV,"2025-05-18 21:25:39",773,415,317,97,1,413,2,900,485,235,178
17,DOLJ,"CAMINUL CULTURAL COVEI",227,AFUMAŢI,70520,1,PART,PRCNCT,PRSD,PRSD_SV,"2025-05-18 21:15:55",354,194,144,50,0,194,0,400,206,122,72
17,DOLJ,"ŞCOALA GIMNAZIALĂ ”ION GHE. PLEŞA”",228,ALMĂJ,70566,1,PART,PRCNCT,PRSD,PRSD_SV,"2025-05-18 21:43:05",1051,619,507,108,4,610,9,1200,581,307,303
17,DOLJ,"ŞCOALA PRIMARĂ ŞITOAIA",229,ALMĂJ,70566,1,PART,PRCNCT,PRSD,PRSD_SV,"2025-05-18 21:32:01",519,356,315,41,0,351,5,600,244,240,111
17,DOLJ,"CĂMINUL CULTURAL",230,"AMĂRĂŞTII DE JOS",70637,1,PART,PRCNCT,PRSD,PRSD_SV,"2025-05-18 22:14:12",1071,603,479,107,17,592,11,1200,597,279,313
17,DOLJ,"GRADINITA TOSCA",231,"AMĂRĂŞTII DE JOS",70637,1,PART,PRCNCT,PRSD,PRSD_SV,"2025-05-18 21:45:39",929,490,424,65,1,485,5,1000,510,275,210
17,DOLJ,"GRADINITA OCOLNA",232,"AMĂRĂŞTII DE JOS",70637,1,PART,PRCNCT,PRSD,PRSD_SV,"2025-05-18 21:53:17",1081,418,403,15,0,396,22,1200,782,350,46
17,DOLJ,"GRĂDINIŢA PRAPOR",233,"AMĂRĂŞTII DE JOS",70637,1,PART,PRCNCT,PRSD,PRSD_SV,"2025-05-18 22:28:31",997,509,444,64,1,502,7,1100,591,287,215
17,DOLJ,"CĂMINUL CULTURAL",234,"AMĂRĂŞTII DE SUS",70673,1,PART,PRCNCT,PRSD,PRSD_SV,"2025-05-18 21:38:56",1239,821,623,149,49,813,8,1400,579,397,416
17,DOLJ,"CĂMIN CULTURAL",235,"APELE VII",70726,1,PART,PRCNCT,PRSD,PRSD_SV,"2025-05-18 21:48:54",1607,814,669,118,27,805,9,1800,986,484,321
17,DOLJ,"ȘCOALA PROFESIONALĂ C-TIN ARGETOAIANU",236,ARGETOAIA,70744,1,PART,PRCNCT,PRSD,PRSD_SV,"2025-05-18 21:23:03",1112,471,418,53,0,464,7,1200,729,376,88
17,DOLJ,"ȘCOALA PROFESIONALĂ C-TIN ARGETOAIANU",237,ARGETOAIA,70744,1,PART,PRCNCT,PRSD,PRSD_SV,"2025-05-18 21:21:27",681,347,303,44,0,343,4,800,453,235,108
17,DOLJ,"ȘCOALA. PRIMARĂ LEORDOASA",238,ARGETOAIA,70744,1,PART,PRCNCT,PRSD,PRSD_SV,"2025-05-18 21:18:29",396,146,137,9,0,146,0,500,354,127,19
17,DOLJ,"GRĂDINIȚA CU PROGRAM NORMAL NOVACU",239,ARGETOAIA,70744,1,PART,PRCNCT,PRSD,PRSD_SV,"2025-05-18 21:19:09",223,122,103,19,0,121,1,300,178,94,27
17,DOLJ,"ȘCOALA. PRIMARĂ PIRIA",240,ARGETOAIA,70744,1,PART,PRCNCT,PRSD,PRSD_SV,"2025-05-18 21:19:53",262,119,99,20,0,117,2,300,181,69,48
17,DOLJ,"ȘCOALA. GIMNAZIALĂ SALCIA",241,ARGETOAIA,70744,1,PART,PRCNCT,PRSD,PRSD_SV,"2025-05-18 21:27:42",949,558,469,88,1,555,3,1100,542,358,197
17,DOLJ,"CAMINUL CULTURAL",242,BÂRCA,70940,1,PART,PRCNCT,PRSD,PRSD_SV,"2025-05-18 21:38:01",1624,594,469,124,1,589,5,1800,1206,351,238
17,DOLJ,"GRADINITA DE COPII",243,BÂRCA,70940,1,PART,PRCNCT,PRSD,PRSD_SV,"2025-05-18 21:41:48",1477,530,473,57,0,523,7,1600,1070,301,222
17,DOLJ,"CĂMINUL CULTURAL BISTREȚ",244,BISTREŢ,70897,1,PART,PRCNCT,PRSD,PRSD_SV,"2025-05-18 21:41:45",1004,483,416,67,0,473,10,1100,617,292,181
17,DOLJ,"ȘCOALA GIMNAZIALĂ BISTREȚ",245,BISTREŢ,70897,1,PART,PRCNCT,PRSD,PRSD_SV,"2025-05-18 21:25:17",783,359,299,60,0,352,7,900,541,216,136
17,DOLJ,"GRĂDINIȚA BISTRETU NOU",246,BISTREŢ,70897,1,PART,PRCNCT,PRSD,PRSD_SV,"2025-05-18 21:27:16",600,234,186,48,0,228,6,700,466,148,80
17,DOLJ,"ȘCOALA PRIMARĂ PLOSCA",247,BISTREŢ,70897,1,PART,PRCNCT,PRSD,PRSD_SV,"2025-05-18 21:50:49",634,371,289,68,14,364,7,700,329,215,149
17,DOLJ,"CĂMINUL CULTURAL",248,BOTOŞEŞTI-PAIA,70968,1,PART,PRCNCT,PRSD,PRSD_SV,"2025-05-18 21:59:55",513,344,252,79,13,338,6,700,356,223,115
17,DOLJ,"ȘCOALA GIMNAZIALĂ ILIE MARTIN BRABOVA",249,BRABOVA,70986,1,PART,PRCNCT,PRSD,PRSD_SV,"2025-05-18 21:27:32",421,204,162,42,0,199,5,500,296,91,108
17,DOLJ,"ȘCOALA CU CLASELE I-IV MOSNA",250,BRABOVA,70986,1,PART,PRCNCT,PRSD,PRSD_SV,"2025-05-18 21:26:50",110,65,44,21,0,64,1,300,235,25,39
17,DOLJ,"CĂMINUL CULTURAL RĂCHITA DE JOS",251,BRABOVA,70986,1,PART,PRCNCT,PRSD,PRSD_SV,"2025-05-18 21:18:38",214,158,114,44,0,156,2,300,142,67,89
17,DOLJ,"CĂMINUL CULTURAL URDINIȚA",252,BRABOVA,70986,1,PART,PRCNCT,PRSD,PRSD_SV,"2025-05-18 21:09:05",195,122,77,45,0,122,0,300,178,62,60
17,DOLJ,"SALA DE SEDINȚE A CONSILIULUI LOCAL BRALOȘTIȚA",253,BRALOŞTIŢA,71126,1,PART,PRCNCT,PRSD,PRSD_SV,"2025-05-18 21:28:36",609,338,283,54,1,335,3,700,362,192,143
17,DOLJ,"ŞCOALA DIN SATUL CIOCANE",254,BRALOŞTIŢA,71126,1,PART,PRCNCT,PRSD,PRSD_SV,"2025-05-18 21:36:10",685,366,347,17,2,359,7,800,434,213,146
17,DOLJ,"ŞCOALA DIN SATUL SCHITU",255,BRALOŞTIŢA,71126,1,PART,PRCNCT,PRSD,PRSD_SV,"2025-05-18 21:26:58",399,281,260,21,0,279,2,500,219,186,93
17,DOLJ,"SCOALA DIN SATUL SFIRCEA",256,BRALOŞTIŢA,71126,1,PART,PRCNCT,PRSD,PRSD_SV,"2025-05-18 22:12:58",792,429,379,48,2,423,6,900,471,255,168
17,DOLJ,"ŞCOALA DIN SATUL VALEA FÎNTÎNILOR",257,BRALOŞTIŢA,71126,1,PART,PRCNCT,PRSD,PRSD_SV,"2025-05-18 21:34:38",539,317,280,36,1,316,1,600,283,129,187
17,DOLJ,"CĂMIN CULTURAL",258,BRATOVOEŞTI,71199,1,PART,PRCNCT,PRSD,PRSD_SV,"2025-05-18 21:48:35",1108,529,456,73,0,526,3,1200,671,328,198
17,DOLJ,"ȘCOALA PRIMARĂ BĂDOȘI",259,BRATOVOEŞTI,71199,1,PART,PRCNCT,PRSD,PRSD_SV,"2025-05-18 21:30:09",690,362,311,51,0,362,0,800,438,239,123
17,DOLJ,"ȘCOALA PRIMARĂ GEOROCU MARE",260,BRATOVOEŞTI,71199,1,PART,PRCNCT,PRSD,PRSD_SV,"2025-05-18 21:31:27",376,204,161,40,3,203,1,400,196,125,78
17,DOLJ,"ȘCOALA PRIMARĂ PRUNET",261,BRATOVOEŞTI,71199,1,PART,PRCNCT,PRSD,PRSD_SV,"2025-05-18 21:35:12",479,277,222,54,1,275,2,600,323,160,115
17,DOLJ,"ŞCOALA GIMNAZIALĂ ”IOAN GRECESCU ” BRĂDEŞTI",262,BRĂDEŞTI,71055,1,PART,PRCNCT,PRSD,PRSD_SV,"2025-05-18 21:59:56",1599,858,737,121,0,845,13,1700,842,507,338
17,DOLJ,"GRĂDINIŢA CU PROGRAM NORMAL BRĂDEŞTII BĂTRÂNI",263,BRĂDEŞTI,71055,1,PART,PRCNCT,PRSD,PRSD_SV,"2025-05-18 21:28:10",309,176,147,29,0,172,4,400,224,115,57
17,DOLJ,"SCOALA GENERALA PISCANI",264,BRĂDEŞTI,71055,1,PART,PRCNCT,PRSD,PRSD_SV,"2025-05-18 21:12:28",57,38,23,15,0,35,3,200,162,15,20
17,DOLJ,"GRĂDINIŢA CU PROGRAM NORMAL ” CURCUBEUL ” RĂCARI",265,BRĂDEŞTI,71055,1,PART,PRCNCT,PRSD,PRSD_SV,"2025-05-18 21:42:58",916,517,448,69,0,515,2,1000,483,388,127
17,DOLJ,"GRĂDINIȚA CU PROGRAM PRELUNGIT ” DUMITRU CONSTANTINESCU ” TATOMIREŞTI",266,BRĂDEŞTI,71055,2,PART,PRCNCT,PRSD,PRSD_SV,"2025-05-18 23:31:27",817,469,431,38,0,463,6,900,431,347,116
17,DOLJ,"ŞCOALA BREASTA",267,BREASTA,71260,1,PART,PRCNCT,PRSD,PRSD_SV,"2025-05-18 21:42:30",1384,679,588,91,0,673,6,1500,821,405,268
17,DOLJ,"ŞCOALA BREASTA",268,BREASTA,71260,1,PART,PRCNCT,PRSD,PRSD_SV,"2025-05-18 21:51:12",1042,522,460,61,1,513,9,1100,578,330,183
17,DOLJ,"ŞCOALA OBEDIN",269,BREASTA,71260,1,PART,PRCNCT,PRSD,PRSD_SV,"2025-05-18 21:39:25",555,270,223,47,0,266,4,600,330,208,58
17,DOLJ,"ŞCOALA VALEA LUNGULUI",270,BREASTA,71260,1,PART,PRCNCT,PRSD,PRSD_SV,"2025-05-18 21:28:38",606,305,279,26,0,302,3,700,395,222,80
17,DOLJ,"SCOALA GENERALA CU CLASELE L-VLLL BUCOVAT",271,BUCOVĂŢ,69964,1,PART,PRCNCT,PRSD,PRSD_SV,"2025-05-18 21:51:06",1672,1131,859,272,0,1128,3,1800,669,623,505
17,DOLJ,"SCOALA GENERALA CU CLASELE L-LV LEAMNA DE JOS",272,BUCOVĂŢ,69964,1,PART,PRCNCT,PRSD,PRSD_SV,"2025-05-18 21:23:59",354,272,207,63,2,269,3,400,128,147,122
17,DOLJ,"SCOALA GENERALA CU CLASELE L-LV LEAMNA DE SUS",273,BUCOVĂŢ,69964,1,PART,PRCNCT,PRSD,PRSD_SV,"2025-05-18 21:21:25",350,308,193,61,54,299,9,400,92,166,133
17,DOLJ,"SCOALA GENERALA CU CLASELE L-VLLL PALILULA",274,BUCOVĂŢ,69964,1,PART,PRCNCT,PRSD,PRSD_SV,"2025-05-18 21:19:51",626,301,256,45,0,292,9,700,399,212,80
17,DOLJ,"SCOALA GENERALA CU CLASELE L-VLLL SARBATOAREA",275,BUCOVĂŢ,69964,1,PART,PRCNCT,PRSD,PRSD_SV,"2025-05-18 21:39:05",624,336,280,56,0,333,3,700,364,223,110
17,DOLJ,"CĂMINUL CULTURAL",276,BULZEŞTI,71340,1,PART,PRCNCT,PRSD,PRSD_SV,"2025-05-18 21:17:49",569,368,243,125,0,362,6,700,332,211,151
17,DOLJ,"PUNCT INFORMARE, PRIMĂRIA BULZEŞTI",277,BULZEŞTI,71340,1,PART,PRCNCT,PRSD,PRSD_SV,"2025-05-18 21:19:33",457,271,186,85,0,264,7,500,229,149,115
17,DOLJ,"ȘCOALA CU CLS.I-VIII CALOPĂR",278,CALOPĂR,71457,1,PART,PRCNCT,PRSD,PRSD_SV,"2025-05-18 21:28:13",1108,525,417,108,0,521,4,1200,675,320,201
17,DOLJ,"ȘCOALA CU CLS I-VIII BELCINU",279,CALOPĂR,71457,1,PART,PRCNCT,PRSD,PRSD_SV,"2025-05-18 21:19:57",405,203,165,38,0,201,2,500,297,120,81
17,DOLJ,"ȘCOALA CU CLS I-IV PANAGHIA",280,CALOPĂR,71457,1,PART,PRCNCT,PRSD,PRSD_SV,"2025-05-18 21:22:21",587,285,236,49,0,280,5,700,415,174,106
17,DOLJ,"CĂMIN CULTURAL SĂLCUȚA",281,CALOPĂR,71457,1,PART,PRCNCT,PRSD,PRSD_SV,"2025-05-18 21:27:31",931,240,223,17,0,239,1,1100,860,184,55
17,DOLJ,"CĂMINUL CULTURAL",282,CARAULA,71518,1,PART,PRCNCT,PRSD,PRSD_SV,"2025-05-18 21:27:28",927,467,387,80,0,461,6,1000,533,293,168
17,DOLJ,"CENTRUL SOCIAL CARAULA",283,CARAULA,71518,1,PART,PRCNCT,PRSD,PRSD_SV,"2025-05-18 21:33:13",1001,315,283,31,1,304,11,1100,785,231,73
17,DOLJ,"CĂMINUL CULTURAL CARPEN",284,CARPEN,71536,2,PART,PRCNCT,PRSD,PRSD_SV,"2025-05-19 00:19:14",679,305,246,49,10,295,10,800,495,201,94
17,DOLJ,"CĂMINUL CULTURAL CLEANOV",285,CARPEN,71536,1,PART,PRCNCT,PRSD,PRSD_SV,"2025-05-18 21:41:54",978,398,337,61,0,388,10,1100,702,255,133
17,DOLJ,"CAMINUL CULTURAL",286,CASTRANOVA,71572,2,PART,PRCNCT,PRSD,PRSD_SV,"2025-05-19 00:45:02",1494,1101,806,211,84,1093,8,1700,599,418,675
17,DOLJ,"ŞCOALA PUŢURI",287,CASTRANOVA,71572,1,PART,PRCNCT,PRSD,PRSD_SV,"2025-05-18 22:00:43",1056,691,522,141,28,689,2,1200,509,302,387
17,DOLJ,"SCOALA GIMNAZIALA CATANE",288,CATANE,74842,1,PART,PRCNCT,PRSD,PRSD_SV,"2025-05-18 21:51:04",1433,569,439,85,45,563,6,1600,1031,204,359
17,DOLJ,"ȘCOALA GIMNAZIALĂ NR. 1 CĂLĂRAȘI",289,CĂLĂRAŞI,71607,1,PART,PRCNCT,PRSD,PRSD_SV,"2025-05-18 22:21:21",1407,733,646,62,25,721,12,1500,767,334,387
17,DOLJ,"ŞCOALA GIMNAZIALĂ NR. 1 CĂLĂRAŞI",290,CĂLĂRAŞI,71607,1,PART,PRCNCT,PRSD,PRSD_SV,"2025-05-18 22:24:13",1590,914,762,97,55,901,13,1700,786,450,451
17,DOLJ,"ŞCOALA GIMNAZIALĂ SĂRATA",291,CĂLĂRAŞI,71607,1,PART,PRCNCT,PRSD,PRSD_SV,"2025-05-18 22:11:53",1525,832,720,85,27,829,3,1700,868,438,391
17,DOLJ,"CENTRUL CULTURAL",292,CÂRCEA,74859,1,PART,PRCNCT,PRSD,PRSD_SV,"2025-05-18 22:15:12",1668,1292,942,324,26,1280,12,1800,508,449,831
17,DOLJ,"LICEUL TEHNOLOGIC ”CONSTANTIN IANCULESCU”",293,CÂRCEA,74859,1,PART,PRCNCT,PRSD,PRSD_SV,"2025-05-18 22:15:57",1741,1245,971,247,27,1230,15,1900,655,392,838
17,DOLJ,"SCOALA CU CLS. I-VIII CÂRNA",294,CÂRNA,74867,1,PART,PRCNCT,PRSD,PRSD_SV,"2025-05-18 21:37:52",1015,570,457,81,32,562,8,1200,630,319,243
17,DOLJ,"SCOALA NOUA CELARU",295,CELARU,71634,1,PART,PRCNCT,PRSD,PRSD_SV,"2025-05-18 21:46:17",1393,661,531,130,0,656,5,1500,839,402,254
17,DOLJ,"CAMIN CULTURAL GHIZDAVESTI",296,CELARU,71634,1,PART,PRCNCT,PRSD,PRSD_SV,"2025-05-18 21:50:10",1188,606,493,111,2,596,10,1300,694,372,224
17,DOLJ,"CAMIN CULTURAL MAROTINU DE JOS",297,CELARU,71634,1,PART,PRCNCT,PRSD,PRSD_SV,"2025-05-18 21:36:16",463,215,161,54,0,213,2,600,385,121,92
17,DOLJ,"CAMIN CULTURAL MAROTINU DE SUS",298,CELARU,71634,1,PART,PRCNCT,PRSD,PRSD_SV,"2025-05-18 21:41:03",412,216,161,55,0,212,4,500,284,119,93
17,DOLJ,"CĂMINUL CULTURAL CERĂT",299,CERĂT,71698,1,PART,PRCNCT,PRSD,PRSD_SV,"2025-05-18 21:32:24",1989,710,641,69,0,698,12,2100,1390,440,258
17,DOLJ,"ȘCOALA GIMNAZIALĂ CERĂT - GRĂDINIȚA CU PROGRAM NORMAL NR.2 CERĂT (PREȘCOLARI)",300,CERĂT,71698,1,PART,PRCNCT,PRSD,PRSD_SV,"2025-05-18 21:31:50",1243,263,234,29,0,256,7,1400,1137,166,90
17,DOLJ,"CENTRUL AFTER SCHOOL CERNĂTEȘTI",301,CERNĂTEŞTI,71723,1,PART,PRCNCT,PRSD,PRSD_SV,"2025-05-18 21:26:14",346,222,160,62,0,222,0,400,178,115,107
17,DOLJ,"CENTRUL AFTER SCHOOL CERNĂTEȘTI",302,CERNĂTEŞTI,71723,1,PART,PRCNCT,PRSD,PRSD_SV,"2025-05-18 21:23:54",331,153,106,47,0,149,4,400,247,83,66
17,DOLJ,"ŞCOALA GENERALĂ",303,CERNĂTEŞTI,71723,1,PART,PRCNCT,PRSD,PRSD_SV,"2025-05-18 21:23:13",230,145,109,36,0,144,1,400,255,79,65
17,DOLJ,"ŞCOALA GENERALĂ",304,CERNĂTEŞTI,71723,1,PART,PRCNCT,PRSD,PRSD_SV,"2025-05-18 21:28:49",387,211,178,33,0,209,2,500,289,126,83
17,DOLJ,"SCOALA CU CLS. I-IV CETATE",305,CETATE,71787,1,PART,PRCNCT,PRSD,PRSD_SV,"2025-05-18 22:39:38",1620,738,614,66,58,729,9,1700,962,295,434
17,DOLJ,"CĂMINUL CULTURAL CETATE",306,CETATE,71787,1,PART,PRCNCT,PRSD,PRSD_SV,"2025-05-18 22:26:56",1383,765,546,114,105,750,15,1500,735,351,399
17,DOLJ,"SCOALA CU CLS. I-VIII F-B",307,CETATE,71787,1,PART,PRCNCT,PRSD,PRSD_SV,"2025-05-18 21:40:56",702,406,313,52,41,402,4,800,394,172,230
17,DOLJ,"SCOALA CU CLS. I-IV MORENI",308,CETATE,71787,1,PART,PRCNCT,PRSD,PRSD_SV,"2025-05-18 21:51:54",390,228,182,33,13,226,2,500,272,130,96
17,DOLJ,"ȘCOALA CU CLASELE I-VIII CIOROIAȘI",309,CIOROIAŞI,71812,1,PART,PRCNCT,PRSD,PRSD_SV,"2025-05-18 21:35:01",750,360,272,87,1,351,9,900,540,200,151
17,DOLJ,"ȘCOALA CU CLASELE I-IV CIOROIU NOU",310,CIOROIAŞI,71812,1,PART,PRCNCT,PRSD,PRSD_SV,"2025-05-18 21:38:18",374,212,161,51,0,207,5,500,288,98,109
17,DOLJ,"ȘCOALA GIMNAZIALĂ ”NICOLAE CARAȘ ”",311,"CIUPERCENII NOI",71858,1,PART,PRCNCT,PRSD,PRSD_SV,"2025-05-18 21:40:21",1437,618,560,58,0,613,5,1600,982,397,216
17,DOLJ,"SCOALA GENERALA CIUPERCENII NOI",312,"CIUPERCENII NOI",71858,1,PART,PRCNCT,PRSD,PRSD_SV,"2025-05-18 21:43:36",1714,731,690,41,0,728,3,1900,1169,478,250
17,DOLJ,"SCOALA GENERALA SMÎRDAN",313,"CIUPERCENII NOI",71858,1,PART,PRCNCT,PRSD,PRSD_SV,"2025-05-18 21:34:42",960,430,383,47,0,425,5,1100,670,269,156
17,DOLJ,"CAMIN CULTURAL",314,COŞOVENI,71885,1,PART,PRCNCT,PRSD,PRSD_SV,"2025-05-18 22:17:14",972,536,420,111,5,530,6,1100,564,316,214
17,DOLJ,"GRADINITA NR. 1",315,COŞOVENI,71885,1,PART,PRCNCT,PRSD,PRSD_SV,"2025-05-18 21:50:38",1098,665,560,99,6,660,5,1200,535,365,295
17,DOLJ,"GRADINITA NR. 2",316,COŞOVENI,71885,1,PART,PRCNCT,PRSD,PRSD_SV,"2025-05-18 21:50:13",760,473,373,95,5,465,8,900,427,243,222
17,DOLJ,"CĂMINUL CULTURAL",317,"COŢOFENII DIN DOS",71910,1,PART,PRCNCT,PRSD,PRSD_SV,"2025-05-18 21:31:03",841,500,420,80,0,499,1,1000,500,327,172
17,DOLJ,"SCOALA GIMNAZIALA MIHAITA",318,"COŢOFENII DIN DOS",71910,2,PART,PRCNCT,PRSD,PRSD_SV,"2025-05-18 23:35:09",621,373,292,81,0,368,5,700,327,232,136
17,DOLJ,"GRADINITA CU POGRAM NORMAL POTMELTU",319,"COŢOFENII DIN DOS",71910,1,PART,PRCNCT,PRSD,PRSD_SV,"2025-05-18 21:16:50",419,251,223,28,0,251,0,500,249,188,63
17,DOLJ,"ŞCOALA CU CLASELE I-VIII COȚOFENII DIN FAŢĂ",320,"COŢOFENII DIN FAŢĂ",74875,1,PART,PRCNCT,PRSD,PRSD_SV,"2025-05-18 21:19:09",1311,633,541,85,7,628,5,1500,867,428,200
17,DOLJ,"ȘCOALA CU CLASELE I-IV",321,"COŢOFENII DIN FAŢĂ",74875,1,PART,PRCNCT,PRSD,PRSD_SV,"2025-05-18 21:18:36",243,174,129,45,0,170,4,300,126,83,87
17,DOLJ,"ȘCOALA PROFESIONALĂ DANEŢI",322,DANEŢI,71956,1,PART,PRCNCT,PRSD,PRSD_SV,"2025-05-18 21:33:40",1526,686,567,119,0,678,8,1700,1014,399,279
17,DOLJ,"ŞCOALA PROFESIONALĂ DANEŢI",323,DANEŢI,71956,1,PART,PRCNCT,PRSD,PRSD_SV,"2025-05-18 21:35:20",1274,568,447,121,0,560,8,1500,932,369,191
17,DOLJ,"ŞCOALA GENERALĂ CU CLASELE I-VIII BRABEŢI",324,DANEŢI,71956,1,PART,PRCNCT,PRSD,PRSD_SV,"2025-05-18 21:23:24",802,377,308,69,0,375,2,900,523,250,125
17,DOLJ,"ŞCOALA GENERALĂ CU CLASELE I-VIII BRANIŞTE",325,DANEŢI,71956,2,PART,PRCNCT,PRSD,PRSD_SV,"2025-05-19 01:24:50",481,256,202,54,0,255,1,600,344,157,98
17,DOLJ,"ŞCOALA GENERALĂ CU CLASELE I-IV LOCUSTENI",326,DANEŢI,71956,1,PART,PRCNCT,PRSD,PRSD_SV,"2025-05-18 21:21:53",445,256,199,57,0,253,3,500,244,138,115
17,DOLJ,"GRADINITA DE COPII DESA",327,DESA,72034,1,PART,PRCNCT,PRSD,PRSD_SV,"2025-05-18 21:47:54",1163,525,492,26,7,523,2,1300,775,341,182
17,DOLJ,"CĂMINUL CULTURAL DESA",328,DESA,72034,1,PART,PRCNCT,PRSD,PRSD_SV,"2025-05-18 21:59:52",1500,693,604,72,17,693,0,1700,1007,310,383
17,DOLJ,"CENTRUL MULTIFUNCȚIONAL DESA",329,DESA,72034,1,PART,PRCNCT,PRSD,PRSD_SV,"2025-05-18 21:44:05",1179,368,345,23,0,364,4,1300,932,228,136
17,DOLJ,"CLUB CAMIN CULTURAL DIOSTI",330,DIOŞTI,72052,1,PART,PRCNCT,PRSD,PRSD_SV,"2025-05-18 21:33:06",888,499,382,113,4,487,12,1000,501,277,210
17,DOLJ,"SCOALA GENERALA CU CLASELE I-VIII CIOCANESTI",331,DIOŞTI,72052,1,PART,PRCNCT,PRSD,PRSD_SV,"2025-05-18 21:21:08",530,287,234,53,0,280,7,600,313,181,99
17,DOLJ,"SCOALA GENERALA CU CLASELE I-IV RADOMIR",332,DIOŞTI,72052,1,PART,PRCNCT,PRSD,PRSD_SV,"2025-05-18 21:39:24",840,345,273,69,3,343,2,1000,655,213,130
17,DOLJ,"ȘCOALA DOBREȘTI",333,DOBREŞTI,72098,2,PART,PRCNCT,PRSD,PRSD_SV,"2025-05-19 00:48:33",306,140,112,27,1,140,0,400,260,73,67
17,DOLJ,"ȘCOALA CĂCIULĂTEȘTI",334,DOBREŞTI,72098,1,PART,PRCNCT,PRSD,PRSD_SV,"2025-05-18 21:35:15",403,195,141,54,0,194,1,500,305,113,81
17,DOLJ,"ȘCOALA MURTA",335,DOBREŞTI,72098,1,PART,PRCNCT,PRSD,PRSD_SV,"2025-05-18 21:34:27",634,249,202,47,0,248,1,700,451,158,90
17,DOLJ,"ȘCOALA TOCENI",336,DOBREŞTI,72098,1,PART,PRCNCT,PRSD,PRSD_SV,"2025-05-18 21:24:53",460,234,201,33,0,234,0,500,266,156,78
17,DOLJ,"CĂMINUL CULTURAL",337,DOBROTEŞTI,74883,1,PART,PRCNCT,PRSD,PRSD_SV,"2025-05-18 22:22:29",1297,662,523,138,1,660,2,1500,838,399,261
17,DOLJ,"SCOALA VECHE DRĂGOTEŞTI",338,DRĂGOTEŞTI,72150,1,PART,PRCNCT,PRSD,PRSD_SV,"2025-05-18 21:19:36",359,232,167,65,0,229,3,400,168,117,112
17,DOLJ,"SCOALA CU CLS. I - IV BENEŞTI",339,DRĂGOTEŞTI,72150,1,PART,PRCNCT,PRSD,PRSD_SV,"2025-05-18 21:17:31",333,186,145,41,0,184,2,400,214,122,62
17,DOLJ,"SCOALA CU CLS. I - IV BUZDUC",340,DRĂGOTEŞTI,72150,1,PART,PRCNCT,PRSD,PRSD_SV,"2025-05-18 21:19:20",93,68,41,27,0,66,2,199,131,30,36
17,DOLJ,"CĂMINUL CULTURAL POPÂNZĂLEȘTI",341,DRĂGOTEŞTI,72150,1,PART,PRCNCT,PRSD,PRSD_SV,"2025-05-18 21:26:00",455,277,221,55,1,274,3,500,223,148,126
17,DOLJ,"SCOALA CU CLS. I - IV VIIŞOARA",342,DRĂGOTEŞTI,72150,1,PART,PRCNCT,PRSD,PRSD_SV,"2025-05-18 21:40:15",400,193,158,35,0,187,6,500,307,118,69
17,DOLJ,"CAMINUL CULTURAL DRANIC",343,DRĂNIC,72221,4,PART,PRCNCT,PRSD,PRSD_SV,"2025-05-19 01:22:17",799,387,308,79,0,384,3,900,513,225,159
17,DOLJ,"SCOALA CU CLASELE I-IV BOOVENI",344,DRĂNIC,72221,1,PART,PRCNCT,PRSD,PRSD_SV,"2025-05-18 21:31:47",271,154,131,23,0,152,2,300,146,100,52
17,DOLJ,"SCOALA CU CLASELE I-IV FOISOR",345,DRĂNIC,72221,1,PART,PRCNCT,PRSD,PRSD_SV,"2025-05-18 21:37:30",155,121,66,54,1,119,2,300,179,61,58
17,DOLJ,"SCOALA PRIMARA PADEA",346,DRĂNIC,72221,1,PART,PRCNCT,PRSD,PRSD_SV,"2025-05-18 21:37:06",577,346,261,85,0,342,4,700,354,239,103
17,DOLJ,"ȘCOALA GIMNAZIALĂ FĂRCAȘ",347,FĂRCAŞ,72276,1,PART,PRCNCT,PRSD,PRSD_SV,"2025-05-18 21:38:22",1002,509,424,85,0,503,6,1200,691,322,181
17,DOLJ,"SCOALA GENERALA GOLUMBU",348,FĂRCAŞ,72276,1,PART,PRCNCT,PRSD,PRSD_SV,"2025-05-18 21:26:24",647,299,254,45,0,296,3,700,401,203,93
17,DOLJ,"ȘCOALA GIMNAZIALĂ CORP 3",349,"GALICEA MARE",72383,1,PART,PRCNCT,PRSD,PRSD_SV,"2025-05-18 21:49:17",1305,525,494,31,0,520,5,1500,975,375,145
17,DOLJ,"ȘCOALA GIMNAZIALĂ -CORP 3",350,"GALICEA MARE",72383,1,PART,PRCNCT,PRSD,PRSD_SV,"2025-05-18 21:43:35",725,343,291,50,2,337,6,800,457,233,104
17,DOLJ,"ȘCOALA GIMNAZIALĂ - CORP 3",351,"GALICEA MARE",72383,2,PART,PRCNCT,PRSD,PRSD_SV,"2025-05-19 00:28:43",1200,496,453,43,0,494,2,1400,904,344,150
17,DOLJ,"CAMINUL CULTURAL",352,GALICIUICA,74891,1,PART,PRCNCT,PRSD,PRSD_SV,"2025-05-18 22:10:45",1083,503,430,71,2,499,4,1200,697,364,135
17,DOLJ,"ȘCOALA GIMNAZIALĂ GÂNGIOVA",353,GÂNGIOVA,72579,1,PART,PRCNCT,PRSD,PRSD_SV,"2025-05-18 21:52:27",1160,472,377,94,1,457,15,1300,828,309,148
17,DOLJ,"ȘCOALA GENERALĂ COMOȘTENI",354,GÂNGIOVA,72579,1,PART,PRCNCT,PRSD,PRSD_SV,"2025-05-18 21:56:18",814,330,254,76,0,324,6,900,570,199,125
17,DOLJ,"CĂMINUL CULTURAL",355,GHERCEŞTI,72409,1,PART,PRCNCT,PRSD,PRSD_SV,"2025-05-18 22:17:28",1101,869,638,229,2,859,10,1200,331,447,412
17,DOLJ,"ŞCOALA GENERALĂ GÂRLEŞTI",356,GHERCEŞTI,72409,1,PART,PRCNCT,PRSD,PRSD_SV,"2025-05-18 21:55:47",394,296,233,63,0,296,0,500,204,120,176
17,DOLJ,"ŞCOALA GENERALĂ UNGURENI",357,GHERCEŞTI,72409,1,PART,PRCNCT,PRSD,PRSD_SV,"2025-05-18 21:35:43",264,197,128,68,1,196,1,300,103,94,102
17,DOLJ,"CĂMINUL CULTURAL",358,GHIDICI,74907,1,PART,PRCNCT,PRSD,PRSD_SV,"2025-05-18 21:47:12",1858,683,633,50,0,673,10,2000,1317,401,272
17,DOLJ,"CAMIN CULTURAL",359,GHINDENI,74915,1,PART,PRCNCT,PRSD,PRSD_SV,"2025-05-18 22:07:18",1542,823,686,137,0,816,7,1700,877,504,312
17,DOLJ,"CĂMINUL CULTURAL GIGHERA",360,GIGHERA,72463,1,PART,PRCNCT,PRSD,PRSD_SV,"2025-05-18 21:37:15",940,426,332,94,0,419,7,1100,674,273,146
17,DOLJ,"GRĂDINIȚA CU PROGRAM NORMAL NEDEIA",361,GIGHERA,72463,1,PART,PRCNCT,PRSD,PRSD_SV,"2025-05-18 21:22:28",638,350,250,100,0,342,8,700,350,201,141
17,DOLJ,"GRĂDINIȚA CU PROGRAM NORMAL ZĂVAL",362,GIGHERA,72463,1,PART,PRCNCT,PRSD,PRSD_SV,"2025-05-18 21:27:58",599,286,217,69,0,285,1,700,414,173,112
17,DOLJ,"CAMIN CULTURAL GIUBEGA",363,GIUBEGA,72506,1,PART,PRCNCT,PRSD,PRSD_SV,"2025-05-18 21:42:35",857,419,323,93,3,417,2,1000,581,257,160
17,DOLJ,"PRIMARIA VECHE",364,GIUBEGA,72506,1,PART,PRCNCT,PRSD,PRSD_SV,"2025-05-18 21:46:34",812,428,352,76,0,423,5,900,472,291,132
17,DOLJ,"SCOALA GIMNAZIALA GIURGITA",365,GIURGIŢA,72533,1,PART,PRCNCT,PRSD,PRSD_SV,"2025-05-18 21:45:08",944,521,410,110,1,518,3,1100,579,315,203
17,DOLJ,"GRADINITA PORTARESTI",366,GIURGIŢA,72533,1,PART,PRCNCT,PRSD,PRSD_SV,"2025-05-18 21:52:27",916,389,328,61,0,385,4,1000,611,245,140
17,DOLJ,"GRADINITA CURMATURA",367,GIURGIŢA,72533,1,PART,PRCNCT,PRSD,PRSD_SV,"2025-05-18 21:24:35",390,179,125,54,0,177,2,500,321,108,69
17,DOLJ,"CĂMINUL CULTURAL GOGOŞU",368,GOGOŞU,72604,1,PART,PRCNCT,PRSD,PRSD_SV,"2025-05-18 21:52:28",147,131,75,52,4,130,1,299,168,51,79
17,DOLJ,"ŞCOALA CU CLASELE I-IV",369,GOGOŞU,72604,1,PART,PRCNCT,PRSD,PRSD_SV,"2025-05-18 21:26:22",111,109,63,44,2,107,2,300,191,46,61
17,DOLJ,"ŞCOALA CU CLASELE I-IV",370,GOGOŞU,72604,1,PART,PRCNCT,PRSD,PRSD_SV,"2025-05-18 21:30:53",127,113,66,45,2,113,0,300,187,31,82
17,DOLJ,"CENTRUL SOCIAL",371,GOICEA,72640,1,PART,PRCNCT,PRSD,PRSD_SV,"2025-05-18 22:43:46",1091,702,479,198,25,697,5,1200,498,340,357
17,DOLJ,"GRĂDINIȚA NR.2",372,GOICEA,72640,1,PART,PRCNCT,PRSD,PRSD_SV,"2025-05-18 21:55:02",792,426,303,109,14,419,7,900,474,224,195
17,DOLJ,"CAMIN CULTURAL GOIESTI SALA",373,GOIEŞTI,72677,1,PART,PRCNCT,PRSD,PRSD_SV,"2025-05-18 22:20:43",1148,715,541,171,3,704,11,1200,485,406,298
17,DOLJ,"SCOALA CU CLS I-IV MALAESTI SALA",374,GOIEŞTI,72677,1,PART,PRCNCT,PRSD,PRSD_SV,"2025-05-18 21:20:58",293,202,151,51,0,199,3,400,198,125,74
17,DOLJ,"SCOALA CLS I-IV MOGOSESTI SALA",375,GOIEŞTI,72677,1,PART,PRCNCT,PRSD,PRSD_SV,"2025-05-18 21:30:04",538,342,283,58,1,338,4,600,258,198,140
17,DOLJ,"SCOALA CU CLS I-VIII TANDARA SALA",376,GOIEŞTI,72677,1,PART,PRCNCT,PRSD,PRSD_SV,"2025-05-18 21:31:27",552,276,231,45,0,274,2,600,324,176,98
17,DOLJ,"ȘCOALA GRECEȘTI",377,GRECEŞTI,72819,1,PART,PRCNCT,PRSD,PRSD_SV,"2025-05-18 21:19:38",207,162,106,53,3,161,1,400,238,51,110
17,DOLJ,"ȘCOALA BĂRBOI",378,GRECEŞTI,72819,2,PART,PRCNCT,PRSD,PRSD_SV,"2025-05-19 00:32:30",268,177,115,52,10,172,5,400,223,68,104
17,DOLJ,"ȘCOALA BUSU",379,GRECEŞTI,72819,1,PART,PRCNCT,PRSD,PRSD_SV,"2025-05-18 21:27:53",506,306,227,69,10,304,2,700,394,179,125
17,DOLJ,"ȘCOALA GROPANELE",380,GRECEŞTI,72819,1,PART,PRCNCT,PRSD,PRSD_SV,"2025-05-18 21:19:24",224,120,95,25,0,119,1,400,280,102,17
17,DOLJ,"ŞCOALA GIMNAZIALĂ ELIZA OPRAN",381,IŞALNIŢA,70094,1,PART,PRCNCT,PRSD,PRSD_SV,"2025-05-18 22:17:29",1746,1100,911,122,67,1091,9,1900,800,534,557
17,DOLJ,"ŞCOALA GIMNAZIALĂ ELIZA OPRAN",382,IŞALNIŢA,70094,1,PART,PRCNCT,PRSD,PRSD_SV,"2025-05-18 21:58:35",1893,1401,1070,153,178,1379,22,2100,699,775,604
17,DOLJ,"GRADINITA IZVOARE",383,IZVOARE,72882,1,PART,PRCNCT,PRSD,PRSD_SV,"2025-05-18 21:48:04",891,411,332,78,1,410,1,1000,589,273,137
17,DOLJ,"SCOALA CLASELE I-IV",384,IZVOARE,72882,1,PART,PRCNCT,PRSD,PRSD_SV,"2025-05-18 21:25:39",239,135,96,39,0,134,1,300,165,67,67
17,DOLJ,"CĂMINUL CULTURAL ÎNTORSURA",385,ÎNTORSURA,74923,1,PART,PRCNCT,PRSD,PRSD_SV,"2025-05-18 21:49:26",1166,667,541,124,2,657,10,1300,633,359,298
17,DOLJ,"ȘCOALA GIMNAZIALĂ „ N.B. LOCUSTEANU ” - SALA A",386,LEU,72926,1,PART,PRCNCT,PRSD,PRSD_SV,"2025-05-18 22:25:32",1343,747,616,131,0,734,13,1400,653,418,316
17,DOLJ,"ȘCOALA GIMNAZIALĂ „N.B. LOCUSTEANU” - SALA B",387,LEU,72926,1,PART,PRCNCT,PRSD,PRSD_SV,"2025-05-18 22:19:17",1474,845,700,145,0,838,7,1600,755,493,345
17,DOLJ,"GRADINITA ZĂNOAGA",388,LEU,72926,1,PART,PRCNCT,PRSD,PRSD_SV,"2025-05-18 21:46:50",875,547,405,141,1,547,0,1000,453,328,219
17,DOLJ,"SCOALA GIMNAZIALA CLASELE I-VIII PETRE MANARCESCU",389,LIPOVU,72953,1,PART,PRCNCT,PRSD,PRSD_SV,"2025-05-18 21:23:31",1368,336,291,44,1,334,2,1500,1164,268,66
17,DOLJ,"LOCAL PRIMĂRIE",390,LIPOVU,72953,1,PART,PRCNCT,PRSD,PRSD_SV,"2025-05-18 21:47:21",905,266,232,34,0,262,4,1000,734,178,84
17,DOLJ,"SCOALA PRIMARA CLSELE I-VIII",391,LIPOVU,72953,1,PART,PRCNCT,PRSD,PRSD_SV,"2025-05-18 21:30:12",152,52,36,16,0,52,0,200,148,37,15
17,DOLJ,"SCOALA CU CLASELE I-VIII MAGLAVIT",392,MAGLAVIT,73031,1,PART,PRCNCT,PRSD,PRSD_SV,"2025-05-18 22:00:07",1726,856,698,133,25,841,15,1800,944,475,366
17,DOLJ,"SCOALA CLASELE I-IV MAGLAVIT",393,MAGLAVIT,73031,1,PART,PRCNCT,PRSD,PRSD_SV,"2025-05-18 21:38:02",947,503,390,89,24,496,7,1000,497,210,286
17,DOLJ,"ȘCOALA GENERALĂ HUNIA",394,MAGLAVIT,73031,1,PART,PRCNCT,PRSD,PRSD_SV,"2025-05-18 21:52:37",962,519,394,106,19,512,7,1000,481,245,267
17,DOLJ,"LICEUL TEHNOLOGIC ”ING. IONETE AURELIAN”",395,"MALU MARE",73068,1,PART,PRCNCT,PRSD,PRSD_SV,"2025-05-18 21:48:38",1049,637,474,153,10,632,5,1100,463,321,311
17,DOLJ,"ȘCOALA GIMNAZIALĂ MALU MARE",396,"MALU MARE",73068,2,PART,PRCNCT,PRSD,PRSD_SV,"2025-05-19 01:26:28",1509,864,687,177,0,850,14,1600,736,474,376
17,DOLJ,"ŞCOALA GIMNAZIALĂ MALU MARE-GRĂDINIȚA CU PROGRAM NORMAL PREAJBA",397,"MALU MARE",73068,1,PART,PRCNCT,PRSD,PRSD_SV,"2025-05-18 22:02:24",1206,966,588,184,194,951,15,1400,434,594,357
17,DOLJ,"ȘCOALA GIMNAZIALĂ MALU MARE-GRĂDINIȚA CU PROGRAM NORMAL PREAJBA",398,"MALU MARE",73068,1,PART,PRCNCT,PRSD,PRSD_SV,"2025-05-18 22:39:17",1862,1013,883,130,0,1006,7,2000,987,323,683
17,DOLJ,"ȘCOALA GIMNAZIALĂ MALU MARE- GRĂDINIȚA CU PROGRAM NORMAL PREAJBA",399,"MALU MARE",73068,1,PART,PRCNCT,PRSD,PRSD_SV,"2025-05-18 22:39:06",1515,909,646,151,112,898,11,1700,791,396,502
17,DOLJ,"PRIMĂRIA MĂCEŞU DE JOS",400,"MĂCEŞU DE JOS",72980,1,PART,PRCNCT,PRSD,PRSD_SV,"2025-05-18 21:22:43",733,389,318,71,0,385,4,800,411,237,148
17,DOLJ,"ŞCOALA SĂPATA",401,"MĂCEŞU DE JOS",72980,1,PART,PRCNCT,PRSD,PRSD_SV,"2025-05-18 21:20:34",246,145,111,34,0,143,2,300,155,92,51
17,DOLJ,"CAMINUL CULTURAL",402,"MĂCEŞU DE SUS",73013,1,PART,PRCNCT,PRSD,PRSD_SV,"2025-05-18 21:31:46",890,571,451,120,0,566,5,1000,429,292,274
17,DOLJ,"ȘCOALA GENERALĂ NR. 2 MÎRȘANI",403,MÂRŞANI,73317,1,PART,PRCNCT,PRSD,PRSD_SV,"2025-05-18 21:44:24",1332,724,615,99,10,719,5,1400,676,386,333
17,DOLJ,"ȘCOALA GIMNAZIALĂ NR. 1 MÂRȘANI",404,MÂRŞANI,73317,1,PART,PRCNCT,PRSD,PRSD_SV,"2025-05-18 21:52:14",988,578,465,106,7,569,9,1100,522,259,310
17,DOLJ,"ȘCOALA GENERALĂ NR. 3 MÎRȘANI",405,MÂRŞANI,73317,1,PART,PRCNCT,PRSD,PRSD_SV,"2025-05-18 21:44:15",1061,632,494,122,16,624,8,1200,568,296,328
17,DOLJ,"CĂMINUL CULTURAL MELINEŞTI",406,MELINEŞTI,73102,1,PART,PRCNCT,PRSD,PRSD_SV,"2025-05-18 21:42:21",891,571,411,135,25,562,9,1000,429,338,224
17,DOLJ,"SEDIUL FOSTEI ŞCOLI GENERALE BODAIESTI",407,MELINEŞTI,73102,1,PART,PRCNCT,PRSD,PRSD_SV,"2025-05-18 21:55:56",539,292,228,61,3,291,1,600,308,198,93
17,DOLJ,"ŞCOALA GENERALĂ BODĂIEŞTII DE SUS",408,MELINEŞTI,73102,1,PART,PRCNCT,PRSD,PRSD_SV,"2025-05-18 21:16:28",236,125,105,20,0,124,1,300,175,78,46
17,DOLJ,"ŞCOALA GENERALĂ NEGOIEŞTI",409,MELINEŞTI,73102,1,PART,PRCNCT,PRSD,PRSD_SV,"2025-05-18 21:46:16",1143,599,484,114,1,591,8,1300,701,333,258
17,DOLJ,"ŞCOALA GENERALĂ SPINENI",410,MELINEŞTI,73102,1,PART,PRCNCT,PRSD,PRSD_SV,"2025-05-18 21:17:18",254,172,131,41,0,171,1,300,128,105,66
17,DOLJ,"ŞCOALA GENERALĂ MISCHII",411,MISCHII,73246,1,PART,PRCNCT,PRSD,PRSD_SV,"2025-05-18 21:30:20",553,563,344,181,38,561,2,800,237,269,292
17,DOLJ,"ŞCOALA GENERALĂ CĂLINEŞTI",412,MISCHII,73246,1,PART,PRCNCT,PRSD,PRSD_SV,"2025-05-18 21:20:52",99,102,59,42,1,102,0,300,198,48,54
17,DOLJ,"ŞCOALA GENERALĂ MLECĂNEŞTI",413,MISCHII,73246,1,PART,PRCNCT,PRSD,PRSD_SV,"2025-05-18 21:46:15",440,339,241,65,33,332,7,700,361,145,187
17,DOLJ,"ŞCOALA GENERALĂ URECHEŞTI",414,MISCHII,73246,1,PART,PRCNCT,PRSD,PRSD_SV,"2025-05-18 21:28:18",501,476,288,156,32,471,5,700,224,250,221
17,DOLJ,"GRĂDINIŢA NR. 2 MOŢĂŢEI",415,MOŢĂŢEI,73335,1,PART,PRCNCT,PRSD,PRSD_SV,"2025-05-18 21:50:22",1633,696,626,70,0,692,4,1700,1004,395,297
17,DOLJ,"ŞCOALA NR. 1 MOŢĂŢEI",416,MOŢĂŢEI,73335,1,PART,PRCNCT,PRSD,PRSD_SV,"2025-05-18 21:38:08",1035,445,365,80,0,441,4,1100,655,264,177
17,DOLJ,"GRĂDINIŢA NR. 3 MOŢĂŢEI",417,MOŢĂŢEI,73335,1,PART,PRCNCT,PRSD,PRSD_SV,"2025-05-18 21:34:58",1497,634,586,48,0,627,7,1600,966,375,252
17,DOLJ,"GRĂDINIŢA NR. 2 DOBRIDOR",418,MOŢĂŢEI,73335,1,PART,PRCNCT,PRSD,PRSD_SV,"2025-05-18 21:27:21",575,259,220,39,0,254,5,600,341,141,113
17,DOLJ,"ŞCOALA MOŢĂŢEI GARĂ",419,MOŢĂŢEI,73335,1,PART,PRCNCT,PRSD,PRSD_SV,"2025-05-18 21:29:50",652,293,245,48,0,288,5,700,407,172,116
17,DOLJ,"GRĂDINIŢA BALOTA DE JOS",420,MURGAŞI,73371,1,PART,PRCNCT,PRSD,PRSD_SV,"2025-05-18 21:43:43",710,379,321,38,20,372,7,800,421,193,179
17,DOLJ,"ŞCOALA CU CLASELE I-VIII MURGAŞI",421,MURGAŞI,73371,1,PART,PRCNCT,PRSD,PRSD_SV,"2025-05-18 22:03:58",874,562,431,100,31,555,7,1000,438,264,291
17,DOLJ,"ŞCOALA CU CLASELE I-IV VELEŞTI",422,MURGAŞI,73371,1,PART,PRCNCT,PRSD,PRSD_SV,"2025-05-18 21:27:19",341,223,142,66,15,221,2,400,177,111,110
17,DOLJ,"SCOALA GIMNAZIALA NEGOI",423,NEGOI,73460,1,PART,PRCNCT,PRSD,PRSD_SV,"2025-05-18 21:35:54",896,362,304,56,2,358,4,1000,638,206,152
17,DOLJ,"SCOALA GIMNAZIALA NEGOI",424,NEGOI,73460,1,PART,PRCNCT,PRSD,PRSD_SV,"2025-05-18 21:28:02",801,215,170,45,0,212,3,900,685,127,85
17,DOLJ,"ŞCOALA GENERALĂ ORODEL",425,ORODEL,73503,1,PART,PRCNCT,PRSD,PRSD_SV,"2025-05-18 21:36:11",882,373,320,51,2,365,8,1000,627,301,64
17,DOLJ,"ŞCOALA GENERALĂ CĂLUGĂREI",426,ORODEL,73503,1,PART,PRCNCT,PRSD,PRSD_SV,"2025-05-18 21:24:15",469,284,213,71,0,281,3,600,316,208,73
17,DOLJ,"ŞCOALA GENERALĂ CORNU",427,ORODEL,73503,1,PART,PRCNCT,PRSD,PRSD_SV,"2025-05-18 21:23:39",388,218,149,69,0,216,2,500,282,151,65
17,DOLJ,"ŞCOALA GENERALĂ TEIU",428,ORODEL,73503,1,PART,PRCNCT,PRSD,PRSD_SV,"2025-05-18 21:17:09",160,67,48,19,0,67,0,200,133,37,30
17,DOLJ,"CĂMINUL CULTURAL OSTROVENI",429,OSTROVENI,73567,1,PART,PRCNCT,PRSD,PRSD_SV,"2025-05-18 22:02:50",1033,489,370,116,3,482,7,1100,611,240,242
17,DOLJ,"GRĂDINIŢA DE COPII ORĂŞANI",430,OSTROVENI,73567,2,PART,PRCNCT,PRSD,PRSD_SV,"2025-05-19 01:23:47",969,488,382,106,0,486,2,1100,612,256,230
17,DOLJ,"GRĂDINIŢA DE COPII GRINDENI",431,OSTROVENI,73567,1,PART,PRCNCT,PRSD,PRSD_SV,"2025-05-18 21:36:56",514,266,209,57,0,261,5,600,334,136,125
17,DOLJ,"GRĂDINIŢA CU PROGRAM NORMAL LIŞTEAVA",432,OSTROVENI,73567,1,PART,PRCNCT,PRSD,PRSD_SV,"2025-05-18 21:36:10",1165,447,377,69,1,438,9,1300,853,291,147
17,DOLJ,"ŞCOALA PRIMARĂ(LOCAL VECHI)",433,PERIŞOR,73594,1,PART,PRCNCT,PRSD,PRSD_SV,"2025-05-18 21:51:27",1134,623,475,147,1,617,6,1300,677,392,225
17,DOLJ,"ŞCOALA PRIMARĂ CL. I-IV",434,PERIŞOR,73594,1,PART,PRCNCT,PRSD,PRSD_SV,"2025-05-18 21:18:31",220,160,102,58,0,160,0,300,140,113,47
17,DOLJ,"ŞCOALA GIMNAZIALĂ PIELEŞTI",435,PIELEŞTI,73629,1,PART,PRCNCT,PRSD,PRSD_SV,"2025-05-18 21:57:53",1260,733,592,141,0,720,13,1400,667,392,328
17,DOLJ,"SEDIUL FOSTEI ŞCOLI GENERALE NR 2 PIELEŞTI",436,PIELEŞTI,73629,1,PART,PRCNCT,PRSD,PRSD_SV,"2025-05-18 21:46:26",1000,629,517,112,0,623,6,1100,471,310,313
17,DOLJ,"GRĂDINIȚA CU PROGRAM PRELUNGIT ” SFÂNTUL EFREM CEL NOU”",437,PIELEŞTI,73629,1,PART,PRCNCT,PRSD,PRSD_SV,"2025-05-18 23:09:11",1112,989,650,339,0,981,8,1300,311,374,607
17,DOLJ,"ŞCOALA GIMNAZIALĂ PIELEŞTI",438,PIELEŞTI,73629,1,PART,PRCNCT,PRSD,PRSD_SV,"2025-05-18 21:29:00",599,336,272,62,2,332,4,700,364,206,126
17,DOLJ,"CAMINUL CULTURAL PISCU VECHI",439,"PISCU VECHI",73665,1,PART,PRCNCT,PRSD,PRSD_SV,"2025-05-18 21:26:10",933,395,367,28,0,391,4,1000,605,246,145
17,DOLJ,"SCOALA GIMNAZIALA PISCU VECHI",440,"PISCU VECHI",73665,1,PART,PRCNCT,PRSD,PRSD_SV,"2025-05-18 21:32:24",948,388,362,26,0,383,5,1000,612,217,166
17,DOLJ,"SCOALA PISCULET",441,"PISCU VECHI",73665,1,PART,PRCNCT,PRSD,PRSD_SV,"2025-05-18 21:25:45",230,126,96,30,0,125,1,300,174,100,25
17,DOLJ,"LICEUL TEHNOLOGIC C.N. PLOPSOR",442,PLENIŢA,73709,1,PART,PRCNCT,PRSD,PRSD_SV,"2025-05-18 21:43:45",968,484,393,91,0,478,6,1100,616,268,210
17,DOLJ,"SCOALA CU CALSELE I-VIII LOCAL B POIANA",443,PLENIŢA,73709,1,PART,PRCNCT,PRSD,PRSD_SV,"2025-05-18 21:39:16",902,354,321,33,0,347,7,1000,646,242,105
17,DOLJ,"GRADINITA ”ALBA CA ZAPADA”",444,PLENIŢA,73709,1,PART,PRCNCT,PRSD,PRSD_SV,"2025-05-18 21:59:18",1018,446,380,37,29,433,13,1100,654,273,160
17,DOLJ,"SCOALA CU CLASELEI-IV DIN SATUL CASTRELE TRAIANE",445,PLENIŢA,73709,2,PART,PRCNCT,PRSD,PRSD_SV,"2025-05-19 01:33:53",596,307,253,51,3,300,7,700,393,209,91
17,DOLJ,"GRĂDINIȚA CU PROGRAM NORMAL PLEŞOI",446,PLEŞOI,74931,1,PART,PRCNCT,PRSD,PRSD_SV,"2025-05-18 21:48:04",931,505,421,84,0,501,4,1100,595,362,139
17,DOLJ,"PRIMĂRIA PODARI",447,PODARI,70110,1,PART,PRCNCT,PRSD,PRSD_SV,"2025-05-18 21:50:47",1338,738,619,117,2,728,10,1400,662,442,286
17,DOLJ,"ŞCOALA GENERALĂ PODARI",448,PODARI,70110,1,PART,PRCNCT,PRSD,PRSD_SV,"2025-05-18 22:15:49",1978,935,807,128,0,926,9,2100,1165,590,336
17,DOLJ,"ŞCOALA GENERALĂ BALTA VERDE",449,PODARI,70110,1,PART,PRCNCT,PRSD,PRSD_SV,"2025-05-18 21:29:22",476,304,240,64,0,300,4,600,296,160,140
17,DOLJ,"ŞCOALA GENERALĂ BRANIŞTE",450,PODARI,70110,1,PART,PRCNCT,PRSD,PRSD_SV,"2025-05-18 21:35:25",821,450,353,97,0,443,7,900,450,233,210
17,DOLJ,"ŞCOALA GENERALĂ GURA VĂII",451,PODARI,70110,2,PART,PRCNCT,PRSD,PRSD_SV,"2025-05-18 23:11:45",367,256,197,59,0,255,1,500,244,161,94
17,DOLJ,"ŞCOALA GENERALĂ LIVEZI",452,PODARI,70110,1,PART,PRCNCT,PRSD,PRSD_SV,"2025-05-18 21:33:48",745,424,360,64,0,423,1,900,476,267,156
17,DOLJ,"ŞCOALA PRIMARĂ I-IV SÎRBI",453,"POIANA MARE",73736,1,PART,PRCNCT,PRSD,PRSD_SV,"2025-05-18 21:59:34",1327,652,581,71,0,640,12,1500,848,348,292
17,DOLJ,"ŞCOALA GENERALĂ DRAGU",454,"POIANA MARE",73736,1,PART,PRCNCT,PRSD,PRSD_SV,"2025-05-18 22:10:56",1466,637,595,42,0,635,2,1600,963,379,256
17,DOLJ,"ŞCOALA GENERALĂ NR.3 CENTRU-CLĂDIRE C2",455,"POIANA MARE",73736,1,PART,PRCNCT,PRSD,PRSD_SV,"2025-05-18 21:43:42",1303,683,494,47,142,674,9,1400,717,369,305
17,DOLJ,"LICEUL GEORGE ST. MARINCU",456,"POIANA MARE",73736,1,PART,PRCNCT,PRSD,PRSD_SV,"2025-05-18 21:38:14",1163,556,510,46,0,549,7,1300,744,298,251
17,DOLJ,"ŞCOALA GENERALĂ TRAISTARU",457,"POIANA MARE",73736,1,PART,PRCNCT,PRSD,PRSD_SV,"2025-05-18 21:55:05",1506,723,664,44,15,714,9,1600,877,426,288
17,DOLJ,"ŞCOALA GENERALĂ TUNARII NOI",458,"POIANA MARE",73736,2,PART,PRCNCT,PRSD,PRSD_SV,"2025-05-19 01:50:43",387,184,154,30,0,184,0,500,316,113,71
17,DOLJ,"ŞCOALA GENERALĂ TUNARII VECHI",459,"POIANA MARE",73736,1,PART,PRCNCT,PRSD,PRSD_SV,"2025-05-18 21:55:38",1014,459,411,48,0,455,4,1100,641,270,185
17,DOLJ,"ŞC.GIMNAZIALĂ PREDEŞTI",460,PREDEŞTI,73772,1,PART,PRCNCT,PRSD,PRSD_SV,"2025-05-18 21:48:48",1634,868,717,151,0,855,13,1800,932,555,300
17,DOLJ,"ŞCOALA GIMNAZIALA RADOVAN",461,RADOVAN,73852,1,PART,PRCNCT,PRSD,PRSD_SV,"2025-05-18 21:56:32",846,378,293,85,0,370,8,1000,622,257,113
17,DOLJ,"CAMIN CULTURAL FÂNTÂNELE",462,RADOVAN,73852,1,PART,PRCNCT,PRSD,PRSD_SV,"2025-05-18 21:14:21",73,89,34,55,0,89,0,200,111,43,46
17,DOLJ,"CAMIN CULTURAL TÂRNAVA",463,RADOVAN,73852,2,PART,PRCNCT,PRSD,PRSD_SV,"2025-05-19 00:17:11",150,125,59,62,4,122,3,299,174,55,67
17,DOLJ,"ȘCOALA GIMNAZIALĂ RAST - SALA DE SPORT",464,RAST,73905,2,PART,PRCNCT,PRSD,PRSD_SV,"2025-05-19 01:51:56",1544,764,657,107,0,758,6,1700,936,529,229
17,DOLJ,"SALA DE SPORT",465,RAST,73905,1,PART,PRCNCT,PRSD,PRSD_SV,"2025-05-18 21:44:13",1321,526,460,66,0,517,9,1500,974,368,149
17,DOLJ,"CĂMIN CULTURAL",466,ROBĂNEŞTI,73923,1,PART,PRCNCT,PRSD,PRSD_SV,"2025-05-18 21:35:34",487,340,242,98,0,332,8,600,260,175,157
17,DOLJ,"ŞCOALA GOLFIN",467,ROBĂNEŞTI,73923,1,PART,PRCNCT,PRSD,PRSD_SV,"2025-05-18 21:43:13",451,276,211,65,0,274,2,500,224,170,104
17,DOLJ,"ŞCOALA LĂCRIŢA MARE",468,ROBĂNEŞTI,73923,1,PART,PRCNCT,PRSD,PRSD_SV,"2025-05-18 21:24:46",493,312,243,69,0,309,3,600,288,215,94
17,DOLJ,"ŞCOALA ROBĂNEŞTII DE SUS",469,ROBĂNEŞTI,73923,1,PART,PRCNCT,PRSD,PRSD_SV,"2025-05-18 21:27:29",503,295,248,47,0,290,5,600,305,154,136
17,DOLJ,"ŞCOALA GIMNAZIALĂ ROJIŞTE",470,ROJIŞTE,74949,1,PART,PRCNCT,PRSD,PRSD_SV,"2025-05-18 21:50:52",1461,1065,757,251,57,1061,4,1600,535,273,788
17,DOLJ,"ŞCOALA CU CLS.I-IV",471,ROJIŞTE,74949,1,PART,PRCNCT,PRSD,PRSD_SV,"2025-05-18 21:46:48",507,361,264,72,25,359,2,600,239,134,225
17,DOLJ,"SCOALA GIMNAZIALA STRUCTURA RAIETI",472,SADOVA,73996,1,PART,PRCNCT,PRSD,PRSD_SV,"2025-05-18 21:19:23",522,206,172,34,0,200,6,600,394,110,90
17,DOLJ,"SCOALA GIMNAZIALA STRUCTURA RAIETI",473,SADOVA,73996,1,PART,PRCNCT,PRSD,PRSD_SV,"2025-05-18 21:21:09",1593,184,175,9,0,178,6,1700,1516,147,31
17,DOLJ,"SCOALA GIMNAZIALA SADOVA LOCAL VALE",474,SADOVA,73996,1,PART,PRCNCT,PRSD,PRSD_SV,"2025-05-18 21:38:27",1235,444,413,31,0,439,5,1300,856,310,129
17,DOLJ,"SCOALA GIMNAZIALA SADOVA, LOCAL DEAL",475,SADOVA,73996,1,PART,PRCNCT,PRSD,PRSD_SV,"2025-05-18 21:34:34",1210,467,402,30,35,463,4,1300,833,375,88
17,DOLJ,"CĂMINUL CULTURAL DAMIAN",476,SADOVA,73996,2,PART,PRCNCT,PRSD,PRSD_SV,"2025-05-19 00:15:57",1331,562,478,83,1,560,2,1400,838,353,207
17,DOLJ,"ŞCOALA GIMNAZIALĂ SADOVA, STRUCTURA PISCU – SADOVEI LOCAL VECHI",477,SADOVA,73996,1,PART,PRCNCT,PRSD,PRSD_SV,"2025-05-18 21:30:12",890,437,351,85,1,429,8,1000,563,254,175
17,DOLJ,"ŞCOALA VECHE SĂLCUŢA",478,SĂLCUŢA,74028,2,PART,PRCNCT,PRSD,PRSD_SV,"2025-05-18 23:49:18",818,258,198,59,1,255,3,900,642,185,70
17,DOLJ,"CĂMINUL CULTURAL MÂRZA",479,SĂLCUŢA,74028,1,PART,PRCNCT,PRSD,PRSD_SV,"2025-05-18 21:12:06",436,130,114,16,0,130,0,500,370,111,19
17,DOLJ,"ŞCOALA VECHE TENCĂNĂU",480,SĂLCUŢA,74028,1,PART,PRCNCT,PRSD,PRSD_SV,"2025-05-18 21:16:25",237,149,100,47,2,147,2,300,151,100,47
17,DOLJ,"ŞCOALA GENERALĂ SCAEŞTI",481,SCĂEŞTI,74073,1,PART,PRCNCT,PRSD,PRSD_SV,"2025-05-18 21:28:07",888,475,364,90,21,469,6,1000,525,267,202
17,DOLJ,"GRĂDINIȚA CU PROGRAM NORMAL VALEA LUI PĂTRU",482,SCĂEŞTI,74073,1,PART,PRCNCT,PRSD,PRSD_SV,"2025-05-18 21:31:32",755,363,307,55,1,360,3,900,537,244,116
17,DOLJ,"ŞCOALA GIMNAZIALĂ CU CLASELE I-VIII DIN SEACA DE CÎMP",483,"SEACA DE CÂMP",74108,1,PART,PRCNCT,PRSD,PRSD_SV,"2025-05-18 21:50:29",704,413,339,61,13,412,1,800,387,221,191
17,DOLJ,"ȘCOALA GIMNAZIALĂ PISCU NOU",484,"SEACA DE CÂMP",74108,1,PART,PRCNCT,PRSD,PRSD_SV,"2025-05-18 21:38:07",701,411,357,41,13,407,4,800,389,202,205
17,DOLJ,"ŞCOALA SEACA DE PĂDURE",485,"SEACA DE PĂDURE",74135,1,PART,PRCNCT,PRSD,PRSD_SV,"2025-05-18 21:31:27",296,150,108,41,1,149,1,400,250,90,59
17,DOLJ,"ŞCOALA RĂCHITA DE SUS",486,"SEACA DE PĂDURE",74135,1,PART,PRCNCT,PRSD,PRSD_SV,"2025-05-18 21:19:05",129,73,50,23,0,72,1,200,127,45,27
17,DOLJ,"ŞCOALA VELENI",487,"SEACA DE PĂDURE",74135,1,PART,PRCNCT,PRSD,PRSD_SV,"2025-05-18 21:20:35",252,109,78,31,0,109,0,300,191,60,49
17,DOLJ,"ȘCOALA GIMNAZIALĂ SECU",488,SECU,74171,1,PART,PRCNCT,PRSD,PRSD_SV,"2025-05-18 21:25:10",602,347,272,55,20,347,0,700,353,316,31
17,DOLJ,"ŞCOALA GENERALĂ CU CLS. I-IV SMADOVICIOARA",489,SECU,74171,1,PART,PRCNCT,PRSD,PRSD_SV,"2025-05-18 21:24:57",163,141,114,18,9,141,0,300,159,132,9
17,DOLJ,"CĂMINUL CULTURAL",490,"SILIŞTEA CRUCII",74224,1,PART,PRCNCT,PRSD,PRSD_SV,"2025-05-18 21:55:05",1145,656,515,139,2,645,11,1300,644,403,242
17,DOLJ,"SCOALA CU CLASELE I-IV SOPOT",491,SOPOT,74242,1,PART,PRCNCT,PRSD,PRSD_SV,"2025-05-18 21:12:43",355,193,139,54,0,193,0,400,207,130,63
17,DOLJ,"ANEXĂ ȘCOALĂ",492,SOPOT,74242,1,PART,PRCNCT,PRSD,PRSD_SV,"2025-05-18 21:29:55",274,154,130,24,0,152,2,300,146,105,47
17,DOLJ,"SCOALA CU CLASELE I-VIII BELOŢ",493,SOPOT,74242,1,PART,PRCNCT,PRSD,PRSD_SV,"2025-05-18 21:14:08",241,140,105,35,0,137,3,300,160,72,65
17,DOLJ,"SCOALA CU CLASELE I-IV PIETROAIA",494,SOPOT,74242,1,PART,PRCNCT,PRSD,PRSD_SV,"2025-05-18 21:17:23",329,191,159,32,0,190,1,400,209,132,58
17,DOLJ,"SCOALA SÎRSCA",495,SOPOT,74242,1,PART,PRCNCT,PRSD,PRSD_SV,"2025-05-18 21:08:04",123,90,61,29,0,88,2,200,110,64,24
17,DOLJ,"CAMIN CULTURAL ALBESTI",496,"ŞIMNICU DE SUS",70174,2,PART,PRCNCT,PRSD,PRSD_SV,"2025-05-18 22:47:41",1384,1038,810,228,0,1022,16,1500,462,473,549
17,DOLJ,"CAMIN CULTURAL DUDOVICESTI",497,"ŞIMNICU DE SUS",70174,1,PART,PRCNCT,PRSD,PRSD_SV,"2025-05-18 22:05:35",1027,752,504,247,1,740,12,1100,348,337,403
17,DOLJ,"CAMIN CULTURAL FLORESTI",498,"ŞIMNICU DE SUS",70174,1,PART,PRCNCT,PRSD,PRSD_SV,"2025-05-18 21:28:28",633,406,316,90,0,403,3,700,294,231,172
17,DOLJ,"SCOALA IZVOR",499,"ŞIMNICU DE SUS",70174,1,PART,PRCNCT,PRSD,PRSD_SV,"2025-05-18 21:29:09",651,404,332,72,0,395,9,700,296,214,181
17,DOLJ,"GRADINITA LESILE",500,"ŞIMNICU DE SUS",70174,1,PART,PRCNCT,PRSD,PRSD_SV,"2025-05-18 21:37:32",736,419,337,82,0,416,3,800,381,246,170
17,DOLJ,"SCOALA MILESTI",501,"ŞIMNICU DE SUS",70174,1,PART,PRCNCT,PRSD,PRSD_SV,"2025-05-18 21:44:56",620,320,243,76,1,317,3,700,380,186,131
17,DOLJ,"SCOALA GIMNAZIALA TĂLPAȘ",502,TĂLPAŞ,74956,1,PART,PRCNCT,PRSD,PRSD_SV,"2025-05-18 21:41:10",943,486,378,108,0,484,2,1100,614,288,196
17,DOLJ,"CĂMINUL CULTURAL TEASC",503,TEASC,74322,1,PART,PRCNCT,PRSD,PRSD_SV,"2025-05-18 22:03:05",1316,717,602,115,0,711,6,1500,783,447,264
17,DOLJ,"ŞCOALA GIMNAZIALĂ SECUI",504,TEASC,74322,2,PART,PRCNCT,PRSD,PRSD_SV,"2025-05-19 00:47:03",1218,592,510,82,0,588,4,1300,708,363,225
17,DOLJ,"ŞCOALA GENERALĂ TERPEZIŢA",505,TERPEZIŢA,74359,1,PART,PRCNCT,PRSD,PRSD_SV,"2025-05-18 21:44:48",702,421,332,86,3,417,4,800,379,258,159
17,DOLJ,"ŞCOALA CU CLASELE I-IV CĂCIULATU",506,TERPEZIŢA,74359,1,PART,PRCNCT,PRSD,PRSD_SV,"2025-05-18 21:33:14",253,143,107,36,0,140,3,300,157,85,55
17,DOLJ,"ŞCOALA CU CLASELE I-IV LAZU",507,TERPEZIŢA,74359,1,PART,PRCNCT,PRSD,PRSD_SV,"2025-05-18 21:29:24",233,151,110,41,0,151,0,300,149,99,52
17,DOLJ,"SCOALA GIMNAZIALA TESLUI",508,TESLUI,74411,1,PART,PRCNCT,PRSD,PRSD_SV,"2025-05-18 21:29:29",419,183,149,34,0,183,0,500,317,120,63
17,DOLJ,"ȘCOALA GENERALĂ CLASELE V-VIII PREAJBA DE PĂDURE",509,TESLUI,74411,1,PART,PRCNCT,PRSD,PRSD_SV,"2025-05-18 21:34:50",579,292,245,47,0,287,5,700,408,186,101
17,DOLJ,"ȘCOALA CLASELE I-IV ȚĂRȚĂL",510,TESLUI,74411,1,PART,PRCNCT,PRSD,PRSD_SV,"2025-05-18 21:23:29",256,181,135,46,0,179,2,300,119,118,61
17,DOLJ,"SCOALA VIISOARA MOSNENI",511,TESLUI,74411,1,PART,PRCNCT,PRSD,PRSD_SV,"2025-05-18 21:42:24",427,220,174,46,0,220,0,500,280,142,78
17,DOLJ,"ȘCOALA GIMNAZIALĂ ȚUGLUI",512,ŢUGLUI,74509,1,PART,PRCNCT,PRSD,PRSD_SV,"2025-05-18 21:46:13",1315,739,593,138,8,735,4,1400,661,386,349
17,DOLJ,"GRĂDINIȚA NR 2 ȚUGLUI",513,ŢUGLUI,74509,1,PART,PRCNCT,PRSD,PRSD_SV,"2025-05-18 21:38:00",884,505,438,61,6,501,4,1000,495,307,194
17,DOLJ,"DISPENSAR UMAN",514,ŢUGLUI,74509,1,PART,PRCNCT,PRSD,PRSD_SV,"2025-05-18 21:20:29",221,154,104,50,0,153,1,300,146,77,76
17,DOLJ,"SCOALA DE LA MIJLOC NR. 3",515,UNIREA,74536,2,PART,PRCNCT,PRSD,PRSD_SV,"2025-05-19 01:53:43",1587,710,655,55,0,703,7,1700,990,495,208
17,DOLJ,"SCOALA NR.2",516,UNIREA,74536,1,PART,PRCNCT,PRSD,PRSD_SV,"2025-05-18 21:32:28",1349,636,563,73,0,631,5,1500,864,467,164
17,DOLJ,"SCOALA CU CLS. I-VIII BARBU IONESCU URZICUTA",517,URZICUŢA,74554,1,PART,PRCNCT,PRSD,PRSD_SV,"2025-05-18 21:45:16",1848,616,522,94,0,605,11,2000,1384,362,243
17,DOLJ,"CĂMIN CULTURAL",518,URZICUŢA,74554,1,PART,PRCNCT,PRSD,PRSD_SV,"2025-05-18 21:34:08",379,196,160,36,0,191,5,500,304,102,89
17,DOLJ,"SALA DE SEDINȚĂ A CONSILIULUI LOCAL",519,"VALEA STANCIULUI",74581,1,PART,PRCNCT,PRSD,PRSD_SV,"2025-05-18 21:25:44",1101,560,438,122,0,549,11,1200,640,319,230
17,DOLJ,"GRADINITA TUGURESTI",520,"VALEA STANCIULUI",74581,1,PART,PRCNCT,PRSD,PRSD_SV,"2025-05-18 21:22:49",488,278,224,54,0,275,3,600,322,181,94
17,DOLJ,"GRĂDINIȚA CU PROGRAM NORMAL NR.1 VALEA STANCIULUI",521,"VALEA STANCIULUI",74581,1,PART,PRCNCT,PRSD,PRSD_SV,"2025-05-18 21:20:22",623,310,242,68,0,306,4,700,390,170,136
17,DOLJ,"SCOALA CU CLASELE I-VIII",522,"VALEA STANCIULUI",74581,1,PART,PRCNCT,PRSD,PRSD_SV,"2025-05-18 21:46:51",1315,487,417,70,0,483,4,1400,913,300,183
17,DOLJ,"SCOALA CU CLASELE I-IV",523,"VALEA STANCIULUI",74581,1,PART,PRCNCT,PRSD,PRSD_SV,"2025-05-18 21:33:43",545,259,192,65,2,255,4,600,341,138,117
17,DOLJ,"ŞCOALA GIMNAZIALĂ VÎRTOP",524,VÂRTOP,74732,1,PART,PRCNCT,PRSD,PRSD_SV,"2025-05-18 22:13:50",1267,440,369,71,0,437,3,1400,960,287,150
17,DOLJ,"ŞCOALA CU CLASELE I-VIII VÎRVORU DE JOS",525,"VÂRVORU DE JOS",74750,1,PART,PRCNCT,PRSD,PRSD_SV,"2025-05-18 21:44:02",945,537,381,137,19,537,0,1000,463,352,185
17,DOLJ,"SCOALA CU CLASELE I-IV CIUTURA",526,"VÂRVORU DE JOS",74750,1,PART,PRCNCT,PRSD,PRSD_SV,"2025-05-18 21:31:27",558,387,234,149,4,381,6,700,313,217,164
17,DOLJ,"ŞCOALA CU CLASELE I-IV VÎRVOR",527,"VÂRVORU DE JOS",74750,1,PART,PRCNCT,PRSD,PRSD_SV,"2025-05-18 21:31:39",519,315,202,97,16,310,5,700,385,181,129
17,DOLJ,"ŞCOALA CU CLASELE I-VIII VELA",528,VELA,74616,1,PART,PRCNCT,PRSD,PRSD_SV,"2025-05-18 21:10:54",368,237,186,51,0,233,4,500,263,127,106
17,DOLJ,"ŞCOALA CU CLASELE I-IV BUCOVICIOR",529,VELA,74616,1,PART,PRCNCT,PRSD,PRSD_SV,"2025-05-18 21:20:31",290,150,126,24,0,149,1,400,250,84,65
17,DOLJ,"ŞCOALA CU CLASELE I-VIII GUBAUCEA",530,VELA,74616,1,PART,PRCNCT,PRSD,PRSD_SV,"2025-05-18 21:34:30",524,215,191,24,0,214,1,600,385,133,81
17,DOLJ,"ŞCOALA CU CLASELE I-IV SUHARU",531,VELA,74616,1,PART,PRCNCT,PRSD,PRSD_SV,"2025-05-18 21:11:26",203,122,91,31,0,120,2,300,178,68,52
17,DOLJ,"ŞCOALA CU CLASELE I-IV STIUBEI",532,VELA,74616,1,PART,PRCNCT,PRSD,PRSD_SV,"2025-05-18 21:12:00",71,47,25,22,0,46,1,200,153,27,19
17,DOLJ,"ŞCOALA GIMNAZIALĂ",533,VERBIŢA,74705,1,PART,PRCNCT,PRSD,PRSD_SV,"2025-05-18 21:51:40",627,224,196,27,1,221,3,700,476,131,90
17,DOLJ,"GRĂDINIŢA CU PROGRAM NORMAL",534,VERBIŢA,74705,1,PART,PRCNCT,PRSD,PRSD_SV,"2025-05-18 21:41:37",373,180,146,30,4,178,2,400,220,110,68
18,GALAŢI,"ȘCOALA GIMNAZIALĂ NR. 26 (ŞCOALA GENERALĂ ”ION CREANGĂ” - ȘCOALA GENERALĂ NR. 26)",1,"MUNICIPIUL GALAŢI",75098,1,PART,PRCNCT,PRSD,PRSD_SV,"2025-05-18 22:12:14",1684,650,582,68,0,644,6,1782,1132,226,418
18,GALAŢI,"ȘCOALA GIMNAZIALĂ NR. 26 (ŞCOALA GENERALĂ ”ION CREANGĂ” - ȘCOALA GENERALĂ NR. 26)",2,"MUNICIPIUL GALAŢI",75098,1,PART,PRCNCT,PRSD,PRSD_SV,"2025-05-18 23:05:33",1074,616,557,57,2,608,8,1200,584,157,451
18,GALAŢI,"ȘCOALA GIMNAZIALĂ NR. 26 (ŞCOALA GENERALĂ ”ION CREANGĂ” - ȘCOALA GENERALĂ NR. 26)",3,"MUNICIPIUL GALAŢI",75098,1,PART,PRCNCT,PRSD,PRSD_SV,"2025-05-18 22:01:32",882,508,446,62,0,499,9,950,442,172,327
18,GALAŢI,"ȘCOALA GIMNAZIALĂ NR. 28 (ŞCOALA GIMNAZIALĂ ”MIHAI EMINESCU” - SCOALA GENERALĂ NR. 28)",4,"MUNICIPIUL GALAŢI",75098,1,PART,PRCNCT,PRSD,PRSD_SV,"2025-05-18 22:05:57",1168,737,637,99,1,724,13,1300,563,167,557
18,GALAŢI,"ȘCOALA GIMNAZIALĂ NR. 28 (ŞCOALA GIMNAZIALĂ ”MIHAI EMINESCU” - SCOALA GENERALĂ NR. 28)",5,"MUNICIPIUL GALAŢI",75098,1,PART,PRCNCT,PRSD,PRSD_SV,"2025-05-18 21:55:05",966,593,521,70,2,586,7,1050,457,148,438
18,GALAŢI,"ȘCOALA GIMNAZIALĂ NR. 28 (ŞCOALA GIMNAZIALĂ ”MIHAI EMINESCU” - SCOALA GENERALĂ NR. 28)",6,"MUNICIPIUL GALAŢI",75098,1,PART,PRCNCT,PRSD,PRSD_SV,"2025-05-18 22:07:38",1256,754,682,72,0,749,5,1400,646,170,579
18,GALAŢI,"ȘCOALA GIMNAZIALĂ NR. 28 (ŞCOALA GIMNAZIALĂ ”MIHAI EMINESCU” - SCOALA GENERALĂ NR. 28)",7,"MUNICIPIUL GALAŢI",75098,1,PART,PRCNCT,PRSD,PRSD_SV,"2025-05-18 22:06:42",1176,730,628,98,4,718,12,1300,570,200,518
18,GALAŢI,"ȘCOALA GIMNAZIALĂ NR. 28 (ŞCOALA GIMNAZIALĂ ”MIHAI EMINESCU” - SCOALA GENERALĂ NR. 28)",8,"MUNICIPIUL GALAŢI",75098,2,PART,PRCNCT,PRSD,PRSD_SV,"2025-05-18 23:48:37",878,527,475,52,0,518,9,950,423,129,389
18,GALAŢI,"S.C. ”APA-CANAL” S.A.",9,"MUNICIPIUL GALAŢI",75098,2,PART,PRCNCT,PRSD,PRSD_SV,"2025-05-19 01:53:13",1596,872,837,33,2,861,11,1750,878,214,647
18,GALAŢI,"S.C. ”APA-CANAL” S.A.",10,"MUNICIPIUL GALAŢI",75098,1,PART,PRCNCT,PRSD,PRSD_SV,"2025-05-18 22:00:38",1506,850,815,35,0,841,9,1600,750,211,630
18,GALAŢI,"S.C. ”APA-CANAL” S.A.",11,"MUNICIPIUL GALAŢI",75098,1,PART,PRCNCT,PRSD,PRSD_SV,"2025-05-18 22:53:34",1252,711,667,44,0,700,11,1400,689,187,513
18,GALAŢI,"COLEGIUL NAȚIONAL ”MIHAIL KOGĂLNICEANU”",12,"MUNICIPIUL GALAŢI",75098,1,PART,PRCNCT,PRSD,PRSD_SV,"2025-05-18 21:35:58",1376,772,734,37,1,762,10,1500,728,203,559
18,GALAŢI,"COLEGIUL NAȚIONAL ”MIHAIL KOGĂLNICEANU”",13,"MUNICIPIUL GALAŢI",75098,1,PART,PRCNCT,PRSD,PRSD_SV,"2025-05-18 21:55:52",1495,783,697,84,2,772,11,1600,817,224,548
18,GALAŢI,"COLEGIUL NAȚIONAL ”MIHAIL KOGĂLNICEANU”",14,"MUNICIPIUL GALAŢI",75098,1,PART,PRCNCT,PRSD,PRSD_SV,"2025-05-18 22:34:41",1048,406,363,42,1,398,8,1150,744,193,205
18,GALAŢI,"COLEGIUL NAȚIONAL ”MIHAIL KOGĂLNICEANU”",15,"MUNICIPIUL GALAŢI",75098,1,PART,PRCNCT,PRSD,PRSD_SV,"2025-05-18 21:59:10",1104,610,538,71,1,600,10,1200,590,198,402
18,GALAŢI,"LICEUL TEORETIC ”EMIL RACOVIȚĂ” (LICEUL ”EMIL RACOVIŢĂ” - ȘCOALA GENERALĂ NR. 6)",16,"MUNICIPIUL GALAŢI",75098,2,PART,PRCNCT,PRSD,PRSD_SV,"2025-05-19 01:44:47",1707,911,849,62,0,899,12,1900,989,263,636
18,GALAŢI,"LICEUL TEORETIC ”EMIL RACOVIȚĂ” (LICEUL ”EMIL RACOVIŢĂ” - ȘCOALA GENERALĂ NR. 6)",17,"MUNICIPIUL GALAŢI",75098,1,PART,PRCNCT,PRSD,PRSD_SV,"2025-05-18 21:31:27",1206,597,551,45,1,586,11,1350,753,197,389
18,GALAŢI,"LICEUL TEORETIC ”EMIL RACOVIȚĂ” (LICEUL ”EMIL RACOVIŢĂ” - ȘCOALA GENERALĂ NR. 6)",18,"MUNICIPIUL GALAŢI",75098,1,PART,PRCNCT,PRSD,PRSD_SV,"2025-05-18 21:25:48",1076,455,424,31,0,446,9,1200,745,140,306
18,GALAŢI,"COLEGIUL NAȚIONAL ”COSTACHE NEGRI” (LICEUL PEDAGOGIC ”COSTACHE NEGRI”)",19,"MUNICIPIUL GALAŢI",75098,2,PART,PRCNCT,PRSD,PRSD_SV,"2025-05-19 00:19:44",1266,810,687,121,2,797,13,1400,590,243,554
18,GALAŢI,"COLEGIUL NAȚIONAL ”COSTACHE NEGRI” (LICEUL PEDAGOGIC ”COSTACHE NEGRI”)",20,"MUNICIPIUL GALAŢI",75098,1,PART,PRCNCT,PRSD,PRSD_SV,"2025-05-18 21:53:17",1465,849,793,54,2,833,16,1600,751,242,591
18,GALAŢI,"COLEGIUL NAȚIONAL ”COSTACHE NEGRI” (LICEUL PEDAGOGIC ”COSTACHE NEGRI”)",21,"MUNICIPIUL GALAŢI",75098,1,PART,PRCNCT,PRSD,PRSD_SV,"2025-05-18 22:00:05",1450,769,728,38,3,756,13,1600,831,180,576
18,GALAŢI,"COLEGIUL NAȚIONAL ”COSTACHE NEGRI” (LICEUL PEDAGOGIC ”COSTACHE NEGRI”)",22,"MUNICIPIUL GALAŢI",75098,1,PART,PRCNCT,PRSD,PRSD_SV,"2025-05-18 21:34:49",1348,718,659,39,20,707,11,1500,782,192,515
18,GALAŢI,"COLEGIUL NAȚIONAL ”COSTACHE NEGRI” (LICEUL PEDAGOGIC ”COSTACHE NEGRI”)",23,"MUNICIPIUL GALAŢI",75098,1,PART,PRCNCT,PRSD,PRSD_SV,"2025-05-18 22:13:07",1320,697,663,33,1,681,16,1450,753,213,468
18,GALAŢI,"ȘCOALA GIMNAZIALĂ ”ELENA CUZA” (ȘCOALA NR.15)",24,"MUNICIPIUL GALAŢI",75098,1,PART,PRCNCT,PRSD,PRSD_SV,"2025-05-18 21:52:35",1244,696,648,48,0,687,9,1350,654,307,380
18,GALAŢI,"ȘCOALA GIMNAZIALĂ ”ELENA CUZA” (ȘCOALA NR.15)",25,"MUNICIPIUL GALAŢI",75098,1,PART,PRCNCT,PRSD,PRSD_SV,"2025-05-18 22:03:32",1743,851,825,26,0,841,10,1900,1049,336,505
18,GALAŢI,"ȘCOALA GIMNAZIALĂ ”ELENA CUZA” (ȘCOALA NR.15)",26,"MUNICIPIUL GALAŢI",75098,1,PART,PRCNCT,PRSD,PRSD_SV,"2025-05-18 21:58:07",1252,575,545,29,1,566,9,1400,825,251,315
18,GALAŢI,"ȘCOALA GIMNAZIALĂ ”ELENA CUZA” (ȘCOALA NR.15)",27,"MUNICIPIUL GALAŢI",75098,1,PART,PRCNCT,PRSD,PRSD_SV,"2025-05-18 22:37:32",1300,584,558,26,0,578,6,1450,866,259,319
18,GALAŢI,"ȘCOALA GIMNAZIALĂ NR. 25 (ȘCOALA GENERALĂ ”PETRU RAREȘ” - ȘCOALA GENERALĂ NR. 25)",28,"MUNICIPIUL GALAŢI",75098,1,PART,PRCNCT,PRSD,PRSD_SV,"2025-05-18 22:00:05",1208,670,570,99,1,660,10,1350,680,192,468
18,GALAŢI,"ȘCOALA GIMNAZIALĂ NR. 25 (ȘCOALA GENERALĂ ”PETRU RAREȘ” - ȘCOALA GENERALĂ NR. 25)",29,"MUNICIPIUL GALAŢI",75098,1,PART,PRCNCT,PRSD,PRSD_SV,"2025-05-18 22:30:10",1256,803,658,51,94,791,12,1400,597,323,468
18,GALAŢI,"ȘCOALA GIMNAZIALĂ NR. 25 (ȘCOALA GENERALĂ ”PETRU RAREȘ” - ȘCOALA GENERALĂ NR. 25)",30,"MUNICIPIUL GALAŢI",75098,1,PART,PRCNCT,PRSD,PRSD_SV,"2025-05-18 22:09:14",1655,818,658,33,127,801,17,1800,982,349,452
18,GALAŢI,"ȘCOALA GIMNAZIALĂ NR. 25 (ȘCOALA GENERALĂ ”PETRU RAREȘ” - ȘCOALA GENERALĂ NR. 25)",31,"MUNICIPIUL GALAŢI",75098,2,PART,PRCNCT,PRSD,PRSD_SV,"2025-05-19 00:23:18",1431,902,754,28,120,894,8,1600,698,390,504
18,GALAŢI,"ȘCOALA GIMNAZIALĂ NR. 25 (ȘCOALA GENERALĂ ”PETRU RAREȘ” - ȘCOALA GENERALĂ NR. 25)",32,"MUNICIPIUL GALAŢI",75098,1,PART,PRCNCT,PRSD,PRSD_SV,"2025-05-18 21:42:17",1181,642,603,29,10,632,10,1300,658,233,399
18,GALAŢI,"ȘCOALA GIMNAZIALĂ NR. 16 (ȘCOALA GENERALĂ ”NICOLAE BĂLCESCU” - ȘCOALA GENERALĂ NR. 16)",33,"MUNICIPIUL GALAŢI",75098,1,PART,PRCNCT,PRSD,PRSD_SV,"2025-05-18 22:12:10",1260,696,650,46,0,688,8,1400,704,217,471
18,GALAŢI,"ȘCOALA GIMNAZIALĂ NR. 16 (ȘCOALA GENERALĂ ”NICOLAE BĂLCESCU” - ȘCOALA GENERALĂ NR. 16)",34,"MUNICIPIUL GALAŢI",75098,2,PART,PRCNCT,PRSD,PRSD_SV,"2025-05-18 22:45:37",1058,569,504,65,0,560,9,1150,581,233,327
18,GALAŢI,"ȘCOALA GIMNAZIALĂ NR. 16 (ȘCOALA GENERALĂ ”NICOLAE BĂLCESCU” - ȘCOALA GENERALĂ NR. 16)",35,"MUNICIPIUL GALAŢI",75098,1,PART,PRCNCT,PRSD,PRSD_SV,"2025-05-18 21:46:31",1156,654,616,35,3,645,9,1300,646,177,468
18,GALAŢI,"ȘCOALA GIMNAZIALĂ NR. 16 (ȘCOALA GENERALĂ ”NICOLAE BĂLCESCU” - ȘCOALA GENERALĂ NR. 16)",36,"MUNICIPIUL GALAŢI",75098,3,PART,PRCNCT,PRSD,PRSD_SV,"2025-05-19 00:43:57",1212,655,615,40,0,647,8,1350,695,241,406
18,GALAŢI,"UNIVERSITATEA ”DUNĂREA DE JOS” GALAȚI (UNIVERSITATEA GALAŢI)",37,"MUNICIPIUL GALAŢI",75098,1,PART,PRCNCT,PRSD,PRSD_SV,"2025-05-18 22:10:37",1316,782,635,121,26,773,9,1450,668,294,479
18,GALAŢI,"ȘCOALA GIMNAZIALĂ ”LUDOVIC COSMA” (ȘCOALA GENERALĂ NR. 19)",38,"MUNICIPIUL GALAŢI",75098,1,PART,PRCNCT,PRSD,PRSD_SV,"2025-05-18 22:00:52",1156,670,568,54,48,661,9,1250,580,269,392
18,GALAŢI,"ȘCOALA GIMNAZIALĂ ”LUDOVIC COSMA” (ȘCOALA GENERALĂ NR. 19)",39,"MUNICIPIUL GALAŢI",75098,1,PART,PRCNCT,PRSD,PRSD_SV,"2025-05-18 22:46:59",1450,783,750,30,3,774,9,1600,817,327,447
18,GALAŢI,"LICEUL TEHNOLOGIC ”RADU NEGRU” (COLEGIUL TEHNIC ”RADU NEGRU” - GRUP ȘCOLAR ”RADU NEGRU”)",40,"MUNICIPIUL GALAŢI",75098,1,PART,PRCNCT,PRSD,PRSD_SV,"2025-05-18 22:30:27",1542,841,717,56,68,822,19,1700,859,352,470
18,GALAŢI,"LICEUL TEHNOLOGIC ”RADU NEGRU” (COLEGIUL TEHNIC ”RADU NEGRU” - GRUP ȘCOLAR ”RADU NEGRU”)",41,"MUNICIPIUL GALAŢI",75098,1,PART,PRCNCT,PRSD,PRSD_SV,"2025-05-18 22:52:49",1796,1064,922,50,92,1052,12,2000,936,436,616
18,GALAŢI,"COLEGIUL DE INDUSTRIE ALIMENTARĂ ”ELENA DOAMNA” (GRUP ȘCOLAR ”ELENA DOAMNA”)",42,"MUNICIPIUL GALAŢI",75098,1,PART,PRCNCT,PRSD,PRSD_SV,"2025-05-18 21:46:41",1693,933,740,193,0,924,9,1800,867,291,633
18,GALAŢI,"COLEGIUL DE INDUSTRIE ALIMENTARĂ ”ELENA DOAMNA” (GRUP ȘCOLAR ”ELENA DOAMNA”)",43,"MUNICIPIUL GALAŢI",75098,1,PART,PRCNCT,PRSD,PRSD_SV,"2025-05-18 22:28:30",1536,855,725,114,16,838,17,1700,845,298,540
18,GALAŢI,"ȘCOALA GIMNAZIALĂ NR. 20 (ȘCOALA GENERALĂ NR. 20 ”TRAIAN”)",44,"MUNICIPIUL GALAŢI",75098,1,PART,PRCNCT,PRSD,PRSD_SV,"2025-05-18 21:51:17",1906,736,726,10,0,721,15,2000,1264,258,463
18,GALAŢI,"ȘCOALA GIMNAZIALĂ NR. 20 (ȘCOALA GENERALĂ NR. 20 ”TRAIAN”)",45,"MUNICIPIUL GALAŢI",75098,1,PART,PRCNCT,PRSD,PRSD_SV,"2025-05-18 21:50:33",1894,668,561,75,32,658,10,2000,1332,289,369
18,GALAŢI,"ȘCOALA GIMNAZIALĂ NR. 20 (ȘCOALA GENERALĂ NR. 20 ”TRAIAN”)",46,"MUNICIPIUL GALAŢI",75098,2,PART,PRCNCT,PRSD,PRSD_SV,"2025-05-18 22:58:46",1816,873,783,49,41,868,5,2000,1127,339,529
18,GALAŢI,"ȘCOALA GIMNAZIALĂ NR. 24 (ȘCOALA GENERALĂ NR. 24)",47,"MUNICIPIUL GALAŢI",75098,1,PART,PRCNCT,PRSD,PRSD_SV,"2025-05-18 21:45:27",1494,858,784,71,3,852,6,1600,742,224,628
18,GALAŢI,"LICEUL TEHNOLOGIC ”GENERAL DE MARINA NICOLAE DUMITRESCU MAICAN” (LICEUL TEHNOLOGIC DE MARINĂ - GRUP ȘCOLAR INDUSTRIAL DE MARINĂ - LICEUL DE MARINĂ)",48,"MUNICIPIUL GALAŢI",75098,1,PART,PRCNCT,PRSD,PRSD_SV,"2025-05-18 22:00:23",1257,589,546,39,4,583,6,1400,811,330,253
18,GALAŢI,"LICEUL TEHNOLOGIC ”GENERAL DE MARINA NICOLAE DUMITRESCU MAICAN” (LICEUL TEHNOLOGIC DE MARINĂ - GRUP ȘCOLAR INDUSTRIAL DE MARINĂ - LICEUL DE MARINĂ)",49,"MUNICIPIUL GALAŢI",75098,1,PART,PRCNCT,PRSD,PRSD_SV,"2025-05-18 22:16:07",1528,750,663,86,1,741,9,1684,934,387,354
18,GALAŢI,"LICEUL TEHNOLOGIC ”GENERAL DE MARINA NICOLAE DUMITRESCU MAICAN” (LICEUL TEHNOLOGIC DE MARINĂ - GRUP ȘCOLAR INDUSTRIAL DE MARINĂ - LICEUL DE MARINĂ)",50,"MUNICIPIUL GALAŢI",75098,1,PART,PRCNCT,PRSD,PRSD_SV,"2025-05-18 22:02:32",1266,657,584,73,0,650,7,1400,743,232,418
18,GALAŢI,"COLEGIUL NAȚIONAL ”ALEXANDRU IOAN CUZA” (GRĂDINIȚA NR. 59 - FOSTA ȘCOALĂ GENERALĂ NR. 8)",51,"MUNICIPIUL GALAŢI",75098,1,PART,PRCNCT,PRSD,PRSD_SV,"2025-05-18 22:43:48",1196,688,644,42,2,679,9,1302,614,184,495
18,GALAŢI,"COLEGIUL NAȚIONAL ”ALEXANDRU IOAN CUZA” (GRĂDINIȚA NR. 59 - FOSTA ȘCOALĂ GENERALĂ NR. 8)",52,"MUNICIPIUL GALAŢI",75098,2,PART,PRCNCT,PRSD,PRSD_SV,"2025-05-19 00:37:48",1380,750,714,36,0,743,7,1500,750,209,534
18,GALAŢI,"COLEGIUL NAȚIONAL ”ALEXANDRU IOAN CUZA” (GRĂDINIȚA NR. 59 - FOSTA ȘCOALĂ GENERALĂ NR. 8)",53,"MUNICIPIUL GALAŢI",75098,1,PART,PRCNCT,PRSD,PRSD_SV,"2025-05-18 21:54:10",1278,654,603,51,0,648,6,1400,746,178,470
18,GALAŢI,"COLEGIUL NAȚIONAL ”ALEXANDRU IOAN CUZA” (GRĂDINIȚA NR. 59 - FOSTA ȘCOALĂ GENERALĂ NR. 8)",54,"MUNICIPIUL GALAŢI",75098,1,PART,PRCNCT,PRSD,PRSD_SV,"2025-05-18 21:26:39",1865,542,511,31,0,532,10,2000,1458,210,322
18,GALAŢI,"COLEGIUL ECONOMIC ”VIRGIL MADGEARU” (GRUP ȘCOLAR ECONOMIC ADMINISTRATIV ”VIRGIL MADGEARU”)",55,"MUNICIPIUL GALAŢI",75098,1,PART,PRCNCT,PRSD,PRSD_SV,"2025-05-18 21:47:19",1868,378,256,59,63,376,2,2000,1622,197,179
18,GALAŢI,"COLEGIUL ECONOMIC ”VIRGIL MADGEARU” (GRUP ȘCOLAR ECONOMIC ADMINISTRATIV ”VIRGIL MADGEARU”)",56,"MUNICIPIUL GALAŢI",75098,1,PART,PRCNCT,PRSD,PRSD_SV,"2025-05-18 21:56:36",1813,251,126,29,96,248,3,2000,1749,101,147
18,GALAŢI,"COLEGIUL ECONOMIC ”VIRGIL MADGEARU” (GRUP ȘCOLAR ECONOMIC ADMINISTRATIV ”VIRGIL MADGEARU”)",57,"MUNICIPIUL GALAŢI",75098,1,PART,PRCNCT,PRSD,PRSD_SV,"2025-05-18 21:37:04",1828,166,135,16,15,163,3,2000,1834,69,94
18,GALAŢI,"COLEGIUL ECONOMIC ”VIRGIL MADGEARU” (GRUP ȘCOLAR ECONOMIC ADMINISTRATIV ”VIRGIL MADGEARU”)",58,"MUNICIPIUL GALAŢI",75098,2,PART,PRCNCT,PRSD,PRSD_SV,"2025-05-18 23:43:15",1875,573,552,20,1,559,14,2000,1427,222,337
18,GALAŢI,"COLEGIUL ECONOMIC ”VIRGIL MADGEARU” (GRUP ȘCOLAR ECONOMIC ADMINISTRATIV ”VIRGIL MADGEARU”)",59,"MUNICIPIUL GALAŢI",75098,1,PART,PRCNCT,PRSD,PRSD_SV,"2025-05-18 22:06:31",1738,853,832,20,1,842,11,1900,1047,314,528
18,GALAŢI,"ȘCOALA GIMNAZIALĂ NR. 17 (ȘCOALA GENERALĂ ”NICHITA STĂNESCU” - ȘCOALA GENERALĂ NR. 17)",60,"MUNICIPIUL GALAŢI",75098,1,PART,PRCNCT,PRSD,PRSD_SV,"2025-05-18 21:57:30",1833,567,542,25,0,560,7,2000,1433,255,305
18,GALAŢI,"ȘCOALA GIMNAZIALĂ NR. 17 (ȘCOALA GENERALĂ ”NICHITA STĂNESCU” - ȘCOALA GENERALĂ NR. 17)",61,"MUNICIPIUL GALAŢI",75098,1,PART,PRCNCT,PRSD,PRSD_SV,"2025-05-18 21:36:39",1836,300,259,41,0,289,11,2000,1700,140,149
18,GALAŢI,"ȘCOALA GIMNAZIALĂ NR. 17 (ȘCOALA GENERALĂ ”NICHITA STĂNESCU” - ȘCOALA GENERALĂ NR. 17)",62,"MUNICIPIUL GALAŢI",75098,1,PART,PRCNCT,PRSD,PRSD_SV,"2025-05-18 21:45:26",1723,368,274,94,0,358,10,1900,1532,180,178
18,GALAŢI,"ȘCOALA GIMNAZIALĂ NR. 29 (ȘCOALA GENERALĂ ”SFÂNTA ANA” - ȘCOALA GENERALĂ NR. 29)",63,"MUNICIPIUL GALAŢI",75098,3,PART,PRCNCT,PRSD,PRSD_SV,"2025-05-18 23:36:56",1834,767,714,53,0,756,11,2000,1233,303,453
18,GALAŢI,"ȘCOALA GIMNAZIALĂ NR. 29 (ȘCOALA GENERALĂ ”SFÂNTA ANA” - ȘCOALA GENERALĂ NR. 29)",64,"MUNICIPIUL GALAŢI",75098,1,PART,PRCNCT,PRSD,PRSD_SV,"2025-05-18 22:02:48",1835,820,789,31,0,803,17,2000,1180,348,455
18,GALAŢI,"ȘCOALA GIMNAZIALĂ NR. 29 (ȘCOALA GENERALĂ ”SFÂNTA ANA” - ȘCOALA GENERALĂ NR. 29)",65,"MUNICIPIUL GALAŢI",75098,1,PART,PRCNCT,PRSD,PRSD_SV,"2025-05-18 21:53:17",1819,833,808,25,0,815,18,2000,1167,349,466
18,GALAŢI,"ȘCOALA GIMNAZIALĂ NR. 29 (ȘCOALA GENERALĂ ”SFÂNTA ANA” - ȘCOALA GENERALĂ NR. 29)",66,"MUNICIPIUL GALAŢI",75098,1,PART,PRCNCT,PRSD,PRSD_SV,"2025-05-18 22:03:27",1829,954,921,32,1,944,10,2000,1046,325,619
18,GALAŢI,"ȘCOALA GIMNAZIALĂ NR. 22 (ȘCOALA GENERALĂ ”DIMITRIE CANTEMIR” - ȘCOALA GENERALĂ NR. 22)",67,"MUNICIPIUL GALAŢI",75098,1,PART,PRCNCT,PRSD,PRSD_SV,"2025-05-18 22:14:20",1748,867,781,86,0,845,22,1950,1083,347,498
18,GALAŢI,"ȘCOALA GIMNAZIALĂ NR. 22 (ȘCOALA GENERALĂ ”DIMITRIE CANTEMIR” - ȘCOALA GENERALĂ NR. 22)",68,"MUNICIPIUL GALAŢI",75098,1,PART,PRCNCT,PRSD,PRSD_SV,"2025-05-18 21:38:21",1785,939,900,39,0,928,11,1950,1011,305,623
18,GALAŢI,"ȘCOALA GIMNAZIALĂ NR. 22 (ȘCOALA GENERALĂ ”DIMITRIE CANTEMIR” - ȘCOALA GENERALĂ NR. 22)",69,"MUNICIPIUL GALAŢI",75098,1,PART,PRCNCT,PRSD,PRSD_SV,"2025-05-18 21:50:55",1821,827,803,24,0,808,19,2000,1173,321,487
18,GALAŢI,"GRĂDINIȚA CU PROGRAM PRELUNGIT ”MOTANUL ÎNCĂLȚAT” (GRĂDINIȚA CU PROGRAM PRELUNGIT ”PRICHINDEL” - GRĂDINIȚA ”PRICHINDEL” - GRĂDINIȚA NR. 62)",70,"MUNICIPIUL GALAŢI",75098,1,PART,PRCNCT,PRSD,PRSD_SV,"2025-05-18 22:16:22",1449,795,745,49,1,784,11,1600,805,245,539
18,GALAŢI,"GRĂDINIȚA CU PROGRAM PRELUNGIT ”MOTANUL ÎNCĂLȚAT” (GRĂDINIȚA CU PROGRAM PRELUNGIT ”PRICHINDEL” - GRĂDINIȚA ”PRICHINDEL” - GRĂDINIȚA NR. 62)",71,"MUNICIPIUL GALAŢI",75098,2,PART,PRCNCT,PRSD,PRSD_SV,"2025-05-19 01:01:47",1354,705,649,56,0,697,8,1500,795,278,419
18,GALAŢI,"GRĂDINIȚA CU PROGRAM PRELUNGIT ”MOTANUL ÎNCĂLȚAT” (GRĂDINIȚA CU PROGRAM PRELUNGIT ”PRICHINDEL” - GRĂDINIȚA ”PRICHINDEL” - GRĂDINIȚA NR. 62)",72,"MUNICIPIUL GALAŢI",75098,1,PART,PRCNCT,PRSD,PRSD_SV,"2025-05-18 22:03:04",1283,721,644,76,1,713,8,1400,679,256,457
18,GALAŢI,"STAȚIE DE POMPARE APE UZATE S.C. APĂ-CANAL S.A.",73,"MUNICIPIUL GALAŢI",75098,1,PART,PRCNCT,PRSD,PRSD_SV,"2025-05-18 21:50:30",483,271,228,43,0,268,3,550,279,147,121
18,GALAŢI,"ȘCOALA GIMNAZIALĂ ”DAN BARBILIAN” (ȘCOALA GENERALĂ ”DAN BARBILIAN” - ȘCOALA GENERALĂ NR. 43)",74,"MUNICIPIUL GALAŢI",75098,2,PART,PRCNCT,PRSD,PRSD_SV,"2025-05-19 00:10:01",1507,793,687,106,0,780,13,1600,807,260,520
18,GALAŢI,"ȘCOALA GIMNAZIALĂ ”DAN BARBILIAN” (ȘCOALA GENERALĂ ”DAN BARBILIAN” - ȘCOALA GENERALĂ NR. 43)",75,"MUNICIPIUL GALAŢI",75098,1,PART,PRCNCT,PRSD,PRSD_SV,"2025-05-18 22:10:16",1362,673,630,37,6,664,9,1550,877,210,454
18,GALAŢI,"ȘCOALA GIMNAZIALĂ ”DAN BARBILIAN” (ȘCOALA GENERALĂ ”DAN BARBILIAN” - ȘCOALA GENERALĂ NR. 43)",76,"MUNICIPIUL GALAŢI",75098,1,PART,PRCNCT,PRSD,PRSD_SV,"2025-05-18 21:49:09",1352,662,643,19,0,657,5,1500,838,234,423
18,GALAŢI,"ȘCOALA GIMNAZIALĂ ”DAN BARBILIAN” (ȘCOALA GENERALĂ ”DAN BARBILIAN” - ȘCOALA GENERALĂ NR. 43)",77,"MUNICIPIUL GALAŢI",75098,1,PART,PRCNCT,PRSD,PRSD_SV,"2025-05-18 21:57:04",1404,709,691,18,0,691,18,1550,841,253,438
18,GALAŢI,"ȘCOALA GIMNAZIALĂ ”DAN BARBILIAN” (ȘCOALA GENERALĂ ”DAN BARBILIAN” - ȘCOALA GENERALĂ NR. 43)",78,"MUNICIPIUL GALAŢI",75098,1,PART,PRCNCT,PRSD,PRSD_SV,"2025-05-18 21:51:13",1431,652,636,16,0,639,13,1600,948,227,412
18,GALAŢI,"ȘCOALA GIMNAZIALĂ ”DAN BARBILIAN” (ȘCOALA GENERALĂ ”DAN BARBILIAN” - ȘCOALA GENERALĂ NR. 43)",79,"MUNICIPIUL GALAŢI",75098,1,PART,PRCNCT,PRSD,PRSD_SV,"2025-05-18 22:20:28",1345,707,689,17,1,697,10,1500,793,265,432
18,GALAŢI,"ȘCOALA GIMNAZIALĂ ”DAN BARBILIAN” (ȘCOALA GENERALĂ ”DAN BARBILIAN” - ȘCOALA GENERALĂ NR. 43)",80,"MUNICIPIUL GALAŢI",75098,2,PART,PRCNCT,PRSD,PRSD_SV,"2025-05-18 23:08:27",1424,648,632,16,0,642,6,1550,902,235,407
18,GALAŢI,"ȘCOALA GIMNAZIALĂ NR. 3 (ȘCOALA GENERALĂ NR. 3)",81,"MUNICIPIUL GALAŢI",75098,1,PART,PRCNCT,PRSD,PRSD_SV,"2025-05-18 22:11:56",1470,775,707,66,2,767,8,1600,825,286,481
18,GALAŢI,"ȘCOALA GIMNAZIALĂ NR. 3 (ȘCOALA GENERALĂ NR. 3)",82,"MUNICIPIUL GALAŢI",75098,1,PART,PRCNCT,PRSD,PRSD_SV,"2025-05-18 21:44:33",1468,715,680,34,1,707,8,1600,885,267,440
18,GALAŢI,"ȘCOALA GIMNAZIALĂ NR. 3 (ȘCOALA GENERALĂ NR. 3)",83,"MUNICIPIUL GALAŢI",75098,1,PART,PRCNCT,PRSD,PRSD_SV,"2025-05-18 21:58:48",1437,693,675,18,0,686,7,1600,907,253,433
18,GALAŢI,"ȘCOALA GIMNAZIALĂ NR. 3 (ȘCOALA GENERALĂ NR. 3)",84,"MUNICIPIUL GALAŢI",75098,1,PART,PRCNCT,PRSD,PRSD_SV,"2025-05-18 22:04:36",1628,811,789,22,0,799,12,1800,989,337,462
18,GALAŢI,"ȘCOALA GIMNAZIALĂ NR. 3 (ȘCOALA GENERALĂ NR. 3)",85,"MUNICIPIUL GALAŢI",75098,1,PART,PRCNCT,PRSD,PRSD_SV,"2025-05-18 22:12:15",1528,817,769,48,0,805,12,1700,883,312,493
18,GALAŢI,"ȘCOALA GIMNAZIALĂ ”IULIA HAȘDEU” (ȘCOALA GENERALĂ ”IULIA HAȘDEU” - ȘCOALA GENERALĂ NR. 40)",86,"MUNICIPIUL GALAŢI",75098,1,PART,PRCNCT,PRSD,PRSD_SV,"2025-05-18 22:13:42",1390,684,629,55,0,674,10,1550,866,226,448
18,GALAŢI,"ȘCOALA GIMNAZIALĂ ”IULIA HAȘDEU” (ȘCOALA GENERALĂ ”IULIA HAȘDEU” - ȘCOALA GENERALĂ NR. 40)",87,"MUNICIPIUL GALAŢI",75098,1,PART,PRCNCT,PRSD,PRSD_SV,"2025-05-18 21:46:22",1309,656,625,31,0,646,10,1450,794,263,383
18,GALAŢI,"ȘCOALA GIMNAZIALĂ ”IULIA HAȘDEU” (ȘCOALA GENERALĂ ”IULIA HAȘDEU” - ȘCOALA GENERALĂ NR. 40)",88,"MUNICIPIUL GALAŢI",75098,1,PART,PRCNCT,PRSD,PRSD_SV,"2025-05-18 21:58:00",1317,658,640,18,0,642,16,1450,792,243,399
18,GALAŢI,"ȘCOALA GIMNAZIALĂ ”IULIA HAȘDEU” (ȘCOALA GENERALĂ ”IULIA HAȘDEU” - ȘCOALA GENERALĂ NR. 40)",89,"MUNICIPIUL GALAŢI",75098,1,PART,PRCNCT,PRSD,PRSD_SV,"2025-05-18 21:29:10",1391,713,683,29,1,698,15,1550,837,257,441
18,GALAŢI,"ȘCOALA GIMNAZIALĂ ”IULIA HAȘDEU” (ȘCOALA GENERALĂ ”IULIA HAȘDEU” - ȘCOALA GENERALĂ NR. 40)",90,"MUNICIPIUL GALAŢI",75098,1,PART,PRCNCT,PRSD,PRSD_SV,"2025-05-18 21:46:18",1510,713,684,29,0,706,7,1600,887,264,442
18,GALAŢI,"ȘCOALA GIMNAZIALĂ ”IULIA HAȘDEU” (ȘCOALA GENERALĂ ”IULIA HAȘDEU” - ȘCOALA GENERALĂ NR. 40)",91,"MUNICIPIUL GALAŢI",75098,1,PART,PRCNCT,PRSD,PRSD_SV,"2025-05-18 22:04:51",1213,588,571,17,0,568,20,1350,762,233,335
18,GALAŢI,"ȘCOALA GIMNAZIALĂ NR. 9 (ȘCOALA GIMNAZIALĂ NR. 9 ”CALISTRAT HOGAȘ”)",92,"MUNICIPIUL GALAŢI",75098,1,PART,PRCNCT,PRSD,PRSD_SV,"2025-05-18 22:01:13",1434,825,778,46,1,810,15,1600,775,322,488
18,GALAŢI,"ȘCOALA GIMNAZIALĂ NR. 9 (ȘCOALA GIMNAZIALĂ NR. 9 ”CALISTRAT HOGAȘ”)",93,"MUNICIPIUL GALAŢI",75098,1,PART,PRCNCT,PRSD,PRSD_SV,"2025-05-18 22:05:54",1191,582,540,40,2,568,14,1300,718,190,378
18,GALAŢI,"ȘCOALA GIMNAZIALĂ NR. 9 (ȘCOALA GIMNAZIALĂ NR. 9 ”CALISTRAT HOGAȘ”)",94,"MUNICIPIUL GALAŢI",75098,1,PART,PRCNCT,PRSD,PRSD_SV,"2025-05-18 22:08:04",1667,903,873,28,2,885,18,1800,897,440,445
18,GALAŢI,"GRĂDINIȚA CU PROGRAM NORMAL NR. 59 (FOSTA ȘCOALĂ GIMNAZIALĂ ”NICOLAE MANTU”)",95,"MUNICIPIUL GALAŢI",75098,1,PART,PRCNCT,PRSD,PRSD_SV,"2025-05-18 21:42:14",1545,838,747,38,53,828,10,1700,862,267,561
18,GALAŢI,"GRĂDINIȚA CU PROGRAM NORMAL NR. 59 (FOSTA ȘCOALĂ GIMNAZIALĂ ”NICOLAE MANTU”)",96,"MUNICIPIUL GALAŢI",75098,1,PART,PRCNCT,PRSD,PRSD_SV,"2025-05-18 21:43:21",1332,766,657,43,66,755,11,1450,684,278,477
18,GALAŢI,"ȘCOALA GIMNAZIALĂ NR. 5 (ȘCOALA GENERALĂ ”CUZA VODĂ” - ȘCOALA GENERALĂ NR. 5)",97,"MUNICIPIUL GALAŢI",75098,1,PART,PRCNCT,PRSD,PRSD_SV,"2025-05-18 21:47:11",1503,804,754,50,0,792,12,1600,796,309,483
18,GALAŢI,"ȘCOALA GIMNAZIALĂ NR. 5 (ȘCOALA GENERALĂ ”CUZA VODĂ” - ȘCOALA GENERALĂ NR. 5)",98,"MUNICIPIUL GALAŢI",75098,1,PART,PRCNCT,PRSD,PRSD_SV,"2025-05-18 21:40:43",1427,757,707,49,1,745,12,1550,793,304,441
18,GALAŢI,"ȘCOALA GIMNAZIALĂ NR. 5 (ȘCOALA GENERALĂ ”CUZA VODĂ” - ȘCOALA GENERALĂ NR. 5)",99,"MUNICIPIUL GALAŢI",75098,1,PART,PRCNCT,PRSD,PRSD_SV,"2025-05-18 21:51:41",1454,783,725,58,0,771,12,1600,817,343,428
18,GALAŢI,"ȘCOALA GIMNAZIALĂ NR. 5 (ȘCOALA GENERALĂ ”CUZA VODĂ” - ȘCOALA GENERALĂ NR. 5)",100,"MUNICIPIUL GALAŢI",75098,2,PART,PRCNCT,PRSD,PRSD_SV,"2025-05-18 22:12:09",1271,652,619,32,1,644,8,1400,748,208,436
18,GALAŢI,"LICEUL TEORETIC ”DUNAREA”",101,"MUNICIPIUL GALAŢI",75098,2,PART,PRCNCT,PRSD,PRSD_SV,"2025-05-18 22:39:12",1094,598,536,61,1,592,6,1200,602,211,381
18,GALAŢI,"LICEUL TEORETIC ”DUNAREA”",102,"MUNICIPIUL GALAŢI",75098,1,PART,PRCNCT,PRSD,PRSD_SV,"2025-05-18 22:06:32",1176,607,567,39,1,605,2,1300,693,246,359
18,GALAŢI,"LICEUL TEORETIC ”DUNAREA”",103,"MUNICIPIUL GALAŢI",75098,1,PART,PRCNCT,PRSD,PRSD_SV,"2025-05-18 21:31:39",1249,622,577,45,0,614,8,1400,778,220,394
18,GALAŢI,"ȘCOALA GIMNAZIALĂ ”MIHAIL SADOVEANU” (ȘCOALA GENERALĂ ”MIHAIL SADOVEANU” – ȘCOALA GENERALĂ NR. 11)",104,"MUNICIPIUL GALAŢI",75098,1,PART,PRCNCT,PRSD,PRSD_SV,"2025-05-18 21:43:51",1457,763,711,52,0,749,14,1600,837,285,464
18,GALAŢI,"ȘCOALA GIMNAZIALĂ ”MIHAIL SADOVEANU” (ȘCOALA GENERALĂ ”MIHAIL SADOVEANU” – ȘCOALA GENERALĂ NR. 11)",105,"MUNICIPIUL GALAŢI",75098,2,PART,PRCNCT,PRSD,PRSD_SV,"2025-05-19 00:00:21",1312,707,655,50,2,689,18,1450,743,252,437
18,GALAŢI,"ȘCOALA GIMNAZIALĂ ”MIHAIL SADOVEANU” (ȘCOALA GENERALĂ ”MIHAIL SADOVEANU” – ȘCOALA GENERALĂ NR. 11)",106,"MUNICIPIUL GALAŢI",75098,1,PART,PRCNCT,PRSD,PRSD_SV,"2025-05-18 21:22:39",1047,545,519,26,0,539,6,1150,605,203,336
18,GALAŢI,"ȘCOALA GIMNAZIALĂ ”MIHAIL SADOVEANU” (ȘCOALA GENERALĂ ”MIHAIL SADOVEANU” – ȘCOALA GENERALĂ NR. 11)",107,"MUNICIPIUL GALAŢI",75098,1,PART,PRCNCT,PRSD,PRSD_SV,"2025-05-18 21:58:38",1279,614,597,16,1,604,10,1400,786,259,345
18,GALAŢI,"ȘCOALA GIMNAZIALĂ ”MIHAIL SADOVEANU” (ȘCOALA GENERALĂ ”MIHAIL SADOVEANU” – ȘCOALA GENERALĂ NR. 11)",108,"MUNICIPIUL GALAŢI",75098,1,PART,PRCNCT,PRSD,PRSD_SV,"2025-05-18 21:57:35",1299,679,667,11,1,671,8,1450,771,214,457
18,GALAŢI,"ȘCOALA GIMNAZIALĂ ”MIHAIL SADOVEANU” (ȘCOALA GENERALĂ ”MIHAIL SADOVEANU” – ȘCOALA GENERALĂ NR. 11)",109,"MUNICIPIUL GALAŢI",75098,1,PART,PRCNCT,PRSD,PRSD_SV,"2025-05-18 21:52:25",1280,646,619,26,1,635,11,1450,804,228,407
18,GALAŢI,"ȘCOALA GIMNAZIALĂ NR. 10 (ȘCOALA GENERALĂ ”PETRE ȚUȚEA” - ȘCOALA GENERALĂ NR. 10)",110,"MUNICIPIUL GALAŢI",75098,1,PART,PRCNCT,PRSD,PRSD_SV,"2025-05-18 21:41:29",1494,788,720,68,0,777,11,1600,812,275,502
18,GALAŢI,"ȘCOALA GIMNAZIALĂ NR. 10 (ȘCOALA GENERALĂ ”PETRE ȚUȚEA” - ȘCOALA GENERALĂ NR. 10)",111,"MUNICIPIUL GALAŢI",75098,1,PART,PRCNCT,PRSD,PRSD_SV,"2025-05-18 22:05:42",1454,725,683,40,2,718,7,1600,875,286,432
18,GALAŢI,"ȘCOALA GIMNAZIALĂ NR. 10 (ȘCOALA GENERALĂ ”PETRE ȚUȚEA” - ȘCOALA GENERALĂ NR. 10)",112,"MUNICIPIUL GALAŢI",75098,1,PART,PRCNCT,PRSD,PRSD_SV,"2025-05-18 21:53:48",1558,756,737,19,0,745,11,1700,944,309,436
18,GALAŢI,"ȘCOALA GIMNAZIALĂ NR. 10 (ȘCOALA GENERALĂ ”PETRE ȚUȚEA” - ȘCOALA GENERALĂ NR. 10)",113,"MUNICIPIUL GALAŢI",75098,1,PART,PRCNCT,PRSD,PRSD_SV,"2025-05-18 22:03:25",1348,711,649,61,1,693,18,1500,789,268,425
18,GALAŢI,"ȘCOALA GIMNAZIALĂ NR. 10 (ȘCOALA GENERALĂ ”PETRE ȚUȚEA” - ȘCOALA GENERALĂ NR. 10)",114,"MUNICIPIUL GALAŢI",75098,1,PART,PRCNCT,PRSD,PRSD_SV,"2025-05-18 22:20:27",1620,834,798,36,0,821,13,1800,966,313,508
18,GALAŢI,"LICEUL DE TRANSPORTURI AUTO ”TRAIAN VUIA” (COLEGIUL TEHNIC ”TRAIAN VUIA” - GRUP ŞCOLAR TRANSPORTURI AUTO)",115,"MUNICIPIUL GALAŢI",75098,1,PART,PRCNCT,PRSD,PRSD_SV,"2025-05-18 21:31:35",1182,694,602,48,44,679,15,1300,606,230,449
18,GALAŢI,"LICEUL DE TRANSPORTURI AUTO ”TRAIAN VUIA” (COLEGIUL TEHNIC ”TRAIAN VUIA” - GRUP ŞCOLAR TRANSPORTURI AUTO)",116,"MUNICIPIUL GALAŢI",75098,1,PART,PRCNCT,PRSD,PRSD_SV,"2025-05-18 21:50:03",1280,689,636,53,0,686,3,1400,711,253,433
18,GALAŢI,"LICEUL DE TRANSPORTURI AUTO ”TRAIAN VUIA” (COLEGIUL TEHNIC ”TRAIAN VUIA” - GRUP ŞCOLAR TRANSPORTURI AUTO)",117,"MUNICIPIUL GALAŢI",75098,1,PART,PRCNCT,PRSD,PRSD_SV,"2025-05-18 21:35:23",1201,631,604,26,1,621,10,1300,669,184,437
18,GALAŢI,"ȘCOALA GIMNAZIALĂ ”SFINȚII ÎMPĂRAȚI” (ȘCOALA GENERALĂ ”SFINȚII ÎMPĂRAȚI” - ȘCOALA GENERALĂ NR. 42)",118,"MUNICIPIUL GALAŢI",75098,1,PART,PRCNCT,PRSD,PRSD_SV,"2025-05-18 21:59:19",1580,825,800,23,2,807,18,1750,925,295,512
18,GALAŢI,"ȘCOALA GIMNAZIALĂ ”SFINȚII ÎMPĂRAȚI” (ȘCOALA GENERALĂ ”SFINȚII ÎMPĂRAȚI” - ȘCOALA GENERALĂ NR. 42)",119,"MUNICIPIUL GALAŢI",75098,2,PART,PRCNCT,PRSD,PRSD_SV,"2025-05-18 23:15:15",1506,801,764,36,1,789,12,1600,799,219,570
18,GALAŢI,"ȘCOALA GIMNAZIALĂ ”SFINȚII ÎMPĂRAȚI” (ȘCOALA GENERALĂ ”SFINȚII ÎMPĂRAȚI” - ȘCOALA GENERALĂ NR. 42)",120,"MUNICIPIUL GALAŢI",75098,1,PART,PRCNCT,PRSD,PRSD_SV,"2025-05-18 21:40:45",1267,693,633,60,0,678,15,1400,707,212,466
18,GALAŢI,"ȘCOALA GIMNAZIALĂ ”SFÂNTUL GRIGORIE TEOLOGUL” (ȘCOALA GENERALĂ ”SFÂNTUL GRIGORE TEOLOGUL” - ȘCOALA GENERALĂ NR. 41)",121,"MUNICIPIUL GALAŢI",75098,1,PART,PRCNCT,PRSD,PRSD_SV,"2025-05-18 22:03:42",1579,858,790,67,1,843,15,1750,892,299,544
18,GALAŢI,"ȘCOALA GIMNAZIALĂ ”SFÂNTUL GRIGORIE TEOLOGUL” (ȘCOALA GENERALĂ ”SFÂNTUL GRIGORE TEOLOGUL” - ȘCOALA GENERALĂ NR. 41)",122,"MUNICIPIUL GALAŢI",75098,1,PART,PRCNCT,PRSD,PRSD_SV,"2025-05-18 21:59:20",1776,895,856,39,0,889,6,1950,1055,329,560
18,GALAŢI,"ȘCOALA GIMNAZIALĂ ”SFÂNTUL GRIGORIE TEOLOGUL” (ȘCOALA GENERALĂ ”SFÂNTUL GRIGORE TEOLOGUL” - ȘCOALA GENERALĂ NR. 41)",123,"MUNICIPIUL GALAŢI",75098,1,PART,PRCNCT,PRSD,PRSD_SV,"2025-05-18 22:27:07",1795,920,869,49,2,906,14,1950,1030,356,550
18,GALAŢI,"ȘCOALA GIMNAZIALĂ ”SFÂNTUL GRIGORIE TEOLOGUL” (ȘCOALA GENERALĂ ”SFÂNTUL GRIGORE TEOLOGUL”- ȘCOALA GENERALĂ NR. 41)",124,"MUNICIPIUL GALAŢI",75098,1,PART,PRCNCT,PRSD,PRSD_SV,"2025-05-18 22:36:00",1840,963,908,52,3,951,12,2000,1037,339,612
18,GALAŢI,"LICEUL TEHNOLOGIC ”ANGHEL SALIGNY” (GRUP ȘCOLAR INDUSTRIAL ”ANGHEL SALIGNY” - LICEUL INDUSTRIAL NR.9)",125,"MUNICIPIUL GALAŢI",75098,1,PART,PRCNCT,PRSD,PRSD_SV,"2025-05-18 21:48:16",1811,522,483,37,2,517,5,2000,1478,232,285
18,GALAŢI,"LICEUL TEHNOLOGIC ”ANGHEL SALIGNY” (GRUP ȘCOLAR INDUSTRIAL ”ANGHEL SALIGNY” - LICEUL INDUSTRIAL NR.9)",126,"MUNICIPIUL GALAŢI",75098,1,PART,PRCNCT,PRSD,PRSD_SV,"2025-05-18 21:29:29",1597,118,72,46,0,112,6,1750,1632,70,42
18,GALAŢI,"LICEUL TEHNOLOGIC ”ANGHEL SALIGNY” (GRUP ȘCOLAR INDUSTRIAL ”ANGHEL SALIGNY” - LICEUL INDUSTRIAL NR.9)",127,"MUNICIPIUL GALAŢI",75098,1,PART,PRCNCT,PRSD,PRSD_SV,"2025-05-18 21:36:23",1631,233,184,49,0,230,3,1800,1567,106,124
18,GALAŢI,"LICEUL TEHNOLOGIC ”ANGHEL SALIGNY” (GRUP ȘCOLAR INDUSTRIAL ”ANGHEL SALIGNY” - LICEUL INDUSTRIAL NR.9)",128,"MUNICIPIUL GALAŢI",75098,1,PART,PRCNCT,PRSD,PRSD_SV,"2025-05-18 22:19:38",1790,760,738,22,0,747,13,2000,1240,406,341
18,GALAŢI,"LICEUL TEORETIC ”SFÂNTA MARIA” (GRUP ȘCOLAR INDUSTRIAL ”SFÂNTA MARIA” - LICEUL INDUSTRIAL NR.10)",129,"MUNICIPIUL GALAŢI",75098,1,PART,PRCNCT,PRSD,PRSD_SV,"2025-05-18 21:53:01",1169,669,581,87,1,659,10,1300,631,214,445
18,GALAŢI,"LICEUL TEORETIC ”SFÂNTA MARIA” (GRUP ȘCOLAR INDUSTRIAL ”SFÂNTA MARIA” - LICEUL INDUSTRIAL NR.10)",130,"MUNICIPIUL GALAŢI",75098,1,PART,PRCNCT,PRSD,PRSD_SV,"2025-05-18 21:31:52",1357,732,647,84,1,721,11,1500,768,235,486
18,GALAŢI,"ȘCOALA GIMNAZIALĂ ”ȘTEFAN CEL MARE” (ȘCOALA GENERALĂ ”ȘTEFAN CEL MARE” - ȘCOALA GENERALĂ NR. 13)",131,"MUNICIPIUL GALAŢI",75098,1,PART,PRCNCT,PRSD,PRSD_SV,"2025-05-18 21:59:37",1261,621,561,60,0,606,15,1400,779,203,403
18,GALAŢI,"ȘCOALA GIMNAZIALĂ ”ȘTEFAN CEL MARE” (ȘCOALA GENERALĂ ”ȘTEFAN CEL MARE” - ȘCOALA GENERALĂ NR. 13)",132,"MUNICIPIUL GALAŢI",75098,1,PART,PRCNCT,PRSD,PRSD_SV,"2025-05-18 21:44:48",1414,710,683,27,0,701,9,1550,840,227,474
18,GALAŢI,"ȘCOALA GIMNAZIALĂ ”GRIGORE MOISIL” (ȘCOALA GENERALĂ ”GRIGORE MOISIL” - ȘCOALA GENERALĂ NR. 38)",133,"MUNICIPIUL GALAŢI",75098,1,PART,PRCNCT,PRSD,PRSD_SV,"2025-05-18 22:07:40",1688,880,843,37,0,867,13,1800,920,383,484
18,GALAŢI,"ȘCOALA GIMNAZIALĂ ”GRIGORE MOISIL” (ȘCOALA GENERALĂ ”GRIGORE MOISIL” - ȘCOALA GENERALĂ NR. 38)",134,"MUNICIPIUL GALAŢI",75098,1,PART,PRCNCT,PRSD,PRSD_SV,"2025-05-18 22:10:15",1269,627,596,29,2,614,13,1400,773,221,393
18,GALAŢI,"ȘCOALA GIMNAZIALĂ ”GRIGORE MOISIL” (ȘCOALA GENERALĂ ”GRIGORE MOISIL” - ȘCOALA GENERALĂ NR. 38)",135,"MUNICIPIUL GALAŢI",75098,1,PART,PRCNCT,PRSD,PRSD_SV,"2025-05-18 22:15:11",1409,718,695,23,0,712,6,1550,832,327,385
18,GALAŢI,"ȘCOALA GIMNAZIALĂ ”GRIGORE MOISIL” (ȘCOALA GENERALĂ ”GRIGORE MOISIL” - ȘCOALA GENERALĂ NR. 38)",136,"MUNICIPIUL GALAŢI",75098,1,PART,PRCNCT,PRSD,PRSD_SV,"2025-05-18 22:09:42",1593,820,792,28,0,805,15,1750,930,298,507
18,GALAŢI,"ȘCOALA GIMNAZIALĂ ”GHEORGHE MUNTEANU” (ȘCOALA GENERALĂ ”GHEORGHE MUNTEANU” - ȘCOALA GENERALĂ NR. 31)",137,"MUNICIPIUL GALAŢI",75098,1,PART,PRCNCT,PRSD,PRSD_SV,"2025-05-18 21:34:29",1320,692,642,50,0,686,6,1450,758,243,443
18,GALAŢI,"ȘCOALA GIMNAZIALĂ ”GHEORGHE MUNTEANU” (ȘCOALA GENERALĂ ”GHEORGHE MUNTEANU” - ȘCOALA GENERALĂ NR. 31)",138,"MUNICIPIUL GALAŢI",75098,1,PART,PRCNCT,PRSD,PRSD_SV,"2025-05-18 21:57:51",1417,644,618,25,1,637,7,1550,906,307,330
18,GALAŢI,"ȘCOALA GIMNAZIALĂ ”GHEORGHE MUNTEANU” (ȘCOALA GENERALĂ ”GHEORGHE MUNTEANU” - ȘCOALA GENERALĂ NR. 31)",139,"MUNICIPIUL GALAŢI",75098,1,PART,PRCNCT,PRSD,PRSD_SV,"2025-05-18 21:39:20",1776,840,813,27,0,832,8,1900,1060,342,490
18,GALAŢI,"LICEUL TEHNOLOGIC ”PAUL DIMO” (COLEGIUL TEHNIC ”PAUL DIMO” - LICEUL ENERGETIC NR.4)",140,"MUNICIPIUL GALAŢI",75098,1,PART,PRCNCT,PRSD,PRSD_SV,"2025-05-18 21:22:29",482,331,256,75,0,329,2,550,219,203,126
18,GALAŢI,"LICEUL TEHNOLOGIC ”PAUL DIMO” (COLEGIUL TEHNIC ”PAUL DIMO” - LICEUL ENERGETIC NR.4)",141,"MUNICIPIUL GALAŢI",75098,1,PART,PRCNCT,PRSD,PRSD_SV,"2025-05-18 21:38:27",1304,626,585,41,0,616,10,1450,824,320,296
18,GALAŢI,"LICEUL TEHNOLOGIC ”PAUL DIMO” (COLEGIUL TEHNIC ”PAUL DIMO” - LICEUL ENERGETIC NR.4)",142,"MUNICIPIUL GALAŢI",75098,2,PART,PRCNCT,PRSD,PRSD_SV,"2025-05-19 00:38:59",1328,634,613,21,0,626,8,1450,816,257,369
18,GALAŢI,"LICEUL TEHNOLOGIC ”PAUL DIMO” (COLEGIUL TEHNIC ”PAUL DIMO” - LICEUL ENERGETIC NR.4)",143,"MUNICIPIUL GALAŢI",75098,1,PART,PRCNCT,PRSD,PRSD_SV,"2025-05-18 21:42:09",1391,676,661,15,0,668,8,1550,874,317,351
18,GALAŢI,"LICEUL TEHNOLOGIC ”PAUL DIMO” (COLEGIUL TEHNIC ”PAUL DIMO” - LICEUL ENERGETIC NR.4)",144,"MUNICIPIUL GALAŢI",75098,1,PART,PRCNCT,PRSD,PRSD_SV,"2025-05-18 21:45:20",1026,505,481,24,0,499,6,1150,645,215,284
18,GALAŢI,"ȘCOALA GIMNAZIALĂ NR. 33 (ȘCOALA GENERALĂ ”SFÂNTUL DUMITRU” - ȘCOALA GENERALĂ NR.33)",145,"MUNICIPIUL GALAŢI",75098,1,PART,PRCNCT,PRSD,PRSD_SV,"2025-05-18 21:53:47",1325,672,621,51,0,658,14,1450,778,274,384
18,GALAŢI,"ȘCOALA GIMNAZIALĂ NR. 33 (ȘCOALA GENERALĂ ”SFÂNTUL DUMITRU” - ȘCOALA GENERALĂ NR.33)",146,"MUNICIPIUL GALAŢI",75098,2,PART,PRCNCT,PRSD,PRSD_SV,"2025-05-19 00:54:18",1545,678,634,44,0,672,6,1700,1022,309,363
18,GALAŢI,"ȘCOALA GIMNAZIALĂ NR. 33 (ȘCOALA GENERALĂ ”SFÂNTUL DUMITRU” - ȘCOALA GENERALĂ NR.33)",147,"MUNICIPIUL GALAŢI",75098,2,PART,PRCNCT,PRSD,PRSD_SV,"2025-05-19 00:18:22",1275,605,578,27,0,600,5,1400,795,235,365
18,GALAŢI,"ȘCOALA GIMNAZIALĂ NR. 33 (ȘCOALA GENERALĂ ”SFÂNTUL DUMITRU” - ȘCOALA GENERALĂ NR.33)",148,"MUNICIPIUL GALAŢI",75098,1,PART,PRCNCT,PRSD,PRSD_SV,"2025-05-18 21:46:35",1271,627,601,26,0,615,12,1400,773,271,344
18,GALAŢI,"ȘCOALA GIMNAZIALĂ ”MIHAI VITEAZUL” (ȘCOALA GENERALĂ ”MIHAI VITEAZUL” - ȘCOALA GENERALĂ NR. 34)",149,"MUNICIPIUL GALAŢI",75098,1,PART,PRCNCT,PRSD,PRSD_SV,"2025-05-18 21:40:57",1417,690,632,58,0,683,7,1550,860,334,349
18,GALAŢI,"ȘCOALA GIMNAZIALĂ ”MIHAI VITEAZUL” (ȘCOALA GENERALĂ ”MIHAI VITEAZUL” - ȘCOALA GENERALĂ NR. 34)",150,"MUNICIPIUL GALAŢI",75098,1,PART,PRCNCT,PRSD,PRSD_SV,"2025-05-18 21:47:43",1355,630,593,36,1,619,11,1500,870,252,367
18,GALAŢI,"GRĂDINIȚA CU PROGRAM PRELUNGIT NR. 47, ARONDATĂ GRĂDINIȚEI CU PROGRAM NORMAL ”ION CREANGĂ” (GRĂDINIȚA NR.47)",151,"MUNICIPIUL GALAŢI",75098,2,PART,PRCNCT,PRSD,PRSD_SV,"2025-05-18 23:09:40",1762,717,697,20,0,707,10,1950,1233,340,367
18,GALAŢI,"GRĂDINIȚA CU PROGRAM PRELUNGIT NR. 47, ARONDATĂ GRĂDINIȚEI CU PROGRAM NORMAL ”ION CREANGĂ” (GRĂDINIȚA NR.47)",152,"MUNICIPIUL GALAŢI",75098,1,PART,PRCNCT,PRSD,PRSD_SV,"2025-05-18 22:03:23",1861,781,748,32,1,773,8,2000,1219,399,374
18,GALAŢI,"GRĂDINIȚA CU PROGRAM PRELUNGIT NR. 47, ARONDATĂ GRĂDINIȚEI CU PROGRAM NORMAL ”ION CREANGĂ” (GRĂDINIȚA NR.47)",153,"MUNICIPIUL GALAŢI",75098,1,PART,PRCNCT,PRSD,PRSD_SV,"2025-05-18 21:56:36",1794,740,685,53,2,733,7,2000,1260,391,342
18,GALAŢI,"GRĂDINIȚA CU PROGRAM PRELUNGIT NR. 47, ARONDATĂ GRĂDINIȚEI CU PROGRAM NORMAL ”ION CREANGĂ” (GRĂDINIȚA NR.47)",154,"MUNICIPIUL GALAŢI",75098,1,PART,PRCNCT,PRSD,PRSD_SV,"2025-05-18 21:26:58",1636,317,280,37,0,312,5,1800,1483,190,122
18,GALAŢI,"LICEUL TEHNOLOGIC ”AUREL VLAICU” (COLEGIUL TEHNIC ”AUREL VLAICU” - GRUP ȘCOLAR METALURGIC - LICEUL INDUSTRIAL NR. 3 )",155,"MUNICIPIUL GALAŢI",75098,1,PART,PRCNCT,PRSD,PRSD_SV,"2025-05-18 21:45:51",1612,685,644,41,0,675,10,1800,1115,347,328
18,GALAŢI,"LICEUL TEHNOLOGIC ”AUREL VLAICU” (COLEGIUL TEHNIC ”AUREL VLAICU” - GRUP ȘCOLAR METALURGIC - LICEUL INDUSTRIAL NR. 3 )",156,"MUNICIPIUL GALAŢI",75098,1,PART,PRCNCT,PRSD,PRSD_SV,"2025-05-18 21:33:05",1740,333,248,84,1,331,2,1950,1617,179,152
18,GALAŢI,"LICEUL TEHNOLOGIC ”AUREL VLAICU” (COLEGIUL TEHNIC ”AUREL VLAICU” - GRUP ȘCOLAR METALURGIC - LICEUL INDUSTRIAL NR. 3 )",157,"MUNICIPIUL GALAŢI",75098,1,PART,PRCNCT,PRSD,PRSD_SV,"2025-05-18 21:59:50",1821,815,808,7,0,805,10,2000,1185,297,508
18,GALAŢI,"LICEUL TEHNOLOGIC ”AUREL VLAICU” (COLEGIUL TEHNIC ”AUREL VLAICU” - GRUP ȘCOLAR METALURGIC - LICEUL INDUSTRIAL NR. 3 )",158,"MUNICIPIUL GALAŢI",75098,1,PART,PRCNCT,PRSD,PRSD_SV,"2025-05-18 22:55:57",1717,749,720,29,0,737,12,1900,1151,336,401
18,GALAŢI,"LICEUL TEORETIC ”MIRCEA ELIADE” (GRUP ȘCOLAR INDUSTRIAL ”GHEORGHE ASACHI” - LICEUL INDUSTRIAL NR. 8)",159,"MUNICIPIUL GALAŢI",75098,1,PART,PRCNCT,PRSD,PRSD_SV,"2025-05-18 21:39:52",1835,328,303,25,0,326,2,2000,1672,202,124
18,GALAŢI,"LICEUL TEORETIC ”MIRCEA ELIADE” (GRUP ȘCOLAR INDUSTRIAL ”GHEORGHE ASACHI” - LICEUL INDUSTRIAL NR. 8)",160,"MUNICIPIUL GALAŢI",75098,1,PART,PRCNCT,PRSD,PRSD_SV,"2025-05-18 21:32:17",1605,164,112,52,0,164,0,1800,1636,97,67
18,GALAŢI,"LICEUL TEORETIC ”MIRCEA ELIADE” (GRUP ȘCOLAR INDUSTRIAL ”GHEORGHE ASACHI” - LICEUL INDUSTRIAL NR. 8)",161,"MUNICIPIUL GALAŢI",75098,1,PART,PRCNCT,PRSD,PRSD_SV,"2025-05-18 21:28:00",1708,161,125,36,0,157,4,1900,1739,84,73
18,GALAŢI,"LICEUL TEHNOLOGIC ”CAROL I” (LICEUL TEHNOLOGIC CĂI FERATE - GRUP ȘCOLAR INDUSTRIAL TRANSPORTURI CF - LICEUL CFR)",162,"MUNICIPIUL GALAŢI",75098,1,PART,PRCNCT,PRSD,PRSD_SV,"2025-05-18 21:38:37",1690,791,762,29,0,785,6,1800,1009,275,510
18,GALAŢI,"LICEUL TEHNOLOGIC ”CAROL I” (LICEUL TEHNOLOGIC CĂI FERATE - GRUP ȘCOLAR INDUSTRIAL TRANSPORTURI CF - LICEUL CFR)",163,"MUNICIPIUL GALAŢI",75098,1,PART,PRCNCT,PRSD,PRSD_SV,"2025-05-18 21:44:34",1644,822,779,42,1,814,8,1800,978,309,505
18,GALAŢI,"LICEUL TEHNOLOGIC ”CAROL I” (LICEUL TEHNOLOGIC CĂI FERATE - GRUP ȘCOLAR INDUSTRIAL TRANSPORTURI CF - LICEUL CFR)",164,"MUNICIPIUL GALAŢI",75098,1,PART,PRCNCT,PRSD,PRSD_SV,"2025-05-18 21:53:09",1591,746,715,31,0,741,5,1750,1004,295,446
18,GALAŢI,"ȘCOALA GIMNAZIALĂ ”MIRON COSTIN” (ȘCOALA GENERALĂ ”MIRON COSTIN” - ȘCOALA GENERALĂ NR.12)",165,"MUNICIPIUL GALAŢI",75098,2,PART,PRCNCT,PRSD,PRSD_SV,"2025-05-18 22:53:51",1423,691,652,39,0,688,3,1550,859,234,454
18,GALAŢI,"ȘCOALA GIMNAZIALĂ ”MIRON COSTIN” (ȘCOALA GENERALĂ ”MIRON COSTIN” - ȘCOALA GENERALĂ NR.12)",166,"MUNICIPIUL GALAŢI",75098,2,PART,PRCNCT,PRSD,PRSD_SV,"2025-05-18 23:58:38",1405,756,672,84,0,745,11,1550,794,289,456
18,GALAŢI,"ȘCOALA GIMNAZIALĂ ”MIRON COSTIN” (ȘCOALA GENERALĂ ”MIRON COSTIN” - ȘCOALA GENERALĂ NR.12)",167,"MUNICIPIUL GALAŢI",75098,2,PART,PRCNCT,PRSD,PRSD_SV,"2025-05-18 22:50:38",1468,695,647,47,1,688,7,1600,905,241,447
18,GALAŢI,"ȘCOALA GIMNAZIALĂ ”MIRON COSTIN” (ȘCOALA GENERALĂ ”MIRON COSTIN” - ȘCOALA GENERALĂ NR.12)",168,"MUNICIPIUL GALAŢI",75098,1,PART,PRCNCT,PRSD,PRSD_SV,"2025-05-18 22:20:03",1434,762,711,51,0,750,12,1600,838,262,488
18,GALAŢI,"ȘCOALA GIMNAZIALĂ ”MIRON COSTIN” (ȘCOALA GENERALĂ ”MIRON COSTIN” - ȘCOALA GENERALĂ NR.12)",169,"MUNICIPIUL GALAŢI",75098,1,PART,PRCNCT,PRSD,PRSD_SV,"2025-05-18 22:06:27",1353,677,643,34,0,671,6,1500,823,249,422
18,GALAŢI,"ȘCOALA GIMNAZIALĂ ”MIRON COSTIN” (ȘCOALA GENERALĂ ”MIRON COSTIN” - ȘCOALA GENERALĂ NR.12)",170,"MUNICIPIUL GALAŢI",75098,3,PART,PRCNCT,PRSD,PRSD_SV,"2025-05-18 23:53:41",1436,724,693,30,1,706,18,1600,876,258,448
18,GALAŢI,"ȘCOALA GIMNAZIALĂ ”MIRON COSTIN” (ȘCOALA GENERALĂ ”MIRON COSTIN” - ȘCOALA GENERALĂ NR.12)",171,"MUNICIPIUL GALAŢI",75098,1,PART,PRCNCT,PRSD,PRSD_SV,"2025-05-18 21:51:35",1308,611,582,27,2,605,6,1450,839,221,384
18,GALAŢI,"ȘCOALA GIMNAZIALĂ ”MIRON COSTIN” (ȘCOALA GENERALĂ ”MIRON COSTIN” - ȘCOALA GENERALĂ NR.12)",172,"MUNICIPIUL GALAŢI",75098,1,PART,PRCNCT,PRSD,PRSD_SV,"2025-05-18 21:56:14",1308,704,652,52,0,700,4,1450,746,220,480
18,GALAŢI,"ȘCOALA GIMNAZIALĂ ”MIRON COSTIN” (ȘCOALA GENERALĂ ”MIRON COSTIN” - ȘCOALA GENERALĂ NR.12)",173,"MUNICIPIUL GALAŢI",75098,1,PART,PRCNCT,PRSD,PRSD_SV,"2025-05-18 22:13:39",1352,719,670,49,0,712,7,1500,781,216,496
18,GALAŢI,"ȘCOALA GIMNAZIALĂ ”MIRON COSTIN” (ȘCOALA GENERALĂ ”MIRON COSTIN” - ȘCOALA GENERALĂ NR.12)",174,"MUNICIPIUL GALAŢI",75098,1,PART,PRCNCT,PRSD,PRSD_SV,"2025-05-18 21:25:11",1226,601,579,22,0,598,3,1350,749,201,397
18,GALAŢI,"GRĂDINIȚA CU PROGRAM NORMAL NR. 20, ARONDATĂ ȘCOLII GIMNAZIALE ”MIRON COSTIN” (GRĂDINIȚA NR. 20 - ANEXA ȘCOLII NR. 12)",175,"MUNICIPIUL GALAŢI",75098,1,PART,PRCNCT,PRSD,PRSD_SV,"2025-05-18 21:39:15",1744,929,876,53,0,922,7,1900,971,284,638
18,GALAŢI,"GRĂDINIȚA CU PROGRAM NORMAL NR. 20, ARONDATĂ ȘCOLII GIMNAZIALE ”MIRON COSTIN” (GRĂDINIȚA NR. 20 - ANEXA ȘCOLII NR. 12)",176,"MUNICIPIUL GALAŢI",75098,1,PART,PRCNCT,PRSD,PRSD_SV,"2025-05-18 21:57:03",1303,641,609,32,0,635,6,1450,809,232,403
18,GALAŢI,"ȘCOALA GIMNAZIALĂ ANGHEL RUGINĂ TECUCI",177,"MUNICIPIUL TECUCI",75203,1,PART,PRCNCT,PRSD,PRSD_SV,"2025-05-18 21:35:37",1265,674,631,43,0,670,4,1400,726,437,233
18,GALAŢI,"ŞCOALA GIMNAZIALĂ ANGHEL RUGINĂ TECUCI",178,"MUNICIPIUL TECUCI",75203,2,PART,PRCNCT,PRSD,PRSD_SV,"2025-05-19 01:07:38",1315,603,573,29,1,596,7,1450,847,402,194
18,GALAŢI,"ŞCOALA GIMNAZIALĂ ANGHEL RUGINĂ TECUCI",179,"MUNICIPIUL TECUCI",75203,2,PART,PRCNCT,PRSD,PRSD_SV,"2025-05-18 23:59:14",1476,731,712,16,3,727,4,1600,869,408,319
18,GALAŢI,"ŞCOALA GIMNAZIALĂ DIMITRIE STURDZA TECUCI",180,"MUNICIPIUL TECUCI",75203,1,PART,PRCNCT,PRSD,PRSD_SV,"2025-05-18 22:09:34",911,481,432,49,0,476,5,1000,519,203,273
18,GALAŢI,"ŞCOALA GIMNAZIALĂ DIMITRIE STURDZA TECUCI",181,"MUNICIPIUL TECUCI",75203,1,PART,PRCNCT,PRSD,PRSD_SV,"2025-05-18 21:37:51",732,368,313,55,0,364,4,800,432,164,200
18,GALAŢI,"ŞCOALA GIMNAZIALĂ GHEORGHE PETRAŞCU TECUCI",182,"MUNICIPIUL TECUCI",75203,1,PART,PRCNCT,PRSD,PRSD_SV,"2025-05-18 22:08:18",965,382,338,44,0,379,3,1050,668,223,156
18,GALAŢI,"ŞCOALA GIMNAZIALĂ GHEORGHE PETRAŞCU TECUCI",183,"MUNICIPIUL TECUCI",75203,1,PART,PRCNCT,PRSD,PRSD_SV,"2025-05-18 21:57:20",1470,585,556,29,0,576,9,1600,1015,362,214
18,GALAŢI,"SPAŢIU ALIMENTAŢIE PUBLICĂ OBOR",184,"MUNICIPIUL TECUCI",75203,1,PART,PRCNCT,PRSD,PRSD_SV,"2025-05-18 22:27:16",1509,638,605,33,0,628,10,1592,954,395,233
18,GALAŢI,"ŞCOALA GIMNAZIALĂ ION PETROVICI TECUCI",185,"MUNICIPIUL TECUCI",75203,2,PART,PRCNCT,PRSD,PRSD_SV,"2025-05-19 01:05:31",954,504,394,85,25,496,8,1050,546,296,200
18,GALAŢI,"ŞCOALA GIMNAZIALĂ ION PETROVICI TECUCI",186,"MUNICIPIUL TECUCI",75203,1,PART,PRCNCT,PRSD,PRSD_SV,"2025-05-18 21:43:23",654,327,286,40,1,318,9,700,373,138,180
18,GALAŢI,"COLEGIUL NAŢIONAL SPIRU HARET",187,"MUNICIPIUL TECUCI",75203,1,PART,PRCNCT,PRSD,PRSD_SV,"2025-05-18 21:56:58",1147,657,599,57,1,649,8,1250,593,223,426
18,GALAŢI,"COLEGIUL NAŢIONAL SPIRU HARET",188,"MUNICIPIUL TECUCI",75203,1,PART,PRCNCT,PRSD,PRSD_SV,"2025-05-18 21:59:05",640,339,280,59,0,335,4,700,361,139,196
18,GALAŢI,"COLEGIUL NAŢIONAL DE AGRICULTURĂ ŞI ECONOMIE",189,"MUNICIPIUL TECUCI",75203,1,PART,PRCNCT,PRSD,PRSD_SV,"2025-05-18 21:59:45",924,436,362,74,0,426,10,1000,564,186,240
18,GALAŢI,"COLEGIUL NAŢIONAL DE AGRICULTURĂ ŞI ECONOMIE",190,"MUNICIPIUL TECUCI",75203,1,PART,PRCNCT,PRSD,PRSD_SV,"2025-05-18 21:38:52",1153,605,570,35,0,602,3,1250,645,225,377
18,GALAŢI,"GRĂDINIŢA CU PROGRAM PRELUNGIT NR. 17",191,"MUNICIPIUL TECUCI",75203,2,PART,PRCNCT,PRSD,PRSD_SV,"2025-05-19 02:45:31",1213,594,549,45,0,586,8,1350,756,307,279
18,GALAŢI,"GRĂDINIŢA CU PROGRAM PRELUNGIT NR. 17",192,"MUNICIPIUL TECUCI",75203,1,PART,PRCNCT,PRSD,PRSD_SV,"2025-05-18 22:00:38",829,379,353,25,1,377,2,900,521,151,226
18,GALAŢI,"ŞCOALA GIMNAZIALĂ IORGU IORDAN",193,"MUNICIPIUL TECUCI",75203,1,PART,PRCNCT,PRSD,PRSD_SV,"2025-05-18 22:01:40",754,411,347,63,1,404,7,850,439,141,263
18,GALAŢI,"ŞCOALA GIMNAZIALĂ IORGU IORDAN",194,"MUNICIPIUL TECUCI",75203,1,PART,PRCNCT,PRSD,PRSD_SV,"2025-05-18 21:50:58",1065,523,465,56,2,511,12,1200,677,238,273
18,GALAŢI,"ŞCOALA GIMNAZIALĂ IORGU IORDAN",195,"MUNICIPIUL TECUCI",75203,1,PART,PRCNCT,PRSD,PRSD_SV,"2025-05-18 21:51:30",1148,619,581,37,1,614,5,1250,631,260,354
18,GALAŢI,"LICEUL TEHNOLOGIC OVIDIU CALEDONIU",196,"MUNICIPIUL TECUCI",75203,1,PART,PRCNCT,PRSD,PRSD_SV,"2025-05-18 21:56:10",1273,646,599,46,1,636,10,1400,754,317,319
18,GALAŢI,"ŞCOALA GIMNAZIALĂ ŞTEFAN OCTAVIAN IOSIF",197,"MUNICIPIUL TECUCI",75203,1,PART,PRCNCT,PRSD,PRSD_SV,"2025-05-18 22:31:42",1364,712,679,29,4,706,6,1500,788,326,380
18,GALAŢI,"ŞCOALA GIMNAZIALĂ ŞTEFAN OCTAVIAN IOSIF",198,"MUNICIPIUL TECUCI",75203,1,PART,PRCNCT,PRSD,PRSD_SV,"2025-05-18 21:51:37",1047,526,476,50,0,522,4,1150,624,220,302
18,GALAŢI,"ŞCOALA GIMNAZIALĂ NICOLAE BĂLCESCU",199,"MUNICIPIUL TECUCI",75203,1,PART,PRCNCT,PRSD,PRSD_SV,"2025-05-18 21:49:01",1063,480,453,27,0,473,7,1150,670,330,143
18,GALAŢI,"ŞCOALA GIMNAZIALĂ NICOLAE BĂLCESCU",200,"MUNICIPIUL TECUCI",75203,1,PART,PRCNCT,PRSD,PRSD_SV,"2025-05-18 22:01:29",1025,518,505,13,0,512,6,1150,632,295,217
18,GALAŢI,"GRĂDINIŢA CU PROGRAM NORMAL ALEGRETO",201,"MUNICIPIUL TECUCI",75203,1,PART,PRCNCT,PRSD,PRSD_SV,"2025-05-18 21:52:34",922,466,424,42,0,463,3,1000,534,270,193
18,GALAŢI,"SPAŢIU ADMINISTRATIV",202,"MUNICIPIUL TECUCI",75203,1,PART,PRCNCT,PRSD,PRSD_SV,"2025-05-18 21:55:34",1146,586,526,60,0,582,4,1250,664,256,326
18,GALAŢI,"SPAŢIU ADMINISTRATIV",203,"MUNICIPIUL TECUCI",75203,1,PART,PRCNCT,PRSD,PRSD_SV,"2025-05-18 21:38:14",940,470,447,23,0,465,5,1050,580,288,177
18,GALAŢI,"GRĂDINIŢA CU PROGRAM PRELUNGIT PRICHINDEL",204,"MUNICIPIUL TECUCI",75203,1,PART,PRCNCT,PRSD,PRSD_SV,"2025-05-18 22:06:05",962,503,457,45,1,497,6,1050,547,186,311
18,GALAŢI,"GRĂDINIŢA CU PROGRAM PRELUNGIT PRICHINDEL",205,"MUNICIPIUL TECUCI",75203,2,PART,PRCNCT,PRSD,PRSD_SV,"2025-05-19 02:32:56",1117,505,482,22,1,496,9,1250,745,216,280
18,GALAŢI,"COLEGIUL NAŢIONAL CALISTRAT HOGAŞ",206,"MUNICIPIUL TECUCI",75203,1,PART,PRCNCT,PRSD,PRSD_SV,"2025-05-18 21:55:32",1902,234,188,45,1,230,4,2099,1865,83,147
18,GALAŢI,"COLEGIUL NAŢIONAL CALISTRAT HOGAŞ",207,"MUNICIPIUL TECUCI",75203,1,PART,PRCNCT,PRSD,PRSD_SV,"2025-05-18 21:33:21",1889,194,166,28,0,194,0,2100,1906,87,107
18,GALAŢI,"LICEUL TEHNOLOGIC ”ELENA CARAGIANI” - SALĂ DE SPORT",208,"MUNICIPIUL TECUCI",75203,1,PART,PRCNCT,PRSD,PRSD_SV,"2025-05-18 22:15:47",1906,368,284,74,10,364,4,2100,1732,149,215
18,GALAŢI,"GRĂDINIŢA CU PROGRAM NORMAL NR.1",209,"MUNICIPIUL TECUCI",75203,1,PART,PRCNCT,PRSD,PRSD_SV,"2025-05-18 22:20:12",762,296,277,19,0,292,4,850,554,141,151
18,GALAŢI,"LICEUL TEHNOLOGIC ”ELENA CARAGIANI”",210,"MUNICIPIUL TECUCI",75203,1,PART,PRCNCT,PRSD,PRSD_SV,"2025-05-18 21:56:29",1938,271,260,11,0,269,2,2100,1829,129,140
18,GALAŢI,"CASA DE CULTURA „ION CREANGĂ” BERESTI",211,"ORAŞ BEREŞTI",75338,1,PART,PRCNCT,PRSD,PRSD_SV,"2025-05-18 22:10:22",1217,657,553,95,9,647,10,1350,693,299,348
18,GALAŢI,"SALA DE SPORT",212,"ORAŞ BEREŞTI",75338,1,PART,PRCNCT,PRSD,PRSD_SV,"2025-05-18 21:57:49",1231,611,533,65,13,599,12,1350,739,328,271
18,GALAŢI,"GRADINIŢA NR.2 CĂSUŢA PITICILOR",213,"ORAŞ TÂRGU BUJOR",75472,1,PART,PRCNCT,PRSD,PRSD_SV,"2025-05-18 21:37:58",1911,356,325,31,0,352,4,2100,1744,197,155
18,GALAŢI,"GRADINIŢA NR.2 CĂSUŢA PITICILOR",214,"ORAŞ TÂRGU BUJOR",75472,1,PART,PRCNCT,PRSD,PRSD_SV,"2025-05-18 21:48:29",1850,303,272,31,0,297,6,2000,1697,147,150
18,GALAŢI,"ŞCOALA GIMNAZIALĂ ”GRIGORE HAGIU”",215,"ORAŞ TÂRGU BUJOR",75472,1,PART,PRCNCT,PRSD,PRSD_SV,"2025-05-18 21:54:58",1883,593,512,57,24,586,7,2100,1507,305,281
18,GALAŢI,"LICEUL TEHNOLOGIC ” EREMIA GRIGORESCU”",216,"ORAŞ TÂRGU BUJOR",75472,2,PART,PRCNCT,PRSD,PRSD_SV,"2025-05-19 01:22:57",981,523,454,60,9,514,9,1100,577,225,289
18,GALAŢI,"GRĂDINIŢA MOSCU",217,"ORAŞ TÂRGU BUJOR",75472,2,PART,PRCNCT,PRSD,PRSD_SV,"2025-05-19 01:24:41",943,464,417,47,0,458,6,1050,586,296,162
18,GALAŢI,"CĂMIN CULTURAL UMBRĂREȘTI",218,"ORAŞ TÂRGU BUJOR",75472,1,PART,PRCNCT,PRSD,PRSD_SV,"2025-05-18 21:41:39",881,414,376,38,0,409,5,950,536,259,150
18,GALAŢI,"GRĂDINIȚA CU PROGRAM NORMAL NR. 2 BARCEA",219,BARCEA,75515,1,PART,PRCNCT,PRSD,PRSD_SV,"2025-05-18 21:56:48",815,356,328,28,0,349,7,900,544,202,147
18,GALAŢI,"GRĂDINIȚA CU PROGRAM NORMAL NR. 2 BARCEA",220,BARCEA,75515,1,PART,PRCNCT,PRSD,PRSD_SV,"2025-05-18 21:49:28",880,371,329,42,0,371,0,950,579,234,137
18,GALAŢI,"ŞCOALA NR. 3 BARCEA",221,BARCEA,75515,1,PART,PRCNCT,PRSD,PRSD_SV,"2025-05-18 21:54:23",1000,473,426,47,0,471,2,1100,627,273,198
18,GALAŢI,"ŞCOALA NR. 1 BARCEA",222,BARCEA,75515,1,PART,PRCNCT,PRSD,PRSD_SV,"2025-05-18 22:05:28",1055,492,447,45,0,484,8,1150,658,287,197
18,GALAŢI,"ŞCOALA NR. 4 PODOLENI",223,BARCEA,75515,1,PART,PRCNCT,PRSD,PRSD_SV,"2025-05-18 22:00:46",1326,556,526,30,0,547,9,1450,894,462,85
18,GALAŢI,"CĂMINUL CULTURAL BĂLĂBĂNEŞTI",224,BĂLĂBĂNEŞTI,75542,1,PART,PRCNCT,PRSD,PRSD_SV,"2025-05-18 21:26:10",581,320,270,50,0,316,4,650,330,181,135
18,GALAŢI,"CAMIN CULTURAL BURSUCANI",225,BĂLĂBĂNEŞTI,75542,2,PART,PRCNCT,PRSD,PRSD_SV,"2025-05-19 02:09:51",473,221,187,34,0,220,1,550,329,132,88
18,GALAŢI,"SCOALA GENERALĂ LUNGEŞTI",226,BĂLĂBĂNEŞTI,75542,1,PART,PRCNCT,PRSD,PRSD_SV,"2025-05-18 21:47:21",462,248,196,52,0,247,1,500,252,134,113
18,GALAŢI,"CĂMINUL CULTURAL BĂLĂŞEŞTI",227,BĂLĂŞEŞTI,75613,2,PART,PRCNCT,PRSD,PRSD_SV,"2025-05-19 02:10:49",905,417,357,60,0,415,2,1001,584,228,187
18,GALAŢI,"SCOALA GENERALĂ CIUREŞTI",228,BĂLĂŞEŞTI,75613,1,PART,PRCNCT,PRSD,PRSD_SV,"2025-05-18 21:31:11",195,107,66,41,0,106,1,250,143,48,58
18,GALAŢI,"GRĂDINIȚA CU PROGRAM NORMAL NR.1 CIUREȘTII NOI",229,BĂLĂŞEŞTI,75613,2,PART,PRCNCT,PRSD,PRSD_SV,"2025-05-19 02:09:00",426,220,165,55,0,217,3,500,280,110,107
18,GALAŢI,"SCOALA GENERALĂ PUPEZENI",230,BĂLĂŞEŞTI,75613,1,PART,PRCNCT,PRSD,PRSD_SV,"2025-05-18 21:25:37",150,78,60,18,0,78,0,200,122,46,32
18,GALAŢI,"”ȘCOALA GIMNAZIALĂ NR. 1 BĂLENI”",231,BĂLENI,75668,1,PART,PRCNCT,PRSD,PRSD_SV,"2025-05-18 21:44:01",908,474,380,93,1,472,2,1000,526,312,160
18,GALAŢI,"”ȘCOALA GIMNAZIALĂ NR. 1 BĂLENI”",232,BĂLENI,75668,1,PART,PRCNCT,PRSD,PRSD_SV,"2025-05-18 21:52:51",959,443,366,76,1,437,6,1050,607,256,181
18,GALAŢI,"GRĂDINIȚA BĂNEASA",233,BĂNEASA,75686,1,PART,PRCNCT,PRSD,PRSD_SV,"2025-05-18 21:33:05",1147,552,494,58,0,548,4,1250,698,323,225
18,GALAŢI,"SCOALA PRIMARA ”ION VODA CEL VITEAZ ROSCANI",234,BĂNEASA,75686,1,PART,PRCNCT,PRSD,PRSD_SV,"2025-05-18 21:26:00",452,218,192,26,0,215,3,500,282,145,70
18,GALAŢI,"ŞCOALA GIMNAZIALĂ NR. 1 SAT BEREŞTI - MERIA",235,BEREŞTI-MERIA,75356,2,PART,PRCNCT,PRSD,PRSD_SV,"2025-05-19 01:55:46",386,187,160,20,7,184,3,450,263,106,78
18,GALAŢI,"ŞCOALA PRIMARĂ ANDRONACHI GOGA NR. 1 SAT ALDEŞTI",236,BEREŞTI-MERIA,75356,1,PART,PRCNCT,PRSD,PRSD_SV,"2025-05-18 21:25:24",305,141,109,25,7,140,1,350,209,98,42
18,GALAŢI,"SALĂ DE ACTIVITĂȚI SOCIAL-CULTURALE, SAT BALINTEȘTI",237,BEREŞTI-MERIA,75356,1,PART,PRCNCT,PRSD,PRSD_SV,"2025-05-18 21:45:33",707,370,309,57,4,367,3,800,430,249,118
18,GALAŢI,"GRĂDINIŢA CU PROGRAM NORMAL NR. 1 SAT PLEŞA",238,BEREŞTI-MERIA,75356,1,PART,PRCNCT,PRSD,PRSD_SV,"2025-05-18 21:34:50",493,215,183,30,2,210,5,550,335,131,79
18,GALAŢI,"CĂMIN CULTURAL",239,BEREŞTI-MERIA,75356,1,PART,PRCNCT,PRSD,PRSD_SV,"2025-05-18 21:37:15",220,145,83,60,2,144,1,250,105,56,88
18,GALAŢI,"ŞCOALA GIMNAZIALĂ NR. 1 SAT SLIVNA",240,BEREŞTI-MERIA,75356,1,PART,PRCNCT,PRSD,PRSD_SV,"2025-05-18 21:40:44",505,274,226,46,2,272,2,550,276,166,106
18,GALAŢI,"ȘCOALA GIMNAZIALĂ UNIREA BRANIȘTEA",241,BRANIŞTEA,75711,1,PART,PRCNCT,PRSD,PRSD_SV,"2025-05-18 21:53:16",1263,671,571,97,3,664,7,1400,729,422,242
18,GALAŢI,"ȘCOALA GIMNAZIALĂ UNIREA BRANIȘTEA",242,BRANIŞTEA,75711,1,PART,PRCNCT,PRSD,PRSD_SV,"2025-05-18 21:45:34",1058,561,494,64,3,559,2,1150,589,326,233
18,GALAŢI,"SCOALA GENERALĂ TRAIAN",243,BRANIŞTEA,75711,1,PART,PRCNCT,PRSD,PRSD_SV,"2025-05-18 21:41:15",484,286,246,40,0,285,1,550,264,164,121
18,GALAŢI,"SCOALA GENERALA VASILE ALECSANDRI",244,BRANIŞTEA,75711,1,PART,PRCNCT,PRSD,PRSD_SV,"2025-05-18 21:47:21",915,575,481,94,0,569,6,1000,425,353,216
18,GALAŢI,"GRĂDINIȚA NR.1 BRĂHĂȘEȘTI",245,BRĂHĂŞEŞTI,75766,1,PART,PRCNCT,PRSD,PRSD_SV,"2025-05-18 22:00:11",1398,480,423,54,3,474,6,1550,1070,314,160
18,GALAŢI,"GRĂDINIȚA NR.1 BRĂHĂȘEȘTI",246,BRĂHĂŞEŞTI,75766,1,PART,PRCNCT,PRSD,PRSD_SV,"2025-05-18 21:51:56",1015,389,358,31,0,388,1,1100,711,262,126
18,GALAŢI,"SCOALA GIMNAZIALA NR. 1 TOFLEA",247,BRĂHĂŞEŞTI,75766,1,PART,PRCNCT,PRSD,PRSD_SV,"2025-05-18 21:44:23",1642,339,320,19,0,329,10,1800,1461,289,40
18,GALAŢI,"SCOALA GIMNAZIALA NR. 1 TOFLEA",248,BRĂHĂŞEŞTI,75766,1,PART,PRCNCT,PRSD,PRSD_SV,"2025-05-18 21:49:54",1222,218,196,22,0,211,7,1350,1132,186,25
18,GALAŢI,"SCOALA GIMNAZIALA NR.1 TOFLEA",249,BRĂHĂŞEŞTI,75766,1,PART,PRCNCT,PRSD,PRSD_SV,"2025-05-18 21:27:40",1529,311,289,22,0,300,11,1700,1389,266,34
18,GALAŢI,"SCOALA NATALIA NEGRU",250,BUCIUMENI,75819,1,PART,PRCNCT,PRSD,PRSD_SV,"2025-05-18 21:47:59",881,405,359,46,0,400,5,950,545,279,121
18,GALAŢI,"SCOALA SMARANDA BRAESCU",251,BUCIUMENI,75819,1,PART,PRCNCT,PRSD,PRSD_SV,"2025-05-18 21:32:40",346,188,151,37,0,185,3,400,212,119,66
18,GALAŢI,"SCOALA CU CLASE I-IV",252,BUCIUMENI,75819,1,PART,PRCNCT,PRSD,PRSD_SV,"2025-05-18 21:35:54",316,187,159,28,0,183,4,350,163,128,55
18,GALAŢI,GRĂDINIȚĂ,253,BUCIUMENI,75819,2,PART,PRCNCT,PRSD,PRSD_SV,"2025-05-19 02:25:18",316,145,124,20,1,144,1,350,205,99,45
18,GALAŢI,"SCOALA PRIMARA NR.3",254,CAVADINEŞTI,75864,1,PART,PRCNCT,PRSD,PRSD_SV,"2025-05-18 21:48:04",191,99,74,25,0,99,0,250,151,59,40
18,GALAŢI,"SCOALA GIMNAZIALĂ NR.2",255,CAVADINEŞTI,75864,1,PART,PRCNCT,PRSD,PRSD_SV,"2025-05-18 21:54:00",828,393,333,60,0,384,9,900,507,204,180
18,GALAŢI,"SCOALA GENERALĂ COMĂNEŞTI",256,CAVADINEŞTI,75864,1,PART,PRCNCT,PRSD,PRSD_SV,"2025-05-18 21:27:20",148,72,46,26,0,72,0,200,128,38,34
18,GALAŢI,"ȘCOALA PRIMARĂ NR.1 SAT GĂNEȘTI",257,CAVADINEŞTI,75864,1,PART,PRCNCT,PRSD,PRSD_SV,"2025-05-18 21:51:45",698,338,269,68,1,335,3,800,462,180,155
18,GALAŢI,"ȘCOALA PRIMARĂ NR.1 SAT VĂDENI",258,CAVADINEŞTI,75864,1,PART,PRCNCT,PRSD,PRSD_SV,"2025-05-18 21:56:25",321,177,120,57,0,175,2,350,173,75,100
18,GALAŢI,"ȘCOALA GIMNAZIALĂ ”GEORGE IVAȘCU”",259,CERŢEŞTI,75917,1,PART,PRCNCT,PRSD,PRSD_SV,"2025-05-18 21:45:37",679,316,265,51,0,314,2,750,434,175,139
18,GALAŢI,"ȘCOALA PRIMARĂ",260,CERŢEŞTI,75917,2,PART,PRCNCT,PRSD,PRSD_SV,"2025-05-19 02:13:26",581,253,213,40,0,250,3,650,397,154,96
18,GALAŢI,"ȘCOALA PRIMARĂ",261,CERŢEŞTI,75917,1,PART,PRCNCT,PRSD,PRSD_SV,"2025-05-18 21:48:30",537,290,236,54,0,288,2,600,310,147,141
18,GALAŢI,"SCOALA NOUA - SAT CORNI",262,CORNI,76004,1,PART,PRCNCT,PRSD,PRSD_SV,"2025-05-18 22:26:18",653,347,306,41,0,343,4,700,353,212,131
18,GALAŢI,"SCOALA GENERALA MĂCIŞENI",263,CORNI,76004,1,PART,PRCNCT,PRSD,PRSD_SV,"2025-05-18 22:36:09",633,300,260,40,0,297,3,700,400,170,127
18,GALAŢI,"SCOALA GENERALA URLEŞTI",264,CORNI,76004,1,PART,PRCNCT,PRSD,PRSD_SV,"2025-05-18 21:28:23",349,190,158,32,0,189,1,400,210,134,55
18,GALAŢI,"ŞCOALA GIMNAZIALĂ NR. 1 COROD",265,COROD,75953,1,PART,PRCNCT,PRSD,PRSD_SV,"2025-05-18 22:00:37",1243,570,519,50,1,560,10,1350,780,277,283
18,GALAŢI,"GRĂDINIŢA CU PROGRAM PRELUNGIT NR. 1 COROD",266,COROD,75953,1,PART,PRCNCT,PRSD,PRSD_SV,"2025-05-18 22:06:58",1187,571,519,51,1,563,8,1300,729,247,316
18,GALAŢI,"ŞCOALA NR.3 COROD",267,COROD,75953,2,PART,PRCNCT,PRSD,PRSD_SV,"2025-05-19 03:12:09",1434,584,542,42,0,581,3,1600,1016,324,257
18,GALAŢI,"DIPENSAR BLÂNZI",268,COROD,75953,1,PART,PRCNCT,PRSD,PRSD_SV,"2025-05-18 21:46:48",959,350,331,19,0,342,8,1050,700,195,147
18,GALAŢI,"ŞCOALA PRIMARĂ NR. 1 BRĂTULEŞTI",269,COROD,75953,1,PART,PRCNCT,PRSD,PRSD_SV,"2025-05-18 21:27:46",473,186,166,20,0,185,1,550,364,109,76
18,GALAŢI,"CASA PRAZNICALĂ PAROHIA CĂRĂPCEȘTI",270,COROD,75953,1,PART,PRCNCT,PRSD,PRSD_SV,"2025-05-18 21:24:18",649,288,246,42,0,284,4,700,412,213,71
18,GALAŢI,"CĂMIN CULTURAL ”G-RAL EREMIA GRIGORESCU”",271,COSMEŞTI,76040,1,PART,PRCNCT,PRSD,PRSD_SV,"2025-05-18 21:44:01",1207,561,425,136,0,550,11,1350,789,311,239
18,GALAŢI,"GRĂDINIȚA CU PROGRAM NORMAL NR. 1",272,COSMEŞTI,76040,1,PART,PRCNCT,PRSD,PRSD_SV,"2025-05-18 21:55:45",699,311,269,42,0,309,2,750,439,171,138
18,GALAŢI,"GRĂDINIȚA CU PROGRAM NORMAL NR. 1",273,COSMEŞTI,76040,1,PART,PRCNCT,PRSD,PRSD_SV,"2025-05-18 21:33:17",921,424,361,60,3,420,4,1000,576,252,168
18,GALAŢI,"ȘCOALA GIMNAZIALĂ NR. 1",274,COSMEŞTI,76040,1,PART,PRCNCT,PRSD,PRSD_SV,"2025-05-18 22:03:28",1239,542,488,54,0,538,4,1350,808,391,147
18,GALAŢI,"CĂMIN CULTURAL DIN SAT FURCENII VECHI",275,COSMEŞTI,76040,1,PART,PRCNCT,PRSD,PRSD_SV,"2025-05-18 21:52:27",1285,525,469,54,2,518,7,1400,875,321,197
18,GALAŢI,"CAMINUL CULTURAL COSTACHE NEGRI",276,"COSTACHE NEGRI",76111,1,PART,PRCNCT,PRSD,PRSD_SV,"2025-05-18 22:02:46",1187,563,501,62,0,554,9,1300,737,340,214
18,GALAŢI,"CAMINUL CULTURAL COSTACHE NEGRI",277,"COSTACHE NEGRI",76111,1,PART,PRCNCT,PRSD,PRSD_SV,"2025-05-18 22:05:08",1048,527,474,53,0,515,12,1150,623,290,225
18,GALAŢI,"CĂMINUL CULTURAL CUCA",278,CUCA,76139,1,PART,PRCNCT,PRSD,PRSD_SV,"2025-05-18 21:58:39",849,474,357,117,0,472,2,950,476,301,171
18,GALAŢI,"ŞCOALA GIMNAZIALĂ ”SF. GHEORGHE ” CUCA",279,CUCA,76139,1,PART,PRCNCT,PRSD,PRSD_SV,"2025-05-18 22:18:44",806,381,323,56,2,379,2,900,519,200,179
18,GALAŢI,"CENTRU COMUNITAR INTEGRAT DE SERVICII SOCIALE, MEDICALE SI CONEXE",280,CUDALBI,76157,1,PART,PRCNCT,PRSD,PRSD_SV,"2025-05-18 21:45:00",1775,784,753,30,1,769,15,1950,1166,499,270
18,GALAŢI,"ŞCOALA GIMNAZIALA PROF. EMIL PANAITESCU",281,CUDALBI,76157,1,PART,PRCNCT,PRSD,PRSD_SV,"2025-05-18 21:44:31",1427,663,585,78,0,657,6,1550,887,380,277
18,GALAŢI,"ŞCOALA GIMNAZIALA PROF. EMIL PANAITESCU",282,CUDALBI,76157,2,PART,PRCNCT,PRSD,PRSD_SV,"2025-05-19 00:32:35",1194,534,485,48,1,526,8,1300,766,332,194
18,GALAŢI,"LICEUL TEHNOLOGIC NR.1",283,CUDALBI,76157,1,PART,PRCNCT,PRSD,PRSD_SV,"2025-05-18 21:50:26",1535,678,626,52,0,670,8,1700,1022,447,223
18,GALAŢI,"ŞCOALA GIMNAZIALA ELENA DOAMNA,",284,"CUZA VODĂ",77595,1,PART,PRCNCT,PRSD,PRSD_SV,"2025-05-18 21:53:54",1159,540,500,40,0,534,6,1300,760,314,220
18,GALAŢI,"ŞCOALA GIMNAZIALA ELENA DOAMNA,",285,"CUZA VODĂ",77595,1,PART,PRCNCT,PRSD,PRSD_SV,"2025-05-18 21:28:41",1034,507,460,47,0,502,5,1150,643,322,180
18,GALAŢI,"SCOALA DIN SATUL DRĂGĂNEŞTI",286,DRĂGĂNEŞTI,75221,1,PART,PRCNCT,PRSD,PRSD_SV,"2025-05-18 22:01:20",1759,767,701,66,0,765,2,1950,1183,427,338
18,GALAŢI,"CAMINUL CULTURAL DIN SATUL DRĂGĂNEŞTI",287,DRĂGĂNEŞTI,75221,1,PART,PRCNCT,PRSD,PRSD_SV,"2025-05-18 22:11:11",1847,825,764,61,0,817,8,2000,1175,618,199
18,GALAŢI,"SCOALA DIN MALU ALB",288,DRĂGĂNEŞTI,75221,1,PART,PRCNCT,PRSD,PRSD_SV,"2025-05-18 22:11:02",1803,817,769,48,0,808,9,2000,1183,478,330
18,GALAŢI,"ŞCOALA GIMNAZIALĂ NR. 1",289,DRĂGUŞENI,76175,1,PART,PRCNCT,PRSD,PRSD_SV,"2025-05-18 21:48:24",1463,642,589,53,0,635,7,1600,958,444,191
18,GALAŢI,"SCOALA GIMNAZIALA NR.1",290,DRĂGUŞENI,76175,1,PART,PRCNCT,PRSD,PRSD_SV,"2025-05-18 21:38:09",536,237,209,28,0,234,3,600,363,149,85
18,GALAŢI,"GRADINITA CU PROGRAM NORMAL NR.1",291,DRĂGUŞENI,76175,2,PART,PRCNCT,PRSD,PRSD_SV,"2025-05-19 01:43:34",471,204,191,13,0,201,3,550,346,121,80
18,GALAŢI,"ȘCOALA GIMNAZIALĂ NR.1",292,DRĂGUŞENI,76175,1,PART,PRCNCT,PRSD,PRSD_SV,"2025-05-18 21:40:12",722,297,260,37,0,293,4,800,503,193,100
18,GALAŢI,"GRĂDINIȚA CU PROGRAM NORMAL NR. 1",293,DRĂGUŞENI,76175,2,PART,PRCNCT,PRSD,PRSD_SV,"2025-05-19 01:46:51",236,129,107,22,0,128,1,300,171,81,47
18,GALAŢI,"GRĂDINIȚA CU PROGRAM NORMAL NR. 1",294,DRĂGUŞENI,76175,1,PART,PRCNCT,PRSD,PRSD_SV,"2025-05-18 21:47:11",442,196,174,22,0,192,4,500,304,117,75
18,GALAŢI,"GRĂDINIȚA CU PROGRAM NORMAL NR. 1",295,DRĂGUŞENI,76175,1,PART,PRCNCT,PRSD,PRSD_SV,"2025-05-18 21:29:12",217,140,116,24,0,139,1,250,110,82,57
18,GALAŢI,"CĂMINUL CULTURAL FÂRȚĂNEȘTI",296,FÂRŢĂNEŞTI,76255,1,PART,PRCNCT,PRSD,PRSD_SV,"2025-05-18 21:52:41",1324,542,466,76,0,536,6,1450,908,338,198
18,GALAŢI,"CĂMINUL CULTURAL FÂRȚĂNEȘTI",297,FÂRŢĂNEŞTI,76255,1,PART,PRCNCT,PRSD,PRSD_SV,"2025-05-18 22:03:19",1464,636,569,67,0,630,6,1600,964,406,224
18,GALAŢI,"CĂMINUL CULTURAL VIILE",298,FÂRŢĂNEŞTI,76255,1,PART,PRCNCT,PRSD,PRSD_SV,"2025-05-18 21:52:30",1203,546,485,61,0,541,5,1350,804,288,253
18,GALAŢI,"GRADINITA CU PROGRAM NORMAL NR. 1 FOLTESTI - SALA NR.1",299,FOLTEŞTI,76282,1,PART,PRCNCT,PRSD,PRSD_SV,"2025-05-18 21:40:32",832,410,344,66,0,403,7,900,490,255,148
18,GALAŢI,"GRADINITA CU PROGRAM NORMAL NR.1 FOLTESTI - SALA NR.2",300,FOLTEŞTI,76282,1,PART,PRCNCT,PRSD,PRSD_SV,"2025-05-18 21:38:36",900,466,395,71,0,456,10,1000,534,276,180
18,GALAŢI,"SCOALA GIMNAZIALA NR.1 STOICANI",301,FOLTEŞTI,76282,1,PART,PRCNCT,PRSD,PRSD_SV,"2025-05-18 21:47:27",797,414,352,62,0,412,2,900,486,254,158
18,GALAŢI,"ŞCOALA GENERALA NR.1 FRUMUŞIŢA (ŞCOALA DIN CENTRU)",302,FRUMUŞIŢA,76317,1,PART,PRCNCT,PRSD,PRSD_SV,"2025-05-18 22:25:11",1773,772,698,61,13,764,8,1950,1178,522,242
18,GALAŢI,"SCOALA GENERALĂ NR.2 PETRU RAREŞ",303,FRUMUŞIŢA,76317,1,PART,PRCNCT,PRSD,PRSD_SV,"2025-05-18 21:47:47",807,428,352,68,8,425,3,850,422,232,193
18,GALAŢI,"SCOALA GENERALA IJDILENI",304,FRUMUŞIŢA,76317,1,PART,PRCNCT,PRSD,PRSD_SV,"2025-05-18 21:48:19",741,323,273,44,6,322,1,850,527,187,135
18,GALAŢI,"SCOALA GENERALA TĂMĂOANI",305,FRUMUŞIŢA,76317,1,PART,PRCNCT,PRSD,PRSD_SV,"2025-05-18 21:50:23",995,511,428,77,6,509,2,1100,589,333,176
18,GALAŢI,"ŞCOALA GENERALA FUNDENI",306,FUNDENI,76353,1,PART,PRCNCT,PRSD,PRSD_SV,"2025-05-18 21:49:56",624,324,278,46,0,319,5,700,376,181,138
18,GALAŢI,"ŞCOALA GENERALA HANU CONACHI",307,FUNDENI,76353,1,PART,PRCNCT,PRSD,PRSD_SV,"2025-05-18 21:46:30",1174,534,479,55,0,529,5,1300,766,338,191
18,GALAŢI,"ŞCOALA GENERALA HANU CONACHI",308,FUNDENI,76353,1,PART,PRCNCT,PRSD,PRSD_SV,"2025-05-18 21:43:42",847,463,398,65,0,458,5,950,487,296,162
18,GALAŢI,"SCOALA ELEMENTARA LUNGOCI",309,FUNDENI,76353,1,PART,PRCNCT,PRSD,PRSD_SV,"2025-05-18 21:31:04",387,228,164,61,3,227,1,450,222,124,103
18,GALAŢI,"ŞCOALA GIMNAZIALĂ NR.1 GHIDIGENI",310,GHIDIGENI,76406,1,PART,PRCNCT,PRSD,PRSD_SV,"2025-05-18 21:23:37",1719,736,681,54,1,726,10,1900,1164,404,322
18,GALAŢI,"ȘCOALA PRIMARĂ NR. 1 GÂRBOVĂȚ",311,GHIDIGENI,76406,1,PART,PRCNCT,PRSD,PRSD_SV,"2025-05-18 21:25:01",219,109,86,23,0,108,1,250,141,53,55
18,GALAŢI,"ȘCOALA PRIMARĂ NR. 1 GEFU",312,GHIDIGENI,76406,1,PART,PRCNCT,PRSD,PRSD_SV,"2025-05-18 21:47:25",909,448,424,24,0,443,5,1000,552,193,250
18,GALAŢI,"GRĂDINIȚA CU PROGRAM NORMAL NR. 1 SLOBOZIA CORNI",313,GHIDIGENI,76406,1,PART,PRCNCT,PRSD,PRSD_SV,"2025-05-18 21:29:12",649,324,291,32,1,323,1,700,376,185,138
18,GALAŢI,"ȘCOALA GIMNAZIALĂ ION CREANGĂ TĂLPIGI",314,GHIDIGENI,76406,1,PART,PRCNCT,PRSD,PRSD_SV,"2025-05-18 21:51:12",1654,859,804,49,6,849,10,1800,941,384,465
18,GALAŢI,"ŞCOALA GIMNAZIALA NR.1 GOHOR",315,GOHOR,76497,1,PART,PRCNCT,PRSD,PRSD_SV,"2025-05-18 22:07:06",1306,675,613,62,0,665,10,1450,775,353,312
18,GALAŢI,"ȘCOALA GIMNAZIALĂ NR. 1 GOHOR",316,GOHOR,76497,1,PART,PRCNCT,PRSD,PRSD_SV,"2025-05-18 21:43:50",231,123,86,37,0,123,0,250,127,52,71
18,GALAŢI,"ŞCOALA GIMNAZIALA - SAT GARA BERHECI",317,GOHOR,76497,1,PART,PRCNCT,PRSD,PRSD_SV,"2025-05-18 21:44:14",563,301,255,46,0,299,2,600,299,165,134
18,GALAŢI,"ŞCOALA CU CLASELE I-IV NĂRTEŞTI",318,GOHOR,76497,1,PART,PRCNCT,PRSD,PRSD_SV,"2025-05-18 21:49:13",627,344,294,49,1,342,2,700,356,209,133
18,GALAŢI,"ȘCOALA GIMNAZIALĂ ”DUMITRU CĂPRARU” GRIVIȚA",319,GRIVIŢA,76558,1,PART,PRCNCT,PRSD,PRSD_SV,"2025-05-18 22:02:27",1538,551,493,56,2,545,6,1700,1149,322,223
18,GALAŢI,"ȘCOALA GIMNAZIALĂ ”DUMITRU CĂPRARU” GRIVIȚA, CORP C2,",320,GRIVIŢA,76558,1,PART,PRCNCT,PRSD,PRSD_SV,"2025-05-18 21:40:53",952,377,330,46,1,372,5,1050,673,196,176
18,GALAŢI,"GRĂDINIȚA CU PROGRAM NORMAL CĂLMĂȚUI",321,GRIVIŢA,76558,1,PART,PRCNCT,PRSD,PRSD_SV,"2025-05-18 21:49:14",545,178,162,16,0,175,3,600,422,121,54
18,GALAŢI,"SCOALA GIMNAZIALA NR. 1",322,INDEPENDENŢA,76585,1,PART,PRCNCT,PRSD,PRSD_SV,"2025-05-18 21:37:55",1321,726,629,97,0,720,6,1450,724,384,336
18,GALAŢI,"SCOALA GIMNAZIALA NR. 2",323,INDEPENDENŢA,76585,1,PART,PRCNCT,PRSD,PRSD_SV,"2025-05-18 22:37:25",1590,836,740,96,0,829,7,1750,914,430,399
18,GALAŢI,"CLADIREA GRADINITA NR.1",324,INDEPENDENŢA,76585,1,PART,PRCNCT,PRSD,PRSD_SV,"2025-05-18 21:47:29",924,478,413,65,0,470,8,1000,522,269,201
18,GALAŢI,"ŞCOALA NR.2 IVEŞTI",325,IVEŞTI,76601,1,PART,PRCNCT,PRSD,PRSD_SV,"2025-05-18 21:42:22",706,354,299,55,0,351,3,800,446,188,163
18,GALAŢI,"ŞCOALA GIMNAZIALĂ ”VICTOR ION POPA ” IVEŞTI (ŞCOALA GIMNAZIALA NR.3 IVEŞTI)",326,IVEŞTI,76601,1,PART,PRCNCT,PRSD,PRSD_SV,"2025-05-18 22:20:06",1513,791,735,56,0,769,22,1600,809,466,303
18,GALAŢI,"ȘCOALA PROFESIONALĂ „HORTENSIA PAPADAT – BENGESCU”",327,IVEŞTI,76601,1,PART,PRCNCT,PRSD,PRSD_SV,"2025-05-18 22:03:04",965,440,364,76,0,433,7,1050,610,231,202
18,GALAŢI,"ȘCOALA PROFESIONALĂ „HORTENSIA PAPADAT – BENGESCU”",328,IVEŞTI,76601,2,PART,PRCNCT,PRSD,PRSD_SV,"2025-05-19 02:37:44",1091,551,506,45,0,536,15,1200,649,334,202
18,GALAŢI,"ŞCOALA GIMNAZIALĂ ”NEGOIŢĂ DĂNĂILĂ”",329,IVEŞTI,76601,1,PART,PRCNCT,PRSD,PRSD_SV,"2025-05-18 22:12:17",1892,842,768,74,0,829,13,2100,1258,462,367
18,GALAŢI,"ŞCOALA GIMNAZIALĂ NR.1 BUCEȘTI",330,IVEŞTI,76601,1,PART,PRCNCT,PRSD,PRSD_SV,"2025-05-18 21:54:00",1690,840,739,101,0,828,12,1850,1010,440,388
18,GALAŢI,"CĂMINUL CULTURAL JORĂȘTI",331,JORĂŞTI,76638,1,PART,PRCNCT,PRSD,PRSD_SV,"2025-05-18 21:29:26",838,395,332,61,2,390,5,900,505,263,127
18,GALAŢI,"SALĂ ÎNTRUNIRI LUNCA",332,JORĂŞTI,76638,1,PART,PRCNCT,PRSD,PRSD_SV,"2025-05-18 21:21:12",181,102,75,27,0,100,2,200,98,66,34
18,GALAŢI,"CĂMINUL CULTURAL ZĂRNEȘTI",333,JORĂŞTI,76638,1,PART,PRCNCT,PRSD,PRSD_SV,"2025-05-18 21:19:43",264,141,123,18,0,141,0,300,159,96,45
18,GALAŢI,"ŞCOALA GIMNAZIALĂ NR. 1",334,LIEŞTI,76674,1,PART,PRCNCT,PRSD,PRSD_SV,"2025-05-18 21:37:46",1696,836,754,81,1,824,12,1850,1014,434,390
18,GALAŢI,"ŞCOALA GIMNAZIALĂ NR. 2",335,LIEŞTI,76674,1,PART,PRCNCT,PRSD,PRSD_SV,"2025-05-18 21:55:16",1317,567,543,24,0,564,3,1450,883,287,277
18,GALAŢI,"ŞCOALA GIMNAZIALĂ NR. 2",336,LIEŞTI,76674,1,PART,PRCNCT,PRSD,PRSD_SV,"2025-05-18 21:51:05",1352,637,570,67,0,630,7,1500,863,358,272
18,GALAŢI,"ŞCOALA GIMNAZIALĂ NR. 3",337,LIEŞTI,76674,1,PART,PRCNCT,PRSD,PRSD_SV,"2025-05-18 21:30:23",1407,699,624,75,0,692,7,1550,851,399,293
18,GALAŢI,"GRADINITA NR. 3",338,LIEŞTI,76674,3,PART,PRCNCT,PRSD,PRSD_SV,"2025-05-18 23:16:31",1477,758,706,52,0,742,16,1600,842,431,311
18,GALAŢI,"ŞCOALA GIMNAZIALĂ ”SFÂNTUL NICOLAE”",339,LIEŞTI,76674,1,PART,PRCNCT,PRSD,PRSD_SV,"2025-05-18 21:45:37",1573,839,731,108,0,825,14,1750,911,485,340
18,GALAŢI,"SCOALA DIMITRIE CANTEMIR NR.3, MATCA",340,MATCA,76692,1,PART,PRCNCT,PRSD,PRSD_SV,"2025-05-18 22:03:14",1502,776,698,78,0,769,7,1600,824,457,312
18,GALAŢI,"SCOALA DIMITRIE CANTEMIR NR.3, MATCA",341,MATCA,76692,1,PART,PRCNCT,PRSD,PRSD_SV,"2025-05-18 22:14:16",1984,1131,970,161,0,1117,14,2200,1069,664,453
18,GALAŢI,"SCOALA GIMNAZIALA NR.1 MATCA - CORP C",342,MATCA,76692,2,PART,PRCNCT,PRSD,PRSD_SV,"2025-05-19 02:18:02",1932,941,885,56,0,933,8,2000,1059,618,315
18,GALAŢI,"GRADINITA CU PROGRAM PRELUNGIT NR.1 MATCA",343,MATCA,76692,1,PART,PRCNCT,PRSD,PRSD_SV,"2025-05-18 21:45:12",1470,693,676,17,0,684,9,1600,907,386,298
18,GALAŢI,"GRADINITA CU PROGRAM PRELUNGIT NR.1 MATCA",344,MATCA,76692,1,PART,PRCNCT,PRSD,PRSD_SV,"2025-05-18 21:55:33",1597,801,755,46,0,790,11,1750,949,454,336
18,GALAŢI,"GRADINITA CU PROGRAM NORMAL NR.1 MATCA",345,MATCA,76692,1,PART,PRCNCT,PRSD,PRSD_SV,"2025-05-18 22:06:29",1330,610,579,31,0,602,8,1450,840,341,261
18,GALAŢI,"SCOALA GIMNAZIALA NR 1 GHE. POALELUNGI MASTACANI",346,MĂSTĂCANI,76718,1,PART,PRCNCT,PRSD,PRSD_SV,"2025-05-18 21:48:45",975,433,361,72,0,429,4,1100,667,280,149
18,GALAŢI,"SCOALA GIMNAZIALA NR. 3 MĂSTĂCANI",347,MĂSTĂCANI,76718,1,PART,PRCNCT,PRSD,PRSD_SV,"2025-05-18 21:25:08",739,374,284,90,0,368,6,800,426,274,94
18,GALAŢI,"SCOALA GIMNAZIALA NR. 1 CHIRAFTEI",348,MĂSTĂCANI,76718,1,PART,PRCNCT,PRSD,PRSD_SV,"2025-05-18 21:21:39",1051,472,398,74,0,465,7,1150,678,321,144
18,GALAŢI,"SCOALA GIMNAZIALA NR. 2 CHIRAFTEI",349,MĂSTĂCANI,76718,2,PART,PRCNCT,PRSD,PRSD_SV,"2025-05-19 00:20:59",1009,456,373,69,14,454,2,1100,644,288,166
18,GALAŢI,"BIBLIOTECA COMUNALA",350,MOVILENI,76745,1,PART,PRCNCT,PRSD,PRSD_SV,"2025-05-18 22:25:12",1540,581,515,66,0,579,2,1700,1119,390,189
18,GALAŢI,"SCOALA NR.2 MOVILENI",351,MOVILENI,76745,1,PART,PRCNCT,PRSD,PRSD_SV,"2025-05-18 22:20:16",1124,468,416,52,0,465,3,1250,782,320,145
18,GALAŢI,"ȘCOALA GIMNAZIALĂ NR.1 MUNTENI - GRĂDINIȚA MUNTENI",352,MUNTENI,75258,1,PART,PRCNCT,PRSD,PRSD_SV,"2025-05-18 22:04:32",1313,722,653,69,0,711,11,1450,728,432,279
18,GALAŢI,"ȘCOALA GIMNAZIALĂ NR.1 MUNTENI",353,MUNTENI,75258,1,PART,PRCNCT,PRSD,PRSD_SV,"2025-05-18 22:23:52",1746,978,913,65,0,956,22,1950,972,690,266
18,GALAŢI,"ȘCOALA GIMNAZIALĂ NR.1 UNGURENI - SAT FRUNZEASCA",354,MUNTENI,75258,1,PART,PRCNCT,PRSD,PRSD_SV,"2025-05-18 21:56:02",1017,539,503,36,0,530,9,1100,561,343,187
18,GALAŢI,"CENTRUL SOCIAL MULTIFUNCTIONAL INTEGRAT PENTRU PERSOANE VARSTNICE TIGANESTI",355,MUNTENI,75258,1,PART,PRCNCT,PRSD,PRSD_SV,"2025-05-18 22:01:09",821,391,354,35,2,386,5,900,509,235,151
18,GALAŢI,"ANEXA DISPENSARULUI UNGURENI",356,MUNTENI,75258,1,PART,PRCNCT,PRSD,PRSD_SV,"2025-05-18 21:59:20",1047,471,435,36,0,465,6,1150,679,306,159
18,GALAŢI,"ȘCOALA GIMNAZIALĂ NR.1 NĂMOLOASA (GRĂDINIȚA NR. 1)",357,NĂMOLOASA,76763,1,PART,PRCNCT,PRSD,PRSD_SV,"2025-05-18 22:03:49",766,435,344,57,34,429,6,850,415,248,181
18,GALAŢI,"ȘCOALA GIMNAZIALĂ NR. 1 NĂMOLOASA",358,NĂMOLOASA,76763,1,PART,PRCNCT,PRSD,PRSD_SV,"2025-05-18 22:01:02",828,424,320,77,27,419,5,900,476,235,184
18,GALAŢI,"CĂMINUL CULTURAL DIN SATUL NEGRILEŞTI",359,NEGRILEŞTI,77579,1,PART,PRCNCT,PRSD,PRSD_SV,"2025-05-18 22:28:23",1318,618,572,46,0,611,7,1450,832,420,191
18,GALAŢI,"SCOALA PRIMARĂ SLOBOZIA BLĂNEASA",360,NEGRILEŞTI,77579,1,PART,PRCNCT,PRSD,PRSD_SV,"2025-05-18 21:50:08",810,447,397,50,0,441,6,900,453,295,146
18,GALAŢI,"ȘCOALA GIMNAZIALĂ ”GABRIEL DRĂGAN” NICOREŞTI",361,NICOREŞTI,76807,2,PART,PRCNCT,PRSD,PRSD_SV,"2025-05-19 02:49:40",1156,506,437,68,1,498,8,1250,744,338,160
18,GALAŢI,"ŞCOALA GIMNAZIALĂ NR.1 COASTA LUPEI",362,NICOREŞTI,76807,1,PART,PRCNCT,PRSD,PRSD_SV,"2025-05-18 21:34:54",312,169,142,27,0,169,0,350,181,112,57
18,GALAŢI,"ŞCOALA GENERALĂ DOBRINEŞTI CLASELE I-IV",363,NICOREŞTI,76807,1,PART,PRCNCT,PRSD,PRSD_SV,"2025-05-18 22:08:25",406,194,166,28,0,192,2,450,256,151,41
18,GALAŢI,"GRĂDINIȚA CU PROGRAM NORMAL FÎNTÎNI",364,NICOREŞTI,76807,1,PART,PRCNCT,PRSD,PRSD_SV,"2025-05-18 21:33:34",456,247,193,54,0,242,5,500,253,134,108
18,GALAŢI,"ŞCOALA PRIMARĂ NR.1 IONĂŞEŞTI",365,NICOREŞTI,76807,1,PART,PRCNCT,PRSD,PRSD_SV,"2025-05-18 21:25:21",552,240,217,23,0,234,6,600,360,172,62
18,GALAŢI,"ŞCOALA MĂLURENI",366,NICOREŞTI,76807,1,PART,PRCNCT,PRSD,PRSD_SV,"2025-05-18 21:29:15",156,94,78,16,0,94,0,200,106,59,35
18,GALAŢI,"ȘCOALA CU CLASELE I-IV AUREL BRĂESCU",367,NICOREŞTI,76807,1,PART,PRCNCT,PRSD,PRSD_SV,"2025-05-18 21:25:21",215,118,90,28,0,115,3,250,132,78,37
18,GALAŢI,"CĂMIN CULTURAL OANCEA",368,OANCEA,76932,2,PART,PRCNCT,PRSD,PRSD_SV,"2025-05-19 01:33:41",1279,603,55,486,62,590,13,1400,797,322,268
18,GALAŢI,"ȘCOALA GIMNAZIALĂ ”VASILE ȘEICARU”OANCEA",369,OANCEA,76932,1,PART,PRCNCT,PRSD,PRSD_SV,"2025-05-18 21:39:48",1268,163,21,142,0,163,0,1400,1237,88,75
18,GALAŢI,"ȘCOALA GIMNAZIALĂ NR. 1 PECHEA",370,PECHEA,76969,1,PART,PRCNCT,PRSD,PRSD_SV,"2025-05-18 21:54:10",1192,557,465,92,0,544,13,1300,743,305,239
18,GALAŢI,"ȘCOALA GIMNAZIALĂ „ALEXANDRU MORUZI” PECHEA",371,PECHEA,76969,1,PART,PRCNCT,PRSD,PRSD_SV,"2025-05-18 21:48:34",1396,637,572,65,0,633,4,1550,913,403,230
18,GALAŢI,"ȘCOALA GIMNAZIALĂ NR. 3 PECHEA",372,PECHEA,76969,1,PART,PRCNCT,PRSD,PRSD_SV,"2025-05-18 22:12:24",1655,673,621,52,0,668,5,1800,1127,445,223
18,GALAŢI,"GRĂDINIŢA CU PROGRAM NORMAL ”VIOLETA” PECHEA",373,PECHEA,76969,1,PART,PRCNCT,PRSD,PRSD_SV,"2025-05-18 22:03:36",1274,566,523,41,2,558,8,1400,834,340,218
18,GALAŢI,"CĂMIN CULTURAL PECHEA",374,PECHEA,76969,1,PART,PRCNCT,PRSD,PRSD_SV,"2025-05-18 22:01:13",1929,843,765,78,0,832,11,2150,1307,531,301
18,GALAŢI,"ȘCOALA GIMNAZIALĂ NR. 4 PECHEA",375,PECHEA,76969,1,PART,PRCNCT,PRSD,PRSD_SV,"2025-05-18 22:02:08",1701,772,683,74,15,765,7,1900,1128,555,210
18,GALAŢI,"CĂMINUL CULTURAL ION PANAIT-POET 1941-2009",376,PISCU,76996,1,PART,PRCNCT,PRSD,PRSD_SV,"2025-05-18 22:01:10",1168,596,499,97,0,586,10,1300,704,330,256
18,GALAŢI,"SCOALA GIMNAZIALĂ ”DIMITRIE LUCHIAN ”CORP B , PISCU",377,PISCU,76996,1,PART,PRCNCT,PRSD,PRSD_SV,"2025-05-18 22:15:50",876,432,387,45,0,427,5,950,518,252,175
18,GALAŢI,"SCOALA GIMNAZIALĂ ” STEFAN CEL MARE” PISCU",378,PISCU,76996,1,PART,PRCNCT,PRSD,PRSD_SV,"2025-05-18 22:41:00",1429,759,670,88,1,751,8,1550,791,430,321
18,GALAŢI,"ȘCOALA PRIMARĂ VAMEȘ",379,PISCU,76996,1,PART,PRCNCT,PRSD,PRSD_SV,"2025-05-18 21:39:41",422,244,179,65,0,239,5,450,206,146,93
18,GALAŢI,"SCOALA GIMNAZIALA NR.1 COMUNA POIANA,JUDETUL GALATI",380,POIANA,77587,2,PART,PRCNCT,PRSD,PRSD_SV,"2025-05-19 02:44:44",981,500,423,76,1,491,9,1100,600,291,200
18,GALAŢI,"SCOALA PRIMARA NR.1 SAT VISINA, COMUNA POIANA, JUDETUL GALATI",381,POIANA,77587,1,PART,PRCNCT,PRSD,PRSD_SV,"2025-05-18 22:26:52",387,235,186,49,0,231,4,450,215,151,80
18,GALAŢI,"SCOALA GIMNAZIALĂ NR. 1",382,PRIPONEŞTI,77028,1,PART,PRCNCT,PRSD,PRSD_SV,"2025-05-18 21:56:32",706,312,263,49,0,310,2,800,488,164,146
18,GALAŢI,"ȘCOALA GIMNAZIALĂ NR. 1",383,PRIPONEŞTI,77028,1,PART,PRCNCT,PRSD,PRSD_SV,"2025-05-18 22:17:53",771,408,334,72,2,402,6,850,442,243,159
18,GALAŢI,"ȘCOALA GENERALĂ LIEȘTI",384,PRIPONEŞTI,77028,1,PART,PRCNCT,PRSD,PRSD_SV,"2025-05-18 21:41:05",172,102,69,33,0,101,1,200,98,49,52
18,GALAŢI,"ȘCOALA GIMNAZIALĂ NR. 1 RĂDEȘTI",385,RĂDEŞTI,77561,1,PART,PRCNCT,PRSD,PRSD_SV,"2025-05-18 21:55:32",856,459,384,68,7,448,11,950,491,283,165
18,GALAŢI,"GRĂDINIŢA CU PROGRAM NORMAL CRUCEANU",386,RĂDEŞTI,77561,1,PART,PRCNCT,PRSD,PRSD_SV,"2025-05-18 21:39:29",248,118,102,16,0,114,4,300,182,82,32
18,GALAŢI,"GRĂDINIȚA CU PROGRAM NORMAL NR.1, COMUNA REDIU",387,REDIU,77082,1,PART,PRCNCT,PRSD,PRSD_SV,"2025-05-18 21:45:00",1211,586,472,81,33,580,6,1350,764,328,252
18,GALAŢI,"ȘCOALA CU CLASELE I-IV, SAT PLEVNA",388,REDIU,77082,1,PART,PRCNCT,PRSD,PRSD_SV,"2025-05-18 21:49:22",433,236,173,58,5,232,4,500,264,124,108
18,GALAŢI,"CAMINUL CULTURAL",389,SCÂNTEIEŞTI,77126,1,PART,PRCNCT,PRSD,PRSD_SV,"2025-05-18 21:57:00",742,384,317,63,4,380,4,800,416,216,164
18,GALAŢI,"GRĂDINIȚA CU PROGRAM NORMAL NR. 1 SAT FÂNTÂNELE",390,SCÂNTEIEŞTI,77126,1,PART,PRCNCT,PRSD,PRSD_SV,"2025-05-18 21:45:22",1227,644,534,66,44,633,11,1350,706,398,235
18,GALAŢI,"CREȘĂ SCHELA",391,SCHELA,77153,1,PART,PRCNCT,PRSD,PRSD_SV,"2025-05-18 22:15:28",1438,758,687,71,0,750,8,1600,842,477,273
18,GALAŢI,"CREȘĂ SCHELA",392,SCHELA,77153,1,PART,PRCNCT,PRSD,PRSD_SV,"2025-05-18 21:57:17",1234,659,573,86,0,657,2,1350,691,399,258
18,GALAŢI,"AȘEZĂMÂNTUL CULTURAL NEGREA",393,SCHELA,77153,1,PART,PRCNCT,PRSD,PRSD_SV,"2025-05-18 21:49:32",534,305,250,55,0,302,3,600,295,203,99
18,GALAŢI,"ȘCOALA GIMNAZIALĂ NR. 1 SLOBOZIA CONACHI",394,"SLOBOZIA CONACHI",77180,1,PART,PRCNCT,PRSD,PRSD_SV,"2025-05-18 21:26:52",1356,728,660,60,8,724,4,1500,772,400,324
18,GALAŢI,"ȘCOALA GIMNAZIALĂ NR. 1 SLOBOZIA CONACHI",395,"SLOBOZIA CONACHI",77180,1,PART,PRCNCT,PRSD,PRSD_SV,"2025-05-18 21:32:03",1230,614,535,70,9,611,3,1350,736,383,228
18,GALAŢI,"ȘCOALA PRIMARĂ NR. 1 IZVOARELE",396,"SLOBOZIA CONACHI",77180,1,PART,PRCNCT,PRSD,PRSD_SV,"2025-05-18 21:43:59",779,399,349,40,10,393,6,850,451,255,138
18,GALAŢI,"ȘCOALA GIMNAZIALĂ SFÂNTA CUVIOASA PARASCHEVA",397,SMÂRDAN,77224,1,PART,PRCNCT,PRSD,PRSD_SV,"2025-05-18 21:37:50",1511,1036,762,273,1,1030,6,1600,564,636,394
18,GALAŢI,"ŞCOALA GIMNAZIALĂ SFÂNTA CUVIOASA PARASCHEVA",398,SMÂRDAN,77224,2,PART,PRCNCT,PRSD,PRSD_SV,"2025-05-18 22:31:29",1218,891,576,313,2,882,9,1350,459,540,342
18,GALAŢI,"SCOALA PRIMARĂ NR.1 CIŞMELE",399,SMÂRDAN,77224,1,PART,PRCNCT,PRSD,PRSD_SV,"2025-05-18 21:45:38",1253,734,583,151,0,728,6,1400,666,512,216
18,GALAŢI,"SCOALA GIMNAZIALĂ ”MIHAIL ŞI GAVRIL” M.KOGĂLNICEANU",400,SMÂRDAN,77224,1,PART,PRCNCT,PRSD,PRSD_SV,"2025-05-18 21:52:09",972,601,447,154,0,597,4,1050,449,375,222
18,GALAŢI,"GRADINITA SMULTI",401,SMULŢI,77260,1,PART,PRCNCT,PRSD,PRSD_SV,"2025-05-18 21:47:50",1070,554,424,108,22,549,5,1200,646,275,274
18,GALAŢI,"CĂMINUL CULTURAL SUCEVENI",402,SUCEVENI,77288,1,PART,PRCNCT,PRSD,PRSD_SV,"2025-05-18 21:58:57",1388,531,382,132,17,518,13,1500,969,250,268
18,GALAŢI,"SCOALA GIMNAZIALĂ ROGOJENI",403,SUCEVENI,77288,1,PART,PRCNCT,PRSD,PRSD_SV,"2025-05-18 21:18:26",494,232,185,47,0,227,5,550,318,109,118
18,GALAŢI,"SCOALA GIMNAZIALĂ NR.1 SUHURLUI",404,SUHURLUI,77601,1,PART,PRCNCT,PRSD,PRSD_SV,"2025-05-18 21:54:46",1103,576,439,130,7,570,6,1200,624,337,233
18,GALAŢI,"SCOALA GIMNAZIALA NR. 1",405,ŞENDRENI,75114,1,PART,PRCNCT,PRSD,PRSD_SV,"2025-05-18 21:52:51",1678,1056,896,147,13,1039,17,1850,794,408,631
18,GALAŢI,"SCOALA GIMNAZIALA NR. 1",406,ŞENDRENI,75114,1,PART,PRCNCT,PRSD,PRSD_SV,"2025-05-18 22:15:01",1812,1025,885,139,1,1015,10,2000,975,512,503
18,GALAŢI,"GRADINITA MOVILENI",407,ŞENDRENI,75114,1,PART,PRCNCT,PRSD,PRSD_SV,"2025-05-18 21:37:22",558,293,257,35,1,290,3,600,307,159,131
18,GALAŢI,"GRADINITA SERBESTII VECHI",408,ŞENDRENI,75114,1,PART,PRCNCT,PRSD,PRSD_SV,"2025-05-18 21:52:17",827,442,377,62,3,439,3,900,458,265,174
18,GALAŢI,"ŞCOALA GIMNAZIALĂ NR. 1(ŞCOALA GENERALA DE 8 CLASETUDOR VLADIMIRESCU MOARĂ)",409,"TUDOR VLADIMIRESCU",77313,1,PART,PRCNCT,PRSD,PRSD_SV,"2025-05-18 21:43:50",744,392,312,80,0,386,6,800,408,224,162
18,GALAŢI,"GRĂDINIŢA TUDOR VLADIMIRESCU,",410,"TUDOR VLADIMIRESCU",77313,1,PART,PRCNCT,PRSD,PRSD_SV,"2025-05-18 22:29:06",1365,775,655,120,0,766,9,1500,725,437,329
18,GALAŢI,"LICEUL TEHNOLOGIC ”TUDOR VLADIMIRESCU”",411,"TUDOR VLADIMIRESCU",77313,1,PART,PRCNCT,PRSD,PRSD_SV,"2025-05-18 21:53:19",915,458,362,96,0,453,5,1000,542,272,181
18,GALAŢI,"LICEUL TEHNOLOGIC ”TUDOR VLADIMIRESCU”",412,"TUDOR VLADIMIRESCU",77313,2,PART,PRCNCT,PRSD,PRSD_SV,"2025-05-19 01:44:35",1162,624,558,66,0,612,12,1250,626,388,224
18,GALAŢI,"GRADINITA TULUCESTI",413,TULUCEŞTI,77331,1,PART,PRCNCT,PRSD,PRSD_SV,"2025-05-18 22:30:01",1846,1005,881,85,39,999,6,2000,995,583,416
18,GALAŢI,"SCOALA TULUCESTI",414,TULUCEŞTI,77331,1,PART,PRCNCT,PRSD,PRSD_SV,"2025-05-18 21:46:28",1978,1054,896,154,4,1039,15,2200,1146,574,465
18,GALAŢI,"SALA DE SPORT SIVITA",415,TULUCEŞTI,77331,1,PART,PRCNCT,PRSD,PRSD_SV,"2025-05-18 22:06:37",1047,521,450,68,3,515,6,1150,629,232,283
18,GALAŢI,"ŞCOALA VECHE ŞIVIŢA",416,TULUCEŞTI,77331,1,PART,PRCNCT,PRSD,PRSD_SV,"2025-05-18 21:43:57",997,521,438,77,6,514,7,1100,579,231,283
18,GALAŢI,"SCOALA TATARCA",417,TULUCEŞTI,77331,1,PART,PRCNCT,PRSD,PRSD_SV,"2025-05-18 21:29:05",614,318,250,66,2,316,2,700,382,192,124
18,GALAŢI,"SCOALA GIMNAZIALĂ TUDOR PAMFILE",418,ŢEPU,77377,1,PART,PRCNCT,PRSD,PRSD_SV,"2025-05-18 22:10:25",1106,604,534,68,2,596,8,1200,596,328,268
18,GALAŢI,"GRĂDINIȚA CU PROGRAM NORMAL NR.1",419,ŢEPU,77377,1,PART,PRCNCT,PRSD,PRSD_SV,"2025-05-18 21:44:05",809,423,381,42,0,416,7,900,477,230,186
18,GALAŢI,"ȘCOALA GIMNAZIALĂ NR. 1 UMBRĂREȘTI",420,UMBRĂREŞTI,77402,1,PART,PRCNCT,PRSD,PRSD_SV,"2025-05-18 21:42:08",1682,621,582,39,0,612,9,1800,1179,414,198
18,GALAŢI,"ȘCOALA GIMNAZIALĂ CONDREA",421,UMBRĂREŞTI,77402,1,PART,PRCNCT,PRSD,PRSD_SV,"2025-05-18 21:35:23",571,266,236,30,0,263,3,650,384,158,105
18,GALAŢI,"GRADINIȚA SALCIA",422,UMBRĂREŞTI,77402,1,PART,PRCNCT,PRSD,PRSD_SV,"2025-05-18 21:43:35",694,272,235,37,0,267,5,750,478,179,88
18,GALAŢI,MUZEU,423,UMBRĂREŞTI,77402,1,PART,PRCNCT,PRSD,PRSD_SV,"2025-05-18 21:37:58",257,126,105,21,0,123,3,300,174,66,57
18,GALAŢI,"GRADINIȚA TORCEȘTI",424,UMBRĂREŞTI,77402,1,PART,PRCNCT,PRSD,PRSD_SV,"2025-05-18 21:24:54",606,296,272,24,0,292,4,650,354,173,119
18,GALAŢI,"GRĂDINIȚA CU PROGRAM NORMAL NR.2 UMBRĂREȘTI-DEAL",425,UMBRĂREŞTI,77402,2,PART,PRCNCT,PRSD,PRSD_SV,"2025-05-19 01:53:31",1004,469,437,32,0,462,7,1100,631,288,174
18,GALAŢI,"ȘCOALA GIMNAZIALĂ NR.2 „SFÂNTUL STELIAN„ UMBRĂREȘTI - DEAL",426,UMBRĂREŞTI,77402,1,PART,PRCNCT,PRSD,PRSD_SV,"2025-05-18 22:19:52",999,446,402,44,0,442,4,1100,654,252,190
18,GALAŢI,"ȘCOALA GIMNAZIALĂ ”DOAMNA NICA” CORP C5",427,"VALEA MĂRULUI",77475,1,PART,PRCNCT,PRSD,PRSD_SV,"2025-05-18 21:47:00",980,482,434,45,3,475,7,1100,618,279,196
18,GALAŢI,"ȘCOALA GIMNAZIALĂ ”DOAMNA NICA” CORP C5",428,"VALEA MĂRULUI",77475,1,PART,PRCNCT,PRSD,PRSD_SV,"2025-05-18 21:40:23",782,363,311,51,1,360,3,850,487,224,136
18,GALAŢI,"ȘCOALA COASTA VĂII",429,"VALEA MĂRULUI",77475,1,PART,PRCNCT,PRSD,PRSD_SV,"2025-05-18 21:44:45",385,213,199,14,0,210,3,450,237,164,46
18,GALAŢI,"ȘCOALA MÎNDRESTI",430,"VALEA MĂRULUI",77475,1,PART,PRCNCT,PRSD,PRSD_SV,"2025-05-18 21:47:16",756,331,287,44,0,329,2,850,519,195,134
18,GALAŢI,"SCOALA SFINTUL NICOLAE",431,VÂNĂTORI,75150,1,PART,PRCNCT,PRSD,PRSD_SV,"2025-05-18 22:05:18",1395,852,729,123,0,844,8,1550,698,358,486
18,GALAŢI,"SCOALA SFINTUL NICOLAE",432,VÂNĂTORI,75150,1,PART,PRCNCT,PRSD,PRSD_SV,"2025-05-18 21:42:49",1316,887,711,176,0,873,14,1450,563,354,519
18,GALAŢI,"GRADINITA COPII",433,VÂNĂTORI,75150,1,PART,PRCNCT,PRSD,PRSD_SV,"2025-05-18 22:21:05",1959,1275,1049,223,3,1267,8,2150,875,505,762
18,GALAŢI,"SCOALA GIMNAZIALA MARIA GRECU ODAIA MANOLACHE",434,VÂNĂTORI,75150,1,PART,PRCNCT,PRSD,PRSD_SV,"2025-05-18 22:12:26",1757,980,875,105,0,969,11,1950,970,531,438
18,GALAŢI,"GRĂDINIȚA CU PROGRAM NORMAL CU DOUĂ SĂLI DE GRUPĂ",435,VÂRLEZI,77509,1,PART,PRCNCT,PRSD,PRSD_SV,"2025-05-18 22:02:02",827,426,358,67,1,423,3,900,474,294,129
18,GALAŢI,"ȘCOALA PRIMARĂ CRĂIEȘTI",436,VÂRLEZI,77509,1,PART,PRCNCT,PRSD,PRSD_SV,"2025-05-18 21:38:59",620,360,307,52,1,357,3,700,340,223,134
18,GALAŢI,"CAMINUL CULTURAL",437,VLĂDEŞTI,77536,1,PART,PRCNCT,PRSD,PRSD_SV,"2025-05-18 21:54:55",1179,528,379,145,4,523,5,1300,772,308,215
18,GALAŢI,"GRĂDINIȚA ”ALBA CA ZĂPADA” BRĂNEȘTI",438,VLĂDEŞTI,77536,1,PART,PRCNCT,PRSD,PRSD_SV,"2025-05-18 21:39:07",746,326,259,67,0,323,3,850,524,225,98
19,GIURGIU,"ŞCOALA GIMNAZIALĂ SFÂNTUL GHEORGHE",1,"MUNICIPIUL GIURGIU",100521,1,PART,PRCNCT,PRSD,PRSD_SV,"2025-05-18 22:08:42",1231,675,584,91,0,663,12,1353,678,321,342
19,GIURGIU,"ȘCOALA GIMNAZIALĂ NR.7",2,"MUNICIPIUL GIURGIU",100521,1,PART,PRCNCT,PRSD,PRSD_SV,"2025-05-18 21:47:22",883,571,460,95,16,564,7,971,400,210,354
19,GIURGIU,"ŞCOALA GIMNAZIALĂ NR.7",3,"MUNICIPIUL GIURGIU",100521,1,PART,PRCNCT,PRSD,PRSD_SV,"2025-05-18 21:33:09",1278,675,613,59,3,660,15,1403,728,307,353
19,GIURGIU,"PRIMĂRIA MUNICIPIULUI GIURGIU",4,"MUNICIPIUL GIURGIU",100521,1,PART,PRCNCT,PRSD,PRSD_SV,"2025-05-18 22:16:09",998,641,481,160,0,627,14,1096,455,257,370
19,GIURGIU,"LICEUL „TUDOR VIANU”",5,"MUNICIPIUL GIURGIU",100521,1,PART,PRCNCT,PRSD,PRSD_SV,"2025-05-18 22:17:59",1080,660,508,61,91,650,10,1178,518,384,266
19,GIURGIU,"ŞCOALA GIMNAZIALĂ MIRCEA CEL BĂTRÂN",6,"MUNICIPIUL GIURGIU",100521,1,PART,PRCNCT,PRSD,PRSD_SV,"2025-05-18 21:37:19",1169,794,639,54,101,774,20,1284,490,429,345
19,GIURGIU,"SEMINARUL TEOLOGIC TEOCTIST PATRIARHUL",7,"MUNICIPIUL GIURGIU",100521,1,PART,PRCNCT,PRSD,PRSD_SV,"2025-05-18 21:53:54",954,567,439,28,100,558,9,1048,481,384,174
19,GIURGIU,"CANTINA SEMINARULUI TEOLOGIC TEOCTIST PATRIARHUL",8,"MUNICIPIUL GIURGIU",100521,1,PART,PRCNCT,PRSD,PRSD_SV,"2025-05-18 22:17:07",827,533,413,24,96,525,8,909,376,357,168
19,GIURGIU,"COLEGIUL TEHNIC VICEAMIRAL IOAN BĂLĂNESCU",9,"MUNICIPIUL GIURGIU",100521,1,PART,PRCNCT,PRSD,PRSD_SV,"2025-05-18 21:52:06",971,576,438,40,98,563,13,1069,493,353,210
19,GIURGIU,"LICEUL ”NICOLAE CARTOJAN”",10,"MUNICIPIUL GIURGIU",100521,1,PART,PRCNCT,PRSD,PRSD_SV,"2025-05-18 21:44:41",1155,711,540,73,98,698,13,1270,559,431,267
19,GIURGIU,"LICEUL ”NICOLAE CARTOJAN”",11,"MUNICIPIUL GIURGIU",100521,1,PART,PRCNCT,PRSD,PRSD_SV,"2025-05-18 22:04:55",1364,694,567,30,97,676,18,1500,806,355,321
19,GIURGIU,"ȘCOALA GIMNAZIALĂ NR.3",12,"MUNICIPIUL GIURGIU",100521,2,PART,PRCNCT,PRSD,PRSD_SV,"2025-05-19 00:11:58",713,416,291,29,96,406,10,784,368,262,144
19,GIURGIU,"ŞCOALA GIMNAZIALĂ NR.3",13,"MUNICIPIUL GIURGIU",100521,1,PART,PRCNCT,PRSD,PRSD_SV,"2025-05-18 21:37:10",1237,643,528,17,98,631,12,1360,717,386,245
19,GIURGIU,"ȘCOALA GIMNAZIALĂ NR.3",14,"MUNICIPIUL GIURGIU",100521,1,PART,PRCNCT,PRSD,PRSD_SV,"2025-05-18 21:55:41",1377,589,474,19,96,576,13,1513,924,407,169
19,GIURGIU,"GRĂDINIŢA CU PROGRAM NORMAL NR.8 GORNENI",15,"MUNICIPIUL GIURGIU",100521,1,PART,PRCNCT,PRSD,PRSD_SV,"2025-05-18 22:14:28",1175,676,544,39,93,663,13,1297,621,359,304
19,GIURGIU,"DIRECŢIA PENTRU AGRICULTURĂ JUDEŢEANĂ",16,"MUNICIPIUL GIURGIU",100521,1,PART,PRCNCT,PRSD,PRSD_SV,"2025-05-18 21:59:28",1159,641,492,51,98,629,12,1273,632,407,222
19,GIURGIU,"GRĂDINIŢA CU PN NR.8 CĂRĂMIDARI",17,"MUNICIPIUL GIURGIU",100521,1,PART,PRCNCT,PRSD,PRSD_SV,"2025-05-18 22:08:19",1672,858,740,36,82,854,4,1739,881,568,286
19,GIURGIU,"ȘCOALA GIMNAZIALĂ ACAD. MARIN VOICULESCU",18,"MUNICIPIUL GIURGIU",100521,1,PART,PRCNCT,PRSD,PRSD_SV,"2025-05-18 22:07:45",1420,716,658,58,0,697,19,1561,845,304,393
19,GIURGIU,"ȘCOALA GIMNAZIALĂ ACAD. MARIN VOICULESCU",19,"MUNICIPIUL GIURGIU",100521,1,PART,PRCNCT,PRSD,PRSD_SV,"2025-05-18 22:14:04",958,556,490,65,1,543,13,1052,496,249,294
19,GIURGIU,"ŞCOALA GIMNAZIALĂ ACAD. MARIN VOICULESCU",20,"MUNICIPIUL GIURGIU",100521,1,PART,PRCNCT,PRSD,PRSD_SV,"2025-05-18 21:47:52",1093,540,519,21,0,527,13,1201,661,286,241
19,GIURGIU,"ŞCOALA GIMNAZIALĂ ACAD. MARIN VOICULESCU",21,"MUNICIPIUL GIURGIU",100521,1,PART,PRCNCT,PRSD,PRSD_SV,"2025-05-18 21:57:14",1067,585,504,81,0,578,7,1173,588,278,300
19,GIURGIU,"ŞCOALA GIMNAZIALĂ ACAD. MARIN VOICULESCU",22,"MUNICIPIUL GIURGIU",100521,1,PART,PRCNCT,PRSD,PRSD_SV,"2025-05-18 21:45:54",1166,609,574,35,0,594,15,1281,672,279,315
19,GIURGIU,"ŞCOALA GIMNAZIALĂ ACAD. MARIN VOICULESCU",23,"MUNICIPIUL GIURGIU",100521,1,PART,PRCNCT,PRSD,PRSD_SV,"2025-05-18 21:27:00",936,482,460,22,0,472,10,1030,548,202,270
19,GIURGIU,"ȘCOALA GIMNAZIALĂ MIHAI EMINESCU",24,"MUNICIPIUL GIURGIU",100521,1,PART,PRCNCT,PRSD,PRSD_SV,"2025-05-18 22:19:59",1717,740,719,21,0,723,17,1887,1147,440,283
19,GIURGIU,"ŞCOALA GIMNAZIALĂ MIHAI EMINESCU",25,"MUNICIPIUL GIURGIU",100521,1,PART,PRCNCT,PRSD,PRSD_SV,"2025-05-18 21:49:53",1270,687,627,60,0,668,19,1396,709,311,357
19,GIURGIU,"ȘCOALA GIMNAZIALĂ MIHAI EMINESCU",26,"MUNICIPIUL GIURGIU",100521,1,PART,PRCNCT,PRSD,PRSD_SV,"2025-05-18 21:46:49",1182,636,562,74,0,630,6,1299,663,373,257
19,GIURGIU,"CLUBUL CADRELOR MILITARE ÎN RETRAGERE",27,"MUNICIPIUL GIURGIU",100521,1,PART,PRCNCT,PRSD,PRSD_SV,"2025-05-18 22:22:19",1443,811,683,72,56,800,11,1586,775,430,370
19,GIURGIU,"GRĂDINIŢA CU PROGRAM NORMAL NR.6",28,"MUNICIPIUL GIURGIU",100521,1,PART,PRCNCT,PRSD,PRSD_SV,"2025-05-18 22:11:52",1174,596,560,36,0,580,16,1292,696,308,272
19,GIURGIU,"ŞCOALA GIMNAZIALĂ NR.10",29,"MUNICIPIUL GIURGIU",100521,1,PART,PRCNCT,PRSD,PRSD_SV,"2025-05-18 21:42:12",990,477,436,41,0,467,10,1088,611,231,236
19,GIURGIU,"ŞCOALA GIMNAZIALĂ NR.10",30,"MUNICIPIUL GIURGIU",100521,1,PART,PRCNCT,PRSD,PRSD_SV,"2025-05-18 21:27:32",993,485,456,29,0,474,11,1091,606,263,211
19,GIURGIU,"ŞCOALA GIMNAZIALĂ NR.10",31,"MUNICIPIUL GIURGIU",100521,1,PART,PRCNCT,PRSD,PRSD_SV,"2025-05-18 22:30:14",1004,562,441,120,1,551,11,1104,542,296,255
19,GIURGIU,"ȘCOALA GIMNAZIALĂ NR.10",32,"MUNICIPIUL GIURGIU",100521,1,PART,PRCNCT,PRSD,PRSD_SV,"2025-05-18 21:43:28",1147,580,539,41,0,569,11,1260,680,309,260
19,GIURGIU,"ŞCOALA GIMNAZIALĂ NR,10",33,"MUNICIPIUL GIURGIU",100521,1,PART,PRCNCT,PRSD,PRSD_SV,"2025-05-18 21:41:26",777,381,341,39,1,373,8,854,473,203,170
19,GIURGIU,"ŞCOALA GIMNAZIALĂ NR.5",34,"MUNICIPIUL GIURGIU",100521,1,PART,PRCNCT,PRSD,PRSD_SV,"2025-05-18 21:54:11",838,459,394,65,0,454,5,923,464,189,265
19,GIURGIU,"ŞCOALA GIMNAZIALĂ NR.5",35,"MUNICIPIUL GIURGIU",100521,1,PART,PRCNCT,PRSD,PRSD_SV,"2025-05-18 21:36:57",1049,500,463,37,0,487,13,1152,652,244,243
19,GIURGIU,"ŞCOALA GIMNAZIALĂ NR.5",36,"MUNICIPIUL GIURGIU",100521,1,PART,PRCNCT,PRSD,PRSD_SV,"2025-05-18 21:35:05",1039,466,446,20,0,455,11,1141,675,246,209
19,GIURGIU,"PUNCTUL TERMIC NR. 35",37,"MUNICIPIUL GIURGIU",100521,1,PART,PRCNCT,PRSD,PRSD_SV,"2025-05-18 21:50:38",1094,513,485,28,0,505,8,1204,691,257,248
19,GIURGIU,"PUNCTUL TERMIC NR.35",38,"MUNICIPIUL GIURGIU",100521,1,PART,PRCNCT,PRSD,PRSD_SV,"2025-05-18 21:34:04",787,425,399,25,1,419,6,865,440,236,183
19,GIURGIU,"GRĂDINIŢA CU PN NR.9",39,"MUNICIPIUL GIURGIU",100521,1,PART,PRCNCT,PRSD,PRSD_SV,"2025-05-18 21:42:06",850,371,326,45,0,363,8,935,564,190,173
19,GIURGIU,"GRĂDINIŢA CU PP NR.9",40,"MUNICIPIUL GIURGIU",100521,1,PART,PRCNCT,PRSD,PRSD_SV,"2025-05-18 21:39:42",946,406,362,43,1,402,4,1039,633,249,153
19,GIURGIU,"GRĂDINIŢA CĂSUŢA FERMECATĂ",41,"MUNICIPIUL GIURGIU",100521,1,PART,PRCNCT,PRSD,PRSD_SV,"2025-05-18 21:26:24",892,420,389,31,0,411,9,983,563,237,174
19,GIURGIU,"CANTINA DE AJUTOR SOCIAL",42,"MUNICIPIUL GIURGIU",100521,1,PART,PRCNCT,PRSD,PRSD_SV,"2025-05-18 21:37:51",754,316,268,48,0,309,7,829,513,187,122
19,GIURGIU,"ŞCOALA GIMNAZIALĂ SAVIN POPESCU",43,"MUNICIPIUL GIURGIU",100521,1,PART,PRCNCT,PRSD,PRSD_SV,"2025-05-18 22:07:44",1365,726,637,89,0,718,8,1500,774,349,369
19,GIURGIU,"ŞCOALA GIMNAZIALĂ SAVIN POPESCU",44,"MUNICIPIUL GIURGIU",100521,1,PART,PRCNCT,PRSD,PRSD_SV,"2025-05-18 21:28:52",984,461,404,57,0,455,6,1081,620,226,229
19,GIURGIU,"ȘCOALA GIMNAZIALĂ SAVIN POPESCU",45,"MUNICIPIUL GIURGIU",100521,1,PART,PRCNCT,PRSD,PRSD_SV,"2025-05-18 21:54:04",1179,548,501,46,1,540,8,1295,747,313,227
19,GIURGIU,"ȘCOALA GIMNAZIALĂ SAVIN POPESCU",46,"MUNICIPIUL GIURGIU",100521,1,PART,PRCNCT,PRSD,PRSD_SV,"2025-05-18 21:57:45",1039,523,465,58,0,516,7,1141,618,271,245
19,GIURGIU,"COLEGIUL NAŢIONAL ”ION MAIORESCU”",47,"MUNICIPIUL GIURGIU",100521,1,PART,PRCNCT,PRSD,PRSD_SV,"2025-05-18 21:42:31",772,486,405,79,2,478,8,849,363,206,272
19,GIURGIU,"COLEGIUL NAŢIONAL ”ION MAIORESCU”",48,"MUNICIPIUL GIURGIU",100521,1,PART,PRCNCT,PRSD,PRSD_SV,"2025-05-18 22:11:26",1006,604,515,87,2,592,12,1106,502,236,356
19,GIURGIU,"ŞCOALA GIMNAZIALĂ NR. 1 BOLINTIN-VALE",49,"ORAŞ BOLINTIN-VALE",101190,1,PART,PRCNCT,PRSD,PRSD_SV,"2025-05-18 22:01:17",1151,774,634,137,3,766,8,1266,492,293,473
19,GIURGIU,"ŞCOALA GIMNAZIALĂ NR. 1 BOLINTIN-VALE",50,"ORAŞ BOLINTIN-VALE",101190,1,PART,PRCNCT,PRSD,PRSD_SV,"2025-05-18 21:59:05",1397,493,433,60,0,478,15,1534,1041,317,161
19,GIURGIU,"ŞCOALA GIMNAZIALĂ NR. 1 BOLINTIN-VALE",51,"ORAŞ BOLINTIN-VALE",101190,1,PART,PRCNCT,PRSD,PRSD_SV,"2025-05-18 22:05:16",1611,439,397,42,0,426,13,1771,1332,285,141
19,GIURGIU,"LICEU TEHNOLOGIC ”DIMITRIE BOLINTINEANU”",52,"ORAŞ BOLINTIN-VALE",101190,1,PART,PRCNCT,PRSD,PRSD_SV,"2025-05-18 21:52:02",892,699,510,187,2,688,11,979,280,307,381
19,GIURGIU,PRIMĂRIE,53,"ORAŞ BOLINTIN-VALE",101190,1,PART,PRCNCT,PRSD,PRSD_SV,"2025-05-18 21:58:41",1772,1024,853,170,1,1021,3,1948,924,465,556
19,GIURGIU,"GRĂDINIŢA CRIVINA",54,"ORAŞ BOLINTIN-VALE",101190,1,PART,PRCNCT,PRSD,PRSD_SV,"2025-05-18 21:44:27",727,464,372,92,0,463,1,800,336,303,160
19,GIURGIU,"ŞCOALA GIMNAZIALĂ NR. 1 MALU SPART",55,"ORAŞ BOLINTIN-VALE",101190,1,PART,PRCNCT,PRSD,PRSD_SV,"2025-05-18 21:41:54",1393,761,664,97,0,752,9,1530,769,473,279
19,GIURGIU,"ŞCOALA GIMNAZIALĂ NR. 1 MALU SPART",56,"ORAŞ BOLINTIN-VALE",101190,2,PART,PRCNCT,PRSD,PRSD_SV,"2025-05-19 01:23:54",1540,840,757,83,0,828,12,1691,851,539,289
19,GIURGIU,"LICEUL TEHNOLOGIC TIU DUMITRESCU",57,"ORAŞ MIHĂILEŞTI",104136,1,PART,PRCNCT,PRSD,PRSD_SV,"2025-05-18 21:48:04",1068,878,614,264,0,868,10,1173,295,448,420
19,GIURGIU,"LICEUL TEHNOLOGIC TIU DUMITRESCU",58,"ORAŞ MIHĂILEŞTI",104136,1,PART,PRCNCT,PRSD,PRSD_SV,"2025-05-18 22:03:48",850,696,478,218,0,691,5,935,239,418,273
19,GIURGIU,"LICEUL TEHNOLOGIC TIU DUMITRESCU",59,"ORAŞ MIHĂILEŞTI",104136,1,PART,PRCNCT,PRSD,PRSD_SV,"2025-05-18 21:52:42",922,675,514,161,0,671,4,1014,339,378,293
19,GIURGIU,"GRĂDINIȚA CU PROGRAM NORMAL NR 3",60,"ORAŞ MIHĂILEŞTI",104136,2,PART,PRCNCT,PRSD,PRSD_SV,"2025-05-19 00:45:15",1157,974,658,316,0,964,10,1271,297,618,346
19,GIURGIU,"ŞCOALA PRIMARĂ NR. 2 MIHĂILEŞTI-DRĂGĂNESCU",61,"ORAŞ MIHĂILEŞTI",104136,1,PART,PRCNCT,PRSD,PRSD_SV,"2025-05-18 21:38:23",355,296,206,90,0,293,3,390,94,170,123
19,GIURGIU,"ŞCOALA PRIMARĂ NR. 3 NOVACI",62,"ORAŞ MIHĂILEŞTI",104136,1,PART,PRCNCT,PRSD,PRSD_SV,"2025-05-18 21:55:01",877,581,408,173,0,569,12,965,384,365,204
19,GIURGIU,"ŞCOALA GIMNAZIALĂ NR. 1 POPEŞTI",63,"ORAŞ MIHĂILEŞTI",104136,1,PART,PRCNCT,PRSD,PRSD_SV,"2025-05-18 22:03:26",833,574,416,158,0,569,5,916,342,296,273
19,GIURGIU,"ŞCOALA GIMNAZIALĂ NR. 1 ADUNAŢII COPĂCENI",64,ADUNAŢII-COPĂCENI,100781,1,PART,PRCNCT,PRSD,PRSD_SV,"2025-05-18 21:56:19",1514,1008,760,247,1,996,12,1662,654,567,429
19,GIURGIU,"GRĂDINIŢA CU PROGRAM PRELUNGIT",65,ADUNAŢII-COPĂCENI,100781,1,PART,PRCNCT,PRSD,PRSD_SV,"2025-05-18 22:12:43",1133,855,630,225,0,842,13,1245,390,458,384
19,GIURGIU,"CENTRUL DE ASISTENŢĂ DUPĂ PROGRAMUL ŞCOLAR, DĂRĂŞTI-VLAŞCA",66,ADUNAŢII-COPĂCENI,100781,1,PART,PRCNCT,PRSD,PRSD_SV,"2025-05-18 22:07:43",1592,1027,693,333,1,1010,17,1751,724,530,480
19,GIURGIU,"GRĂDINIȚA CU PROGRAM NORMAL NR. 4 MOGOŞEŞTI",67,ADUNAŢII-COPĂCENI,100781,1,PART,PRCNCT,PRSD,PRSD_SV,"2025-05-18 21:43:53",375,346,230,116,0,342,4,412,66,201,141
19,GIURGIU,"GRĂDINIȚA CU PROGRAM NORMAL NR. 3 VARLAAM",68,ADUNAŢII-COPĂCENI,100781,1,PART,PRCNCT,PRSD,PRSD_SV,"2025-05-18 21:32:00",478,393,268,125,0,391,2,525,132,224,167
19,GIURGIU,"ŞCOALA GIMNAZIALA ”MARIN M. ȚICULESCU” BĂNEASA",69,BĂNEASA,101001,1,PART,PRCNCT,PRSD,PRSD_SV,"2025-05-18 21:38:00",1111,685,563,101,21,676,9,1218,533,437,239
19,GIURGIU,"ŞCOALA PIMARĂ NR.5 BĂNEASA",70,BĂNEASA,101001,1,PART,PRCNCT,PRSD,PRSD_SV,"2025-05-18 21:37:58",512,326,259,54,13,321,5,563,237,194,127
19,GIURGIU,"ŞCOALA PRIMARĂ NR.2 BĂNEASA",71,BĂNEASA,101001,1,PART,PRCNCT,PRSD,PRSD_SV,"2025-05-18 21:44:14",743,451,358,74,19,447,4,818,367,284,163
19,GIURGIU,"ŞCOALA PRIMARĂ NR. 3 FRASINU",72,BĂNEASA,101001,1,PART,PRCNCT,PRSD,PRSD_SV,"2025-05-18 21:29:33",320,254,156,84,14,252,2,352,98,138,114
19,GIURGIU,"ŞCOALA GIMNAZIALĂ ”REMUS BEGNESCU” PIETRELE",73,BĂNEASA,101001,1,PART,PRCNCT,PRSD,PRSD_SV,"2025-05-18 21:41:23",790,519,393,93,33,513,6,869,350,317,196
19,GIURGIU,"ŞCOALA PRIMARĂ NR. 6 SF. GHEORGHE",74,BĂNEASA,101001,1,PART,PRCNCT,PRSD,PRSD_SV,"2025-05-18 21:23:04",204,168,111,55,2,166,2,224,56,84,82
19,GIURGIU,"CĂMINUL CULTURAL BOLINTIN - DEAL",75,BOLINTIN-DEAL,101163,1,PART,PRCNCT,PRSD,PRSD_SV,"2025-05-18 22:27:55",1433,1046,709,329,8,1038,8,1575,529,545,493
19,GIURGIU,"ŞCOALA GIMNAZIALĂ BANU BALEANU",76,BOLINTIN-DEAL,101163,1,PART,PRCNCT,PRSD,PRSD_SV,"2025-05-18 22:18:36",1178,829,581,243,5,818,11,1295,466,429,389
19,GIURGIU,"GRĂDINIŢA DE COPII BOLINTIN - DEAL",77,BOLINTIN-DEAL,101163,1,PART,PRCNCT,PRSD,PRSD_SV,"2025-05-18 21:53:57",960,590,467,122,1,579,11,1050,460,336,243
19,GIURGIU,"ŞCOALA GIMNAZIALĂ NR. 2 MIHAI VODĂ",78,BOLINTIN-DEAL,101163,1,PART,PRCNCT,PRSD,PRSD_SV,"2025-05-18 22:28:48",1545,1100,839,261,0,1087,13,1697,597,550,537
19,GIURGIU,"ȘCOALA GIMNAZIALĂ NR. 1",79,BUCŞANI,101378,1,PART,PRCNCT,PRSD,PRSD_SV,"2025-05-18 21:51:06",759,546,429,110,7,542,4,834,288,249,293
19,GIURGIU,"ŞCOALA PRIMARĂ NR. 5",80,BUCŞANI,101378,1,PART,PRCNCT,PRSD,PRSD_SV,"2025-05-18 21:50:21",324,251,188,63,0,250,1,356,105,116,134
19,GIURGIU,"GRĂDINIȚA CU PROGRAM NORMAL NR. 6",81,BUCŞANI,101378,1,PART,PRCNCT,PRSD,PRSD_SV,"2025-05-18 21:45:07",362,296,219,77,0,296,0,398,102,135,161
19,GIURGIU,"ŞCOALA PRIMARĂ NR. 3",82,BUCŞANI,101378,1,PART,PRCNCT,PRSD,PRSD_SV,"2025-05-18 22:09:08",435,340,234,106,0,335,5,478,138,218,117
19,GIURGIU,"ŞCOALA PRIMARĂ NR. 4",83,BUCŞANI,101378,1,PART,PRCNCT,PRSD,PRSD_SV,"2025-05-18 21:31:55",258,207,147,60,0,207,0,283,76,112,95
19,GIURGIU,"ŞCOALA GIMNAZIALĂ NR. 2",84,BUCŞANI,101378,2,PART,PRCNCT,PRSD,PRSD_SV,"2025-05-19 12:47:45",540,500,330,145,25,498,2,594,92,199,299
19,GIURGIU,"CĂMINUL CULTURAL BULBUCATA",85,BULBUCATA,101519,1,PART,PRCNCT,PRSD,PRSD_SV,"2025-05-18 21:41:33",1081,936,578,355,3,932,4,1188,252,552,380
19,GIURGIU,"ŞCOALA GIMNAZIALA NR1 BUTURUGENI",86,BUTURUGENI,101617,1,PART,PRCNCT,PRSD,PRSD_SV,"2025-05-18 22:02:15",967,739,556,183,0,729,10,1048,309,459,270
19,GIURGIU,"CAMIN CULTURAL BUTURUGENI",87,BUTURUGENI,101617,1,PART,PRCNCT,PRSD,PRSD_SV,"2025-05-18 21:48:39",599,436,352,84,0,435,1,653,217,262,173
19,GIURGIU,"ŞCOALA GIMNAZIALA NR 2 PĂDURENI",88,BUTURUGENI,101617,1,PART,PRCNCT,PRSD,PRSD_SV,"2025-05-18 21:49:22",1178,775,624,151,0,765,10,1295,520,543,222
19,GIURGIU,"GRĂDINIŢA CU PROGRAM NORMAL NR. 4 POŞTA",89,BUTURUGENI,101617,1,PART,PRCNCT,PRSD,PRSD_SV,"2025-05-18 21:33:38",352,298,205,93,0,294,4,387,89,204,90
19,GIURGIU,"ŞCOALA VECHE CĂLUGĂRENI( MUZEU ).",90,CĂLUGĂRENI,101662,1,PART,PRCNCT,PRSD,PRSD_SV,"2025-05-18 22:15:38",1398,1365,740,625,0,1352,13,1536,171,766,586
19,GIURGIU,"GRADINITA BRĂNIŞTARI",91,CĂLUGĂRENI,101662,1,PART,PRCNCT,PRSD,PRSD_SV,"2025-05-18 21:54:01",538,534,257,277,0,526,8,591,57,326,200
19,GIURGIU,"CĂMINUL CULTURAL HULUBEŞTI",92,CĂLUGĂRENI,101662,1,PART,PRCNCT,PRSD,PRSD_SV,"2025-05-18 21:52:47",1210,737,586,151,0,731,6,1330,593,474,257
19,GIURGIU,"ŞCOALA GIMNAZIALA NR.3 UZUNU",93,CĂLUGĂRENI,101662,1,PART,PRCNCT,PRSD,PRSD_SV,"2025-05-18 22:07:42",1122,713,537,176,0,709,4,1233,520,494,215
19,GIURGIU,"CĂMINUL CULTURAL CLEJANI",94,CLEJANI,101984,2,PART,PRCNCT,PRSD,PRSD_SV,"2025-05-19 01:28:25",1330,1599,760,785,54,1589,10,1662,63,344,1245
19,GIURGIU,"GRĂDINIŢA CU PN NR.3 NEAJLOV",95,CLEJANI,101984,1,PART,PRCNCT,PRSD,PRSD_SV,"2025-05-18 22:55:53",1178,1319,779,488,52,1314,5,1354,35,216,1098
19,GIURGIU,"CĂMINUL CULTURAL",96,COLIBAŞI,102071,1,PART,PRCNCT,PRSD,PRSD_SV,"2025-05-18 22:02:40",817,649,529,76,44,645,4,898,249,295,350
19,GIURGIU,"ŞCOALA PRIMARA NR. 3 COLIBAŞI",97,COLIBAŞI,102071,1,PART,PRCNCT,PRSD,PRSD_SV,"2025-05-18 21:39:26",659,574,430,104,40,571,3,723,149,264,307
19,GIURGIU,"ŞCOALA GIMNAZIALA NR. 2 CÂMPURELU",98,COLIBAŞI,102071,1,PART,PRCNCT,PRSD,PRSD_SV,"2025-05-18 21:44:01",1045,768,571,146,51,754,14,1145,377,429,325
19,GIURGIU,"ȘCOALA GIMNAZIALĂ NR. 3 COMANA SALA NR. 1",99,COMANA,102106,1,PART,PRCNCT,PRSD,PRSD_SV,"2025-05-18 22:23:34",797,679,413,219,47,673,6,876,197,464,209
19,GIURGIU,"ȘCOALA GIMNAZIALĂ NR. 3 COMANA SALA NR. 2",100,COMANA,102106,1,PART,PRCNCT,PRSD,PRSD_SV,"2025-05-18 21:46:58",858,728,455,230,43,718,10,943,215,476,242
19,GIURGIU,"CAMIN CULTURAL SAT BUDENI",101,COMANA,102106,1,PART,PRCNCT,PRSD,PRSD_SV,"2025-05-18 21:55:24",598,503,311,176,16,494,9,657,154,343,151
19,GIURGIU,"ŞCOALA GIMNAZIALA NR. 3 FALASTOACA",102,COMANA,102106,1,PART,PRCNCT,PRSD,PRSD_SV,"2025-05-18 21:40:22",608,530,340,141,49,522,8,668,138,331,191
19,GIURGIU,"GRĂDINIŢA CU PROGRAM NORMAL GRĂDIŞTEA",103,COMANA,102106,1,PART,PRCNCT,PRSD,PRSD_SV,"2025-05-18 21:54:14",1083,795,543,182,70,784,11,1191,396,493,291
19,GIURGIU,"ŞCOALA GIMNAZIALA NR. 1 VLAD-TEPES, CORP B",104,COMANA,102106,1,PART,PRCNCT,PRSD,PRSD_SV,"2025-05-18 21:41:13",1222,811,547,176,88,805,6,1343,532,308,497
19,GIURGIU,"GRĂDINIŢA DE COPII COSOBA",105,COSOBA,179748,1,PART,PRCNCT,PRSD,PRSD_SV,"2025-05-18 21:41:47",1097,721,598,123,0,714,7,1205,484,469,245
19,GIURGIU,"GRĂDINIŢA DE COPII COSOBA",106,COSOBA,179748,1,PART,PRCNCT,PRSD,PRSD_SV,"2025-05-18 21:34:01",1112,696,588,108,0,684,12,1222,526,446,238
19,GIURGIU,"ŞCOALA GIMNAZIALĂ NICOLAE CREVEDIA",107,"CREVEDIA MARE",102348,1,PART,PRCNCT,PRSD,PRSD_SV,"2025-05-18 22:00:55",1186,793,632,161,0,790,3,1304,511,472,318
19,GIURGIU,"ŞCOALA GIMNAZIALĂ DUMITRU PĂTRAȘCU",108,"CREVEDIA MARE",102348,1,PART,PRCNCT,PRSD,PRSD_SV,"2025-05-18 21:51:45",1480,942,764,178,0,937,5,1625,683,510,427
19,GIURGIU,"ŞCOALA PRIMARĂ NR 1 DEALU",109,"CREVEDIA MARE",102348,1,PART,PRCNCT,PRSD,PRSD_SV,"2025-05-18 21:57:20",1090,549,484,65,0,547,2,1198,649,357,190
19,GIURGIU,"CAMIN CULTURAL",110,DAIA,102446,1,PART,PRCNCT,PRSD,PRSD_SV,"2025-05-18 21:33:17",487,420,276,144,0,415,5,535,115,257,158
19,GIURGIU,"PRIMĂRIA COMUNEI DAIA",111,DAIA,102446,1,PART,PRCNCT,PRSD,PRSD_SV,"2025-05-18 21:42:44",236,227,103,124,0,221,6,261,34,94,127
19,GIURGIU,"GRADINIŢA CU PROGRAM NORMAL NR.2 PLOPŞORU",112,DAIA,102446,1,PART,PRCNCT,PRSD,PRSD_SV,"2025-05-18 21:37:05",555,426,282,144,0,423,3,610,184,251,172
19,GIURGIU,"GRĂDINIŢA CU PROGRAM NORMAL NR.3 PLOPŞORU",113,DAIA,102446,1,PART,PRCNCT,PRSD,PRSD_SV,"2025-05-18 21:35:38",643,380,279,101,0,376,4,707,327,209,167
19,GIURGIU,"ŞCOALA GIMNAZIALĂ NR.2 STOENEŞTI",114,FLOREŞTI-STOENEŞTI,102794,1,PART,PRCNCT,PRSD,PRSD_SV,"2025-05-18 22:11:46",1579,973,796,177,0,964,9,1739,766,527,437
19,GIURGIU,"ŞCOALA GIMNAZIALĂ NR.1 FLOREŞTI",115,FLOREŞTI-STOENEŞTI,102794,1,PART,PRCNCT,PRSD,PRSD_SV,"2025-05-18 21:47:43",1127,666,572,94,0,657,9,1240,574,399,258
19,GIURGIU,"ŞCOALA GIMNAZIALĂ NR.1 FLOREŞTI",116,FLOREŞTI-STOENEŞTI,102794,1,PART,PRCNCT,PRSD,PRSD_SV,"2025-05-18 21:47:37",1001,628,518,110,0,621,7,1102,474,345,276
19,GIURGIU,"ŞCOALA GIMNAZIALĂ NR.1 FLOREŞTI",117,FLOREŞTI-STOENEŞTI,102794,1,PART,PRCNCT,PRSD,PRSD_SV,"2025-05-18 21:56:24",1161,742,652,89,1,736,6,1278,536,443,293
19,GIURGIU,"ŞCOALA GIMNAZIALĂ NR.3 PALANCA",118,FLOREŞTI-STOENEŞTI,102794,1,PART,PRCNCT,PRSD,PRSD_SV,"2025-05-18 21:54:12",1171,788,692,96,0,781,7,1289,501,358,423
19,GIURGIU,"ŞCOALA GIMNAZIALĂ NR.3 PALANCA",119,FLOREŞTI-STOENEŞTI,102794,1,PART,PRCNCT,PRSD,PRSD_SV,"2025-05-18 21:44:31",960,691,571,120,0,686,5,1056,365,336,350
19,GIURGIU,"CĂMINUL CULTURAL FRĂTEŞTI",120,FRĂTEŞTI,102909,1,PART,PRCNCT,PRSD,PRSD_SV,"2025-05-18 21:51:09",1327,661,525,116,20,652,9,1460,799,396,256
19,GIURGIU,"ŞCOALA GIMNAZIALA NR.2 LUNCA FRĂTEŞTI",121,FRĂTEŞTI,102909,1,PART,PRCNCT,PRSD,PRSD_SV,"2025-05-18 21:40:39",623,344,283,60,1,337,7,684,340,222,115
19,GIURGIU,"GRADINITA CU PROGRAM NORMAL NR 3 CETATEA",122,FRĂTEŞTI,102909,1,PART,PRCNCT,PRSD,PRSD_SV,"2025-05-18 21:48:47",396,249,178,65,6,245,4,435,186,154,91
19,GIURGIU,"GRADINITA CU PROGRAM NORMAL NR 4 CETATEA (BĂLĂNOAIA)",123,FRĂTEŞTI,102909,1,PART,PRCNCT,PRSD,PRSD_SV,"2025-05-18 21:51:23",226,201,103,98,0,198,3,249,48,103,95
19,GIURGIU,"CĂMINUL CULTURAL REMUŞ",124,FRĂTEŞTI,102909,2,PART,PRCNCT,PRSD,PRSD_SV,"2025-05-19 00:12:54",1665,1110,846,263,1,1098,12,1835,725,583,515
19,GIURGIU,"ȘCOALA GIMNAZIALA NR. 1 SAT GĂISENI , COM GĂISENI .",125,GĂISENI,103087,1,PART,PRCNCT,PRSD,PRSD_SV,"2025-05-18 21:55:19",990,563,481,78,4,556,7,1089,526,428,128
19,GIURGIU,"ȘCOALA GIMNAZIALA NR. 1 SAT GĂISENI , COM GĂISENI ,",126,GĂISENI,103087,1,PART,PRCNCT,PRSD,PRSD_SV,"2025-05-18 21:40:04",798,484,394,83,7,479,5,877,393,325,154
19,GIURGIU,"ȘCOALA PRIMARĂ NR. 3 SAT CĂRPENIȘU , COM GĂISENI",127,GĂISENI,103087,1,PART,PRCNCT,PRSD,PRSD_SV,"2025-05-18 21:51:21",673,482,360,99,23,474,8,740,258,287,187
19,GIURGIU,"ȘCOALA GIMNAZIALA NR. 2 , SAT CĂSCIOARELE COM GĂISENI",128,GĂISENI,103087,1,PART,PRCNCT,PRSD,PRSD_SV,"2025-05-18 21:46:41",891,471,402,64,5,462,9,980,509,316,146
19,GIURGIU,"ȘCOALA GIMNAZIALA NR. 2 SAT CĂSCIOARELE , COM GĂISENI",129,GĂISENI,103087,1,PART,PRCNCT,PRSD,PRSD_SV,"2025-05-18 21:48:00",712,403,341,57,5,398,5,783,380,264,134
19,GIURGIU,"FOSTA ŞCOALA CU CLASELE I-IV PODU POPA NAE",130,GĂISENI,103087,1,PART,PRCNCT,PRSD,PRSD_SV,"2025-05-18 21:27:24",121,97,71,26,0,96,1,133,36,69,27
19,GIURGIU,"ŞCOALA GIMNAZIALĂ ”DRĂGHICI DAVILA”",131,GĂUJANI,103194,1,PART,PRCNCT,PRSD,PRSD_SV,"2025-05-18 21:41:28",905,431,341,85,5,426,5,996,565,224,202
19,GIURGIU,"ŞCOALA DIN CETĂTUIA",132,GĂUJANI,103194,1,PART,PRCNCT,PRSD,PRSD_SV,"2025-05-18 21:28:24",145,101,57,42,2,101,0,159,58,65,36
19,GIURGIU,"GRĂDINIŢA CU PROGRAM NORMAL NR.1 PIETRIŞU",133,GĂUJANI,103194,1,PART,PRCNCT,PRSD,PRSD_SV,"2025-05-18 21:47:39",768,350,289,61,0,346,4,844,494,256,90
19,GIURGIU,"SCOALA GIMNAZIALA NR.1GHIMPATI",134,GHIMPAŢI,103238,1,PART,PRCNCT,PRSD,PRSD_SV,"2025-05-18 22:21:47",1172,704,503,125,76,703,1,1129,425,308,395
19,GIURGIU,"CLADIREA PRIMARIEI GHIMPATI",135,GHIMPAŢI,103238,1,PART,PRCNCT,PRSD,PRSD_SV,"2025-05-18 21:25:25",541,478,276,133,69,462,16,596,118,174,288
19,GIURGIU,"GRĂDINIŢA CU PROGRAM NORMAL NR.5 COPACIU",136,GHIMPAŢI,103238,1,PART,PRCNCT,PRSD,PRSD_SV,"2025-05-18 21:24:07",650,480,333,103,44,446,34,715,235,146,300
19,GIURGIU,"GRĂDINIȚA CU PROGRAM NORMAL CU 3 SĂLI DE GRUPĂ GHIMPAȚI",137,GHIMPAŢI,103238,1,PART,PRCNCT,PRSD,PRSD_SV,"2025-05-18 22:19:05",1191,955,609,260,86,933,22,1310,355,531,402
19,GIURGIU,"ŞCOALA PRIMARA NR.4 VALEA PLOPILOR",138,GHIMPAŢI,103238,1,PART,PRCNCT,PRSD,PRSD_SV,"2025-05-18 21:21:59",562,269,196,73,0,269,0,518,249,192,77
19,GIURGIU,"CĂMINUL CULTURAL GOGOŞARI",139,GOGOŞARI,103309,1,PART,PRCNCT,PRSD,PRSD_SV,"2025-05-18 21:53:48",561,477,279,195,3,474,3,617,140,203,271
19,GIURGIU,"FOSTA PRIMĂRIE",140,GOGOŞARI,103309,1,PART,PRCNCT,PRSD,PRSD_SV,"2025-05-18 21:20:25",84,98,55,41,2,97,1,142,44,33,64
19,GIURGIU,"DISPENSAR UMAN IZVORU",141,GOGOŞARI,103309,1,PART,PRCNCT,PRSD,PRSD_SV,"2025-05-18 21:49:36",490,295,237,52,6,295,0,539,244,135,160
19,GIURGIU,"FOSTA ŞCOALA RĂLEŞTI",142,GOGOŞARI,103309,1,PART,PRCNCT,PRSD,PRSD_SV,"2025-05-18 21:31:18",119,87,46,39,2,85,2,130,43,40,45
19,GIURGIU,"ŞCOALA GIMNAZIALĂ NR.1 GOSTINARI",143,GOSTINARI,103372,1,PART,PRCNCT,PRSD,PRSD_SV,"2025-05-18 22:06:59",1483,973,753,168,52,955,18,1631,658,647,308
19,GIURGIU,"ŞCOALA PRIMARĂ NR.3 MIRONEŞTI",144,GOSTINARI,103372,1,PART,PRCNCT,PRSD,PRSD_SV,"2025-05-18 21:38:11",304,293,143,131,19,290,3,334,41,172,118
19,GIURGIU,"SCOALA GIMNAZIALA ANGHEL MARES - LOCAL GRADINITA GOSTINU",145,GOSTINU,103354,1,PART,PRCNCT,PRSD,PRSD_SV,"2025-05-18 21:48:23",656,384,301,83,0,380,4,722,338,214,166
19,GIURGIU,"SCOALA GIMNAZIALA ANGHEL MARES- LOCAL GRADINITA GOSTINU",146,GOSTINU,103354,1,PART,PRCNCT,PRSD,PRSD_SV,"2025-05-18 21:55:47",729,418,334,84,0,411,7,803,385,241,170
19,GIURGIU,"ŞCOALA GIMNZIALA NR. 1 GRADINARI",147,GRĂDINARI,103407,1,PART,PRCNCT,PRSD,PRSD_SV,"2025-05-18 21:44:17",802,535,378,155,2,530,5,883,348,320,210
19,GIURGIU,"ŞCOALA GIMNAZIALA NR. 2 TÂNTAVA",148,GRĂDINARI,103407,1,PART,PRCNCT,PRSD,PRSD_SV,"2025-05-18 21:33:27",984,638,463,175,0,633,5,1082,444,360,273
19,GIURGIU,"ŞCOALA PRIMARA NR. 3 ZORILE",149,GRĂDINARI,103407,1,PART,PRCNCT,PRSD,PRSD_SV,"2025-05-18 21:50:42",870,577,465,112,0,571,6,957,380,375,196
19,GIURGIU,"ȘCOALA GIMNAZIALĂ NR.1 GREACA",150,GREACA,103470,1,PART,PRCNCT,PRSD,PRSD_SV,"2025-05-18 21:55:26",1224,847,631,209,7,839,8,1346,499,519,320
19,GIURGIU,"ŞCOALA PUŢU GRECI",151,GREACA,103470,1,PART,PRCNCT,PRSD,PRSD_SV,"2025-05-18 21:33:53",224,180,123,57,0,178,2,246,66,107,71
19,GIURGIU,"ŞCOALA ZBOIU",152,GREACA,103470,1,PART,PRCNCT,PRSD,PRSD_SV,"2025-05-18 21:33:34",208,104,87,17,0,104,0,228,124,66,38
19,GIURGIU,"ŞCOALA GIMNAZIALĂ ”ELINA BASARAB” HERĂŞTI",153,HERĂŞTI,179757,1,PART,PRCNCT,PRSD,PRSD_SV,"2025-05-18 22:00:33",1693,1017,806,210,1,1007,10,1862,845,581,426
19,GIURGIU,"LICEUL ”UDRISTE NASTUREL HOTARELE",154,HOTARELE,103639,1,PART,PRCNCT,PRSD,PRSD_SV,"2025-05-18 22:12:14",974,684,499,185,0,679,5,1069,385,415,264
19,GIURGIU,"SALA DE SPORT",155,HOTARELE,103639,2,PART,PRCNCT,PRSD,PRSD_SV,"2025-05-19 00:55:05",516,421,268,153,0,419,2,567,146,229,190
19,GIURGIU,"LICEUL ”UDRIŞTE NĂSTUREL”",156,HOTARELE,103639,1,PART,PRCNCT,PRSD,PRSD_SV,"2025-05-18 21:49:39",538,424,265,159,0,421,3,589,165,216,205
19,GIURGIU,"GRADINITA CU PROGRAM NORMAL NR. 3",157,HOTARELE,103639,1,PART,PRCNCT,PRSD,PRSD_SV,"2025-05-18 21:53:00",543,408,300,108,0,406,2,597,189,256,150
19,GIURGIU,"CĂMINUL CULTURAL IEPUREŞTI",158,IEPUREŞTI,103693,1,PART,PRCNCT,PRSD,PRSD_SV,"2025-05-18 21:52:56",757,787,431,343,13,781,6,833,46,314,467
19,GIURGIU,"GRADINITA CU PROGRAM NORMAL NR. 2 GORNENI",159,IEPUREŞTI,103693,1,PART,PRCNCT,PRSD,PRSD_SV,"2025-05-18 22:11:11",511,436,271,159,6,427,9,512,76,262,165
19,GIURGIU,"ŞCOALA STÂLPU",160,IEPUREŞTI,103693,1,PART,PRCNCT,PRSD,PRSD_SV,"2025-05-18 21:56:28",215,230,129,95,6,230,0,286,56,145,85
19,GIURGIU,"ŞCOALA GIMNAZIALĂ STOLNICUL CONSTANTIN CANTACUZINO - ISVOARELE",161,ISVOARELE,179766,1,PART,PRCNCT,PRSD,PRSD_SV,"2025-05-18 21:59:17",998,623,442,181,0,618,5,1097,474,366,252
19,GIURGIU,"ŞCOALA TEIUŞU",162,ISVOARELE,179766,1,PART,PRCNCT,PRSD,PRSD_SV,"2025-05-18 21:34:45",160,137,87,50,0,135,2,176,39,80,55
19,GIURGIU,"ŞCOALA GIMNAZIALA NR.1 IZVOARELE",163,IZVOARELE,103899,2,PART,PRCNCT,PRSD,PRSD_SV,"2025-05-19 00:11:48",917,646,430,113,103,639,7,1008,362,346,293
19,GIURGIU,"ŞCOALA GIMNAZIALA NR.2 CHIRIACU",164,IZVOARELE,103899,1,PART,PRCNCT,PRSD,PRSD_SV,"2025-05-18 22:21:34",951,689,464,129,96,685,4,997,308,396,289
19,GIURGIU,"SEDIUL FOSTEI SECŢII DE MECANIZARE A SATULUI DIMITRIE CANTEMIR",165,IZVOARELE,103899,1,PART,PRCNCT,PRSD,PRSD_SV,"2025-05-18 21:30:08",108,103,34,49,20,102,1,118,15,42,60
19,GIURGIU,"CLĂDIRE DE INTERES PUBLIC",166,IZVOARELE,103899,1,PART,PRCNCT,PRSD,PRSD_SV,"2025-05-18 21:11:19",51,95,25,63,7,94,1,106,11,32,62
19,GIURGIU,"ŞCOALA GENERALĂ RADU VODĂ",167,IZVOARELE,103899,1,PART,PRCNCT,PRSD,PRSD_SV,"2025-05-18 21:34:51",161,154,66,68,20,153,1,177,23,57,96
19,GIURGIU,"GRADINITA CU PROGRAM NORMAL NR.3 VALEA BUJORULUI",168,IZVOARELE,103899,1,PART,PRCNCT,PRSD,PRSD_SV,"2025-05-18 21:36:34",359,322,177,86,59,320,2,394,72,130,190
19,GIURGIU,"ȘCOALA GIMNAZIALĂ NR. 1 JOIȚA",169,JOIŢA,103997,1,PART,PRCNCT,PRSD,PRSD_SV,"2025-05-18 21:53:41",1880,1635,1009,626,0,1624,11,2069,434,760,864
19,GIURGIU,"ȘCOALA GIMNAZIALĂ NR. 2 BÎCU",170,JOIŢA,103997,2,PART,PRCNCT,PRSD,PRSD_SV,"2025-05-19 01:07:58",1509,1550,858,692,0,1537,13,1659,109,670,867
19,GIURGIU,"CĂMINUL CULTURAL LETCA NOUĂ",171,"LETCA NOUĂ",104047,1,PART,PRCNCT,PRSD,PRSD_SV,"2025-05-18 21:28:10",688,442,274,138,30,440,2,756,314,298,142
19,GIURGIU,"CĂMINUL CULTURAL LETCA VECHE",172,"LETCA NOUĂ",104047,1,PART,PRCNCT,PRSD,PRSD_SV,"2025-05-18 21:45:00",698,454,290,134,30,445,9,767,313,244,201
19,GIURGIU,"CĂMINUL CULTURAL MILCOVĂȚU",173,"LETCA NOUĂ",104047,1,PART,PRCNCT,PRSD,PRSD_SV,"2025-05-18 21:50:37",1099,710,536,121,53,705,5,1208,498,454,251
19,GIURGIU,"CĂMINUL CULTURAL MALU",174,MALU,179739,1,PART,PRCNCT,PRSD,PRSD_SV,"2025-05-18 21:34:25",829,462,368,92,2,454,8,911,449,265,189
19,GIURGIU,"ȘCOALĂ GIMNAZIALĂ IOAN BĂDILĂ MALU",175,MALU,179739,1,PART,PRCNCT,PRSD,PRSD_SV,"2025-05-18 21:55:39",836,484,395,89,0,476,8,920,436,260,216
19,GIURGIU,"ŞCOALA GIMNAZIALĂ NR. 1 MÂRŞA",176,MÂRŞA,104225,1,PART,PRCNCT,PRSD,PRSD_SV,"2025-05-18 21:48:20",945,550,458,92,0,548,2,1038,488,350,198
19,GIURGIU,"ŞCOALA GIMNAZIALĂ NR. 1 MÂRŞA",177,MÂRŞA,104225,1,PART,PRCNCT,PRSD,PRSD_SV,"2025-05-18 21:53:58",1152,646,558,88,0,645,1,1266,620,441,204
19,GIURGIU,"SCOALA GIMNAZIALA DUMITRU CONSTANTIN MIHAI BRAVU",178,"MIHAI BRAVU",104118,1,PART,PRCNCT,PRSD,PRSD_SV,"2025-05-18 21:44:02",1002,730,539,152,39,722,8,1102,372,440,282
19,GIURGIU,"SCOALA GIMNAZIALA DUMITRU CONSTANTIN MIHAI BRAVU",179,"MIHAI BRAVU",104118,1,PART,PRCNCT,PRSD,PRSD_SV,"2025-05-18 22:00:24",808,593,413,136,44,589,4,888,295,353,236
19,GIURGIU,"ŞCOALA GIMNAZIALA ” SFANTUL NECTARIE” OGREZENI",180,OGREZENI,104485,2,PART,PRCNCT,PRSD,PRSD_SV,"2025-05-19 00:49:35",958,627,486,138,3,620,7,1053,426,331,289
19,GIURGIU,"ŞCOALA GIMNAZIALA ” AUREL SOLACOLU” OGREZENI",181,OGREZENI,104485,2,PART,PRCNCT,PRSD,PRSD_SV,"2025-05-19 00:40:16",1232,747,583,164,0,739,8,1355,608,421,318
19,GIURGIU,"GRĂDINIŢA ” IRIS” OGREZENI",182,OGREZENI,104485,1,PART,PRCNCT,PRSD,PRSD_SV,"2025-05-18 21:35:14",797,534,410,122,2,530,4,876,342,262,268
19,GIURGIU,"ŞCOALA PRIMARA NR.1 HOBAIA",183,OGREZENI,104485,1,PART,PRCNCT,PRSD,PRSD_SV,"2025-05-18 21:42:52",709,436,351,84,1,432,4,781,345,257,175
19,GIURGIU,"CĂMINUL CULTURAL OINACU",184,OINACU,104519,1,PART,PRCNCT,PRSD,PRSD_SV,"2025-05-18 22:01:16",1320,867,638,174,55,863,4,1455,588,309,554
19,GIURGIU,"GRADINITA NR. 2 BRANISTEA",185,OINACU,104519,1,PART,PRCNCT,PRSD,PRSD_SV,"2025-05-18 22:29:26",758,596,419,141,36,593,3,834,238,162,431
19,GIURGIU,"GRADINITA NR. 3 COMASCA",186,OINACU,104519,1,PART,PRCNCT,PRSD,PRSD_SV,"2025-05-18 21:35:54",512,339,256,66,17,332,7,563,224,131,201
19,GIURGIU,"PRIMARIA COMUNEI PRUNDU",187,PRUNDU,104680,1,PART,PRCNCT,PRSD,PRSD_SV,"2025-05-18 21:42:07",1623,918,788,130,0,900,18,1785,867,587,313
19,GIURGIU,"ŞCOALA PRIMARĂ NR.1 PRUNDU",188,PRUNDU,104680,1,PART,PRCNCT,PRSD,PRSD_SV,"2025-05-18 21:36:37",1039,610,494,116,0,605,5,1142,532,393,212
19,GIURGIU,"ŞCOALA PRIMARĂ NR.1 PUIENI",189,PRUNDU,104680,1,PART,PRCNCT,PRSD,PRSD_SV,"2025-05-18 21:52:42",566,340,279,61,0,337,3,622,282,227,110
19,GIURGIU,"CASA DE CULTURĂ PUTINEIU",190,PUTINEIU,104715,1,PART,PRCNCT,PRSD,PRSD_SV,"2025-05-18 21:46:13",911,597,500,97,0,588,9,1003,406,316,272
19,GIURGIU,"ŞCOALA HODIVOAIA",191,PUTINEIU,104715,1,PART,PRCNCT,PRSD,PRSD_SV,"2025-05-18 21:32:18",305,217,146,71,0,214,3,335,118,109,105
19,GIURGIU,"ŞCOALA VIERU",192,PUTINEIU,104715,1,PART,PRCNCT,PRSD,PRSD_SV,"2025-05-18 21:35:49",533,365,268,97,0,363,2,536,171,242,121
19,GIURGIU,"ŞCOALA GIMNAZIALĂ ”CONSTANTIN STĂNCESCU”",193,RĂSUCENI,104788,1,PART,PRCNCT,PRSD,PRSD_SV,"2025-05-18 21:27:43",687,462,296,166,0,459,3,754,292,221,238
19,GIURGIU,"ŞCOALA GENERALĂ NR. 2 RĂSUCENI",194,RĂSUCENI,104788,1,PART,PRCNCT,PRSD,PRSD_SV,"2025-05-18 21:19:25",280,182,119,63,0,182,0,308,126,69,113
19,GIURGIU,"ŞCOALA GIMNAZIALĂ NR.1 CUCURUZU",195,RĂSUCENI,104788,1,PART,PRCNCT,PRSD,PRSD_SV,"2025-05-18 21:29:22",608,387,277,110,0,384,3,668,281,277,107
19,GIURGIU,"ȘCOALA GIMNAZIALĂ NR. 1 ROATA DE JOS",196,"ROATA DE JOS",104831,1,PART,PRCNCT,PRSD,PRSD_SV,"2025-05-18 21:59:14",900,474,418,56,0,471,3,992,518,297,174
19,GIURGIU,"ŞCOALA GIMNAZIALA NR. 1 ROATA DE JOS",197,"ROATA DE JOS",104831,1,PART,PRCNCT,PRSD,PRSD_SV,"2025-05-18 21:49:50",942,561,464,97,0,555,6,1037,476,359,196
19,GIURGIU,"GRĂDINIŢA CU PROGRAM NORMAL CARTOJANI",198,"ROATA DE JOS",104831,1,PART,PRCNCT,PRSD,PRSD_SV,"2025-05-18 22:07:16",737,416,360,56,0,414,2,810,394,242,172
19,GIURGIU,"ŞCOALA GIMNAZIALA NR. 2 CARTOJANI",199,"ROATA DE JOS",104831,1,PART,PRCNCT,PRSD,PRSD_SV,"2025-05-18 21:44:47",969,515,459,56,0,510,5,1067,552,328,182
19,GIURGIU,"ŞCOALA GIMNAZIALA NR. 2 CARTOJANI",200,"ROATA DE JOS",104831,1,PART,PRCNCT,PRSD,PRSD_SV,"2025-05-18 21:40:03",1058,551,490,61,0,547,4,1164,613,338,209
19,GIURGIU,"GRADINITA CU PROGRAM NORMAL NR. 1 ROATA MICA",201,"ROATA DE JOS",104831,1,PART,PRCNCT,PRSD,PRSD_SV,"2025-05-18 21:24:37",424,296,238,58,0,295,1,466,170,210,85
19,GIURGIU,"ŞCOALA PRIMARA NR. 2 SADINA",202,"ROATA DE JOS",104831,1,PART,PRCNCT,PRSD,PRSD_SV,"2025-05-18 21:59:15",1260,706,620,86,0,701,5,1386,680,528,173
19,GIURGIU,"ŞCOALA GIMNAZIALA NR. 1 SABARENI",203,SĂBĂRENI,179775,1,PART,PRCNCT,PRSD,PRSD_SV,"2025-05-18 21:55:47",1187,1174,699,462,13,1160,14,1307,133,500,660
19,GIURGIU,"ŞCOALA GIMNAZIALA NR. 1 SABARENI",204,SĂBĂRENI,179775,1,PART,PRCNCT,PRSD,PRSD_SV,"2025-05-18 21:49:03",1193,1117,656,446,15,1105,12,1313,196,522,583
19,GIURGIU,"ŞCOALA SCHITU",205,SCHITU,104975,1,PART,PRCNCT,PRSD,PRSD_SV,"2025-05-18 21:19:51",155,157,98,49,10,156,1,170,13,78,78
19,GIURGIU,"ŞCOALA PRIMARA FLORIN NICULESCU BILA",206,SCHITU,104975,2,PART,PRCNCT,PRSD,PRSD_SV,"2025-05-18 23:51:11",291,279,155,115,9,277,2,320,41,136,141
19,GIURGIU,"ŞCOALA PRIMARA , NR.1 CAMINEASCA",207,SCHITU,104975,1,PART,PRCNCT,PRSD,PRSD_SV,"2025-05-18 21:30:16",375,349,177,133,39,340,9,412,63,233,107
19,GIURGIU,"ŞCOALA GIMNAZIALA PROF. DINU NICOLAE VLASIN",208,SCHITU,104975,1,PART,PRCNCT,PRSD,PRSD_SV,"2025-05-18 21:30:01",334,292,183,91,18,289,3,368,76,168,121
19,GIURGIU,"PRIMARIA SINGURENI",209,SINGURENI,105106,1,PART,PRCNCT,PRSD,PRSD_SV,"2025-05-18 21:24:38",1043,622,404,164,54,617,5,1147,525,467,150
19,GIURGIU,"ŞCOALA PRIMARĂ NR.2 CRÎNGURI",210,SINGURENI,105106,1,PART,PRCNCT,PRSD,PRSD_SV,"2025-05-18 21:34:35",581,362,255,101,6,360,2,639,277,212,148
19,GIURGIU,"GRĂDINIŢA CU PROGRAM NORMAL NR. 3 STEJARU",211,SINGURENI,105106,1,PART,PRCNCT,PRSD,PRSD_SV,"2025-05-18 21:27:14",530,330,259,71,0,330,0,583,253,286,44
19,GIURGIU,"ŞCOALA GIMNAZIALĂ NR.1 SLOBOZIA",212,SLOBOZIA,100549,1,PART,PRCNCT,PRSD,PRSD_SV,"2025-05-18 21:30:56",753,495,331,164,0,490,5,828,333,283,207
19,GIURGIU,"GRĂDINIŢA DE COPII SLOBOZIA",213,SLOBOZIA,100549,1,PART,PRCNCT,PRSD,PRSD_SV,"2025-05-18 22:14:53",1102,590,504,85,1,584,6,1210,620,389,195
19,GIURGIU,"ȘCOALA GIMNAZIALĂ NR. 1 STĂNEȘTI",214,STĂNEŞTI,105295,1,PART,PRCNCT,PRSD,PRSD_SV,"2025-05-18 21:43:05",997,536,423,113,0,529,7,1100,564,363,166
19,GIURGIU,"GRĂDINIȚA CU PROGRAM NORMAL NR. 4 BĂLANU",215,STĂNEŞTI,105295,2,PART,PRCNCT,PRSD,PRSD_SV,"2025-05-18 22:50:33",455,337,194,143,0,329,8,501,164,209,120
19,GIURGIU,"ŞCOALA PRIMARĂ NR. 2 GHIZDARU",216,STĂNEŞTI,105295,1,PART,PRCNCT,PRSD,PRSD_SV,"2025-05-18 21:31:04",376,246,174,72,0,241,5,414,168,158,83
19,GIURGIU,"GRĂDINIȚA CU PROGRAM NORMAL NR. 3 ONCEŞTI",217,STĂNEŞTI,105295,1,PART,PRCNCT,PRSD,PRSD_SV,"2025-05-18 21:40:10",276,197,119,60,18,195,2,303,106,121,74
19,GIURGIU,"CĂMINUL CULTURAL STOENEŞTI",218,STOENEŞTI,105348,1,PART,PRCNCT,PRSD,PRSD_SV,"2025-05-18 22:02:15",801,612,421,143,48,610,2,881,269,417,193
19,GIURGIU,"GRĂDINIŢĂ CU PROGRAM NORMAL",219,STOENEŞTI,105348,1,PART,PRCNCT,PRSD,PRSD_SV,"2025-05-18 22:04:42",332,298,174,106,18,298,0,366,68,162,136
19,GIURGIU,"ŞCOALA CU CLASELE I-IV IANCULEŞTI",220,STOENEŞTI,105348,1,PART,PRCNCT,PRSD,PRSD_SV,"2025-05-18 22:00:56",215,181,147,26,8,181,0,236,55,135,46
19,GIURGIU,"ŞCOALA CU CLASELE I-IV MIRĂU",221,STOENEŞTI,105348,1,PART,PRCNCT,PRSD,PRSD_SV,"2025-05-18 21:22:31",117,106,60,41,5,105,1,129,23,69,36
19,GIURGIU,"ŞCOALA GIMNAZIALǍ ” PETRE ADAMEȘTEANU” TOPORU ( ŞCOALA VECHE)",222,TOPORU,154709,1,PART,PRCNCT,PRSD,PRSD_SV,"2025-05-18 21:58:21",855,601,369,134,98,586,15,940,339,282,304
19,GIURGIU,"ŞCOALA PRIMARA NR. 2 TOMULEŞTI",223,TOPORU,154709,1,PART,PRCNCT,PRSD,PRSD_SV,"2025-05-18 21:52:29",473,314,185,76,53,309,5,520,206,195,114
19,GIURGIU,"SCOALA PRIMARA NR.3 ULMI",224,ULMI,105623,1,PART,PRCNCT,PRSD,PRSD_SV,"2025-05-18 21:52:05",955,750,543,205,2,745,5,1050,300,415,330
19,GIURGIU,"GRĂDINIŢA ”MARIN MOGESCU”",225,ULMI,105623,1,PART,PRCNCT,PRSD,PRSD_SV,"2025-05-18 21:41:50",661,405,349,56,0,402,3,727,322,293,109
19,GIURGIU,"GRADINITA NR.4 GHIONEA",226,ULMI,105623,1,PART,PRCNCT,PRSD,PRSD_SV,"2025-05-18 21:39:37",467,365,255,110,0,363,2,513,148,206,157
19,GIURGIU,"SCOALA PRIMARA NR.2 ICOANA",227,ULMI,105623,1,PART,PRCNCT,PRSD,PRSD_SV,"2025-05-18 21:49:48",894,549,502,47,0,548,1,983,434,361,187
19,GIURGIU,"SCOALA GIMNAZIALA NR.1 POENARI",228,ULMI,105623,1,PART,PRCNCT,PRSD,PRSD_SV,"2025-05-18 21:50:26",1111,742,567,175,0,735,7,1222,480,366,369
19,GIURGIU,"SCOALA GIMNAZIALA ”NICOLAE LAHOVARY",229,ULMI,105623,1,PART,PRCNCT,PRSD,PRSD_SV,"2025-05-18 21:54:45",1005,593,502,91,0,589,4,1105,512,366,223
19,GIURGIU,"”SCOALA GIMNAZIALA ”NICOLAE LAHOVARY”",230,ULMI,105623,1,PART,PRCNCT,PRSD,PRSD_SV,"2025-05-18 22:24:49",940,534,428,105,1,532,2,1035,501,325,207
19,GIURGIU,"CAMINUL CULTURAL VALEA DRAGULUI",231,"VALEA DRAGULUI",105776,1,PART,PRCNCT,PRSD,PRSD_SV,"2025-05-18 22:09:35",1134,805,632,173,0,803,2,1246,441,467,336
19,GIURGIU,"FOSTA PRIMARIE CIOCOVENI VALEA DRAGULUI",232,"VALEA DRAGULUI",105776,1,PART,PRCNCT,PRSD,PRSD_SV,"2025-05-18 21:43:13",1023,612,486,126,0,605,7,1125,513,385,220
19,GIURGIU,"ȘCOALA GIMNAZIALĂ NR.1 VĂRĂȘTI",233,VĂRĂŞTI,105874,1,PART,PRCNCT,PRSD,PRSD_SV,"2025-05-18 21:35:19",911,608,486,122,0,601,7,1001,393,317,284
19,GIURGIU,"ŞCOALA GIMNAZIALĂ NR.1 VĂRĂŞTI",234,VĂRĂŞTI,105874,1,PART,PRCNCT,PRSD,PRSD_SV,"2025-05-18 22:00:38",816,576,447,129,0,571,5,897,321,314,257
19,GIURGIU,"ŞCOALA PRIMARĂ NR.3 OBEDENI",235,VĂRĂŞTI,105874,1,PART,PRCNCT,PRSD,PRSD_SV,"2025-05-18 22:19:57",860,607,480,127,0,601,6,943,336,347,254
19,GIURGIU,"ŞCOALA GIMNAZIALĂ NR.2 DOBRENI",236,VĂRĂŞTI,105874,1,PART,PRCNCT,PRSD,PRSD_SV,"2025-05-18 22:30:20",1967,1054,851,203,0,1037,17,2162,1108,695,342
19,GIURGIU,"ŞCOALA GIMNAZIALĂ NR. 1 VÂNĂTORII MICI",237,"VÂNĂTORII MICI",105972,1,PART,PRCNCT,PRSD,PRSD_SV,"2025-05-18 21:33:22",793,536,415,121,0,533,3,872,336,363,170
19,GIURGIU,"ŞCOALA PRIMARĂ NR.6 CORBEANCA",238,"VÂNĂTORII MICI",105972,2,PART,PRCNCT,PRSD,PRSD_SV,"2025-05-19 00:36:47",391,253,198,55,0,248,5,430,177,170,78
19,GIURGIU,"ŞCOALA PRIMARĂ NR.7 CUPELE",239,"VÂNĂTORII MICI",105972,1,PART,PRCNCT,PRSD,PRSD_SV,"2025-05-18 21:23:11",350,223,172,51,0,220,3,385,162,166,54
19,GIURGIU,"ŞCOALA GIMNAZIALĂ NR. 2 IZVORU",240,"VÂNĂTORII MICI",105972,1,PART,PRCNCT,PRSD,PRSD_SV,"2025-05-18 21:47:01",591,436,276,104,56,433,3,651,215,260,173
19,GIURGIU,"ŞCOALA PRIMARĂ NR.5 POIANA LUI STÂNGĂ",241,"VÂNĂTORII MICI",105972,1,PART,PRCNCT,PRSD,PRSD_SV,"2025-05-18 21:32:15",592,361,300,61,0,358,3,651,290,263,95
19,GIURGIU,"ŞCOALA GIMNAZIALĂ NR. 3 VÂNĂTORII MARI",242,"VÂNĂTORII MICI",105972,1,PART,PRCNCT,PRSD,PRSD_SV,"2025-05-18 21:44:31",879,559,447,112,0,554,5,968,409,395,159
19,GIURGIU,"ŞCOALA JAPCA",243,VEDEA,105909,1,PART,PRCNCT,PRSD,PRSD_SV,"2025-05-18 21:30:27",638,330,264,63,3,325,5,699,369,186,139
19,GIURGIU,"CĂMIN CULTURAL VEDEA",244,VEDEA,105909,1,PART,PRCNCT,PRSD,PRSD_SV,"2025-05-18 21:37:29",709,414,343,65,6,404,10,775,361,228,176
19,GIURGIU,"ŞCOALA GIMNAZIALA ”APOSTOL ARSACHE” VEDEA",245,VEDEA,105909,1,PART,PRCNCT,PRSD,PRSD_SV,"2025-05-18 21:46:05",742,385,300,81,4,382,3,816,431,180,202
20,GORJ,"UNIVERSITATEA „CONSTANTIN BRÂNCUȘI”",1,"MUNICIPIUL TÂRGU JIU",77812,1,PART,PRCNCT,PRSD,PRSD_SV,"2025-05-18 22:45:16",1578,971,756,171,44,954,17,1800,829,361,593
20,GORJ,"COLEGIUL NAȚIONAL TUDOR VLADIMIRESCU",2,"MUNICIPIUL TÂRGU JIU",77812,1,PART,PRCNCT,PRSD,PRSD_SV,"2025-05-18 21:47:26",1049,623,554,67,2,615,8,1100,477,212,403
20,GORJ,"COLEGIUL NAȚIONAL TUDOR VLADIMIRESCU",3,"MUNICIPIUL TÂRGU JIU",77812,1,PART,PRCNCT,PRSD,PRSD_SV,"2025-05-18 21:56:33",1168,603,565,38,0,598,5,1300,697,227,371
20,GORJ,"ŞCOALA GIMNAZIALĂ CONSTANTIN SĂVOIU",4,"MUNICIPIUL TÂRGU JIU",77812,1,PART,PRCNCT,PRSD,PRSD_SV,"2025-05-18 22:11:10",1009,638,504,134,0,625,13,1100,462,246,379
20,GORJ,"ŞCOALA GIMNAZIALĂ CONSTANTIN SĂVOIU",5,"MUNICIPIUL TÂRGU JIU",77812,2,PART,PRCNCT,PRSD,PRSD_SV,"2025-05-19 00:12:49",1049,589,504,85,0,579,10,1100,511,229,350
20,GORJ,"COLEGIUL TEHNIC NR.2",6,"MUNICIPIUL TÂRGU JIU",77812,1,PART,PRCNCT,PRSD,PRSD_SV,"2025-05-18 22:12:38",1338,696,611,85,0,685,11,1500,804,327,358
20,GORJ,"ŞCOALA GIMNAZIALĂ ALEXANDRU ŞTEFULESCU",7,"MUNICIPIUL TÂRGU JIU",77812,1,PART,PRCNCT,PRSD,PRSD_SV,"2025-05-18 22:32:13",1121,721,571,110,40,712,9,1200,479,291,421
20,GORJ,"UNIVERSITATEA CONSTANTIN BRÂNCUŞI",8,"MUNICIPIUL TÂRGU JIU",77812,1,PART,PRCNCT,PRSD,PRSD_SV,"2025-05-18 22:33:43",1637,977,898,79,0,956,21,1800,823,443,513
20,GORJ,"COLEGIUL NAȚIONAL SPIRU HARET",9,"MUNICIPIUL TÂRGU JIU",77812,1,PART,PRCNCT,PRSD,PRSD_SV,"2025-05-18 21:54:30",1024,554,496,58,0,546,8,1100,546,236,310
20,GORJ,"COLEGIUL NAŢIONAL SPIRU HARET",10,"MUNICIPIUL TÂRGU JIU",77812,1,PART,PRCNCT,PRSD,PRSD_SV,"2025-05-18 21:45:43",934,560,467,54,39,552,8,1100,540,234,318
20,GORJ,"COLEGIUL NAŢIONAL SPIRU HARET",11,"MUNICIPIUL TÂRGU JIU",77812,1,PART,PRCNCT,PRSD,PRSD_SV,"2025-05-18 21:46:54",1459,749,644,105,0,735,14,1600,851,364,371
20,GORJ,"COLEGIUL NAŢIONAL SPIRU HARET",12,"MUNICIPIUL TÂRGU JIU",77812,1,PART,PRCNCT,PRSD,PRSD_SV,"2025-05-18 21:41:17",1288,637,584,53,0,623,14,1400,763,369,254
20,GORJ,"COLEGIUL NAŢIONAL SPIRU HARET",13,"MUNICIPIUL TÂRGU JIU",77812,1,PART,PRCNCT,PRSD,PRSD_SV,"2025-05-18 22:19:57",1050,532,469,63,0,523,9,1100,568,293,230
20,GORJ,"PALATUL COPIILOR",14,"MUNICIPIUL TÂRGU JIU",77812,1,PART,PRCNCT,PRSD,PRSD_SV,"2025-05-18 22:55:14",989,606,494,110,2,599,7,1100,494,234,365
20,GORJ,"LICEUL TEOLOGIC",15,"MUNICIPIUL TÂRGU JIU",77812,1,PART,PRCNCT,PRSD,PRSD_SV,"2025-05-18 22:23:02",1386,781,675,104,2,765,16,1500,719,321,444
20,GORJ,"LICEUL TEOLOGIC",16,"MUNICIPIUL TÂRGU JIU",77812,1,PART,PRCNCT,PRSD,PRSD_SV,"2025-05-18 22:16:53",1309,613,487,98,28,606,7,1500,887,350,256
20,GORJ,"LICEUL TEOLOGIC",17,"MUNICIPIUL TÂRGU JIU",77812,1,PART,PRCNCT,PRSD,PRSD_SV,"2025-05-18 22:20:24",1272,647,584,35,28,634,13,1500,853,322,312
20,GORJ,"ŞCOALA GIMNAZIALĂ GHEORGHE TĂTĂRĂSCU",18,"MUNICIPIUL TÂRGU JIU",77812,1,PART,PRCNCT,PRSD,PRSD_SV,"2025-05-18 21:55:51",1379,690,611,78,1,673,17,1500,810,392,281
20,GORJ,"ŞCOALA GIMNAZIALĂ GHEORGHE TĂTĂRĂSCU",19,"MUNICIPIUL TÂRGU JIU",77812,1,PART,PRCNCT,PRSD,PRSD_SV,"2025-05-18 21:52:29",1375,721,684,37,0,712,9,1500,779,356,356
20,GORJ,"ŞCOALA GIMNAZIALĂ POMPILIU MARCEA",20,"MUNICIPIUL TÂRGU JIU",77812,1,PART,PRCNCT,PRSD,PRSD_SV,"2025-05-18 22:06:08",1525,654,572,82,0,640,14,1600,946,396,244
20,GORJ,"ŞCOALA GIMNAZIALĂ POMPILIU MARCEA",21,"MUNICIPIUL TÂRGU JIU",77812,1,PART,PRCNCT,PRSD,PRSD_SV,"2025-05-18 22:41:33",1582,798,714,84,0,785,13,1700,902,428,357
20,GORJ,"ŞCOALA GIMNAZIALĂ CONSTANTIN BRÂNCUŞI",22,"MUNICIPIUL TÂRGU JIU",77812,1,PART,PRCNCT,PRSD,PRSD_SV,"2025-05-18 22:03:42",1511,863,744,119,0,846,17,1600,737,402,444
20,GORJ,"ŞCOALA GIMNAZIALĂ CONSTANTIN BRÂNCUŞI",23,"MUNICIPIUL TÂRGU JIU",77812,3,PART,PRCNCT,PRSD,PRSD_SV,"2025-05-18 23:53:50",1496,694,641,53,0,683,11,1600,906,369,314
20,GORJ,"ŞCOALA GIMNAZIALĂ CONSTANTIN BRÂNCUŞI",24,"MUNICIPIUL TÂRGU JIU",77812,1,PART,PRCNCT,PRSD,PRSD_SV,"2025-05-18 21:33:40",1377,599,564,35,0,592,7,1500,901,303,289
20,GORJ,"ŞCOALA GIMNAZIALĂ CONSTANTIN BRÂNCUŞI",25,"MUNICIPIUL TÂRGU JIU",77812,1,PART,PRCNCT,PRSD,PRSD_SV,"2025-05-18 21:57:19",1384,562,525,37,0,555,7,1500,938,297,258
20,GORJ,"COLEGIUL NAȚIONAL ECATERINA TEODOROIU",26,"MUNICIPIUL TÂRGU JIU",77812,2,PART,PRCNCT,PRSD,PRSD_SV,"2025-05-19 00:32:54",1317,669,547,122,0,662,7,1400,731,297,365
20,GORJ,"COLEGIUL NAŢIONAL ECATERINA TEODOROIU",27,"MUNICIPIUL TÂRGU JIU",77812,1,PART,PRCNCT,PRSD,PRSD_SV,"2025-05-18 21:46:55",1436,630,563,67,0,625,5,1600,970,322,303
20,GORJ,"COLEGIUL NAŢIONAL ECATERINA TEODOROIU",28,"MUNICIPIUL TÂRGU JIU",77812,3,PART,PRCNCT,PRSD,PRSD_SV,"2025-05-18 23:27:42",1321,627,593,34,0,616,11,1400,773,294,322
20,GORJ,"LICEUL CU PROGRAM SPORTIV",29,"MUNICIPIUL TÂRGU JIU",77812,1,PART,PRCNCT,PRSD,PRSD_SV,"2025-05-18 22:10:07",1027,609,497,112,0,596,13,1100,491,285,311
20,GORJ,"LICEUL CU PROGRAM SPORTIV",30,"MUNICIPIUL TÂRGU JIU",77812,1,PART,PRCNCT,PRSD,PRSD_SV,"2025-05-18 22:06:53",897,464,397,67,0,459,5,1000,536,253,206
20,GORJ,"COLEGIUL ECONOMIC VIRGIL MADGEARU",31,"MUNICIPIUL TÂRGU JIU",77812,1,PART,PRCNCT,PRSD,PRSD_SV,"2025-05-18 21:58:55",1717,864,781,83,0,852,12,1800,936,514,338
20,GORJ,"COLEGIUL ECONOMIC VIRGIL MADGEARU",32,"MUNICIPIUL TÂRGU JIU",77812,1,PART,PRCNCT,PRSD,PRSD_SV,"2025-05-18 22:19:58",1544,976,890,86,0,961,15,1700,724,427,534
20,GORJ,"COLEGIUL ECONOMIC VIRGIL MADGEARU",33,"MUNICIPIUL TÂRGU JIU",77812,1,PART,PRCNCT,PRSD,PRSD_SV,"2025-05-18 22:21:33",1278,758,704,52,2,746,12,1400,642,287,459
20,GORJ,"LICEUL DE ARTE CONSTANTIN BRĂILOIU",34,"MUNICIPIUL TÂRGU JIU",77812,1,PART,PRCNCT,PRSD,PRSD_SV,"2025-05-18 21:49:35",1144,628,551,77,0,616,12,1200,572,235,381
20,GORJ,"LICEUL DE ARTE CONSTANTIN BRĂILOIU",35,"MUNICIPIUL TÂRGU JIU",77812,1,PART,PRCNCT,PRSD,PRSD_SV,"2025-05-18 21:54:25",1470,823,753,68,2,809,14,1600,777,320,489
20,GORJ,"LICEUL DE ARTE CONSTANTIN BRĂILOIU",36,"MUNICIPIUL TÂRGU JIU",77812,3,PART,PRCNCT,PRSD,PRSD_SV,"2025-05-18 23:48:51",1388,493,454,39,0,482,11,1500,1007,349,133
20,GORJ,"LICEUL DE ARTE CONSTANTIN BRĂILOIU",37,"MUNICIPIUL TÂRGU JIU",77812,1,PART,PRCNCT,PRSD,PRSD_SV,"2025-05-18 21:47:02",1135,577,540,37,0,568,9,1200,623,253,315
20,GORJ,"UNIVERSITATEA ”CONSTANTIN BRÂNCUȘI”-FACULTATEA DE ȘTIINȚE ALE EDUCAȚIEI, DREPT ȘI ADMINISTRAȚIE PUBLICĂ",38,"MUNICIPIUL TÂRGU JIU",77812,1,PART,PRCNCT,PRSD,PRSD_SV,"2025-05-18 22:02:47",885,575,400,164,11,569,6,1100,525,197,372
20,GORJ,"ŞCOALA GIMNAZIALĂ SFÂNTU NICOLAE",39,"MUNICIPIUL TÂRGU JIU",77812,1,PART,PRCNCT,PRSD,PRSD_SV,"2025-05-18 22:25:44",1481,977,787,83,107,954,23,1700,723,428,526
20,GORJ,"ŞCOALA GIMNAZIALĂ SFÂNTU NICOLAE",40,"MUNICIPIUL TÂRGU JIU",77812,1,PART,PRCNCT,PRSD,PRSD_SV,"2025-05-18 21:43:29",686,516,323,68,125,506,10,900,384,284,222
20,GORJ,"ŞCOALA GIMNAZIALĂ SFÂNTU NICOLAE",41,"MUNICIPIUL TÂRGU JIU",77812,1,PART,PRCNCT,PRSD,PRSD_SV,"2025-05-18 22:02:07",1167,773,614,62,97,754,19,1400,627,361,393
20,GORJ,"ŞCOALA GENERALĂ ECATERINA TEODOROIU",42,"MUNICIPIUL TÂRGU JIU",77812,1,PART,PRCNCT,PRSD,PRSD_SV,"2025-05-18 21:49:43",1339,717,607,110,0,704,13,1400,683,372,332
20,GORJ,"COLEGIUL TEHNIC ION MINCU",43,"MUNICIPIUL TÂRGU JIU",77812,1,PART,PRCNCT,PRSD,PRSD_SV,"2025-05-18 21:50:25",1232,587,554,33,0,574,13,1300,713,305,269
20,GORJ,"COLEGIUL TEHNIC ION MINCU",44,"MUNICIPIUL TÂRGU JIU",77812,1,PART,PRCNCT,PRSD,PRSD_SV,"2025-05-18 21:39:15",1138,555,498,57,0,547,8,1200,645,290,257
20,GORJ,"COLEGIUL TEHNIC GENERAL GHEORGHE MAGHERU",45,"MUNICIPIUL TÂRGU JIU",77812,1,PART,PRCNCT,PRSD,PRSD_SV,"2025-05-18 22:26:01",1654,649,602,47,0,638,11,1780,1131,420,218
20,GORJ,"COLEGIUL TEHNIC GENERAL GHEORGHE MAGHERU",46,"MUNICIPIUL TÂRGU JIU",77812,1,PART,PRCNCT,PRSD,PRSD_SV,"2025-05-18 22:03:37",1793,883,763,120,0,872,11,1900,1017,468,404
20,GORJ,"ŞCOALA GIMNAZIALĂ NR.7",47,"MUNICIPIUL TÂRGU JIU",77812,1,PART,PRCNCT,PRSD,PRSD_SV,"2025-05-18 22:13:53",1725,960,854,106,0,945,15,1900,940,492,453
20,GORJ,"ŞCOALA GIMNAZIALĂ NR.7",48,"MUNICIPIUL TÂRGU JIU",77812,1,PART,PRCNCT,PRSD,PRSD_SV,"2025-05-18 23:04:08",1695,871,828,43,0,862,9,1800,929,540,322
20,GORJ,"ŞCOALA GIMNAZIALĂ VOIEVOD LITOVOI",49,"MUNICIPIUL TÂRGU JIU",77812,1,PART,PRCNCT,PRSD,PRSD_SV,"2025-05-18 22:35:03",1601,939,851,87,1,926,13,1700,761,499,427
20,GORJ,"ŞCOALA GIMNAZIALĂ VOIEVOD LITOVOI",50,"MUNICIPIUL TÂRGU JIU",77812,1,PART,PRCNCT,PRSD,PRSD_SV,"2025-05-18 22:31:25",1683,923,885,36,2,914,9,1800,877,499,415
20,GORJ,"ŞCOALA GIMNAZIALĂ VOIEVOD LITOVOI",51,"MUNICIPIUL TÂRGU JIU",77812,1,PART,PRCNCT,PRSD,PRSD_SV,"2025-05-18 21:54:05",1479,746,684,62,0,738,8,1600,854,503,235
20,GORJ,"ŞCOALA GIMNAZIALĂ VOIEVOD LITOVOI",52,"MUNICIPIUL TÂRGU JIU",77812,1,PART,PRCNCT,PRSD,PRSD_SV,"2025-05-18 21:49:46",1397,746,706,40,0,738,8,1500,754,396,342
20,GORJ,"COLEGIUL TEHNIC HENRI COANDĂ",53,"MUNICIPIUL TÂRGU JIU",77812,1,PART,PRCNCT,PRSD,PRSD_SV,"2025-05-18 22:12:04",787,467,416,50,1,458,9,900,433,271,187
20,GORJ,"ŞCOALA GIMNAZIALĂ NR.9",54,"MUNICIPIUL TÂRGU JIU",77812,1,PART,PRCNCT,PRSD,PRSD_SV,"2025-05-18 22:42:24",1511,887,808,79,0,871,16,1600,713,472,399
20,GORJ,"ŞCOALA PRIMARĂ DIN LOCALITATEA COMPONENTĂ DRĂGOENI",55,"MUNICIPIUL TÂRGU JIU",77812,1,PART,PRCNCT,PRSD,PRSD_SV,"2025-05-18 22:33:22",1612,926,866,60,0,908,18,1800,874,481,427
20,GORJ,"IMOBIL NR.42",56,"MUNICIPIUL TÂRGU JIU",77812,1,PART,PRCNCT,PRSD,PRSD_SV,"2025-05-18 21:53:34",752,456,413,41,2,453,3,800,344,298,155
20,GORJ,"ȘCOALA PRIMARĂ DIN LOCALITATEA COMPONENTĂ ROMANEȘTI",57,"MUNICIPIUL TÂRGU JIU",77812,1,PART,PRCNCT,PRSD,PRSD_SV,"2025-05-18 22:08:42",810,422,395,27,0,412,10,900,478,233,179
20,GORJ,"ŞCOALA PRIMARĂ ŞI GRĂDINIŢA DE COPII URSAŢI",58,"MUNICIPIUL TÂRGU JIU",77812,1,PART,PRCNCT,PRSD,PRSD_SV,"2025-05-18 21:54:38",640,433,389,44,0,430,3,700,267,251,179
20,GORJ,"ŞCOALA GIMNAZIALĂ NR. 2 MOTRU",59,"MUNICIPIUL MOTRU",78141,1,PART,PRCNCT,PRSD,PRSD_SV,"2025-05-18 22:29:35",1357,660,587,73,0,654,6,1500,840,344,310
20,GORJ,"COLEGIUL TEHNIC MOTRU",60,"MUNICIPIUL MOTRU",78141,1,PART,PRCNCT,PRSD,PRSD_SV,"2025-05-18 22:01:33",929,467,421,46,0,459,8,1000,533,256,203
20,GORJ,"CASA DE CULTURĂ MOTRU",61,"MUNICIPIUL MOTRU",78141,1,PART,PRCNCT,PRSD,PRSD_SV,"2025-05-18 22:38:18",1591,738,654,84,0,727,11,1700,962,457,270
20,GORJ,"COLEGIUL NAŢIONAL GEORGE COŞBUC MOTRU",62,"MUNICIPIUL MOTRU",78141,1,PART,PRCNCT,PRSD,PRSD_SV,"2025-05-18 21:43:16",1390,579,527,51,1,569,10,1500,921,342,227
20,GORJ,"ŞCOALA GIMNAZIALĂ NR.1 MOTRU",63,"MUNICIPIUL MOTRU",78141,1,PART,PRCNCT,PRSD,PRSD_SV,"2025-05-18 22:12:38",1529,676,606,69,1,670,6,1700,1024,352,318
20,GORJ,"ȘCOALA SFÂNTUL IOAN",64,"MUNICIPIUL MOTRU",78141,1,PART,PRCNCT,PRSD,PRSD_SV,"2025-05-18 21:59:37",1087,470,440,28,2,465,5,1200,730,248,217
20,GORJ,"GRĂDINIŢA CATOLICĂ MOTRU",65,"MUNICIPIUL MOTRU",78141,1,PART,PRCNCT,PRSD,PRSD_SV,"2025-05-18 21:53:34",1520,687,615,72,0,680,7,1700,1013,441,239
20,GORJ,"GRĂDINIŢA CREŞĂ NR.1 MOTRU",66,"MUNICIPIUL MOTRU",78141,1,PART,PRCNCT,PRSD,PRSD_SV,"2025-05-18 22:44:48",1638,792,647,88,57,776,16,1800,1008,479,297
20,GORJ,"SEDIUL IMPOZITE ŞI TAXE LOCALE MOTRU",67,"MUNICIPIUL MOTRU",78141,1,PART,PRCNCT,PRSD,PRSD_SV,"2025-05-18 22:17:03",1527,728,609,119,0,719,9,1700,972,428,291
20,GORJ,"ȘCOALA GIMNAZIALĂ NR. 1 MOTRU",68,"MUNICIPIUL MOTRU",78141,1,PART,PRCNCT,PRSD,PRSD_SV,"2025-05-18 23:07:46",1535,656,598,58,0,645,11,1700,1044,375,270
20,GORJ,"ŞCOALA HORĂŞTI",69,"MUNICIPIUL MOTRU",78141,1,PART,PRCNCT,PRSD,PRSD_SV,"2025-05-18 21:40:10",366,196,175,21,0,194,2,400,204,119,75
20,GORJ,"ŞCOALA LEURDA",70,"MUNICIPIUL MOTRU",78141,1,PART,PRCNCT,PRSD,PRSD_SV,"2025-05-18 22:33:29",613,308,286,22,0,304,4,700,392,184,120
20,GORJ,"ŞCOALA PRIMARĂ PLOŞTINA",71,"MUNICIPIUL MOTRU",78141,1,PART,PRCNCT,PRSD,PRSD_SV,"2025-05-18 22:28:15",973,546,502,44,0,536,10,1000,454,317,219
20,GORJ,"ŞCOALA RÂPA",72,"MUNICIPIUL MOTRU",78141,1,PART,PRCNCT,PRSD,PRSD_SV,"2025-05-18 21:57:15",246,168,139,29,0,161,7,300,132,106,55
20,GORJ,"ŞCOALA PRIMARĂ ROŞIUŢA",73,"MUNICIPIUL MOTRU",78141,1,PART,PRCNCT,PRSD,PRSD_SV,"2025-05-18 22:34:30",421,277,239,38,0,275,2,500,223,201,74
20,GORJ,"SALA DE SPORT A ORAȘULUI",74,"ORAŞ BUMBEŞTI-JIU",79308,1,PART,PRCNCT,PRSD,PRSD_SV,"2025-05-18 22:10:40",931,532,405,96,31,526,6,1100,568,314,212
20,GORJ,"GRĂDINIȚA BUMBEȘTI-JIU",75,"ORAŞ BUMBEŞTI-JIU",79308,1,PART,PRCNCT,PRSD,PRSD_SV,"2025-05-18 21:53:17",1020,501,428,73,0,491,10,1100,599,288,203
20,GORJ,"ȘCOALA GIMNAZIALĂ NR.1 BUMBEȘTI-JIU",76,"ORAŞ BUMBEŞTI-JIU",79308,1,PART,PRCNCT,PRSD,PRSD_SV,"2025-05-18 21:38:24",1296,562,491,71,0,555,7,1300,738,299,256
20,GORJ,"ȘCOALA GIMNAZIALĂ NR.1 BUMBEȘTI-JIU",77,"ORAŞ BUMBEŞTI-JIU",79308,1,PART,PRCNCT,PRSD,PRSD_SV,"2025-05-18 21:33:18",856,408,353,55,0,401,7,900,492,229,172
20,GORJ,"LICEUL ”MIHAI VITEAZUL” BUMBEȘTI-JIU",78,"ORAŞ BUMBEŞTI-JIU",79308,1,PART,PRCNCT,PRSD,PRSD_SV,"2025-05-18 21:56:46",927,484,433,50,1,478,6,1000,516,281,197
20,GORJ,"ȘCOALA PRIMARĂ BUMBEȘTI-JIU",79,"ORAŞ BUMBEŞTI-JIU",79308,1,PART,PRCNCT,PRSD,PRSD_SV,"2025-05-18 21:55:04",847,496,434,62,0,489,7,900,404,263,226
20,GORJ,"ȘCOALA GIMNAZIALĂ CURTIȘOARA",80,"ORAŞ BUMBEŞTI-JIU",79308,1,PART,PRCNCT,PRSD,PRSD_SV,"2025-05-18 22:01:32",562,362,281,81,0,358,4,600,238,222,136
20,GORJ,"ȘCOALA PRIMARĂ TETILA",81,"ORAŞ BUMBEŞTI-JIU",79308,1,PART,PRCNCT,PRSD,PRSD_SV,"2025-05-18 21:40:49",1101,551,475,76,0,547,4,1200,649,394,153
20,GORJ,"ŞCOALA GIMNAZIALĂ NOVACI",82,"ORAŞ NOVACI",78258,1,PART,PRCNCT,PRSD,PRSD_SV,"2025-05-18 22:12:32",1604,1127,912,195,20,1120,7,1700,573,654,466
20,GORJ,"ȘCOALA GIMNAZIALĂ NOVACI",83,"ORAŞ NOVACI",78258,1,PART,PRCNCT,PRSD,PRSD_SV,"2025-05-18 22:18:19",1093,689,586,103,0,679,10,1300,611,402,277
20,GORJ,"GRĂDINIŢA BERCEŞTI",84,"ORAŞ NOVACI",78258,1,PART,PRCNCT,PRSD,PRSD_SV,"2025-05-18 21:34:29",500,310,277,33,0,309,1,600,290,186,123
20,GORJ,"ŞCOALA GIMNAZIALĂ POCIOVALIŞTEA",85,"ORAŞ NOVACI",78258,1,PART,PRCNCT,PRSD,PRSD_SV,"2025-05-18 21:48:43",1363,838,732,106,0,826,12,1500,662,494,332
20,GORJ,"ŞCOALA GIMNAZIALĂ NR. 1 ROVINARI",86,"ORAŞ ROVINARI",82895,1,PART,PRCNCT,PRSD,PRSD_SV,"2025-05-18 21:39:18",1274,552,510,42,0,543,9,1400,848,412,131
20,GORJ,"ŞCOALA GIMNAZIALĂ NR. 1 ROVINARI",87,"ORAŞ ROVINARI",82895,1,PART,PRCNCT,PRSD,PRSD_SV,"2025-05-18 21:57:39",1164,483,433,50,0,478,5,1300,817,364,114
20,GORJ,"ŞCOALA GIMNAZIALĂ NR. 3 ROVINARI",88,"ORAŞ ROVINARI",82895,1,PART,PRCNCT,PRSD,PRSD_SV,"2025-05-18 21:50:49",1294,591,550,41,0,584,7,1400,809,452,132
20,GORJ,"ŞCOALA GIMNAZIALĂ NR. 3 ROVINARI",89,"ORAŞ ROVINARI",82895,1,PART,PRCNCT,PRSD,PRSD_SV,"2025-05-18 21:58:11",1215,507,460,47,0,499,8,1300,793,365,134
20,GORJ,"COLEGIUL ”GHEORGHE TĂTĂRESCU” ROVINARI",90,"ORAŞ ROVINARI",82895,1,PART,PRCNCT,PRSD,PRSD_SV,"2025-05-18 21:57:48",1247,515,439,75,1,500,15,1300,785,371,129
20,GORJ,"COLEGIUL ”GHEORGHE TĂTĂRESCU” ROVINARI",91,"ORAŞ ROVINARI",82895,1,PART,PRCNCT,PRSD,PRSD_SV,"2025-05-18 21:54:38",1133,553,475,57,21,547,6,1300,747,380,167
20,GORJ,"GRĂDINIŢA NR. 3 ROVINARI",92,"ORAŞ ROVINARI",82895,1,PART,PRCNCT,PRSD,PRSD_SV,"2025-05-18 21:31:08",1223,540,510,30,0,536,4,1300,760,403,133
20,GORJ,"GRĂDINIȚA NR. 3 ROVINARI",93,"ORAŞ ROVINARI",82895,1,PART,PRCNCT,PRSD,PRSD_SV,"2025-05-18 21:46:55",1150,458,433,24,1,454,4,1300,842,335,119
20,GORJ,"GRĂDINIȚA CARTIER VÎRȚ",94,"ORAŞ ROVINARI",82895,1,PART,PRCNCT,PRSD,PRSD_SV,"2025-05-18 21:21:11",556,357,312,45,0,355,2,600,243,255,100
20,GORJ,"ŞCOALA GIMNAZIALĂ GEORGE USCĂTESCU",95,"ORAŞ TÂRGU CĂRBUNEŞTI",78329,1,PART,PRCNCT,PRSD,PRSD_SV,"2025-05-18 21:43:11",1283,682,498,184,0,677,5,1300,618,355,322
20,GORJ,"ȘCOALA GIMNAZIALĂ GEORGE USCĂTESCU",96,"ORAŞ TÂRGU CĂRBUNEŞTI",78329,4,PART,PRCNCT,PRSD,PRSD_SV,"2025-05-19 00:22:56",1227,588,506,42,40,581,7,1400,812,310,271
20,GORJ,"COLEGIU NAŢIONAL TUDOR ARGHEZI",97,"ORAŞ TÂRGU CĂRBUNEŞTI",78329,1,PART,PRCNCT,PRSD,PRSD_SV,"2025-05-18 22:11:22",1481,647,573,74,0,637,10,1600,953,348,289
20,GORJ,"CĂMIN CULTURAL",98,"ORAŞ TÂRGU CĂRBUNEŞTI",78329,1,PART,PRCNCT,PRSD,PRSD_SV,"2025-05-18 21:33:21",544,266,234,32,0,262,4,600,334,138,124
20,GORJ,"ŞCOALA PRIMARĂ COJANI",99,"ORAŞ TÂRGU CĂRBUNEŞTI",78329,1,PART,PRCNCT,PRSD,PRSD_SV,"2025-05-18 21:30:58",363,233,197,36,0,231,2,400,167,161,70
20,GORJ,"ŞCOALA GIMNAZIALĂ CREŢEŞTI",100,"ORAŞ TÂRGU CĂRBUNEŞTI",78329,1,PART,PRCNCT,PRSD,PRSD_SV,"2025-05-18 21:59:03",703,348,315,33,0,344,4,800,452,248,96
20,GORJ,"ŞCOALA GIMNAZIALĂ POJOGENI",101,"ORAŞ TÂRGU CĂRBUNEŞTI",78329,1,PART,PRCNCT,PRSD,PRSD_SV,"2025-05-18 21:44:33",577,338,252,86,0,337,1,600,262,166,171
20,GORJ,"ŞCOALA PRIMARĂ POJOGENI CERĂT",102,"ORAŞ TÂRGU CĂRBUNEŞTI",78329,1,PART,PRCNCT,PRSD,PRSD_SV,"2025-05-18 21:33:58",246,144,100,43,1,143,1,300,156,94,49
20,GORJ,"ŞCOALA PRIMARĂ ŞTEFĂNEŞTI",103,"ORAŞ TÂRGU CĂRBUNEŞTI",78329,1,PART,PRCNCT,PRSD,PRSD_SV,"2025-05-18 21:31:53",429,220,183,36,1,220,0,500,280,141,79
20,GORJ,"GRĂDINIȚA CU PROGRAM NORMAL TISMANA",104,"ORAŞ TISMANA",82430,1,PART,PRCNCT,PRSD,PRSD_SV,"2025-05-18 21:37:07",713,443,341,102,0,437,6,800,357,237,200
20,GORJ,"GRĂDINIȚA CU PROGRAM NORMAL TISMANA",105,"ORAŞ TISMANA",82430,1,PART,PRCNCT,PRSD,PRSD_SV,"2025-05-18 21:50:20",1035,510,437,73,0,503,7,1100,590,318,185
20,GORJ,"ȘCOALA GENERALĂ CELEI",106,"ORAŞ TISMANA",82430,1,PART,PRCNCT,PRSD,PRSD_SV,"2025-05-18 21:34:19",688,356,282,74,0,355,1,800,444,223,132
20,GORJ,"ȘCOALA GENERALĂ COSTENI",107,"ORAŞ TISMANA",82430,1,PART,PRCNCT,PRSD,PRSD_SV,"2025-05-18 21:54:35",844,505,402,103,0,495,10,900,395,343,152
20,GORJ,"ȘCOALA GENERALĂ POCRUIA",108,"ORAŞ TISMANA",82430,1,PART,PRCNCT,PRSD,PRSD_SV,"2025-05-18 21:41:36",821,519,425,94,0,513,6,900,381,339,174
20,GORJ,"ȘCOALA GENERALĂ SOHODOL",109,"ORAŞ TISMANA",82430,1,PART,PRCNCT,PRSD,PRSD_SV,"2025-05-18 21:44:31",676,325,285,40,0,323,2,700,375,213,110
20,GORJ,"ȘCOALA GENERALĂ TOPEȘTI",110,"ORAŞ TISMANA",82430,1,PART,PRCNCT,PRSD,PRSD_SV,"2025-05-18 21:52:44",851,522,438,83,1,518,4,900,378,325,193
20,GORJ,"LICEUL TEHNOLOGIC TURCENI-CLĂDIREA INTERNAT",111,"ORAŞ TURCENI",82617,1,PART,PRCNCT,PRSD,PRSD_SV,"2025-05-18 21:59:41",1455,827,729,96,2,821,6,1600,773,476,345
20,GORJ,"LICEUL TEHNOLOGIC TURCENI-CLĂDIREA INTERNAT",112,"ORAŞ TURCENI",82617,1,PART,PRCNCT,PRSD,PRSD_SV,"2025-05-18 21:32:50",1414,685,606,47,32,682,3,1700,1015,457,225
20,GORJ,"POLIȚIA LOCALĂ TURCENI",113,"ORAŞ TURCENI",82617,1,PART,PRCNCT,PRSD,PRSD_SV,"2025-05-18 21:57:20",581,335,291,44,0,332,3,600,265,203,129
20,GORJ,"ȘCOALA GENERALĂ STOLOJANI",114,"ORAŞ TURCENI",82617,1,PART,PRCNCT,PRSD,PRSD_SV,"2025-05-18 21:39:06",533,329,297,32,0,327,2,600,271,226,101
20,GORJ,"ȘCOALA GENERALĂ GÂRBOVU",115,"ORAŞ TURCENI",82617,1,PART,PRCNCT,PRSD,PRSD_SV,"2025-05-18 21:48:25",706,415,373,42,0,410,5,800,385,289,121
20,GORJ,"ȘCOALA GENERALĂ MURGEȘTI",116,"ORAŞ TURCENI",82617,1,PART,PRCNCT,PRSD,PRSD_SV,"2025-05-18 21:42:33",599,351,334,17,0,348,3,600,249,228,120
20,GORJ,"ȘCOALA GENERALĂ STRÂMBA JIU",117,"ORAŞ TURCENI",82617,1,PART,PRCNCT,PRSD,PRSD_SV,"2025-05-18 22:03:36",1175,623,553,70,0,621,2,1300,677,465,156
20,GORJ,"GRĂDINIȚA NR. 2 TUNȘI",118,"ORAŞ ŢICLENI",78454,1,PART,PRCNCT,PRSD,PRSD_SV,"2025-05-18 22:09:06",756,446,404,41,1,439,7,800,354,275,164
20,GORJ,"ȘCOALA GIMNAZIALĂ NR. 1 ȚICLENI",119,"ORAŞ ŢICLENI",78454,1,PART,PRCNCT,PRSD,PRSD_SV,"2025-05-18 21:47:57",985,562,499,63,0,555,7,1100,538,284,271
20,GORJ,"ȘCOALA GIMNAZIALĂ NR. 1 ȚICLENI",120,"ORAŞ ŢICLENI",78454,1,PART,PRCNCT,PRSD,PRSD_SV,"2025-05-18 21:39:32",898,473,426,47,0,471,2,1000,527,310,161
20,GORJ,"GRĂDINIȚA NR. 3 RĂȘINA",121,"ORAŞ ŢICLENI",78454,1,PART,PRCNCT,PRSD,PRSD_SV,"2025-05-18 21:58:06",1148,532,500,32,0,529,3,1300,768,364,165
20,GORJ,"ȘCOALA GIMNAZIALĂ ALBENI",122,ALBENI,78472,1,PART,PRCNCT,PRSD,PRSD_SV,"2025-05-18 22:02:20",958,504,411,90,3,500,4,1100,596,355,145
20,GORJ,"ȘCOALA PRIMARÂ ALBENI",123,ALBENI,78472,1,PART,PRCNCT,PRSD,PRSD_SV,"2025-05-18 21:23:39",798,329,287,41,1,325,4,900,571,286,39
20,GORJ,"ȘCOALA PRIMARÂ BOLBOCEȘTI",124,ALBENI,78472,1,PART,PRCNCT,PRSD,PRSD_SV,"2025-05-18 21:35:42",410,207,178,29,0,205,2,500,293,126,79
20,GORJ,"ȘCOALA PRIMARÂ PRUNEȘTI",125,ALBENI,78472,1,PART,PRCNCT,PRSD,PRSD_SV,"2025-05-18 21:34:46",88,48,31,17,0,48,0,100,52,37,11
20,GORJ,"ŞCOALA GIMNAZIALĂ ALIMPEŞTI",126,ALIMPEŞTI,78542,1,PART,PRCNCT,PRSD,PRSD_SV,"2025-05-18 22:12:58",839,486,392,94,0,482,4,900,414,275,207
20,GORJ,"ŞCOALA PRIMARĂ SÎRBEŞTI",127,ALIMPEŞTI,78542,1,PART,PRCNCT,PRSD,PRSD_SV,"2025-05-18 22:07:38",589,366,282,84,0,363,3,600,234,206,157
20,GORJ,"ŞCOALA GIMNAZIALĂ ANINOASA",128,ANINOASA,78604,1,PART,PRCNCT,PRSD,PRSD_SV,"2025-05-18 21:33:18",1119,533,431,99,3,529,4,1200,667,299,230
20,GORJ,"ŞCOALA PRIMARĂ COSTEȘTI",129,ANINOASA,78604,2,PART,PRCNCT,PRSD,PRSD_SV,"2025-05-19 01:20:27",778,360,310,50,0,356,4,900,540,265,91
20,GORJ,"ŞCOALA GIMNAZIALĂ GROȘEREA",130,ANINOASA,78604,1,PART,PRCNCT,PRSD,PRSD_SV,"2025-05-18 22:03:22",484,290,213,77,0,288,2,500,210,211,77
20,GORJ,"ŞCOALA PRIMARĂ NR.2 STERPOAIA",131,ANINOASA,78604,1,PART,PRCNCT,PRSD,PRSD_SV,"2025-05-18 22:02:17",677,346,295,51,0,343,3,700,354,248,95
20,GORJ,"CĂMIN CULTURAL",132,ARCANI,78668,1,PART,PRCNCT,PRSD,PRSD_SV,"2025-05-18 22:53:57",1175,883,616,222,45,872,11,1300,417,394,478
20,GORJ,"ŞCOALA GENERALĂ BAIA DE FIER",133,"BAIA DE FIER",78711,1,PART,PRCNCT,PRSD,PRSD_SV,"2025-05-18 21:53:22",1381,794,667,127,0,789,5,1500,706,470,319
20,GORJ,"ŞCOALA GENERALĂ BAIA DE FIER",134,"BAIA DE FIER",78711,1,PART,PRCNCT,PRSD,PRSD_SV,"2025-05-18 22:08:09",1413,785,678,107,0,773,12,1600,815,509,264
20,GORJ,"ŞCOALA GENERALĂ CERNĂDIA",135,"BAIA DE FIER",78711,1,PART,PRCNCT,PRSD,PRSD_SV,"2025-05-18 21:56:06",626,376,336,40,0,372,4,700,324,253,119
20,GORJ,"PRIMĂRIA COMUNEI BĂLĂNEȘTI",136,BĂLĂNEŞTI,78748,1,PART,PRCNCT,PRSD,PRSD_SV,"2025-05-18 22:07:24",480,360,260,100,0,357,3,500,140,217,140
20,GORJ,"ȘCOALA PRIMARĂ BĂLANEȘTI",137,BĂLĂNEŞTI,78748,1,PART,PRCNCT,PRSD,PRSD_SV,"2025-05-18 21:47:03",657,433,346,87,0,429,4,700,267,285,144
20,GORJ,"ȘCOALA PRIMARĂ GLODENI",138,BĂLĂNEŞTI,78748,1,PART,PRCNCT,PRSD,PRSD_SV,"2025-05-18 21:45:56",632,399,328,71,0,395,4,700,301,229,166
20,GORJ,"CĂMIN CULTURAL BĂLEŞTI",139,BĂLEŞTI,77910,1,PART,PRCNCT,PRSD,PRSD_SV,"2025-05-18 23:19:30",1756,1034,939,93,2,1020,14,1900,866,601,419
20,GORJ,"ŞCOALA GIMNAZIALĂ ”ANTONIE MOGOŞ”",140,BĂLEŞTI,77910,1,PART,PRCNCT,PRSD,PRSD_SV,"2025-05-18 21:42:30",1884,1102,995,107,0,1090,12,2100,998,669,421
20,GORJ,"ŞCOALA GIMNAZIALĂ CORNEŞTI",141,BĂLEŞTI,77910,1,PART,PRCNCT,PRSD,PRSD_SV,"2025-05-18 22:19:25",799,485,404,79,2,479,6,900,415,333,146
20,GORJ,"CĂMIN CULTURAL RASOVA",142,BĂLEŞTI,77910,1,PART,PRCNCT,PRSD,PRSD_SV,"2025-05-18 22:10:53",430,287,236,51,0,283,4,500,213,163,120
20,GORJ,"CĂMIN CULTURAL STOLOJANI",143,BĂLEŞTI,77910,1,PART,PRCNCT,PRSD,PRSD_SV,"2025-05-18 21:40:16",560,388,276,105,7,385,3,600,212,244,141
20,GORJ,"ŞCOALA PRIMARĂ TĂLPĂŞEŞTI",144,BĂLEŞTI,77910,1,PART,PRCNCT,PRSD,PRSD_SV,"2025-05-18 21:41:15",503,289,241,48,0,288,1,600,311,184,104
20,GORJ,"ŞCOALA PRIMARĂ TĂMĂŞEŞTI",145,BĂLEŞTI,77910,1,PART,PRCNCT,PRSD,PRSD_SV,"2025-05-18 21:21:50",557,350,300,49,1,343,7,600,250,218,125
20,GORJ,"ŞCOALA GIMNAZIALĂ BĂRBĂTEŞTI",146,BĂRBĂTEŞTI,78828,1,PART,PRCNCT,PRSD,PRSD_SV,"2025-05-18 21:44:55",664,349,290,59,0,345,4,700,351,197,148
20,GORJ,"ŞCOALA PRIMARĂ PETREŞTI",147,BĂRBĂTEŞTI,78828,1,PART,PRCNCT,PRSD,PRSD_SV,"2025-05-18 21:40:22",611,345,275,69,1,338,7,700,355,216,122
20,GORJ,"ȘCOALA PRIMARĂ DINKĂ SKELERU",148,BÂLTENI,79004,1,PART,PRCNCT,PRSD,PRSD_SV,"2025-05-18 22:40:41",1563,801,719,81,1,793,8,1700,899,520,273
20,GORJ,"ŞCOALA PRIMARĂ COCORENI",149,BÂLTENI,79004,1,PART,PRCNCT,PRSD,PRSD_SV,"2025-05-18 22:28:57",1051,586,522,64,0,586,0,1202,616,402,184
20,GORJ,"ŞCOALA GENERALĂ MOI",150,BÂLTENI,79004,1,PART,PRCNCT,PRSD,PRSD_SV,"2025-05-18 22:40:01",855,515,445,70,0,512,3,900,385,366,146
20,GORJ,"ŞCOALA PRIMARĂ NR.2 PEŞTEANA-JIU",151,BÂLTENI,79004,1,PART,PRCNCT,PRSD,PRSD_SV,"2025-05-18 22:28:17",1712,844,761,82,1,835,9,1900,1056,570,265
20,GORJ,"ȘCOALA PRIMARĂ VLĂDULENI",152,BÂLTENI,79004,1,PART,PRCNCT,PRSD,PRSD_SV,"2025-05-18 22:06:01",862,482,442,39,1,477,5,1000,518,309,168
20,GORJ,"ȘCOALA GIMNAZIALĂ BENGEȘTI NR. 1",153,BENGEŞTI-CIOCADIA,78873,1,PART,PRCNCT,PRSD,PRSD_SV,"2025-05-18 21:42:25",961,399,336,62,1,396,3,1100,701,269,127
20,GORJ,"CĂMIN CULTURAL BENGEŞTI",154,BENGEŞTI-CIOCADIA,78873,1,PART,PRCNCT,PRSD,PRSD_SV,"2025-05-18 21:23:06",280,178,131,47,0,177,1,300,122,118,59
20,GORJ,"CĂMIN CULTURAL BĂLCEŞTI",155,BENGEŞTI-CIOCADIA,78873,1,PART,PRCNCT,PRSD,PRSD_SV,"2025-05-18 21:36:43",605,396,320,76,0,389,7,700,304,255,134
20,GORJ,"ȘCOALA PRIMARĂ CIOCADIA",156,BENGEŞTI-CIOCADIA,78873,1,PART,PRCNCT,PRSD,PRSD_SV,"2025-05-18 21:22:17",689,365,291,74,0,358,7,800,435,248,110
20,GORJ,"CĂMINUL CULTURAL SCRADA",157,BERLEŞTI,78926,1,PART,PRCNCT,PRSD,PRSD_SV,"2025-05-18 21:34:57",455,239,184,55,0,235,4,500,261,165,70
20,GORJ,"SALA DE EDUCAȚIE FIZICĂ ȘCOLARĂ",158,BERLEŞTI,78926,1,PART,PRCNCT,PRSD,PRSD_SV,"2025-05-18 21:51:10",585,274,237,37,0,272,2,600,326,172,100
20,GORJ,"CĂMINUL CULTURAL PÂRÂU VIU",159,BERLEŞTI,78926,1,PART,PRCNCT,PRSD,PRSD_SV,"2025-05-18 21:37:51",573,324,257,67,0,322,2,600,276,194,128
20,GORJ,"ŞCOALA PRIMARĂ BOLBOŞI",160,BOLBOŞI,79077,1,PART,PRCNCT,PRSD,PRSD_SV,"2025-05-18 21:48:18",875,491,432,59,0,491,0,1000,509,382,109
20,GORJ,"ŞCOALA PRIMARĂ BĂLĂCEŞTI",161,BOLBOŞI,79077,1,PART,PRCNCT,PRSD,PRSD_SV,"2025-05-18 21:36:08",530,291,261,30,0,291,0,600,309,227,64
20,GORJ,"ŞCOALA GENERALĂ VALEA",162,BOLBOŞI,79077,1,PART,PRCNCT,PRSD,PRSD_SV,"2025-05-18 21:36:18",1107,432,396,36,0,431,1,1200,768,351,80
20,GORJ,"ŞCOALA GENERALĂ CU CLASELE I-IV BORĂSCU",163,BORĂSCU,79157,1,PART,PRCNCT,PRSD,PRSD_SV,"2025-05-18 21:57:33",895,444,389,55,0,437,7,1000,556,331,106
20,GORJ,"ŞCOALA GENERALĂ CALAPĂRU",164,BORĂSCU,79157,1,PART,PRCNCT,PRSD,PRSD_SV,"2025-05-18 21:30:19",624,319,272,47,0,319,0,700,381,204,115
20,GORJ,"ŞCOALA GENERALĂ CU CLASELE I-IV MENŢII DIN DOS",165,BORĂSCU,79157,1,PART,PRCNCT,PRSD,PRSD_SV,"2025-05-18 21:35:58",536,285,258,27,0,278,7,600,315,226,52
20,GORJ,"ŞCOALA GIMNAZIALĂ MILUTA",166,BORĂSCU,79157,1,PART,PRCNCT,PRSD,PRSD_SV,"2025-05-18 21:51:46",455,185,153,32,0,184,1,500,315,144,40
20,GORJ,"ȘCOALA PRIMARĂ BRĂNEȘTI",167,BRĂNEŞTI,79237,1,PART,PRCNCT,PRSD,PRSD_SV,"2025-05-18 21:38:20",550,342,269,73,0,340,2,600,258,216,124
20,GORJ,"ȘCOALA PRIMARĂ BĂDEȘTI",168,BRĂNEŞTI,79237,1,PART,PRCNCT,PRSD,PRSD_SV,"2025-05-18 21:55:01",180,94,67,26,1,92,2,200,106,57,35
20,GORJ,"ȘCOALA GIMNAZIALĂ CAPU-DEALULUI",169,BRĂNEŞTI,79237,1,PART,PRCNCT,PRSD,PRSD_SV,"2025-05-18 21:41:13",618,354,280,74,0,352,2,700,346,270,82
20,GORJ,"ȘCOALA PRIMARĂ GILORTU",170,BRĂNEŞTI,79237,1,PART,PRCNCT,PRSD,PRSD_SV,"2025-05-18 21:37:49",467,175,152,22,1,175,0,500,325,99,76
20,GORJ,"CĂMINUL CULTURAL BUMBEŞTI-PIŢIC",171,BUMBEŞTI-PIŢIC,79362,1,PART,PRCNCT,PRSD,PRSD_SV,"2025-05-18 21:42:02",975,631,485,142,4,624,7,1100,469,346,278
20,GORJ,"SEDIU ADMINISTRATIV",172,BUMBEŞTI-PIŢIC,79362,1,PART,PRCNCT,PRSD,PRSD_SV,"2025-05-18 21:37:31",172,150,81,69,0,148,2,200,50,76,72
20,GORJ,"ŞCOALA GENERALĂ POIENARI",173,BUMBEŞTI-PIŢIC,79362,1,PART,PRCNCT,PRSD,PRSD_SV,"2025-05-18 21:42:20",549,341,277,64,0,338,3,600,259,167,171
20,GORJ,"LICEUL TEHNOLOGIC BUSTUCHIN",174,BUSTUCHIN,79406,1,PART,PRCNCT,PRSD,PRSD_SV,"2025-05-18 21:57:31",907,484,404,77,3,483,1,1000,516,283,200
20,GORJ,"ŞCOALA GENERALĂ POIANA-SECIURI",175,BUSTUCHIN,79406,1,PART,PRCNCT,PRSD,PRSD_SV,"2025-05-18 21:37:44",686,340,299,40,1,340,0,800,460,256,84
20,GORJ,"ŞCOALA PRIMARĂ POIENIŢA",176,BUSTUCHIN,79406,1,PART,PRCNCT,PRSD,PRSD_SV,"2025-05-18 21:27:27",302,163,138,21,4,161,2,300,137,96,65
20,GORJ,"ŞCOALA PRIMARĂ POJARU",177,BUSTUCHIN,79406,2,PART,PRCNCT,PRSD,PRSD_SV,"2025-05-19 01:04:21",386,195,153,41,1,195,0,400,205,155,40
20,GORJ,"ŞCOALA PRIMARĂ VALEA POJARULUI",178,BUSTUCHIN,79406,1,PART,PRCNCT,PRSD,PRSD_SV,"2025-05-18 21:56:27",333,189,154,35,0,188,1,400,211,135,53
20,GORJ,"ŞCOALA GIMNAZIALĂ CĂPRENI",179,CĂPRENI,79497,1,PART,PRCNCT,PRSD,PRSD_SV,"2025-05-18 21:46:56",751,412,318,94,0,404,8,800,388,267,137
20,GORJ,"ŞCOALA PRIMARĂ BULBUCENI",180,CĂPRENI,79497,1,PART,PRCNCT,PRSD,PRSD_SV,"2025-05-18 21:36:44",359,185,141,43,1,184,1,400,215,147,37
20,GORJ,"ŞCOALA PRIMARĂ CĂPRENI DE SUS",181,CĂPRENI,79497,1,PART,PRCNCT,PRSD,PRSD_SV,"2025-05-18 21:42:58",486,256,211,43,2,254,2,500,244,161,93
20,GORJ,"ȘCOALA PRIMARĂ DEALU VIILOR",182,CĂTUNELE,79585,1,PART,PRCNCT,PRSD,PRSD_SV,"2025-05-18 21:42:48",503,341,248,93,0,335,6,600,259,233,102
20,GORJ,"ȘCOALA LUPOAIA",183,CĂTUNELE,79585,1,PART,PRCNCT,PRSD,PRSD_SV,"2025-05-18 21:41:31",743,419,384,35,0,414,5,800,381,285,129
20,GORJ,"ȘCOALA GIMNAZIALĂ ”MAZILU VIPIE GHEORGHE”",184,CĂTUNELE,79585,3,PART,PRCNCT,PRSD,PRSD_SV,"2025-05-18 23:30:42",327,202,173,29,0,198,4,400,198,148,50
20,GORJ,"GRĂDINIȚA VALEA PERILOR",185,CĂTUNELE,79585,1,PART,PRCNCT,PRSD,PRSD_SV,"2025-05-18 21:23:14",553,305,268,37,0,301,4,600,295,204,97
20,GORJ,"CĂMINUL CULTURAL CÎLNIC",186,CÂLNIC,79736,1,PART,PRCNCT,PRSD,PRSD_SV,"2025-05-18 22:11:39",679,515,381,125,9,511,4,700,185,332,179
20,GORJ,"ŞCOALA PRIMARĂ CÎLNICU DE SUS",187,CÂLNIC,79736,1,PART,PRCNCT,PRSD,PRSD_SV,"2025-05-18 21:28:39",676,319,262,47,10,314,5,700,381,207,107
20,GORJ,"ŞCOALA PRIMARĂ HODOREASCA",188,CÂLNIC,79736,1,PART,PRCNCT,PRSD,PRSD_SV,"2025-05-18 21:27:39",304,218,178,36,4,215,3,300,82,142,73
20,GORJ,"ŞCOALA PRIMARĂ PINOASA",189,CÂLNIC,79736,1,PART,PRCNCT,PRSD,PRSD_SV,"2025-05-18 21:20:58",153,116,77,39,0,115,1,200,84,74,41
20,GORJ,"CĂMINUL CULTURAL CIUPERCENI",190,CIUPERCENI,79656,1,PART,PRCNCT,PRSD,PRSD_SV,"2025-05-18 21:33:04",394,321,220,101,0,318,3,400,79,200,118
20,GORJ,"CĂMINUL CULTURAL PEŞTEANA-VULCAN",191,CIUPERCENI,79656,1,PART,PRCNCT,PRSD,PRSD_SV,"2025-05-18 21:32:52",252,201,129,72,0,200,1,300,99,142,58
20,GORJ,"ŞCOALA PRIMARĂ STRÎMBA VULCAN",192,CIUPERCENI,79656,1,PART,PRCNCT,PRSD,PRSD_SV,"2025-05-18 21:43:20",312,207,143,64,0,204,3,300,93,132,72
20,GORJ,"CĂMINUL CULTURAL VÂRTOPU",193,CIUPERCENI,79656,1,PART,PRCNCT,PRSD,PRSD_SV,"2025-05-18 21:46:41",327,242,181,61,0,240,2,400,158,143,97
20,GORJ,"CĂMINUL CULTURAL ANINIŞ",194,CRASNA,79834,1,PART,PRCNCT,PRSD,PRSD_SV,"2025-05-18 21:39:30",766,491,422,69,0,488,3,800,309,280,208
20,GORJ,"CĂMINUL CULTURAL CĂRPINIŞ",195,CRASNA,79834,1,PART,PRCNCT,PRSD,PRSD_SV,"2025-05-18 22:49:11",1521,969,807,162,0,958,11,1700,731,538,420
20,GORJ,"ŞCOALA PRIMARĂ DRĂGOIEŞTI",196,CRASNA,79834,1,PART,PRCNCT,PRSD,PRSD_SV,"2025-05-18 22:27:30",1005,600,512,88,0,595,5,1100,500,412,183
20,GORJ,"CĂMINUL CULTURAL DUMBRĂVENI",197,CRASNA,79834,1,PART,PRCNCT,PRSD,PRSD_SV,"2025-05-18 21:31:14",655,405,329,76,0,400,5,700,295,255,145
20,GORJ,"ȘCOALA PRIMARĂ CRUȘEȚ",198,CRUŞEŢ,79932,1,PART,PRCNCT,PRSD,PRSD_SV,"2025-05-18 23:28:58",1358,715,581,133,1,711,4,1500,785,480,231
20,GORJ,"CĂMINUL CULTURAL MĂIAG",199,CRUŞEŢ,79932,1,PART,PRCNCT,PRSD,PRSD_SV,"2025-05-18 22:09:27",626,277,219,58,0,275,2,700,423,201,74
20,GORJ,"CĂMINUL CULTURAL SLĂVUȚA",200,CRUŞEŢ,79932,1,PART,PRCNCT,PRSD,PRSD_SV,"2025-05-18 22:18:32",479,252,188,64,0,251,1,500,248,151,100
20,GORJ,"ŞCOALA PRIMARĂ HĂLĂNGEȘTI",201,DĂNCIULEŞTI,80043,1,PART,PRCNCT,PRSD,PRSD_SV,"2025-05-18 22:06:33",614,367,254,112,1,366,1,700,333,213,153
20,GORJ,"ȘCOALA GIMNAZIALĂ OBÂRȘIA",202,DĂNCIULEŞTI,80043,1,PART,PRCNCT,PRSD,PRSD_SV,"2025-05-18 21:54:53",437,248,188,59,1,248,0,500,252,156,92
20,GORJ,"ŞCOALA GIMNAZIALĂ ”CORNELIUS RADU” RĂDINEŞTI",203,DĂNCIULEŞTI,80043,1,PART,PRCNCT,PRSD,PRSD_SV,"2025-05-18 21:39:16",427,285,213,71,1,283,2,500,215,168,115
20,GORJ,"ŞCOALA PRIMARĂ DĂNEȘTI",204,DĂNEŞTI,80123,1,PART,PRCNCT,PRSD,PRSD_SV,"2025-05-18 21:54:35",1157,628,537,91,0,626,2,1300,672,405,221
20,GORJ,"ŞCOALA PRIMARĂ BRĂTUIA",205,DĂNEŞTI,80123,1,PART,PRCNCT,PRSD,PRSD_SV,"2025-05-18 21:51:33",747,411,330,81,0,407,4,800,389,287,120
20,GORJ,"ŞCOALA PRIMARĂ ȘASA",206,DĂNEŞTI,80123,1,PART,PRCNCT,PRSD,PRSD_SV,"2025-05-18 21:42:16",594,391,291,100,0,384,7,700,309,232,152
20,GORJ,"ŞCOALA PRIMARĂ VĂCAREA",207,DĂNEŞTI,80123,1,PART,PRCNCT,PRSD,PRSD_SV,"2025-05-18 21:57:54",763,476,390,86,0,472,4,800,324,333,139
20,GORJ,"CĂMINUL CULTURAL ”MIHAI EMINESCU”",208,DRĂGOTEŞTI,80249,1,PART,PRCNCT,PRSD,PRSD_SV,"2025-05-18 21:33:01",911,476,436,40,0,475,1,1000,524,358,117
20,GORJ,"ȘCOALA GENERALĂ COROBĂI",209,DRĂGOTEŞTI,80249,3,PART,PRCNCT,PRSD,PRSD_SV,"2025-05-19 00:58:28",1069,554,519,35,0,547,7,1200,646,434,113
20,GORJ,"ȘCOALA GENERALĂ DRĂGUȚEȘTI",210,DRĂGUŢEŞTI,78016,1,PART,PRCNCT,PRSD,PRSD_SV,"2025-05-18 21:37:29",854,537,448,0,89,532,5,900,363,321,211
20,GORJ,"ȘCOALA GENERALĂ CÎRBEȘTI",211,DRĂGUŢEŞTI,78016,1,PART,PRCNCT,PRSD,PRSD_SV,"2025-05-18 22:40:53",1225,694,638,56,0,683,11,1400,706,455,228
20,GORJ,"ȘCOALA PRIMARĂ IAȘI-GORJ",212,DRĂGUŢEŞTI,78016,1,PART,PRCNCT,PRSD,PRSD_SV,"2025-05-18 21:28:32",831,550,474,73,3,541,9,900,350,300,241
20,GORJ,"ȘCOALA PRIMARĂ TÎLVEȘTI",213,DRĂGUŢEŞTI,78016,1,PART,PRCNCT,PRSD,PRSD_SV,"2025-05-18 22:31:00",530,334,278,56,0,327,7,600,266,223,104
20,GORJ,"ȘCOALA GENERALĂ URECHEȘTI",214,DRĂGUŢEŞTI,78016,1,PART,PRCNCT,PRSD,PRSD_SV,"2025-05-18 21:51:14",786,449,394,54,1,445,4,900,451,296,149
20,GORJ,"ŞCOALA PRIMARĂ FĂRCĂŞEŞTI",215,FĂRCĂŞEŞTI,80285,1,PART,PRCNCT,PRSD,PRSD_SV,"2025-05-18 21:25:45",600,364,306,57,1,364,0,700,336,290,74
20,GORJ,"GRĂDINIȚA PEȘTEANA DE JOS",216,FĂRCĂŞEŞTI,80285,1,PART,PRCNCT,PRSD,PRSD_SV,"2025-05-18 21:42:39",638,437,380,57,0,433,4,700,263,311,122
20,GORJ,"LICEU ROŞIA JIU",217,FĂRCĂŞEŞTI,80285,1,PART,PRCNCT,PRSD,PRSD_SV,"2025-05-18 21:26:32",594,342,309,33,0,339,3,700,358,264,75
20,GORJ,"ŞCOALA PRIMARĂ TIMIŞENI",218,FĂRCĂŞEŞTI,80285,1,PART,PRCNCT,PRSD,PRSD_SV,"2025-05-18 21:15:14",90,75,43,32,0,75,0,100,25,54,21
20,GORJ,"ȘCOALA GENERALĂ VICTOR POPESCU",219,FĂRCĂŞEŞTI,80285,1,PART,PRCNCT,PRSD,PRSD_SV,"2025-05-18 21:20:59",635,414,363,51,0,411,3,700,286,324,87
20,GORJ,"PRIMARIA GLOGOVA",220,GLOGOVA,80365,1,PART,PRCNCT,PRSD,PRSD_SV,"2025-05-18 21:50:42",502,335,245,90,0,333,2,600,265,240,93
20,GORJ,"ŞCOALA GIMNAZIALĂ PROF. NICOLAE CARANDA",221,GLOGOVA,80365,1,PART,PRCNCT,PRSD,PRSD_SV,"2025-05-18 21:38:19",566,314,239,75,0,307,7,600,286,230,77
20,GORJ,"ŞCOALA PRIMARĂ OLTEANU",222,GLOGOVA,80365,1,PART,PRCNCT,PRSD,PRSD_SV,"2025-05-18 21:28:36",463,262,229,33,0,260,2,500,238,201,59
20,GORJ,"PRIMĂRIA GODINEŞTI",223,GODINEŞTI,80427,1,PART,PRCNCT,PRSD,PRSD_SV,"2025-05-18 21:54:55",877,521,416,104,1,512,9,1000,479,322,190
20,GORJ,"ŞCOALA CÎLCEŞTI",224,GODINEŞTI,80427,1,PART,PRCNCT,PRSD,PRSD_SV,"2025-05-18 21:37:55",235,172,102,70,0,171,1,300,128,101,70
20,GORJ,"ŞCOALA PRIMARĂ PÎRÎU DE PRIPOR",225,GODINEŞTI,80427,1,PART,PRCNCT,PRSD,PRSD_SV,"2025-05-18 21:52:04",334,204,187,17,0,200,4,400,196,112,88
20,GORJ,"ȘCOALA PÎRÎU DE VALE",226,GODINEŞTI,80427,1,PART,PRCNCT,PRSD,PRSD_SV,"2025-05-18 21:26:34",169,140,80,60,0,138,2,200,60,96,42
20,GORJ,"ŞCOALA GENERALĂ HUREZANI",227,HUREZANI,80506,1,PART,PRCNCT,PRSD,PRSD_SV,"2025-05-18 22:40:04",1115,559,430,129,0,551,8,1200,641,353,198
20,GORJ,"ŞCOALA PRIMARĂ PLOPU",228,HUREZANI,80506,1,PART,PRCNCT,PRSD,PRSD_SV,"2025-05-18 21:33:25",136,97,57,40,0,96,1,200,103,45,51
20,GORJ,"ȘCOALA GIMNAZIALĂ IONEȘTI",229,IONEŞTI,80560,1,PART,PRCNCT,PRSD,PRSD_SV,"2025-05-18 21:44:26",927,511,450,61,0,507,4,1000,489,361,146
20,GORJ,"GRĂDINIȚA GURA ȘUȘIȚEI",230,IONEŞTI,80560,1,PART,PRCNCT,PRSD,PRSD_SV,"2025-05-18 21:43:29",495,254,208,46,0,253,1,500,246,176,77
20,GORJ,"ȘCOALA PRIMARĂ ILIEȘTI",231,IONEŞTI,80560,1,PART,PRCNCT,PRSD,PRSD_SV,"2025-05-18 21:36:02",424,275,226,49,0,273,2,500,225,198,75
20,GORJ,"ŞCOALA GIMNAZIALĂ ȘI GRĂDINIȚA JUPÂNEȘTI",232,JUPÂNEŞTI,80613,1,PART,PRCNCT,PRSD,PRSD_SV,"2025-05-18 21:24:10",276,132,89,43,0,132,0,300,168,94,38
20,GORJ,"CĂMIN CULTURAL JUPÎNEŞTI",233,JUPÂNEŞTI,80613,1,PART,PRCNCT,PRSD,PRSD_SV,"2025-05-18 21:37:59",514,272,227,45,0,267,5,600,328,145,122
20,GORJ,"ŞCOALA PRIMARĂ VIDIN",234,JUPÂNEŞTI,80613,1,PART,PRCNCT,PRSD,PRSD_SV,"2025-05-18 21:18:32",195,116,88,28,0,113,3,200,84,71,42
20,GORJ,"SCOALA PRIMARĂ VIERŞANI",235,JUPÂNEŞTI,80613,2,PART,PRCNCT,PRSD,PRSD_SV,"2025-05-18 23:29:28",623,325,228,97,0,324,1,700,375,208,116
20,GORJ,"ȘCOALA GENERALA ”ION GRIGOROIU” LELEȘTI",236,LELEŞTI,80677,1,PART,PRCNCT,PRSD,PRSD_SV,"2025-05-18 22:45:40",1014,681,546,132,3,676,5,1100,419,386,290
20,GORJ,"CĂMINUL CULTURAL FRĂTEȘTI",237,LELEŞTI,80677,1,PART,PRCNCT,PRSD,PRSD_SV,"2025-05-18 21:25:59",291,239,168,71,0,237,2,300,61,145,92
20,GORJ,"ȘCOALA PRIMARĂ RASOVIȚA",238,LELEŞTI,80677,1,PART,PRCNCT,PRSD,PRSD_SV,"2025-05-18 21:41:52",182,123,88,34,1,118,5,200,77,55,63
20,GORJ,"ŞCOALA PRIMARĂ LICURICI",239,LICURICI,80711,1,PART,PRCNCT,PRSD,PRSD_SV,"2025-05-18 21:52:25",607,316,246,66,4,312,4,700,384,242,70
20,GORJ,"ŞCOALA GIMNAZIALĂ NEGRENI",240,LICURICI,80711,1,PART,PRCNCT,PRSD,PRSD_SV,"2025-05-18 21:40:43",520,286,227,55,4,285,1,600,314,165,120
20,GORJ,"ŞCOALA GIMNAZIALĂ NR. 1 TOTEA",241,LICURICI,80711,1,PART,PRCNCT,PRSD,PRSD_SV,"2025-05-18 22:09:09",572,282,234,48,0,278,4,600,318,185,93
20,GORJ,"CĂMIN CULTURAL TÎRGU LOGREȘTI",242,LOGREŞTI,80766,1,PART,PRCNCT,PRSD,PRSD_SV,"2025-05-18 21:41:16",513,297,201,96,0,295,2,600,303,202,93
20,GORJ,"CĂMIN CULTURAL FRUNZA",243,LOGREŞTI,80766,1,PART,PRCNCT,PRSD,PRSD_SV,"2025-05-18 21:53:28",548,249,205,44,0,248,1,600,351,155,93
20,GORJ,"ȘCOALA PRIMARĂ MOȘTENI",244,LOGREŞTI,80766,1,PART,PRCNCT,PRSD,PRSD_SV,"2025-05-18 21:58:20",451,207,163,44,0,204,3,500,293,116,88
20,GORJ,"ȘCOALA PRIMARĂ MĂRU",245,LOGREŞTI,80766,1,PART,PRCNCT,PRSD,PRSD_SV,"2025-05-18 21:28:58",262,158,113,45,0,156,2,300,142,90,66
20,GORJ,"ȘCOALA PRIMARĂ SEACA",246,LOGREŞTI,80766,1,PART,PRCNCT,PRSD,PRSD_SV,"2025-05-18 21:26:13",237,128,87,41,0,127,1,300,172,78,49
20,GORJ,"GRĂDINIŢA MĂTĂSARI",247,MĂTĂSARI,80846,1,PART,PRCNCT,PRSD,PRSD_SV,"2025-05-18 21:41:45",1009,411,371,38,2,401,10,1100,689,317,84
20,GORJ,"GRĂDINIŢA MĂTĂSARI",248,MĂTĂSARI,80846,1,PART,PRCNCT,PRSD,PRSD_SV,"2025-05-18 21:40:59",1459,539,465,74,0,535,4,1600,1061,396,139
20,GORJ,"CLUBUL PENSIONARILOR",249,MĂTĂSARI,80846,1,PART,PRCNCT,PRSD,PRSD_SV,"2025-05-18 21:41:18",481,285,244,39,2,281,4,500,215,195,86
20,GORJ,"CĂMINUL CULTURAL BRĂDET",250,MĂTĂSARI,80846,1,PART,PRCNCT,PRSD,PRSD_SV,"2025-05-18 21:43:08",659,392,341,49,2,385,7,700,308,273,112
20,GORJ,"ŞCOALA PRIMARĂ CROICI",251,MĂTĂSARI,80846,1,PART,PRCNCT,PRSD,PRSD_SV,"2025-05-18 21:16:44",260,137,119,18,0,135,2,300,163,100,35
20,GORJ,"ȘCOALA GIMNAZIALĂ MUȘETEȘTI",252,MUŞETEŞTI,80908,1,PART,PRCNCT,PRSD,PRSD_SV,"2025-05-18 21:34:16",664,430,363,67,0,427,3,700,270,271,156
20,GORJ,"ŞCOALA GIMNAZIALĂ MUŞETEŞTI",253,MUŞETEŞTI,80908,1,PART,PRCNCT,PRSD,PRSD_SV,"2025-05-18 21:27:03",437,260,216,44,0,258,2,500,240,158,100
20,GORJ,"ŞCOALA PRIMARĂ LARGA",254,MUŞETEŞTI,80908,1,PART,PRCNCT,PRSD,PRSD_SV,"2025-05-18 21:25:56",461,286,244,42,0,285,1,500,214,190,95
20,GORJ,"ȘCOALA GIMNAZIALĂ NR.1 NEGOMIR",255,NEGOMIR,80980,2,PART,PRCNCT,PRSD,PRSD_SV,"2025-05-19 00:39:34",1054,573,520,53,0,568,5,1200,627,456,112
20,GORJ,"ȘCOALA PRIMARĂ ARTANU",256,NEGOMIR,80980,1,PART,PRCNCT,PRSD,PRSD_SV,"2025-05-18 22:07:00",914,539,499,40,0,530,9,1000,461,406,124
20,GORJ,"ȘCOALA GIMNAZIALĂ RACI",257,NEGOMIR,80980,2,PART,PRCNCT,PRSD,PRSD_SV,"2025-05-19 00:21:25",786,493,433,59,1,491,2,900,407,378,113
20,GORJ,"CĂMIN CULTURAL CĂLUGĂRENI",258,PADEŞ,81095,1,PART,PRCNCT,PRSD,PRSD_SV,"2025-05-18 22:12:50",866,466,424,42,0,463,3,1000,534,322,141
20,GORJ,"ȘCOALA GENERALĂ CERNA SAT",259,PADEŞ,81095,1,PART,PRCNCT,PRSD,PRSD_SV,"2025-05-18 21:22:54",43,47,22,25,0,47,0,100,53,38,9
20,GORJ,"ȘCOALA GIMNAZIALĂ MOTRU-SEC",260,PADEŞ,81095,2,PART,PRCNCT,PRSD,PRSD_SV,"2025-05-19 00:37:44",1634,811,768,43,0,804,7,1800,989,640,164
20,GORJ,"ȘCOALA GIMNAZIALĂ PADEȘ",261,PADEŞ,81095,1,PART,PRCNCT,PRSD,PRSD_SV,"2025-05-18 21:53:51",1339,665,594,71,0,659,6,1500,835,483,176
20,GORJ,"LICEUL TEHNOLOGIC ”CONSTANTIN BRÂNCUȘI” PEŞTIŞANI",262,PEŞTIŞANI,81184,1,PART,PRCNCT,PRSD,PRSD_SV,"2025-05-18 22:10:27",1303,770,641,128,1,766,4,1400,630,501,265
20,GORJ,"ȘCOALA GIMNAZIALĂ PEȘTIȘANI",263,PEŞTIŞANI,81184,1,PART,PRCNCT,PRSD,PRSD_SV,"2025-05-18 23:01:28",1284,765,606,154,5,757,8,1400,635,464,293
20,GORJ,"ȘCOALA PRIMARĂ BRĂDICENI",264,PEŞTIŞANI,81184,1,PART,PRCNCT,PRSD,PRSD_SV,"2025-05-18 21:49:38",501,394,262,132,0,387,7,600,206,182,205
20,GORJ,"ȘCOALA GIMNAZIALĂ” NICOLAE TOMOVICI PLOPȘOR” PLOPȘORU",265,PLOPŞORU,81264,1,PART,PRCNCT,PRSD,PRSD_SV,"2025-05-18 22:33:50",1854,1002,913,88,1,999,3,2000,998,703,296
20,GORJ,"ȘCOALA PRIMARĂ BROȘTENI",266,PLOPŞORU,81264,1,PART,PRCNCT,PRSD,PRSD_SV,"2025-05-18 21:56:31",812,482,428,48,6,479,3,900,418,341,138
20,GORJ,"ȘCOALA GIMNAZIALĂ PISCURI",267,PLOPŞORU,81264,1,PART,PRCNCT,PRSD,PRSD_SV,"2025-05-18 22:12:02",1016,496,453,43,0,491,5,1100,604,362,129
20,GORJ,"ȘCOALA PRIMARĂ VĂLENI",268,PLOPŞORU,81264,2,PART,PRCNCT,PRSD,PRSD_SV,"2025-05-19 00:55:31",1568,810,727,80,3,808,2,1700,890,632,176
20,GORJ,"ŞCOALA GIMNAZIALĂ NR.1 POLOVRAGI",269,POLOVRAGI,81380,2,PART,PRCNCT,PRSD,PRSD_SV,"2025-05-19 00:50:23",903,603,459,143,1,597,6,1000,397,332,265
20,GORJ,"ȘCOALA GIMNAZIALĂ NR.1 POLOVRAGI",270,POLOVRAGI,81380,1,PART,PRCNCT,PRSD,PRSD_SV,"2025-05-18 21:54:28",941,534,414,120,0,524,10,1000,466,327,197
20,GORJ,"ŞCOALA PRIMARĂ RACOVIȚA",271,POLOVRAGI,81380,1,PART,PRCNCT,PRSD,PRSD_SV,"2025-05-18 21:27:21",355,293,195,98,0,291,2,400,107,154,137
20,GORJ,"ŞCOALA GIMNAZIALĂ PRIGORIA",272,PRIGORIA,81415,1,PART,PRCNCT,PRSD,PRSD_SV,"2025-05-18 21:19:46",329,135,114,21,0,135,0,400,265,80,55
20,GORJ,"ȘCOALA CU CLASELE I-IV BUCȘANA",273,PRIGORIA,81415,1,PART,PRCNCT,PRSD,PRSD_SV,"2025-05-18 21:45:56",631,313,290,23,0,311,2,700,387,272,39
20,GORJ,"ȘCOALA CU CLASELE I-IV CĂLUGAREASA",274,PRIGORIA,81415,1,PART,PRCNCT,PRSD,PRSD_SV,"2025-05-18 21:25:05",470,271,220,51,0,271,0,500,229,200,71
20,GORJ,"ȘCOALA CU CLASELE I-IV DOBRANA",275,PRIGORIA,81415,1,PART,PRCNCT,PRSD,PRSD_SV,"2025-05-18 21:27:22",289,168,136,32,0,167,1,300,132,120,47
20,GORJ,"ȘCOALA CU CLASELE I-IV NEGOIEȘTI",276,PRIGORIA,81415,1,PART,PRCNCT,PRSD,PRSD_SV,"2025-05-18 21:18:08",224,103,90,13,0,103,0,200,97,85,18
20,GORJ,"ȘCOALA CU CLASELE I-IV ZORLEȘTI",277,PRIGORIA,81415,1,PART,PRCNCT,PRSD,PRSD_SV,"2025-05-18 21:29:37",326,194,148,46,0,192,2,400,206,117,75
20,GORJ,"CĂMINUL CULTURAL „IZVORUL”",278,"ROŞIA DE AMARADIA",81497,1,PART,PRCNCT,PRSD,PRSD_SV,"2025-05-18 21:50:28",1091,621,559,47,15,617,4,1200,579,397,220
20,GORJ,"ŞCOALA PRIMARĂ RUGET",279,"ROŞIA DE AMARADIA",81497,1,PART,PRCNCT,PRSD,PRSD_SV,"2025-05-18 21:39:01",455,222,184,32,6,222,0,500,278,153,69
20,GORJ,"ŞCOALA PRIMARĂ SECIURILE",280,"ROŞIA DE AMARADIA",81497,1,PART,PRCNCT,PRSD,PRSD_SV,"2025-05-18 21:42:03",566,292,258,27,7,290,2,600,308,221,69
20,GORJ,"GRĂDINIȚA ȘITOAIA",281,"ROŞIA DE AMARADIA",81497,1,PART,PRCNCT,PRSD,PRSD_SV,"2025-05-18 21:24:06",277,150,130,12,8,150,0,300,150,107,43
20,GORJ,"ŞCOALA GENERALĂ RUNCU",282,RUNCU,81576,1,PART,PRCNCT,PRSD,PRSD_SV,"2025-05-18 22:04:43",1241,900,692,208,0,886,14,1300,400,504,382
20,GORJ,"CĂMINUL CULTURAL BÂLTA",283,RUNCU,81576,1,PART,PRCNCT,PRSD,PRSD_SV,"2025-05-18 22:49:17",1392,869,754,113,2,854,15,1400,531,540,314
20,GORJ,"CĂMINUL CULTURAL DOBRIŢA",284,RUNCU,81576,1,PART,PRCNCT,PRSD,PRSD_SV,"2025-05-18 22:00:14",800,543,438,97,8,541,2,900,357,300,241
20,GORJ,"CĂMINUL CULTURAL SUSENI",285,RUNCU,81576,1,PART,PRCNCT,PRSD,PRSD_SV,"2025-05-18 21:45:14",249,276,115,49,112,269,7,500,224,154,115
20,GORJ,"CĂMINUL CULTURAL VALEA MARE",286,RUNCU,81576,2,PART,PRCNCT,PRSD,PRSD_SV,"2025-05-18 23:32:57",668,434,362,72,0,430,4,700,266,278,152
20,GORJ,"ŞCOALA GENERALĂ CU CLASELE V-VIII SAMARINEŞTI",287,SAMARINEŞTI,81656,1,PART,PRCNCT,PRSD,PRSD_SV,"2025-05-18 22:35:05",1072,641,549,92,0,630,11,1200,559,414,216
20,GORJ,"ŞCOALA PRIMARĂ LARGA",288,SAMARINEŞTI,81656,1,PART,PRCNCT,PRSD,PRSD_SV,"2025-05-18 21:27:28",321,221,162,59,0,220,1,400,179,153,67
20,GORJ,"ȘCOALA GENERALĂ SĂCELU",289,SĂCELU,81754,1,PART,PRCNCT,PRSD,PRSD_SV,"2025-05-18 21:28:09",710,451,346,105,0,445,6,800,349,286,159
20,GORJ,"ȘCOALA PRIMARĂ ”ÎNVĂȚĂTOR GRIGORE MAGHERESCU”",290,SĂCELU,81754,1,PART,PRCNCT,PRSD,PRSD_SV,"2025-05-18 21:26:43",456,327,224,103,0,325,2,500,173,207,118
20,GORJ,"ȘCOALA GIMNAZIALĂ SĂULEȘTI",291,SĂULEŞTI,81816,1,PART,PRCNCT,PRSD,PRSD_SV,"2025-05-18 21:55:38",1189,680,560,107,13,674,6,1300,620,416,258
20,GORJ,"ȘCOALA PRIMARĂ BIBEȘTI",292,SĂULEŞTI,81816,1,PART,PRCNCT,PRSD,PRSD_SV,"2025-05-18 21:50:51",609,380,286,88,6,376,4,700,320,234,142
20,GORJ,"FOSTA ŞCOALA PRIMARĂ SÎMBOTIN",293,SCHELA,81987,1,PART,PRCNCT,PRSD,PRSD_SV,"2025-05-18 21:36:26",469,325,263,62,0,324,1,500,175,190,134
20,GORJ,"ȘCOALA PRIMARĂ CU CLASELE I - IV GORNĂCEL",294,SCHELA,81987,1,PART,PRCNCT,PRSD,PRSD_SV,"2025-05-18 21:39:04",460,247,222,25,0,245,2,500,253,174,71
20,GORJ,"FOSTA ŞCOALĂ GENERALĂ CU CLASELE I - VIII SCHELA",295,SCHELA,81987,1,PART,PRCNCT,PRSD,PRSD_SV,"2025-05-18 21:44:02",471,289,237,52,0,286,3,500,211,170,116
20,GORJ,"CĂMINUL CULTURAL POMPILIU MARCEA",296,SCOARŢA,81861,1,PART,PRCNCT,PRSD,PRSD_SV,"2025-05-18 22:10:09",727,508,352,156,0,506,2,800,292,282,224
20,GORJ,"CĂMINUL CULTURAL BOBU",297,SCOARŢA,81861,1,PART,PRCNCT,PRSD,PRSD_SV,"2025-05-18 21:53:27",947,599,453,145,1,594,5,1000,401,394,200
20,GORJ,"CĂMINUL CULTURAL BUDIENI",298,SCOARŢA,81861,1,PART,PRCNCT,PRSD,PRSD_SV,"2025-05-18 21:40:10",599,357,288,64,5,351,6,700,343,224,127
20,GORJ,"ŞCOALA PRIMARĂ COPĂCIOASA",299,SCOARŢA,81861,1,PART,PRCNCT,PRSD,PRSD_SV,"2025-05-18 21:35:57",736,446,357,88,1,441,5,800,354,267,174
20,GORJ,"ŞCOALA PRIMARĂ PIŞTEŞTII DIN DEAL",300,SCOARŢA,81861,1,PART,PRCNCT,PRSD,PRSD_SV,"2025-05-18 22:02:03",895,323,287,36,0,317,6,1000,677,254,63
20,GORJ,"SALA MULTIFUNCȚIONALĂ",301,SLIVILEŞTI,82047,1,PART,PRCNCT,PRSD,PRSD_SV,"2025-05-18 21:48:52",768,437,367,68,2,434,3,800,363,312,122
20,GORJ,"SALA DE SPORT",302,SLIVILEŞTI,82047,1,PART,PRCNCT,PRSD,PRSD_SV,"2025-05-18 22:16:08",693,409,340,67,2,404,5,800,391,304,100
20,GORJ,"ȘCOALA PRIMARĂ STRÎMTU CU CLASELE I-IV",303,SLIVILEŞTI,82047,1,PART,PRCNCT,PRSD,PRSD_SV,"2025-05-18 22:15:32",407,233,193,40,0,231,2,400,167,180,51
20,GORJ,"ȘCOALA PRIMARĂ SURA CU CLASELE I-IV",304,SLIVILEŞTI,82047,1,PART,PRCNCT,PRSD,PRSD_SV,"2025-05-18 21:50:29",590,278,247,31,0,278,0,700,422,231,47
20,GORJ,"PRIMĂRIA STĂNEŞTI",305,STĂNEŞTI,82136,1,PART,PRCNCT,PRSD,PRSD_SV,"2025-05-18 22:04:03",1201,760,637,123,0,756,4,1300,540,509,247
20,GORJ,"ŞCOALA GENERALĂ CURPEN",306,STĂNEŞTI,82136,1,PART,PRCNCT,PRSD,PRSD_SV,"2025-05-18 21:32:56",731,427,329,98,0,424,3,800,373,236,188
20,GORJ,"CENTRUL CULTURAL ”GH.ZAMFIR”",307,STEJARI,82243,1,PART,PRCNCT,PRSD,PRSD_SV,"2025-05-18 22:36:34",804,449,339,109,1,446,3,900,451,287,159
20,GORJ,"ŞCOALA PRIMARĂ BALOŞANI",308,STEJARI,82243,1,PART,PRCNCT,PRSD,PRSD_SV,"2025-05-18 21:59:05",376,218,168,50,0,218,0,400,182,147,71
20,GORJ,"ȘCOALA GENERALĂ PISCOIU",309,STEJARI,82243,1,PART,PRCNCT,PRSD,PRSD_SV,"2025-05-18 21:37:59",651,348,259,87,2,346,2,700,352,267,79
20,GORJ,"ȘCOALA PRIMARĂ STOINA",310,STOINA,82314,1,PART,PRCNCT,PRSD,PRSD_SV,"2025-05-18 21:47:57",1168,646,514,132,0,635,11,1300,654,404,231
20,GORJ,"ŞCOALA CU CLASELE I-IV PĂIŞANI",311,STOINA,82314,3,PART,PRCNCT,PRSD,PRSD_SV,"2025-05-19 01:14:05",627,382,295,87,0,380,2,700,318,306,74
20,GORJ,"CLĂDIREA DE LÂNGĂ SEDIUL PRIMĂRIEI COMUNEI TELEŞTI - SALA DE ŞEDINŢE A CONSILIULUI LOCAL TELEŞTI",312,TELEŞTI,82396,1,PART,PRCNCT,PRSD,PRSD_SV,"2025-05-18 21:48:08",539,363,268,95,0,360,3,600,237,241,119
20,GORJ,"ŞCOALA PRIMARĂ TELEŞTI",313,TELEŞTI,82396,1,PART,PRCNCT,PRSD,PRSD_SV,"2025-05-18 21:58:52",527,348,268,80,0,347,1,600,252,249,98
20,GORJ,"ŞCOALA PRIMARĂ NR.1 BUDUHALA",314,TELEŞTI,82396,1,PART,PRCNCT,PRSD,PRSD_SV,"2025-05-18 21:42:43",698,294,250,44,0,293,1,800,506,218,75
20,GORJ,"ŞCOALA PRIMARĂ ŞOMĂNEŞTI",315,TELEŞTI,82396,1,PART,PRCNCT,PRSD,PRSD_SV,"2025-05-18 21:33:46",556,350,297,53,0,348,2,600,250,266,82
20,GORJ,"ŞCOALA PRIMARĂ TURBUREA",316,TURBUREA,82555,1,PART,PRCNCT,PRSD,PRSD_SV,"2025-05-18 21:26:06",419,303,219,66,18,296,7,500,197,197,99
20,GORJ,"ŞCOALA GENERALĂ TURBUREA",317,TURBUREA,82555,1,PART,PRCNCT,PRSD,PRSD_SV,"2025-05-18 21:54:27",766,455,368,74,13,453,2,800,345,231,222
20,GORJ,"ŞCOALA PRIMARĂ COCOROVA",318,TURBUREA,82555,1,PART,PRCNCT,PRSD,PRSD_SV,"2025-05-18 21:18:35",359,182,143,33,6,181,1,400,218,106,75
20,GORJ,"ŞCOALA GENERALĂ POIANA",319,TURBUREA,82555,1,PART,PRCNCT,PRSD,PRSD_SV,"2025-05-18 21:56:18",1194,627,522,88,17,623,4,1300,673,397,226
20,GORJ,"SPAȚIUL PUBLIC ȘIPOTU",320,TURBUREA,82555,1,PART,PRCNCT,PRSD,PRSD_SV,"2025-05-18 21:44:39",668,424,320,82,22,421,3,700,276,213,208
20,GORJ,"ȘCOALA GIMNAZIALĂ GRIGORE GEAMĂNU",321,TURCINEŞTI,78089,2,PART,PRCNCT,PRSD,PRSD_SV,"2025-05-18 23:59:35",1363,887,730,151,6,876,11,1500,613,468,408
20,GORJ,"ȘCOALA PRIMARĂ RUGI",322,TURCINEŞTI,78089,1,PART,PRCNCT,PRSD,PRSD_SV,"2025-05-18 22:17:41",466,339,254,84,1,333,6,500,161,205,128
20,GORJ,"ŞCOALA GIMNAZIALĂ ”GHEORGHE VASILESCU”",323,ŢÂNŢĂRENI,82680,1,PART,PRCNCT,PRSD,PRSD_SV,"2025-05-18 21:53:42",1921,744,673,71,0,736,8,2100,1356,525,211
20,GORJ,"ŞCOALA PRIMARĂ CHICIORA",324,ŢÂNŢĂRENI,82680,1,PART,PRCNCT,PRSD,PRSD_SV,"2025-05-18 21:34:45",243,116,85,31,0,115,1,300,184,95,20
20,GORJ,"ȘCOALA PRIMARĂ FLOREȘTI NR. 2",325,ŢÂNŢĂRENI,82680,1,PART,PRCNCT,PRSD,PRSD_SV,"2025-05-18 22:11:10",980,546,486,60,0,545,1,1100,554,390,155
20,GORJ,"ȘCOALA GIMNAZIALĂ ”MARIA CONSTANTIN”",326,ŢÂNŢĂRENI,82680,1,PART,PRCNCT,PRSD,PRSD_SV,"2025-05-18 22:02:39",1289,600,554,46,0,598,2,1400,800,417,181
20,GORJ,"ŞCOALA GIMNAZIALĂ NR. 1 URDARI",327,URDARI,82733,1,PART,PRCNCT,PRSD,PRSD_SV,"2025-05-18 22:44:55",1286,716,657,59,0,706,10,1400,684,538,168
20,GORJ,"GRĂDINIŢA HOTĂROASA",328,URDARI,82733,1,PART,PRCNCT,PRSD,PRSD_SV,"2025-05-18 22:21:42",432,233,198,35,0,231,2,500,267,178,53
20,GORJ,"ŞCOALA GIMNAZIALĂ FÂNTÂNELE",329,URDARI,82733,1,PART,PRCNCT,PRSD,PRSD_SV,"2025-05-18 22:25:50",768,415,381,34,0,411,4,800,385,306,105
20,GORJ,"ŞCOALA GENERALĂ NR.1 VÂGIULEŞTI",330,VĂGIULEŞTI,82779,1,PART,PRCNCT,PRSD,PRSD_SV,"2025-05-18 22:10:09",1011,511,441,70,0,508,3,1100,589,340,168
20,GORJ,"CĂMINUL CULTURAL COVRIGI",331,VĂGIULEŞTI,82779,1,PART,PRCNCT,PRSD,PRSD_SV,"2025-05-18 22:14:25",870,439,358,81,0,434,5,900,461,325,109
20,GORJ,"CĂMIN CULTURAL",332,VLADIMIR,82831,1,PART,PRCNCT,PRSD,PRSD_SV,"2025-05-18 21:51:45",811,429,332,91,6,424,5,900,471,224,200
20,GORJ,"ŞCOALA PRIMARĂ NR. 2 FRASIN",333,VLADIMIR,82831,1,PART,PRCNCT,PRSD,PRSD_SV,"2025-05-18 21:55:57",560,278,214,64,0,278,0,600,322,168,110
20,GORJ,"ŞCOALA PRIMARĂ NR 1 VLADIMIR",334,VLADIMIR,82831,1,PART,PRCNCT,PRSD,PRSD_SV,"2025-05-18 22:12:28",812,429,326,103,0,424,5,879,450,270,154
21,HARGHITA,"TEATRUL MUNICIPAL ”CSIKI JÁTÉKSZÍN” MIERCUREA-CIUC",1,"MUNICIPIUL MIERCUREA-CIUC",83320,1,PART,PRCNCT,PRSD,PRSD_SV,"2025-05-18 21:41:58",1727,999,830,131,38,983,16,2000,1001,63,920
21,HARGHITA,"LICEUL DE ARTE ”NAGY ISTVÁN” MIERCUREA-CIUC",2,"MUNICIPIUL MIERCUREA-CIUC",83320,1,PART,PRCNCT,PRSD,PRSD_SV,"2025-05-18 21:45:56",1442,929,774,155,0,917,12,1600,671,85,832
21,HARGHITA,"CASA DE CULTURĂ A SINDICATELOR MIERCUREA-CIUC",3,"MUNICIPIUL MIERCUREA-CIUC",83320,1,PART,PRCNCT,PRSD,PRSD_SV,"2025-05-18 21:38:28",1469,961,788,172,1,956,5,1600,639,90,866
21,HARGHITA,"ȘCOALA GIMNAZIALĂ ”NAGY IMRE” MIERCUREA-CIUC",4,"MUNICIPIUL MIERCUREA-CIUC",83320,1,PART,PRCNCT,PRSD,PRSD_SV,"2025-05-18 22:07:43",1459,961,812,146,3,959,2,1600,639,83,876
21,HARGHITA,"ŞCOALA GIMNAZIALĂ „NAGY IMRE” MIERCUREA-CIUC",5,"MUNICIPIUL MIERCUREA-CIUC",83320,1,PART,PRCNCT,PRSD,PRSD_SV,"2025-05-18 21:49:44",1494,924,831,93,0,917,7,1600,676,87,830
21,HARGHITA,"ȘCOALA GIMNAZIALĂ ”NAGY IMRE”",6,"MUNICIPIUL MIERCUREA-CIUC",83320,1,PART,PRCNCT,PRSD,PRSD_SV,"2025-05-18 21:35:35",1531,877,811,65,1,872,5,1600,723,54,818
21,HARGHITA,"ȘCOALA GIMNAZIALĂ ”PETŐFI SÁNDOR” MIERCUREA-CIUC",7,"MUNICIPIUL MIERCUREA-CIUC",83320,1,PART,PRCNCT,PRSD,PRSD_SV,"2025-05-18 21:40:51",1369,845,742,98,5,840,5,1600,755,50,790
21,HARGHITA,"ȘCOALA GIMNAZIALĂ ”PETŐFI SÁNDOR” MIERCUREA-CIUC",8,"MUNICIPIUL MIERCUREA-CIUC",83320,1,PART,PRCNCT,PRSD,PRSD_SV,"2025-05-18 21:44:12",1316,736,652,82,2,731,5,1600,864,93,638
21,HARGHITA,"ȘCOALA GIMNAZIALĂ ”LIVIU REBREANU” MIERCUREA-CIUC",9,"MUNICIPIUL MIERCUREA-CIUC",83320,1,PART,PRCNCT,PRSD,PRSD_SV,"2025-05-18 21:53:39",1485,1013,818,192,3,1005,8,1600,587,92,913
21,HARGHITA,"GRĂDINIŢA „NAPRAFORGÓ” MIERCUREA-CIUC",10,"MUNICIPIUL MIERCUREA-CIUC",83320,1,PART,PRCNCT,PRSD,PRSD_SV,"2025-05-18 21:50:26",1428,868,772,96,0,862,6,1600,732,79,783
21,HARGHITA,"S.C. GOSCOM S.A MIERCUREA-CIUC",11,"MUNICIPIUL MIERCUREA-CIUC",83320,1,PART,PRCNCT,PRSD,PRSD_SV,"2025-05-18 21:47:58",1170,668,608,60,0,664,4,1200,532,60,604
21,HARGHITA,"ȘCOALA GIMNAZIALĂ ”JÓZSEF ATTILA” MIERCUREA-CIUC",12,"MUNICIPIUL MIERCUREA-CIUC",83320,1,PART,PRCNCT,PRSD,PRSD_SV,"2025-05-18 21:33:06",1376,1070,775,104,191,1059,11,1600,530,219,840
21,HARGHITA,"ȘCOALA GIMNAZIALĂ ”JÓZSEF ATTILA” MIERCUREA-CIUC",13,"MUNICIPIUL MIERCUREA-CIUC",83320,1,PART,PRCNCT,PRSD,PRSD_SV,"2025-05-18 21:33:31",1431,761,724,36,1,754,7,1600,839,57,697
21,HARGHITA,"ȘCOALA GIMNAZIALĂ ”JÓZSEF ATTILA” MIERCUREA-CIUC",14,"MUNICIPIUL MIERCUREA-CIUC",83320,1,PART,PRCNCT,PRSD,PRSD_SV,"2025-05-18 21:31:43",1617,877,818,55,4,873,4,1600,723,105,768
21,HARGHITA,"SALA DE SPORT A ȘCOLII GIMNAZIALE ”JÓZSEF ATTILA” MIERCUREA-CIUC",15,"MUNICIPIUL MIERCUREA-CIUC",83320,1,PART,PRCNCT,PRSD,PRSD_SV,"2025-05-18 21:33:56",1618,973,863,108,2,968,5,1600,627,94,874
21,HARGHITA,"SALA DE SPORT A ȘCOLII GIMNAZILAE ”JÓZSEF ATTILA” MIERCUREA-CIUC",16,"MUNICIPIUL MIERCUREA-CIUC",83320,1,PART,PRCNCT,PRSD,PRSD_SV,"2025-05-18 22:01:17",1404,1066,752,129,185,1064,2,1600,534,114,950
21,HARGHITA,"GRĂDINIŢA ”ARANYALMA” MIERCUREA-CIUC",17,"MUNICIPIUL MIERCUREA-CIUC",83320,1,PART,PRCNCT,PRSD,PRSD_SV,"2025-05-18 21:26:03",1517,731,626,104,1,728,3,1600,869,72,656
21,HARGHITA,"LICEUL TEHNOLIGIC ”SZÉKELY KÁROLY” MIERCUREA-CIUC",18,"MUNICIPIUL MIERCUREA-CIUC",83320,1,PART,PRCNCT,PRSD,PRSD_SV,"2025-05-18 21:31:51",1436,893,778,111,4,891,2,1600,707,68,823
21,HARGHITA,"LICEUL TEHNOLIGIC ”SZÉKELY KÁROLY” MIERCUREA-CIUC",19,"MUNICIPIUL MIERCUREA-CIUC",83320,1,PART,PRCNCT,PRSD,PRSD_SV,"2025-05-18 21:49:44",1383,857,751,102,4,847,10,1600,743,77,770
21,HARGHITA,"ŞCOALA GIMNAZIALĂ ”XANTUS JANOS” MIERCUREA-CIUC",20,"MUNICIPIUL MIERCUREA-CIUC",83320,1,PART,PRCNCT,PRSD,PRSD_SV,"2025-05-18 21:36:36",1235,824,751,73,0,815,9,1200,376,27,788
21,HARGHITA,"SEDIUL ASOCIAȚIEI ”CSÍKSOMLYÓ” MIERCUREA-CIUC",21,"MUNICIPIUL MIERCUREA-CIUC",83320,1,PART,PRCNCT,PRSD,PRSD_SV,"2025-05-18 21:40:37",1849,1232,1101,102,29,1222,10,2000,768,48,1174
21,HARGHITA,"CASA DE CULTURĂ TOPLIȚA MIERCUREA-CIUC",22,"MUNICIPIUL MIERCUREA-CIUC",83320,2,PART,PRCNCT,PRSD,PRSD_SV,"2025-05-18 23:42:21",1686,1055,1006,49,0,1043,12,1600,545,32,1011
21,HARGHITA,"ȘCOALA PRIMARĂ DIN SUBPĂDURE",23,"MUNICIPIUL MIERCUREA-CIUC",83320,1,PART,PRCNCT,PRSD,PRSD_SV,"2025-05-18 21:28:25",480,327,291,36,0,326,1,800,473,17,309
21,HARGHITA,"ȘCOALA GIMNAZIALĂ ”XÁNTUS JÁNOS” HARGHITA-BĂI MIERCUREA-CIUC",24,"MUNICIPIUL MIERCUREA-CIUC",83320,1,PART,PRCNCT,PRSD,PRSD_SV,"2025-05-18 21:12:58",174,146,99,47,0,145,1,800,654,5,140
21,HARGHITA,"ŞCOALA GIMNAZIALĂ ”KÓS KÁROLY”",25,"MUNICIPIUL GHEORGHENI",83561,1,PART,PRCNCT,PRSD,PRSD_SV,"2025-05-18 21:43:02",1780,897,842,55,0,889,8,1600,703,102,787
21,HARGHITA,"ŞCOALA GIMNAZIALĂ ”KÓS KÁROLY”",26,"MUNICIPIUL GHEORGHENI",83561,1,PART,PRCNCT,PRSD,PRSD_SV,"2025-05-18 21:49:58",1635,793,748,42,3,790,3,1600,807,74,716
21,HARGHITA,"ŞCOALA GIMNAZIALĂ ”KÓS KÁROLY”",27,"MUNICIPIUL GHEORGHENI",83561,1,PART,PRCNCT,PRSD,PRSD_SV,"2025-05-18 22:21:51",1748,831,800,30,1,828,3,2000,1169,113,715
21,HARGHITA,"ŞCOALA GIMNAZIALĂ ”VASKERTES”",28,"MUNICIPIUL GHEORGHENI",83561,1,PART,PRCNCT,PRSD,PRSD_SV,"2025-05-18 21:41:51",1590,809,769,39,1,803,6,1600,791,52,751
21,HARGHITA,"ŞCOALA GIMNAZIALĂ ”VASKERTES”",29,"MUNICIPIUL GHEORGHENI",83561,2,PART,PRCNCT,PRSD,PRSD_SV,"2025-05-19 01:35:32",1565,766,697,66,3,763,3,1600,834,60,703
21,HARGHITA,"ŞCOALA GIMNAZIALĂ ”VASKERTES”",30,"MUNICIPIUL GHEORGHENI",83561,1,PART,PRCNCT,PRSD,PRSD_SV,"2025-05-18 21:39:44",1775,992,936,55,1,983,9,2000,1008,56,927
21,HARGHITA,"LICEUL TEORETIC ”SALAMON ERNŐ”",31,"MUNICIPIUL GHEORGHENI",83561,1,PART,PRCNCT,PRSD,PRSD_SV,"2025-05-18 22:29:51",1718,1013,863,121,29,998,15,1700,687,72,926
21,HARGHITA,"LICEUL TEHNOLOGIC ”FOGARASY MIHÁLY”",32,"MUNICIPIUL GHEORGHENI",83561,1,PART,PRCNCT,PRSD,PRSD_SV,"2025-05-18 21:43:07",1719,941,873,66,2,936,5,1700,759,46,890
21,HARGHITA,"COLEGIUL TEHNIC ”BATTHYÁNY IGNÁC”",33,"MUNICIPIUL GHEORGHENI",83561,1,PART,PRCNCT,PRSD,PRSD_SV,"2025-05-18 21:56:28",1908,1077,984,64,29,1074,3,2000,923,40,1034
21,HARGHITA,"CORP DE CLĂDIRE CU 20 DE APARTAMENTE",34,"MUNICIPIUL GHEORGHENI",83561,1,PART,PRCNCT,PRSD,PRSD_SV,"2025-05-18 21:35:27",77,157,35,122,0,155,2,800,643,63,92
21,HARGHITA,"SEDIU CLUBUL SPORTIV ŞCOLAR",35,"MUNICIPIUL ODORHEIU SECUIESC",83133,1,PART,PRCNCT,PRSD,PRSD_SV,"2025-05-18 21:39:50",1551,728,682,45,1,721,7,1700,972,31,690
21,HARGHITA,"LICEUL „MARIN PREDA” ODORHEIU SECUIESC",36,"MUNICIPIUL ODORHEIU SECUIESC",83133,1,PART,PRCNCT,PRSD,PRSD_SV,"2025-05-18 21:50:35",1784,1171,1067,104,0,1166,5,1900,729,51,1115
21,HARGHITA,"GRĂDINIŢA ”ZSIBONGÓ”",37,"MUNICIPIUL ODORHEIU SECUIESC",83133,1,PART,PRCNCT,PRSD,PRSD_SV,"2025-05-18 21:39:51",1179,680,596,82,2,679,1,1200,520,39,640
21,HARGHITA,"COLEGIUL REFORMAT ”BACZKAMADARASI KIS GERGELY”",38,"MUNICIPIUL ODORHEIU SECUIESC",83133,1,PART,PRCNCT,PRSD,PRSD_SV,"2025-05-18 22:07:41",1728,1112,1034,29,49,1107,5,1800,688,32,1075
21,HARGHITA,"COLEGIUL REFORMAT ”BACZKAMADARASI KIS GERGELY”",39,"MUNICIPIUL ODORHEIU SECUIESC",83133,1,PART,PRCNCT,PRSD,PRSD_SV,"2025-05-18 21:32:07",991,605,401,200,4,603,2,1000,395,26,577
21,HARGHITA,"CASĂ DE CULTURĂ",40,"MUNICIPIUL ODORHEIU SECUIESC",83133,1,PART,PRCNCT,PRSD,PRSD_SV,"2025-05-18 21:42:14",1267,878,691,152,35,872,6,1600,722,51,821
21,HARGHITA,"LICEUL TEHNOLOGIC ”KÓS KÁROLY”",41,"MUNICIPIUL ODORHEIU SECUIESC",83133,1,PART,PRCNCT,PRSD,PRSD_SV,"2025-05-18 21:55:28",1647,1061,982,78,1,1058,3,1600,539,35,1023
21,HARGHITA,"LICEUL TEHNOLOGIC ”KÓS KÁROLY”",42,"MUNICIPIUL ODORHEIU SECUIESC",83133,1,PART,PRCNCT,PRSD,PRSD_SV,"2025-05-18 21:49:42",1489,893,850,38,5,892,1,1600,707,28,864
21,HARGHITA,"GRĂDINIȚA „VILLANYTELEP”",43,"MUNICIPIUL ODORHEIU SECUIESC",83133,1,PART,PRCNCT,PRSD,PRSD_SV,"2025-05-18 21:41:16",1173,854,597,74,183,851,3,1200,346,50,801
21,HARGHITA,"ŞCOALA GIMNAZIALĂ ”ORBÁN BALÁZS”",44,"MUNICIPIUL ODORHEIU SECUIESC",83133,1,PART,PRCNCT,PRSD,PRSD_SV,"2025-05-18 21:35:01",1319,716,648,65,3,716,0,1600,884,31,685
21,HARGHITA,"ŞCOALA GIMNAZIALĂ ”ORBÁN BALÁZS”",45,"MUNICIPIUL ODORHEIU SECUIESC",83133,1,PART,PRCNCT,PRSD,PRSD_SV,"2025-05-18 21:23:33",1109,637,556,81,0,636,1,1200,563,22,614
21,HARGHITA,"ŞCOALA GIMNAZIALĂ ”ORBÁN BALÁZS”",46,"MUNICIPIUL ODORHEIU SECUIESC",83133,1,PART,PRCNCT,PRSD,PRSD_SV,"2025-05-18 21:41:34",1161,766,720,43,3,765,1,1200,434,23,742
21,HARGHITA,"ŞCOALA GIMNAZIALĂ ”BETHLEN GÁBOR”",47,"MUNICIPIUL ODORHEIU SECUIESC",83133,1,PART,PRCNCT,PRSD,PRSD_SV,"2025-05-18 21:39:54",1242,779,669,109,1,774,5,1600,821,27,747
21,HARGHITA,"ŞCOALA GIMNAZIALĂ ”BETHLEN GÁBOR”",48,"MUNICIPIUL ODORHEIU SECUIESC",83133,1,PART,PRCNCT,PRSD,PRSD_SV,"2025-05-18 21:36:38",1257,721,643,77,1,720,1,1400,679,24,696
21,HARGHITA,"ŞCOALA GIMNAZIALĂ ”BETHLEN GÁBOR”",49,"MUNICIPIUL ODORHEIU SECUIESC",83133,1,PART,PRCNCT,PRSD,PRSD_SV,"2025-05-18 21:28:36",1273,769,729,39,1,768,1,1400,631,22,746
21,HARGHITA,"ŞCOALA GIMNAZIALĂ ”BETHLEN GÁBOR”",50,"MUNICIPIUL ODORHEIU SECUIESC",83133,1,PART,PRCNCT,PRSD,PRSD_SV,"2025-05-18 21:35:33",1325,733,689,39,5,730,3,1500,767,14,716
21,HARGHITA,"ŞCOALA GIMNAZIALĂ ”BETHLEN GÁBOR”",51,"MUNICIPIUL ODORHEIU SECUIESC",83133,1,PART,PRCNCT,PRSD,PRSD_SV,"2025-05-18 21:48:50",1369,654,621,30,3,653,1,1500,846,30,623
21,HARGHITA,"ŞCOALA GIMNAZIALĂ ”MÓRA FERENC”",52,"MUNICIPIUL ODORHEIU SECUIESC",83133,1,PART,PRCNCT,PRSD,PRSD_SV,"2025-05-18 21:36:37",1443,810,745,61,4,808,2,1600,790,21,787
21,HARGHITA,"ŞCOALA GIMNAZIALĂ ”MÓRA FERENC”",53,"MUNICIPIUL ODORHEIU SECUIESC",83133,1,PART,PRCNCT,PRSD,PRSD_SV,"2025-05-18 21:52:13",1468,874,831,43,0,869,5,1600,726,19,850
21,HARGHITA,"ŞCOALA GIMNAZIALĂ ”MÓRA FERENC”",54,"MUNICIPIUL ODORHEIU SECUIESC",83133,1,PART,PRCNCT,PRSD,PRSD_SV,"2025-05-18 21:35:26",1388,788,757,30,1,786,2,1600,812,20,766
21,HARGHITA,"ŞCOALA GIMNAZIALĂ ”MÓRA FERENC”",55,"MUNICIPIUL ODORHEIU SECUIESC",83133,1,PART,PRCNCT,PRSD,PRSD_SV,"2025-05-18 21:43:44",1432,853,787,65,1,848,5,1600,747,27,821
21,HARGHITA,"GRĂDINIȚA „KIPI-KOPI” STRUCTURA BETHLENFALVI",56,"MUNICIPIUL ODORHEIU SECUIESC",83133,1,PART,PRCNCT,PRSD,PRSD_SV,"2025-05-18 21:59:54",1723,1143,1064,77,2,1139,4,1800,657,37,1102
21,HARGHITA,"ŞCOALA GIMNAZIALĂ ”MIRON CRISTEA” TOPLIŢA",57,"MUNICIPIUL TOPLIŢA",83632,1,PART,PRCNCT,PRSD,PRSD_SV,"2025-05-18 22:28:45",1527,697,613,50,34,681,16,1700,1003,262,419
21,HARGHITA,"ŞCOALA GIMNAZIALĂ ”MIRON CRISTEA” TOPLIŢA",58,"MUNICIPIUL TOPLIŢA",83632,1,PART,PRCNCT,PRSD,PRSD_SV,"2025-05-18 22:34:03",1510,773,698,65,10,767,6,1700,927,246,521
21,HARGHITA,"LICEUL TEORETIC ”KEMENY JANOS” TOPLIŢA",59,"MUNICIPIUL TOPLIŢA",83632,1,PART,PRCNCT,PRSD,PRSD_SV,"2025-05-18 22:09:28",1330,718,658,60,0,714,4,1500,782,192,522
21,HARGHITA,"GRĂDINIŢA VOINICEL NR.1 TOPLIŢA",60,"MUNICIPIUL TOPLIŢA",83632,1,PART,PRCNCT,PRSD,PRSD_SV,"2025-05-18 21:36:30",1004,442,405,37,0,439,3,1100,658,188,251
21,HARGHITA,"ŞCOALA GIMNAZIALĂ ”ANDREI ŞAGUNA” VALE",61,"MUNICIPIUL TOPLIŢA",83632,1,PART,PRCNCT,PRSD,PRSD_SV,"2025-05-18 22:20:30",1512,828,741,87,0,823,5,1700,872,380,443
21,HARGHITA,"COLEGIUL NAŢIONAL ”MIHAI EMINESCU” TOPLIŢA",62,"MUNICIPIUL TOPLIŢA",83632,1,PART,PRCNCT,PRSD,PRSD_SV,"2025-05-18 21:34:58",968,541,469,72,0,536,5,1000,459,134,402
21,HARGHITA,"ŞCOALA GIMNAZIALĂ ”SF. ILIE” TOPLIŢA",63,"MUNICIPIUL TOPLIŢA",83632,1,PART,PRCNCT,PRSD,PRSD_SV,"2025-05-18 21:40:54",1002,457,410,47,0,449,8,1100,643,171,278
21,HARGHITA,"ŞCOALA GIMNAZIALĂ ”SFÂNTU ILIE” TOPLIŢA",64,"MUNICIPIUL TOPLIŢA",83632,1,PART,PRCNCT,PRSD,PRSD_SV,"2025-05-18 22:21:25",1177,533,463,70,0,527,6,1300,767,201,326
21,HARGHITA,"ŞCOALA GIMNAZIALĂ ”ANDREI ŞAGUNA” CĂLIMĂNEL",65,"MUNICIPIUL TOPLIŢA",83632,1,PART,PRCNCT,PRSD,PRSD_SV,"2025-05-18 21:35:22",946,458,434,24,0,455,3,1000,542,272,183
21,HARGHITA,"CABANA OCOLULUI SILVIC",66,"MUNICIPIUL TOPLIŢA",83632,1,PART,PRCNCT,PRSD,PRSD_SV,"2025-05-18 21:18:42",53,31,19,12,0,30,1,400,369,12,18
21,HARGHITA,"ŞCOALA GIMNAZIALĂ ”SF. ILIE” ZENCANI",67,"MUNICIPIUL TOPLIŢA",83632,1,PART,PRCNCT,PRSD,PRSD_SV,"2025-05-18 21:52:47",1513,703,671,32,0,697,6,1600,897,379,318
21,HARGHITA,"SEDIUL NOU AL PRIMĂRIEI",68,"ORAŞ BĂILE TUŞNAD",83428,1,PART,PRCNCT,PRSD,PRSD_SV,"2025-05-18 22:19:44",1317,949,609,338,2,942,7,1600,651,98,844
21,HARGHITA,"CASA DE CULTURĂ BĂLAN",69,"ORAŞ BĂLAN",83464,1,PART,PRCNCT,PRSD,PRSD_SV,"2025-05-18 21:32:08",1456,425,380,29,16,422,3,1400,975,102,320
21,HARGHITA,"SCOALA GIMNAZIALĂ ”GEO BOGZA” BĂLAN - CLĂDIRE ȘCOALA NR. 1",70,"ORAŞ BĂLAN",83464,1,PART,PRCNCT,PRSD,PRSD_SV,"2025-05-18 21:38:42",1191,427,387,32,8,424,3,1300,873,128,296
21,HARGHITA,"LICEUL TEHNOLOGIC ”LIVIU REBREANU” BĂLAN - GRĂDINIȚA „CSEPEREDO”",71,"ORAŞ BĂLAN",83464,1,PART,PRCNCT,PRSD,PRSD_SV,"2025-05-18 21:40:52",1161,372,347,19,6,370,2,1300,928,125,245
21,HARGHITA,"LICEUL TEHNOLOGIC ”LIVIU REBREANU” BĂLAN - CLĂDIRE GRĂDINIȚA NR. 2",72,"ORAŞ BĂLAN",83464,1,PART,PRCNCT,PRSD,PRSD_SV,"2025-05-18 21:29:17",1195,368,347,19,2,366,2,1300,932,178,188
21,HARGHITA,"CLUBUL ELEVILOR BĂLAN",73,"ORAŞ BĂLAN",83464,1,PART,PRCNCT,PRSD,PRSD_SV,"2025-05-18 21:41:09",1280,384,368,16,0,381,3,1400,1016,152,229
21,HARGHITA,"LICEUL TEHNOLOGIC „ZIMMETHAUSEN„",74,"ORAŞ BORSEC",83491,1,PART,PRCNCT,PRSD,PRSD_SV,"2025-05-18 21:37:43",912,529,425,96,8,523,6,1200,671,97,426
21,HARGHITA,"SEDIUL CONSILIULUI LOCAL",75,"ORAŞ BORSEC",83491,1,PART,PRCNCT,PRSD,PRSD_SV,"2025-05-18 21:29:06",1347,806,709,84,13,805,1,1300,494,166,639
21,HARGHITA,"ŞCOALA GIMNAZIALĂ ”PETŐFI SÁNDOR” CRISTURU SECUIESC",76,"ORAŞ CRISTURU SECUIESC",83525,1,PART,PRCNCT,PRSD,PRSD_SV,"2025-05-18 21:32:37",1229,577,539,36,2,572,5,1300,723,34,538
21,HARGHITA,"ŞCOALA GIMNAZIALĂ ”PETŐFI SÁNDOR” CRISTURU SECUIESC",77,"ORAŞ CRISTURU SECUIESC",83525,1,PART,PRCNCT,PRSD,PRSD_SV,"2025-05-18 21:38:10",1520,884,824,59,1,881,3,1600,716,49,832
21,HARGHITA,"PAROHIA ROMANO-CATOLICĂ CRISTURU SECUIESC",78,"ORAŞ CRISTURU SECUIESC",83525,1,PART,PRCNCT,PRSD,PRSD_SV,"2025-05-18 21:46:20",1347,681,626,53,2,679,2,1400,719,21,658
21,HARGHITA,"ASOCIATIA INTREPRINZATORILOR PARTICULARI",79,"ORAŞ CRISTURU SECUIESC",83525,1,PART,PRCNCT,PRSD,PRSD_SV,"2025-05-18 21:34:53",1374,749,691,56,2,743,6,1500,751,32,711
21,HARGHITA,"LICEUL TEOLOGIC UNITARIAN „BERDE MÓZES” CRISTURU SECUIESC",80,"ORAŞ CRISTURU SECUIESC",83525,1,PART,PRCNCT,PRSD,PRSD_SV,"2025-05-18 21:31:26",1684,889,836,48,5,880,9,1700,811,35,845
21,HARGHITA,"CĂMINUL CULTURAL BETEŞTI",81,"ORAŞ CRISTURU SECUIESC",83525,1,PART,PRCNCT,PRSD,PRSD_SV,"2025-05-18 21:33:33",713,351,322,29,0,346,5,1000,649,19,327
21,HARGHITA,"CENTRUL DE PLANIFICARE A FAMILIEI FILIAŞ",82,"ORAŞ CRISTURU SECUIESC",83525,1,PART,PRCNCT,PRSD,PRSD_SV,"2025-05-18 21:40:31",932,483,468,15,0,476,7,1200,717,25,451
21,HARGHITA,"ŞCOALA GIMNAZIALĂ ”MÁRTONFFI JÁNOS”, VLĂHIŢA",83,"ORAŞ VLĂHIŢA",83749,1,PART,PRCNCT,PRSD,PRSD_SV,"2025-05-18 21:32:20",1345,769,747,22,0,767,2,1600,831,22,745
21,HARGHITA,"ŞCOALA GIMNAZIALĂ ”MÁRTONFFI JÁNOS”, VLĂHIŢA",84,"ORAŞ VLĂHIŢA",83749,1,PART,PRCNCT,PRSD,PRSD_SV,"2025-05-18 21:42:41",1591,1034,989,45,0,1028,6,1700,666,30,998
21,HARGHITA,"ȘCOALA GIMNAZIALĂ TAMÁSI ÁRON, VLĂHIŢA",85,"ORAŞ VLĂHIŢA",83749,1,PART,PRCNCT,PRSD,PRSD_SV,"2025-05-18 21:39:17",1087,644,606,37,1,643,1,1200,556,18,625
21,HARGHITA,"ȘCOALA GIMNAZIALĂ TAMÁSI ÁRON, VLĂHIŢA",86,"ORAŞ VLĂHIŢA",83749,1,PART,PRCNCT,PRSD,PRSD_SV,"2025-05-18 21:35:46",1162,604,570,18,16,603,1,1200,596,15,588
21,HARGHITA,"LICEUL TEHNOLOGIC ”GÁBOR ÁRON”, VLĂHIŢA",87,"ORAŞ VLĂHIŢA",83749,1,PART,PRCNCT,PRSD,PRSD_SV,"2025-05-18 21:20:31",920,516,491,25,0,513,3,1000,484,10,503
21,HARGHITA,"CÃMINUL CULTURAL ATID",88,ATID,83785,1,PART,PRCNCT,PRSD,PRSD_SV,"2025-05-18 21:32:56",1098,358,316,42,0,349,9,1000,642,32,317
21,HARGHITA,"CÃMINUL CULTURAL CRISENI",89,ATID,83785,1,PART,PRCNCT,PRSD,PRSD_SV,"2025-05-18 21:34:49",556,270,218,52,0,259,11,600,330,29,230
21,HARGHITA,"CÃMINUL CULTURAL CUSMED",90,ATID,83785,1,PART,PRCNCT,PRSD,PRSD_SV,"2025-05-18 21:27:20",358,162,136,26,0,161,1,400,238,13,148
21,HARGHITA,"SEDIU COMPOSESORAT INLÃCENI",91,ATID,83785,1,PART,PRCNCT,PRSD,PRSD_SV,"2025-05-18 21:16:40",114,78,50,28,0,77,1,200,122,6,71
21,HARGHITA,"CÃMINUL CULTURAL SICLOD",92,ATID,83785,1,PART,PRCNCT,PRSD,PRSD_SV,"2025-05-18 21:14:50",141,132,68,64,0,131,1,300,168,4,127
21,HARGHITA,"SEDIUL PRIMĂRIEI AVRĂMEŞTI",93,AVRĂMEŞTI,83847,1,PART,PRCNCT,PRSD,PRSD_SV,"2025-05-18 21:35:26",849,465,418,39,8,461,4,900,435,32,429
21,HARGHITA,"ŞCOALA PRIMARĂ CECHEŞTI",94,AVRĂMEŞTI,83847,1,PART,PRCNCT,PRSD,PRSD_SV,"2025-05-18 21:21:38",533,304,280,19,5,299,5,600,296,35,264
21,HARGHITA,"ŞCOALA PRIMARĂ FIRTĂNUŞ",95,AVRĂMEŞTI,83847,1,PART,PRCNCT,PRSD,PRSD_SV,"2025-05-18 21:33:35",282,133,118,12,3,132,1,300,167,13,119
21,HARGHITA,"ŞCOALA GIMNAZIALĂ ”MÓRA FERENC” GOAGIU",96,AVRĂMEŞTI,83847,1,PART,PRCNCT,PRSD,PRSD_SV,"2025-05-18 21:42:58",532,285,263,18,4,281,4,600,315,30,251
21,HARGHITA,"CĂMINUL CULTURAL",97,BILBOR,83936,1,PART,PRCNCT,PRSD,PRSD_SV,"2025-05-18 21:45:55",1027,504,459,44,1,502,2,1100,596,259,243
21,HARGHITA,"CĂMINUL CULTURAL",98,BILBOR,83936,1,PART,PRCNCT,PRSD,PRSD_SV,"2025-05-18 21:40:50",1116,583,505,78,0,575,8,1200,617,300,275
21,HARGHITA,"ŞCOALA GIMNAZIALĂ MARTON ARON BRĂDEŞTI",99,BRĂDEŞTI,83151,1,PART,PRCNCT,PRSD,PRSD_SV,"2025-05-18 22:12:28",1114,792,720,69,3,790,2,1200,408,36,754
21,HARGHITA,"SCOALA PRIMARA TIRNOVITA",100,BRĂDEŞTI,83151,1,PART,PRCNCT,PRSD,PRSD_SV,"2025-05-18 21:43:23",612,425,380,45,0,420,5,700,275,24,396
21,HARGHITA,"ȘCOALA GIMNAZIALĂ „KRIZA JÁNOS”",101,CĂPÂLNIŢA,83963,1,PART,PRCNCT,PRSD,PRSD_SV,"2025-05-18 21:31:55",826,546,502,34,10,544,2,900,354,15,529
21,HARGHITA,"ȘCOALA GIMNAZIALĂ „KRIZA JÁNOS”",102,CĂPÂLNIŢA,83963,1,PART,PRCNCT,PRSD,PRSD_SV,"2025-05-18 21:21:11",842,495,468,17,10,493,2,900,405,11,482
21,HARGHITA,"PRIMĂRIA CÎRŢA",103,CÂRŢA,84102,1,PART,PRCNCT,PRSD,PRSD_SV,"2025-05-18 21:48:15",807,554,498,41,15,548,6,900,346,32,516
21,HARGHITA,COMPOSESORAT,104,CÂRŢA,84102,1,PART,PRCNCT,PRSD,PRSD_SV,"2025-05-18 21:26:35",1391,921,856,41,24,917,4,1500,579,34,883
21,HARGHITA,"ȘCOALA GIMNAZIALĂ „KÁJONI JÁNOS”",105,CICEU,86461,1,PART,PRCNCT,PRSD,PRSD_SV,"2025-05-18 21:32:19",1164,806,715,35,56,803,3,1300,494,29,774
21,HARGHITA,"SALĂ DE SPORT CICEU",106,CICEU,86461,1,PART,PRCNCT,PRSD,PRSD_SV,"2025-05-18 21:32:19",1130,772,690,26,56,770,2,1200,428,12,758
21,HARGHITA,"ŞCOALA GIMNAZIALĂ ”GAL SANDOR” CIUCSÂNGEORGIU",107,CIUCSÂNGEORGIU,83981,1,PART,PRCNCT,PRSD,PRSD_SV,"2025-05-18 21:34:37",908,521,476,34,11,506,15,900,379,29,477
21,HARGHITA,"ŞCOALA GIMNAZIALĂ ”GAL SANDOR” CIUCSÂNGEORGIU",108,CIUCSÂNGEORGIU,83981,1,PART,PRCNCT,PRSD,PRSD_SV,"2025-05-18 21:33:56",688,430,397,21,12,426,4,800,370,15,411
21,HARGHITA,"CĂMINUL CULTURAL ARMĂŞENI",109,CIUCSÂNGEORGIU,83981,1,PART,PRCNCT,PRSD,PRSD_SV,"2025-05-18 21:34:45",704,463,410,35,18,462,1,800,337,5,457
21,HARGHITA,"CĂMINUL CULTURAL ARMĂŞENI-NOI",110,CIUCSÂNGEORGIU,83981,1,PART,PRCNCT,PRSD,PRSD_SV,"2025-05-18 21:28:11",266,207,184,19,4,204,3,300,93,12,192
21,HARGHITA,"ŞCOALA GIMNAZIALĂ ”MARTON FERENC” BANCU",111,CIUCSÂNGEORGIU,83981,1,PART,PRCNCT,PRSD,PRSD_SV,"2025-05-18 21:35:04",1097,695,622,52,21,694,1,1100,405,13,681
21,HARGHITA,"CĂMINUL CULTURAL EGHERSEC-CINOD",112,CIUCSÂNGEORGIU,83981,1,PART,PRCNCT,PRSD,PRSD_SV,"2025-05-18 21:18:40",147,111,89,22,0,109,2,200,89,10,99
21,HARGHITA,"CĂMINUL CULTURAL EGHERSEC",113,CIUCSÂNGEORGIU,83981,1,PART,PRCNCT,PRSD,PRSD_SV,"2025-05-18 21:18:43",85,58,44,14,0,57,1,200,142,6,51
21,HARGHITA,"ȘCOALA PRIMARĂ KÖLLŐ MIKLÓS",114,CIUMANI,84086,1,PART,PRCNCT,PRSD,PRSD_SV,"2025-05-18 22:08:28",1315,798,724,34,40,798,0,1400,602,28,770
21,HARGHITA,"ȘCOALA PRIMARĂ KÖLLŐ MIKLÓS",115,CIUMANI,84086,1,PART,PRCNCT,PRSD,PRSD_SV,"2025-05-18 21:45:30",1142,702,636,37,29,699,3,1300,598,15,684
21,HARGHITA,"ȘCOALA PRIMARA SZILÁGYI",116,CIUMANI,84086,1,PART,PRCNCT,PRSD,PRSD_SV,"2025-05-18 21:37:35",1092,687,631,29,27,684,3,1200,513,28,656
21,HARGHITA,"LICEUL TEHNOLOGIC CORBU CORP A",117,CORBU,84148,1,PART,PRCNCT,PRSD,PRSD_SV,"2025-05-18 21:34:07",766,374,311,62,1,371,3,800,426,198,173
21,HARGHITA,"LICEUL TEHNOLOGIC CORP D",118,CORBU,84148,1,PART,PRCNCT,PRSD,PRSD_SV,"2025-05-18 21:19:29",417,215,189,26,0,211,4,500,285,160,51
21,HARGHITA,"GRĂDINIŢĂ DE COPII",119,CORUND,84175,1,PART,PRCNCT,PRSD,PRSD_SV,"2025-05-18 21:29:34",1370,691,608,34,49,687,4,1500,809,35,652
21,HARGHITA,"ŞCOALA GIMNAZIALĂ CORUND",120,CORUND,84175,1,PART,PRCNCT,PRSD,PRSD_SV,"2025-05-18 21:31:39",1400,822,754,37,31,816,6,1500,678,36,780
21,HARGHITA,"ȘCOALA GIMNAZIALĂ CORUND",121,CORUND,84175,1,PART,PRCNCT,PRSD,PRSD_SV,"2025-05-18 21:27:51",1414,679,597,44,38,676,3,1600,921,44,632
21,HARGHITA,"CĂMINUL CULTURAL ATIA",122,CORUND,84175,1,PART,PRCNCT,PRSD,PRSD_SV,"2025-05-18 21:24:46",172,137,94,37,6,135,2,200,63,6,129
21,HARGHITA,"ŞCOALA GIMNAZIALĂ FÂNTÂNA BRAZILOR",123,CORUND,84175,1,PART,PRCNCT,PRSD,PRSD_SV,"2025-05-18 21:16:28",257,185,157,13,15,185,0,300,115,9,176
21,HARGHITA,"ŞCOALA GIMNAZIALĂ VALEA LUI PAVEL",124,CORUND,84175,1,PART,PRCNCT,PRSD,PRSD_SV,"2025-05-18 21:21:21",281,188,147,29,12,188,0,300,112,18,170
21,HARGHITA,"COMUNA COZMENI",125,COZMENI,86446,1,PART,PRCNCT,PRSD,PRSD_SV,"2025-05-18 21:42:27",1188,716,622,42,52,709,7,1300,584,44,665
21,HARGHITA,"COMUNA COZMENI",126,COZMENI,86446,1,PART,PRCNCT,PRSD,PRSD_SV,"2025-05-18 21:23:16",452,310,252,33,25,308,2,500,190,6,302
21,HARGHITA,"CĂMINUL CULTURAL DĂNEȘTI",127,DĂNEŞTI,84237,1,PART,PRCNCT,PRSD,PRSD_SV,"2025-05-18 21:41:16",884,626,568,36,22,622,4,1000,374,22,600
21,HARGHITA,"CĂMINUL CULTURAL DĂNEȘTI",128,DĂNEŞTI,84237,1,PART,PRCNCT,PRSD,PRSD_SV,"2025-05-18 21:33:59",935,668,612,19,37,663,5,1000,332,19,644
21,HARGHITA,"ȘCOALA GENERALÂ DÂRJIU JÁNOS ZSIGMOND",129,DÂRJIU,84380,1,PART,PRCNCT,PRSD,PRSD_SV,"2025-05-18 21:29:11",512,274,236,35,3,274,0,600,326,9,265
21,HARGHITA,"ȘCOALA GENERALĂ DIN MUJNA",130,DÂRJIU,84380,1,PART,PRCNCT,PRSD,PRSD_SV,"2025-05-18 21:14:21",290,200,152,48,0,198,2,300,100,9,189
21,HARGHITA,"CĂMIN CULTURAL",131,DEALU,84264,1,PART,PRCNCT,PRSD,PRSD_SV,"2025-05-18 21:32:31",1564,1091,1025,66,0,1087,4,1600,509,27,1060
21,HARGHITA,"CAMIN CULTURAL",132,DEALU,84264,1,PART,PRCNCT,PRSD,PRSD_SV,"2025-05-18 21:22:54",1090,784,744,40,0,783,1,1200,416,32,751
21,HARGHITA,"CASĂ COMUNALĂ",133,DEALU,84264,1,PART,PRCNCT,PRSD,PRSD_SV,"2025-05-18 21:34:18",607,399,360,39,0,395,4,700,301,25,370
21,HARGHITA,"ȘCOALA GIMNAZIALĂ „SIKLODY LORINC” DITRĂU",134,DITRĂU,84344,1,PART,PRCNCT,PRSD,PRSD_SV,"2025-05-18 21:38:44",1550,891,795,47,49,886,5,1600,709,33,853
21,HARGHITA,"GRADINITA CU PROGRAM NORMAL ”CSIGABIGA” DITRĂU",135,DITRĂU,84344,1,PART,PRCNCT,PRSD,PRSD_SV,"2025-05-18 21:17:28",845,489,435,43,11,488,1,900,411,24,464
21,HARGHITA,"ȘCOALA GIMNAZIALĂ „CSIBY ANDOR” DITRĂU „KOHID”",136,DITRĂU,84344,1,PART,PRCNCT,PRSD,PRSD_SV,"2025-05-18 21:22:09",899,521,467,16,38,520,1,1000,479,17,503
21,HARGHITA,"ȘCOALA GIMNAZIALĂ „DR. CSIBY ANDOR” DITRĂU",137,DITRĂU,84344,1,PART,PRCNCT,PRSD,PRSD_SV,"2025-05-18 21:26:31",879,519,484,19,16,516,3,1000,481,33,483
21,HARGHITA,"CĂMINUL CULTURAL „FERENCZI LÁSZLÓ”",138,DITRĂU,84344,1,PART,PRCNCT,PRSD,PRSD_SV,"2025-05-18 21:24:37",495,282,240,28,14,279,3,600,318,9,270
21,HARGHITA,"ŞCOALA GIMNAZIALĂ ”FULOP ARON” FELICENI",139,FELICENI,83197,1,PART,PRCNCT,PRSD,PRSD_SV,"2025-05-18 21:51:13",917,670,571,83,16,664,6,900,230,26,638
21,HARGHITA,"ŞCOALA GENERALĂ FORŢENI",140,FELICENI,83197,1,PART,PRCNCT,PRSD,PRSD_SV,"2025-05-18 21:18:23",424,306,269,27,10,306,0,500,194,10,296
21,HARGHITA,"ŞCOALA GENERALĂ HOGHIA",141,FELICENI,83197,1,PART,PRCNCT,PRSD,PRSD_SV,"2025-05-18 21:26:26",227,175,141,29,5,175,0,300,125,4,171
21,HARGHITA,"ŞCOALA GENERALĂ POLONIŢA",142,FELICENI,83197,1,PART,PRCNCT,PRSD,PRSD_SV,"2025-05-18 21:21:56",324,239,186,51,2,239,0,400,161,9,230
21,HARGHITA,"ŞCOALA GENERALĂ TĂURENI",143,FELICENI,83197,1,PART,PRCNCT,PRSD,PRSD_SV,"2025-05-18 21:34:10",618,418,357,47,14,414,4,600,182,19,395
21,HARGHITA,"ŞCOALA GENERALĂ TELEAC",144,FELICENI,83197,1,PART,PRCNCT,PRSD,PRSD_SV,"2025-05-18 21:21:46",179,120,103,15,2,120,0,200,80,9,111
21,HARGHITA,"CĂMIN CULTURAL VĂLENI",145,FELICENI,83197,1,PART,PRCNCT,PRSD,PRSD_SV,"2025-05-18 21:21:32",282,174,147,27,0,173,1,300,126,6,167
21,HARGHITA,"PRIMĂRIA COMUNEI FRUMOASA",146,FRUMOASA,84415,1,PART,PRCNCT,PRSD,PRSD_SV,"2025-05-18 21:32:04",1546,943,830,60,53,933,10,1600,657,56,877
21,HARGHITA,"ȘCOALA GIMNAZIALĂ BÎRZAVA",147,FRUMOASA,84415,1,PART,PRCNCT,PRSD,PRSD_SV,"2025-05-18 21:25:31",554,415,362,38,15,414,1,700,285,15,399
21,HARGHITA,"ȘCOALA PRIMARĂ",148,FRUMOASA,84415,1,PART,PRCNCT,PRSD,PRSD_SV,"2025-05-18 21:20:42",911,654,592,47,15,652,2,1000,346,21,631
21,HARGHITA,"ŞCOALA GIMNAZIALĂ ”DUMITRU GAFTON” GĂLĂUȚAȘ",149,GĂLĂUŢAŞ,84460,1,PART,PRCNCT,PRSD,PRSD_SV,"2025-05-18 21:56:33",916,371,339,32,0,369,2,900,529,127,242
21,HARGHITA,"ŞCOALA GIMNAZIALĂ ”DUMITRU GAFTON” GĂLĂUȚAȘ",150,GĂLĂUŢAŞ,84460,1,PART,PRCNCT,PRSD,PRSD_SV,"2025-05-18 21:50:21",694,236,225,10,1,232,4,800,564,130,102
21,HARGHITA,"ȘCOALA GIMNAZIALĂ ”DUMITRU GAFTON” GĂLĂUȚAȘ",151,GĂLĂUŢAŞ,84460,1,PART,PRCNCT,PRSD,PRSD_SV,"2025-05-18 21:26:41",313,127,123,3,1,127,0,400,273,85,42
21,HARGHITA,"LICEUL TEHNOLOGIC SOVER ELEK",152,JOSENI,84558,1,PART,PRCNCT,PRSD,PRSD_SV,"2025-05-18 21:38:22",1178,802,723,43,36,794,8,1300,498,33,761
21,HARGHITA,"LICEUL TEHNOLOGIC SOVER ELEK",153,JOSENI,84558,1,PART,PRCNCT,PRSD,PRSD_SV,"2025-05-18 22:04:50",1393,886,822,25,39,884,2,1500,614,32,852
21,HARGHITA,"LICEUL TEHNOLOGIC SOVER ELEK",154,JOSENI,84558,1,PART,PRCNCT,PRSD,PRSD_SV,"2025-05-18 21:33:46",1359,871,808,31,32,862,9,1500,629,33,829
21,HARGHITA,"SCOALA PRIMARA GAÁL TAMÁS, BORZONT",155,JOSENI,84558,1,PART,PRCNCT,PRSD,PRSD_SV,"2025-05-18 21:36:34",710,486,431,40,15,480,6,800,314,22,458
21,HARGHITA,"ŞCOALA GIMNAZIALĂ ”BETHLEN GÁBOR” LĂZAREA",156,LĂZAREA,84594,1,PART,PRCNCT,PRSD,PRSD_SV,"2025-05-18 22:01:10",1661,917,882,32,3,913,4,1700,783,31,882
21,HARGHITA,"ŞCOALA GIMNAZIALĂ ”BETHLEN GÁBOR” LĂZAREA",157,LĂZAREA,84594,1,PART,PRCNCT,PRSD,PRSD_SV,"2025-05-18 21:33:12",1103,635,613,21,1,633,2,1200,565,25,608
21,HARGHITA,"CASA COMUNITARĂ",158,LĂZAREA,84594,1,PART,PRCNCT,PRSD,PRSD_SV,"2025-05-18 21:17:52",150,89,75,14,0,89,0,300,211,6,83
21,HARGHITA,"CAMINUL CULTURAL",159,LELICENI,86479,1,PART,PRCNCT,PRSD,PRSD_SV,"2025-05-18 21:53:06",576,426,364,60,2,421,5,600,174,30,391
21,HARGHITA,"CAMINUL CULTURAL",160,LELICENI,86479,1,PART,PRCNCT,PRSD,PRSD_SV,"2025-05-18 21:49:46",409,300,268,32,0,297,3,500,200,8,289
21,HARGHITA,"SEDIU ADMINISTRATIV",161,LELICENI,86479,1,PART,PRCNCT,PRSD,PRSD_SV,"2025-05-18 21:25:28",951,583,544,39,0,579,4,1000,417,21,558
21,HARGHITA,"SEDIUL PRIMĂRIEI",162,LUETA,84629,1,PART,PRCNCT,PRSD,PRSD_SV,"2025-05-18 21:28:24",1439,798,751,40,7,798,0,1600,802,22,776
21,HARGHITA,"SEDIUL PRIMĂRIEI LUETA",163,LUETA,84629,1,PART,PRCNCT,PRSD,PRSD_SV,"2025-05-18 21:27:44",1581,928,854,62,12,924,4,1700,772,16,908
21,HARGHITA,"CLĂDIREA PRIMĂRIEI",164,"LUNCA DE JOS",84656,1,PART,PRCNCT,PRSD,PRSD_SV,"2025-05-18 21:31:50",594,380,323,42,15,377,3,700,320,26,351
21,HARGHITA,"ŞCOALA GIMNAZIALA ” MAJLATH GUSZTAV KAROLY”",165,"LUNCA DE JOS",84656,1,PART,PRCNCT,PRSD,PRSD_SV,"2025-05-18 21:43:33",1411,873,792,33,48,871,2,1500,627,31,840
21,HARGHITA,"ŞCOALA PRIMARA PUNTEA LUPULUI II",166,"LUNCA DE JOS",84656,1,PART,PRCNCT,PRSD,PRSD_SV,"2025-05-18 21:11:39",108,95,74,21,0,95,0,200,105,11,84
21,HARGHITA,"CĂMINUL CULTURAL VALEA RECE",167,"LUNCA DE JOS",84656,1,PART,PRCNCT,PRSD,PRSD_SV,"2025-05-18 21:40:37",1221,863,801,32,30,862,1,1300,437,18,844
21,HARGHITA,"ŞCOALA PRIMARA GURA VAII RECE",168,"LUNCA DE JOS",84656,1,PART,PRCNCT,PRSD,PRSD_SV,"2025-05-18 21:39:40",913,656,592,33,31,650,6,1000,344,37,613
21,HARGHITA,"PRIMĂRIA LUNCA DE SUS",169,"LUNCA DE SUS",84754,1,PART,PRCNCT,PRSD,PRSD_SV,"2025-05-18 21:36:40",1340,849,782,53,14,843,6,1400,551,56,787
21,HARGHITA,"ŞCOALA PRIMARĂ COMIAT",170,"LUNCA DE SUS",84754,1,PART,PRCNCT,PRSD,PRSD_SV,"2025-05-18 21:24:52",294,195,166,17,12,195,0,300,105,12,183
21,HARGHITA,"ŞCOALA GIMNAZIALĂ IZVORUL TROTUŞULUI",171,"LUNCA DE SUS",84754,1,PART,PRCNCT,PRSD,PRSD_SV,"2025-05-18 21:32:07",583,372,339,23,10,366,6,700,328,18,348
21,HARGHITA,"ŞCOALA PRIMARĂ PĂLTINIŞ-CIUC",172,"LUNCA DE SUS",84754,1,PART,PRCNCT,PRSD,PRSD_SV,"2025-05-18 21:35:19",424,257,228,27,2,255,2,500,243,17,238
21,HARGHITA,"ŞCOALA GIMNAZIALĂ ”TAMASI ARON” LUPENI",173,LUPENI,84825,1,PART,PRCNCT,PRSD,PRSD_SV,"2025-05-18 21:33:07",1628,1224,1094,83,47,1219,5,1700,476,26,1193
21,HARGHITA,"SCOALA GIMNAZIALĂ ”BENEDEK FIDEL” BISERICANI",174,LUPENI,84825,1,PART,PRCNCT,PRSD,PRSD_SV,"2025-05-18 21:48:51",590,487,414,58,15,486,1,700,213,19,467
21,HARGHITA,"SCOALA PRIMARĂ BULGĂRENI",175,LUPENI,84825,1,PART,PRCNCT,PRSD,PRSD_SV,"2025-05-18 21:24:46",233,200,154,32,14,200,0,300,100,9,191
21,HARGHITA,"CASA DE CULTURĂ MORĂRENI",176,LUPENI,84825,1,PART,PRCNCT,PRSD,PRSD_SV,"2025-05-18 21:28:11",660,496,451,30,15,495,1,700,204,13,482
21,HARGHITA,"CASA DE CULTURĂ PĂLTINIŞ",177,LUPENI,84825,1,PART,PRCNCT,PRSD,PRSD_SV,"2025-05-18 21:17:38",454,337,289,28,20,334,3,500,163,12,322
21,HARGHITA,"SCOALA PRIMARĂ PĂULENI",178,LUPENI,84825,1,PART,PRCNCT,PRSD,PRSD_SV,"2025-05-18 21:16:35",284,194,157,26,11,194,0,300,106,10,184
21,HARGHITA,"ŞCOALA GIMNAZIALĂ ”KISS FERENC”",179,MĂDĂRAŞ,86438,1,PART,PRCNCT,PRSD,PRSD_SV,"2025-05-18 21:50:29",1007,702,624,31,47,699,3,1100,398,11,688
21,HARGHITA,"ŞCOALA GIMNAZIALĂ ”KISS FERENC”",180,MĂDĂRAŞ,86438,1,PART,PRCNCT,PRSD,PRSD_SV,"2025-05-18 21:42:38",790,539,478,27,34,538,1,900,361,21,517
21,HARGHITA,"CĂMINUL CULTURAL MĂRTINIȘ",181,MĂRTINIŞ,84923,1,PART,PRCNCT,PRSD,PRSD_SV,"2025-05-18 21:32:55",521,404,296,57,51,400,4,500,96,22,378
21,HARGHITA,"ȘCOALA PRIMARĂ ALDEA",182,MĂRTINIŞ,84923,1,PART,PRCNCT,PRSD,PRSD_SV,"2025-05-18 21:18:20",316,159,136,23,0,155,4,400,241,3,152
21,HARGHITA,"ȘCOALA PRIMARĂ BĂDENI",183,MĂRTINIŞ,84923,1,PART,PRCNCT,PRSD,PRSD_SV,"2025-05-18 21:13:04",158,143,107,27,9,142,1,200,57,7,135
21,HARGHITA,"CĂMINUL CULTURAL CHINUȘU",184,MĂRTINIŞ,84923,1,PART,PRCNCT,PRSD,PRSD_SV,"2025-05-18 21:18:05",115,90,70,20,0,89,1,200,110,11,78
21,HARGHITA,"ȘCOALA PRIMARĂ COMĂNEȘTI",185,MĂRTINIŞ,84923,1,PART,PRCNCT,PRSD,PRSD_SV,"2025-05-18 21:14:14",197,106,74,29,3,106,0,200,94,16,90
21,HARGHITA,"ȘCOALA PRIMARĂ GHIPEȘ",186,MĂRTINIŞ,84923,1,PART,PRCNCT,PRSD,PRSD_SV,"2025-05-18 21:20:58",169,113,88,25,0,110,3,200,87,10,100
21,HARGHITA,"GRĂDINIȚA CU PROGRAM NORMAL ORĂȘENI",187,MĂRTINIŞ,84923,1,PART,PRCNCT,PRSD,PRSD_SV,"2025-05-18 21:34:46",206,173,141,32,0,173,0,200,27,6,167
21,HARGHITA,"ȘCOALA PRIMARĂ PETRENI",188,MĂRTINIŞ,84923,1,PART,PRCNCT,PRSD,PRSD_SV,"2025-05-18 21:16:05",144,120,92,28,0,119,1,200,80,16,103
21,HARGHITA,"ȘCOALA PRIMARĂ RAREȘ",189,MĂRTINIŞ,84923,1,PART,PRCNCT,PRSD,PRSD_SV,"2025-05-18 21:15:48",105,115,72,40,3,114,1,200,85,7,107
21,HARGHITA,"ȘCOALA GIMNAZIALĂ ”LÁSZLÓ GYULA” SÎNPAUL",190,MĂRTINIŞ,84923,1,PART,PRCNCT,PRSD,PRSD_SV,"2025-05-18 21:18:47",399,287,247,32,8,287,0,300,13,19,268
21,HARGHITA,"PRIMĂRIA MEREŞTI",191,MEREŞTI,85056,1,PART,PRCNCT,PRSD,PRSD_SV,"2025-05-18 21:30:16",1052,683,549,105,29,678,5,1100,417,32,646
21,HARGHITA,"SC.GIM. ARANY JANOS",192,MIHĂILENI,85074,1,PART,PRCNCT,PRSD,PRSD_SV,"2025-05-18 21:25:14",811,484,437,35,12,481,3,900,416,29,452
21,HARGHITA,"SCOALA GIMNAZIALA",193,MIHĂILENI,85074,1,PART,PRCNCT,PRSD,PRSD_SV,"2025-05-18 21:23:21",397,188,167,21,0,188,0,400,212,95,93
21,HARGHITA,"SCOALA PRIMARA",194,MIHĂILENI,85074,1,PART,PRCNCT,PRSD,PRSD_SV,"2025-05-18 21:26:25",486,325,260,45,20,321,4,500,175,12,309
21,HARGHITA,"SCOALA PRIMARA",195,MIHĂILENI,85074,1,PART,PRCNCT,PRSD,PRSD_SV,"2025-05-18 21:23:58",511,358,316,30,12,355,3,600,242,11,344
21,HARGHITA,"CĂMINUL CULTURAL MUGENI",196,MUGENI,85127,1,PART,PRCNCT,PRSD,PRSD_SV,"2025-05-18 21:42:34",981,546,473,51,22,543,3,1000,454,36,507
21,HARGHITA,"PAROHIA REFORMATĂ ALUNIȘ",197,MUGENI,85127,1,PART,PRCNCT,PRSD,PRSD_SV,"2025-05-18 21:28:01",130,112,92,16,4,112,0,200,88,5,107
21,HARGHITA,"CĂMINUL CULTURAL BETA",198,MUGENI,85127,1,PART,PRCNCT,PRSD,PRSD_SV,"2025-05-18 21:23:04",266,182,154,24,4,182,0,300,118,13,169
21,HARGHITA,"CĂMINUL CULTURAL DEJUŢIU",199,MUGENI,85127,1,PART,PRCNCT,PRSD,PRSD_SV,"2025-05-18 21:26:39",170,120,96,22,2,119,1,200,80,6,113
21,HARGHITA,"CASA DE RUGĂCIUNI DOBENI",200,MUGENI,85127,1,PART,PRCNCT,PRSD,PRSD_SV,"2025-05-18 21:28:14",473,326,285,37,4,325,1,500,174,14,311
21,HARGHITA,"CĂMINUL CULTURAL LUTIŢA",201,MUGENI,85127,1,PART,PRCNCT,PRSD,PRSD_SV,"2025-05-18 21:42:29",611,424,385,23,16,421,3,600,176,18,403
21,HARGHITA,"CĂMINUL CULTURAL MĂTIŞENI",202,MUGENI,85127,1,PART,PRCNCT,PRSD,PRSD_SV,"2025-05-18 21:19:52",112,92,74,18,0,92,0,200,108,5,87
21,HARGHITA,"ȘCOALA GIMNAZIALĂ „MÁRTON ÁRON”, TĂIETURA",203,MUGENI,85127,1,PART,PRCNCT,PRSD,PRSD_SV,"2025-05-18 21:28:38",203,141,105,27,9,140,1,200,59,12,128
21,HARGHITA,"ȘCOALA GIMNAZIALĂ ”KELEMEN IMRE” OCLAND",204,OCLAND,85243,1,PART,PRCNCT,PRSD,PRSD_SV,"2025-05-18 21:21:14",581,387,337,40,10,387,0,600,213,20,367
21,HARGHITA,"CĂMINUL CULTURAL",205,OCLAND,85243,1,PART,PRCNCT,PRSD,PRSD_SV,"2025-05-18 21:16:52",394,291,238,41,12,288,3,500,209,21,267
21,HARGHITA,"CĂMINUL CULTURAL PĂULENI-CIUC",206,PĂULENI-CIUC,83375,1,PART,PRCNCT,PRSD,PRSD_SV,"2025-05-18 21:35:17",572,392,345,44,3,390,2,600,208,17,373
21,HARGHITA,"SCOALA PRIMARĂ DELNIŢA",207,PĂULENI-CIUC,83375,1,PART,PRCNCT,PRSD,PRSD_SV,"2025-05-18 21:29:55",643,476,418,47,11,476,0,700,224,11,465
21,HARGHITA,"SCOALA PRIMARĂ ŞOIMENI",208,PĂULENI-CIUC,83375,1,PART,PRCNCT,PRSD,PRSD_SV,"2025-05-18 21:29:08",563,418,357,51,10,412,6,600,182,17,395
21,HARGHITA,"CASA DE CULTURĂ PLĂIEȘII DE JOS",209,"PLĂIEŞII DE JOS",85289,1,PART,PRCNCT,PRSD,PRSD_SV,"2025-05-18 21:46:34",634,388,329,45,14,388,0,700,312,16,372
21,HARGHITA,"ȘCOALA GIMNAZIALĂ TUZSON JÁNOS NR.2 CASINU NOU",210,"PLĂIEŞII DE JOS",85289,1,PART,PRCNCT,PRSD,PRSD_SV,"2025-05-18 21:39:26",548,357,303,40,14,350,7,600,243,19,331
21,HARGHITA,"ȘCOALA PRIMARĂ DR.PATAKI JÓZSEF NR.3 IACOBENI",211,"PLĂIEŞII DE JOS",85289,1,PART,PRCNCT,PRSD,PRSD_SV,"2025-05-18 21:38:29",292,174,134,32,8,172,2,300,126,29,143
21,HARGHITA,"ȘCOALA GIMNAZIALĂ NR.4 PLĂIEȘII DE SUS",212,"PLĂIEŞII DE JOS",85289,1,PART,PRCNCT,PRSD,PRSD_SV,"2025-05-18 21:39:02",625,355,310,36,9,347,8,700,345,33,314
21,HARGHITA,"CĂMIN CULTURAL FELEKI MIKLÓS",213,PORUMBENI,86487,1,PART,PRCNCT,PRSD,PRSD_SV,"2025-05-18 21:33:06",1029,681,598,64,19,677,4,1100,419,27,650
21,HARGHITA,"CĂMINUL CULTURAL",214,PORUMBENI,86487,1,PART,PRCNCT,PRSD,PRSD_SV,"2025-05-18 21:18:43",413,301,256,31,14,298,3,500,199,16,282
21,HARGHITA,"PRIMARIA COMUNEI PRAID- SALA DE SEDINTE AL CONS.LOCAL",215,PRAID,85341,1,PART,PRCNCT,PRSD,PRSD_SV,"2025-05-18 21:49:18",1481,907,782,114,11,900,7,1600,693,49,851
21,HARGHITA,"CAMINUL CULTURAL PRAID",216,PRAID,85341,1,PART,PRCNCT,PRSD,PRSD_SV,"2025-05-18 21:39:30",1549,771,694,73,4,760,11,1600,829,36,724
21,HARGHITA,"CĂMINUL CULTURAL BECAŞ",217,PRAID,85341,2,PART,PRCNCT,PRSD,PRSD_SV,"2025-05-19 01:35:29",101,64,45,19,0,64,0,300,236,5,59
21,HARGHITA,"ŞCOALA GIMNAZIALĂ ”SUKOSD FERENC” OCNA DE JOS",218,PRAID,85341,1,PART,PRCNCT,PRSD,PRSD_SV,"2025-05-18 21:48:12",1177,773,681,39,53,764,9,1300,527,27,737
21,HARGHITA,"ŞCOALA GIMNAZIALĂ ”SZEKELY MOZES” OCNA DE SUS",219,PRAID,85341,1,PART,PRCNCT,PRSD,PRSD_SV,"2025-05-18 22:14:56",1197,600,512,43,45,598,2,1300,700,33,565
21,HARGHITA,"CASA DE CULTURĂ RACU",220,RACU,86495,1,PART,PRCNCT,PRSD,PRSD_SV,"2025-05-18 21:19:18",908,644,560,41,43,643,1,1000,356,39,604
21,HARGHITA,"ŞCOALA GIMNAZIALĂ GÂRCIU",221,RACU,86495,1,PART,PRCNCT,PRSD,PRSD_SV,"2025-05-18 21:41:57",374,290,241,35,14,289,1,400,110,11,278
21,HARGHITA,"ȘCOALA GENERALA ”BALÁS JENŐ”",222,REMETEA,85412,1,PART,PRCNCT,PRSD,PRSD_SV,"2025-05-18 21:23:49",1137,760,678,17,65,759,1,1200,440,46,713
21,HARGHITA,"GRĂDINITA DE COPII ALSZEG",223,REMETEA,85412,1,PART,PRCNCT,PRSD,PRSD_SV,"2025-05-18 21:29:21",1378,884,785,46,53,879,5,1600,716,63,816
21,HARGHITA,"SCOLA GIMNAZIALA FRÁTER GYÖRGY",224,REMETEA,85412,1,PART,PRCNCT,PRSD,PRSD_SV,"2025-05-18 21:30:15",1367,900,805,41,54,893,7,1500,600,37,856
21,HARGHITA,"GRADINIȚA DE COPII TULAMAROS",225,REMETEA,85412,1,PART,PRCNCT,PRSD,PRSD_SV,"2025-05-18 21:34:38",1238,815,726,42,47,813,2,1300,485,35,778
21,HARGHITA,"CENTRUL DE INFORMARE TURISTICĂ",226,"SATU MARE",86501,1,PART,PRCNCT,PRSD,PRSD_SV,"2025-05-18 21:26:06",761,539,487,52,0,536,3,800,261,27,509
21,HARGHITA,"CAMINUL CULTURAL SATU MARE",227,"SATU MARE",86501,1,PART,PRCNCT,PRSD,PRSD_SV,"2025-05-18 21:16:21",863,443,401,42,0,442,1,1000,557,27,415
21,HARGHITA,"PRIMĂRIA COMUNEI SĂCEL",228,SĂCEL,85467,1,PART,PRCNCT,PRSD,PRSD_SV,"2025-05-18 21:26:40",88,38,21,17,0,38,0,200,162,15,23
21,HARGHITA,"ȘCOALA GENERALĂ ȘOIMUȘU MARE",229,SĂCEL,85467,1,PART,PRCNCT,PRSD,PRSD_SV,"2025-05-18 21:26:34",255,124,103,21,0,124,0,300,176,17,107
21,HARGHITA,"ȘCOALA GIMNAZIALĂ „AUGUSZTINOVICS PÁL” ȘOIMUȘU MIC",230,SĂCEL,85467,1,PART,PRCNCT,PRSD,PRSD_SV,"2025-05-18 21:24:51",313,203,172,31,0,199,4,300,97,23,176
21,HARGHITA,"CĂMIN CULTURAL VIDACUT",231,SĂCEL,85467,1,PART,PRCNCT,PRSD,PRSD_SV,"2025-05-18 21:17:34",240,104,75,29,0,101,3,200,96,54,47
21,HARGHITA,"ȘCOALA GIMNAZIALĂ ”SFÂNTU ANDREI ”SĂRMAȘ",232,SĂRMAŞ,85528,1,PART,PRCNCT,PRSD,PRSD_SV,"2025-05-18 21:41:45",1043,490,443,46,1,486,4,1100,610,246,240
21,HARGHITA,"ȘCOALA PRIMARĂ FUNDOAIA",233,SĂRMAŞ,85528,1,PART,PRCNCT,PRSD,PRSD_SV,"2025-05-18 21:16:07",511,294,272,21,1,291,3,600,306,180,111
21,HARGHITA,"ȘCOALA GIMNAZIALĂ HODOȘA GARĂ",234,SĂRMAŞ,85528,1,PART,PRCNCT,PRSD,PRSD_SV,"2025-05-18 21:28:22",1153,510,470,36,4,507,3,1200,690,210,297
21,HARGHITA,"ȘCOALA PRIMARĂ PLATONEȘTI",235,SĂRMAŞ,85528,1,PART,PRCNCT,PRSD,PRSD_SV,"2025-05-18 21:27:31",378,219,189,30,0,218,1,500,281,117,101
21,HARGHITA,"ŞCOALA GIMNAZIALĂ SÂNCRĂIENI",236,SÂNCRĂIENI,85680,1,PART,PRCNCT,PRSD,PRSD_SV,"2025-05-18 21:30:46",1152,755,674,50,31,753,2,1200,445,27,726
21,HARGHITA,"ŞCOALA GIMNAZIALĂ SÂNCRĂIENI",237,SÂNCRĂIENI,85680,1,PART,PRCNCT,PRSD,PRSD_SV,"2025-05-18 21:25:28",1000,694,632,48,14,693,1,1000,306,29,664
21,HARGHITA,"PRIMĂRIA SÎNDOMINIC",238,SÂNDOMINIC,85760,1,PART,PRCNCT,PRSD,PRSD_SV,"2025-05-18 21:31:27",1477,954,872,28,54,948,6,1600,646,19,929
21,HARGHITA,"PRIMĂRIA SÎNDOMINIC",239,SÂNDOMINIC,85760,1,PART,PRCNCT,PRSD,PRSD_SV,"2025-05-18 21:31:54",1462,961,866,40,55,958,3,1600,639,37,921
21,HARGHITA,"ŞCOALA GIMNAZIALĂ MARTON ARON SÎNDOMINIC",240,SÂNDOMINIC,85760,1,PART,PRCNCT,PRSD,PRSD_SV,"2025-05-18 21:38:10",1065,690,629,33,28,687,3,1200,510,24,663
21,HARGHITA,"ȘCOALA GIMNAZIALĂ MARTON ARON SÎNDOMINIC",241,SÂNDOMINIC,85760,1,PART,PRCNCT,PRSD,PRSD_SV,"2025-05-18 21:30:40",1052,675,616,23,36,674,1,1200,525,19,655
21,HARGHITA,"PRIMARIA SÎNMARTIN",242,SÂNMARTIN,85788,1,PART,PRCNCT,PRSD,PRSD_SV,"2025-05-18 21:43:00",908,675,613,39,23,667,8,1000,325,11,656
21,HARGHITA,"PRIMARIA SÎNMARTIN",243,SÂNMARTIN,85788,1,PART,PRCNCT,PRSD,PRSD_SV,"2025-05-18 21:50:13",884,537,496,28,13,530,7,1000,463,16,514
21,HARGHITA,"CĂMINUL CULTURAL",244,SÂNSIMION,85840,1,PART,PRCNCT,PRSD,PRSD_SV,"2025-05-18 21:34:56",730,529,434,78,17,524,5,800,271,33,491
21,HARGHITA,"CĂMINUL CULTURAL",245,SÂNSIMION,85840,1,PART,PRCNCT,PRSD,PRSD_SV,"2025-05-18 21:51:11",1206,780,734,8,38,776,4,1200,420,30,746
21,HARGHITA,"ȘCOALA PRIMARĂ ”BENEDEK ELEK”",246,SÂNSIMION,85840,1,PART,PRCNCT,PRSD,PRSD_SV,"2025-05-18 21:34:34",871,609,539,37,33,602,7,1000,391,29,573
21,HARGHITA,"ŞCOALA GIMNAZIALĂ ”ARANY JÁNOS” SÂNTIMBRU",247,SÂNTIMBRU,86519,1,PART,PRCNCT,PRSD,PRSD_SV,"2025-05-18 21:47:33",973,646,592,35,19,643,3,1100,454,21,622
21,HARGHITA,"ŞCOALA PRIMARĂ PÁLSZEG SÂNTIMBRU",248,SÂNTIMBRU,86519,1,PART,PRCNCT,PRSD,PRSD_SV,"2025-05-18 22:01:06",720,474,423,27,24,472,2,800,326,30,442
21,HARGHITA,"CAMIN CULTURAL",249,SECUIENI,85582,1,PART,PRCNCT,PRSD,PRSD_SV,"2025-05-18 21:47:50",646,322,281,41,0,318,4,700,378,63,255
21,HARGHITA,"BIROU ADMINISTRATIV",250,SECUIENI,85582,1,PART,PRCNCT,PRSD,PRSD_SV,"2025-05-18 21:21:43",707,392,360,32,0,388,4,800,408,56,332
21,HARGHITA,"CAMIN CULTURAL",251,SECUIENI,85582,1,PART,PRCNCT,PRSD,PRSD_SV,"2025-05-18 21:38:48",954,375,331,43,1,372,3,1000,625,114,258
21,HARGHITA,"PRIMĂRIA COMUNEI SICULENI",252,SICULENI,85626,1,PART,PRCNCT,PRSD,PRSD_SV,"2025-05-18 21:28:36",1149,738,631,45,62,733,5,1200,462,47,686
21,HARGHITA,"ȘCOALA GIMNAZIALĂ ZOLD PETER SICULENI",253,SICULENI,85626,1,PART,PRCNCT,PRSD,PRSD_SV,"2025-05-18 21:19:22",1059,796,676,48,72,787,9,1200,404,18,769
21,HARGHITA,"LICEUL MIRON CRISTEA SUBCETATE",254,SUBCETATE,85877,1,PART,PRCNCT,PRSD,PRSD_SV,"2025-05-18 21:30:12",1405,598,540,57,1,588,10,1600,1002,312,276
21,HARGHITA,"PRIMĂRIA COMUNEI SUSENI",255,SUSENI,85920,1,PART,PRCNCT,PRSD,PRSD_SV,"2025-05-18 21:56:02",875,560,530,30,0,558,2,900,340,23,535
21,HARGHITA,"PRIMĂRIA COMUNEI SUSENI",256,SUSENI,85920,1,PART,PRCNCT,PRSD,PRSD_SV,"2025-05-18 21:46:57",836,523,495,26,2,522,1,900,377,18,504
21,HARGHITA,"ŞCOALA PRIMARĂ - MUREŞ SAT",257,SUSENI,85920,1,PART,PRCNCT,PRSD,PRSD_SV,"2025-05-18 21:57:16",706,425,405,20,0,425,0,800,375,16,409
21,HARGHITA,"ŞCOALA PRIMARĂ CHILENI",258,SUSENI,85920,1,PART,PRCNCT,PRSD,PRSD_SV,"2025-05-18 21:30:37",622,371,351,20,0,371,0,700,329,17,354
21,HARGHITA,"ŞCOALA PRIMARĂ LIBAN",259,SUSENI,85920,1,PART,PRCNCT,PRSD,PRSD_SV,"2025-05-18 21:22:50",55,61,23,38,0,61,0,200,139,4,57
21,HARGHITA,"ŞCOALA GIMNAZIALĂ ”TARISZNYÁS MÁRTON” VALEA STRÂMBĂ",260,SUSENI,85920,1,PART,PRCNCT,PRSD,PRSD_SV,"2025-05-18 21:42:26",1116,517,481,36,0,512,5,1100,583,24,488
21,HARGHITA,"CLÃDIREA PRIMÃRIEI ŞIMONEŞTI",261,ŞIMONEŞTI,85984,1,PART,PRCNCT,PRSD,PRSD_SV,"2025-05-18 21:47:09",1118,604,514,47,43,601,3,1100,496,51,550
21,HARGHITA,"CÃMINUL CULTURAL CEHEŢEL",262,ŞIMONEŞTI,85984,1,PART,PRCNCT,PRSD,PRSD_SV,"2025-05-18 21:28:59",92,65,39,22,4,65,0,200,135,5,60
21,HARGHITA,"CÃMINUL CULTURAL COBĂTEŞTI",263,ŞIMONEŞTI,85984,1,PART,PRCNCT,PRSD,PRSD_SV,"2025-05-18 21:39:03",444,355,281,35,39,351,4,400,45,16,335
21,HARGHITA,"ŞCOALĂ PRIMARĂ MEDIŞORU MARE",264,ŞIMONEŞTI,85984,1,PART,PRCNCT,PRSD,PRSD_SV,"2025-05-18 21:28:42",77,63,35,25,3,62,1,200,137,6,56
21,HARGHITA,"CÃMINUL CULTURAL MIHĂILENI",265,ŞIMONEŞTI,85984,1,PART,PRCNCT,PRSD,PRSD_SV,"2025-05-18 21:32:42",434,339,270,43,26,338,1,400,61,18,320
21,HARGHITA,"CÃMINUL CULTURAL RUGĂNEŞTI",266,ŞIMONEŞTI,85984,1,PART,PRCNCT,PRSD,PRSD_SV,"2025-05-18 21:27:15",693,396,340,40,16,394,2,700,304,25,369
21,HARGHITA,"CÃMINUL CULTURAL TĂRCEŞTI",267,ŞIMONEŞTI,85984,1,PART,PRCNCT,PRSD,PRSD_SV,"2025-05-18 21:24:27",183,134,117,15,2,134,0,200,66,9,125
21,HARGHITA,"CÃMINUL CULTURAL TURDENI",268,ŞIMONEŞTI,85984,1,PART,PRCNCT,PRSD,PRSD_SV,"2025-05-18 21:21:22",70,69,42,23,4,68,1,200,131,8,60
21,HARGHITA,"CLĂDIREA CĂMINULUI CULTURAL TOMEȘTI",269,TOMEŞTI,86453,1,PART,PRCNCT,PRSD,PRSD_SV,"2025-05-18 21:35:30",1149,745,670,41,34,744,1,1300,555,23,721
21,HARGHITA,"CLĂDIREA CĂMINULUI CULTURAL TOMEȘTI",270,TOMEŞTI,86453,1,PART,PRCNCT,PRSD,PRSD_SV,"2025-05-18 21:54:03",978,643,597,24,22,640,3,1100,457,12,628
21,HARGHITA,"ŞCOALA GIMNAZIALĂ TULGHEŞ",271,TULGHEŞ,86133,1,PART,PRCNCT,PRSD,PRSD_SV,"2025-05-18 21:37:26",1333,686,543,86,57,681,5,1400,714,326,355
21,HARGHITA,"ŞCOALA PRIMARĂ PUTNA",272,TULGHEŞ,86133,1,PART,PRCNCT,PRSD,PRSD_SV,"2025-05-18 21:27:09",446,246,221,25,0,245,1,500,254,173,72
21,HARGHITA,"ŞCOALA PRIMARĂ VALEA FRUMOASĂ",273,TULGHEŞ,86133,1,PART,PRCNCT,PRSD,PRSD_SV,"2025-05-18 21:28:54",565,217,196,21,0,216,1,600,383,112,104
21,HARGHITA,"ŞCOALA PRIMARĂ RECEA",274,TULGHEŞ,86133,1,PART,PRCNCT,PRSD,PRSD_SV,"2025-05-18 21:18:58",203,95,73,20,2,94,1,300,205,37,57
21,HARGHITA,"CĂMINUL CULTURAL TUȘNAD",275,TUŞNAD,86188,1,PART,PRCNCT,PRSD,PRSD_SV,"2025-05-18 21:32:28",726,444,378,46,20,441,3,800,356,49,392
21,HARGHITA,"CĂMINUL CULTURAL",276,TUŞNAD,86188,1,PART,PRCNCT,PRSD,PRSD_SV,"2025-05-18 21:52:14",846,526,460,52,14,522,4,900,374,51,471
21,HARGHITA,"CĂMINUL CULTURAL",277,TUŞNAD,86188,1,PART,PRCNCT,PRSD,PRSD_SV,"2025-05-18 21:16:40",162,127,97,21,9,123,4,200,73,8,115
21,HARGHITA,"CĂMINUL CULTURAL ULIEȘ",278,ULIEŞ,86222,1,PART,PRCNCT,PRSD,PRSD_SV,"2025-05-18 21:17:23",291,192,156,36,0,192,0,300,108,7,185
21,HARGHITA,"ASOCIAȚIA COMPOSESORALĂ ”STEJARUL” DAIA",279,ULIEŞ,86222,1,PART,PRCNCT,PRSD,PRSD_SV,"2025-05-18 21:13:58",228,130,109,20,1,128,2,300,170,18,110
21,HARGHITA,"CĂMINUL CULTURAL IGHIU",280,ULIEŞ,86222,1,PART,PRCNCT,PRSD,PRSD_SV,"2025-05-18 21:11:38",47,37,16,21,0,37,0,200,163,8,29
21,HARGHITA,"CĂMINUL CULTURAL NICOLEȘTI",281,ULIEŞ,86222,1,PART,PRCNCT,PRSD,PRSD_SV,"2025-05-18 21:20:35",193,141,104,37,0,141,0,200,59,3,138
21,HARGHITA,"CĂMINUL CULTURAL PETECU",282,ULIEŞ,86222,1,PART,PRCNCT,PRSD,PRSD_SV,"2025-05-18 21:20:23",175,102,61,41,0,102,0,200,98,12,90
21,HARGHITA,"PRIMĂRIA COMUNEI VĂRȘAG",283,VĂRŞAG,86311,1,PART,PRCNCT,PRSD,PRSD_SV,"2025-05-18 21:37:00",1096,765,669,91,5,764,1,1200,435,31,733
21,HARGHITA,"ȘCOALĂ PRIMARĂ SOLYOMKO",284,VĂRŞAG,86311,1,PART,PRCNCT,PRSD,PRSD_SV,"2025-05-18 21:26:19",271,183,155,26,2,182,1,400,217,14,168
21,HARGHITA,"ȘCOALA GIMNAZIALĂ ”TEODOR CHINDEA” VOȘLĂBENI",285,VOŞLĂBENI,86339,1,PART,PRCNCT,PRSD,PRSD_SV,"2025-05-18 21:35:42",928,469,360,109,0,459,10,1100,631,224,235
21,HARGHITA,"ȘCOALA PRIMARĂ ”ION CREANGĂ” IZVORU MUREȘULUI",286,VOŞLĂBENI,86339,1,PART,PRCNCT,PRSD,PRSD_SV,"2025-05-18 21:40:49",656,427,313,110,4,423,4,800,373,114,309
21,HARGHITA,"GRĂDINIŢA CU PROGRAM NORMAL ALSZEG ZETEA",287,ZETEA,86366,1,PART,PRCNCT,PRSD,PRSD_SV,"2025-05-18 21:43:23",1224,753,716,32,5,747,6,1200,447,48,699
21,HARGHITA,"PRIMĂRIA ZETEA",288,ZETEA,86366,1,PART,PRCNCT,PRSD,PRSD_SV,"2025-05-18 21:48:55",1230,836,733,96,7,830,6,1200,364,34,796
21,HARGHITA,"ŞCOALA PRIMARĂ TOFĂLĂU ZETEA",289,ZETEA,86366,1,PART,PRCNCT,PRSD,PRSD_SV,"2025-05-18 21:32:40",1132,754,714,28,12,752,2,1200,446,27,725
21,HARGHITA,"ŞCOALA PRIMARĂ ”SZÉKELY JÁNOS” IZVOARE",290,ZETEA,86366,1,PART,PRCNCT,PRSD,PRSD_SV,"2025-05-18 21:23:10",343,272,204,68,0,272,0,400,128,8,264
21,HARGHITA,"ŞCOALA GIMNAZIALĂ ”JÓKAI MÓR” SUB CETATE",291,ZETEA,86366,1,PART,PRCNCT,PRSD,PRSD_SV,"2025-05-18 21:31:12",705,505,427,71,7,505,0,800,295,24,481
21,HARGHITA,"CĂMIN CULTURAL ŞICASĂU",292,ZETEA,86366,1,PART,PRCNCT,PRSD,PRSD_SV,"2025-05-18 21:27:22",129,109,71,38,0,109,0,244,135,6,103
22,HUNEDOARA,"CENTRUL CULTURAL DRĂGAN MUNTEAN",1,"MUNICIPIUL DEVA",86687,1,PART,PRCNCT,PRSD,PRSD_SV,"2025-05-18 23:10:03",1671,1047,873,174,0,1026,21,1800,753,332,694
22,HUNEDOARA,"CENTRUL CULTURAL DRĂGAN MUNTEAN",2,"MUNICIPIUL DEVA",86687,1,PART,PRCNCT,PRSD,PRSD_SV,"2025-05-18 21:42:52",1092,622,546,76,0,610,12,1200,578,227,383
22,HUNEDOARA,"CENTRUL CULTURAL DRĂGAN MUNTEAN",3,"MUNICIPIUL DEVA",86687,1,PART,PRCNCT,PRSD,PRSD_SV,"2025-05-18 21:43:49",1402,738,694,42,2,728,10,1500,762,227,501
22,HUNEDOARA,"ȘCOALA GIMNAZIALĂ „ANDREI ȘAGUNA”",4,"MUNICIPIUL DEVA",86687,1,PART,PRCNCT,PRSD,PRSD_SV,"2025-05-18 21:50:47",1254,657,623,34,0,652,5,1400,743,205,447
22,HUNEDOARA,"ȘCOALA GIMNAZIALĂ „ANDREI ȘAGUNA”",5,"MUNICIPIUL DEVA",86687,1,PART,PRCNCT,PRSD,PRSD_SV,"2025-05-18 22:00:13",1236,663,622,41,0,657,6,1300,637,249,408
22,HUNEDOARA,"ȘCOALA GIMNAZIALĂ „ANDREI ȘAGUNA”",6,"MUNICIPIUL DEVA",86687,1,PART,PRCNCT,PRSD,PRSD_SV,"2025-05-18 21:55:20",1228,651,568,83,0,640,11,1300,649,259,381
22,HUNEDOARA,"ȘCOALA GIMNAZIALĂ „ANDREI ȘAGUNA”",7,"MUNICIPIUL DEVA",86687,1,PART,PRCNCT,PRSD,PRSD_SV,"2025-05-18 21:53:44",1217,615,576,37,2,596,19,1300,685,189,407
22,HUNEDOARA,"ȘCOALA GIMNAZIALĂ „ANDREI ȘAGUNA”",8,"MUNICIPIUL DEVA",86687,1,PART,PRCNCT,PRSD,PRSD_SV,"2025-05-18 21:59:10",1304,733,661,72,0,720,13,1400,667,268,452
22,HUNEDOARA,"PALATUL COPIILOR DEVA",9,"MUNICIPIUL DEVA",86687,1,PART,PRCNCT,PRSD,PRSD_SV,"2025-05-18 22:08:36",1145,689,616,72,1,676,13,1200,511,235,441
22,HUNEDOARA,"COLEGIUL NAȚIONAL PEDAGOGIC”REGINA MARIA”",10,"MUNICIPIUL DEVA",86687,1,PART,PRCNCT,PRSD,PRSD_SV,"2025-05-18 21:56:35",1140,710,610,99,1,701,9,1200,490,218,483
22,HUNEDOARA,"COLEGIUL NAŢIONAL ”DECEBAL”",11,"MUNICIPIUL DEVA",86687,1,PART,PRCNCT,PRSD,PRSD_SV,"2025-05-18 21:41:59",1115,577,538,38,1,569,8,1200,623,204,365
22,HUNEDOARA,"COLEGIUL NAŢIONAL ”DECEBAL”",12,"MUNICIPIUL DEVA",86687,1,PART,PRCNCT,PRSD,PRSD_SV,"2025-05-18 22:33:43",1104,679,566,112,1,671,8,1200,521,226,445
22,HUNEDOARA,"GALERIA FORMA",13,"MUNICIPIUL DEVA",86687,1,PART,PRCNCT,PRSD,PRSD_SV,"2025-05-18 22:35:17",1226,851,665,129,57,827,24,1300,449,290,537
22,HUNEDOARA,"COLEGIUL NAȚIONAL SPORTIV CETATE DEVA",14,"MUNICIPIUL DEVA",86687,1,PART,PRCNCT,PRSD,PRSD_SV,"2025-05-18 22:18:52",1375,807,758,48,1,793,14,1500,693,249,544
22,HUNEDOARA,"COLEGIUL NAȚIONAL SPORTIV CETATE DEVA",15,"MUNICIPIUL DEVA",86687,1,PART,PRCNCT,PRSD,PRSD_SV,"2025-05-18 22:14:45",1174,654,587,67,0,642,12,1300,646,224,418
22,HUNEDOARA,"ŞCOALĂ PRIMARĂ VIILE NOI",16,"MUNICIPIUL DEVA",86687,1,PART,PRCNCT,PRSD,PRSD_SV,"2025-05-18 21:42:13",843,421,383,38,0,417,4,900,479,198,219
22,HUNEDOARA,"ŞCOALĂ PRIMARĂ VIILE NOI",17,"MUNICIPIUL DEVA",86687,1,PART,PRCNCT,PRSD,PRSD_SV,"2025-05-18 21:38:56",802,449,408,40,1,443,6,900,451,203,240
22,HUNEDOARA,"DIRECȚIA GENERALĂ DE ASISTENȚĂ SOCIALĂ ȘI PROTECȚIA COPILULUI",18,"MUNICIPIUL DEVA",86687,1,PART,PRCNCT,PRSD,PRSD_SV,"2025-05-18 22:22:06",1008,603,528,75,0,596,7,1100,497,189,407
22,HUNEDOARA,"DIRECŢIA SILVICĂ DEVA",19,"MUNICIPIUL DEVA",86687,1,PART,PRCNCT,PRSD,PRSD_SV,"2025-05-18 21:39:12",1131,629,533,94,2,617,12,1200,571,202,415
22,HUNEDOARA,"SPAŢIUL ADMINISTRATIV AL PRIMĂRIEI MUNICIPIULUI DEVA",20,"MUNICIPIUL DEVA",86687,1,PART,PRCNCT,PRSD,PRSD_SV,"2025-05-18 22:18:38",1229,869,622,183,64,849,20,1500,631,312,537
22,HUNEDOARA,"SALA SPORTURILOR",21,"MUNICIPIUL DEVA",86687,1,PART,PRCNCT,PRSD,PRSD_SV,"2025-05-18 22:18:36",1187,687,559,127,1,679,8,1300,613,320,359
22,HUNEDOARA,"COLEGIUL TEHNIC TRANSILVANIA (FOSTA ȘCOALĂ GENERALĂ)",22,"MUNICIPIUL DEVA",86687,1,PART,PRCNCT,PRSD,PRSD_SV,"2025-05-18 21:41:07",863,439,396,42,1,428,11,900,461,183,245
22,HUNEDOARA,"COLEGIUL TEHNIC TRANSILVANIA (FOSTA ȘCOALĂ GENERALĂ)",23,"MUNICIPIUL DEVA",86687,1,PART,PRCNCT,PRSD,PRSD_SV,"2025-05-18 21:42:29",731,352,320,32,0,348,4,800,448,128,220
22,HUNEDOARA,"COLEGIUL TEHNIC TRANSILVANIA (FOSTA ŞCOALĂ GENERALĂ)",24,"MUNICIPIUL DEVA",86687,1,PART,PRCNCT,PRSD,PRSD_SV,"2025-05-18 22:13:16",1372,732,694,38,0,720,12,1500,768,274,446
22,HUNEDOARA,"COLEGIUL TEHNIC TRANSILVANIA (FOSTA ŞCOALĂ GENERALĂ)",25,"MUNICIPIUL DEVA",86687,1,PART,PRCNCT,PRSD,PRSD_SV,"2025-05-18 22:19:17",1225,593,550,43,0,580,13,1300,707,277,303
22,HUNEDOARA,"COLEGIUL TEHNIC TRANSILVANIA (FOSTA ŞCOALĂ GENERALĂ)",26,"MUNICIPIUL DEVA",86687,1,PART,PRCNCT,PRSD,PRSD_SV,"2025-05-18 22:08:08",1494,712,664,48,0,696,16,1600,888,308,388
22,HUNEDOARA,"COLEGIUL TEHNIC TRANSILVANIA (FOSTA ȘCOALĂ GENERALĂ)",27,"MUNICIPIUL DEVA",86687,1,PART,PRCNCT,PRSD,PRSD_SV,"2025-05-18 22:02:29",1335,747,616,110,21,741,6,1400,653,274,467
22,HUNEDOARA,"COLEGIUL TEHNIC TRANSILVANIA(FOSTA ȘCOALĂ GENERALĂ)",28,"MUNICIPIUL DEVA",86687,2,PART,PRCNCT,PRSD,PRSD_SV,"2025-05-19 00:39:48",1478,744,692,52,0,732,12,1600,856,318,414
22,HUNEDOARA,"LICEUL DE ARTE SIGISMUND TODUŢĂ",29,"MUNICIPIUL DEVA",86687,1,PART,PRCNCT,PRSD,PRSD_SV,"2025-05-18 21:35:25",1103,734,582,108,44,720,14,1200,466,268,452
22,HUNEDOARA,"LICEUL DE ARTE SIGISMUND TODUŢĂ",30,"MUNICIPIUL DEVA",86687,1,PART,PRCNCT,PRSD,PRSD_SV,"2025-05-18 22:23:39",1358,680,636,44,0,668,12,1500,820,251,417
22,HUNEDOARA,"CLUB ŞCOLAR SPORTIV",31,"MUNICIPIUL DEVA",86687,1,PART,PRCNCT,PRSD,PRSD_SV,"2025-05-18 21:50:25",1214,697,625,71,1,687,10,1300,603,248,439
22,HUNEDOARA,"CASA MAGHIARĂ DEVA ( FOSTA CASA ARMATEI)",32,"MUNICIPIUL DEVA",86687,1,PART,PRCNCT,PRSD,PRSD_SV,"2025-05-18 21:52:25",1120,787,586,85,116,780,7,1200,413,324,456
22,HUNEDOARA,"CASA MAGHIARĂ DEVA (FOSTA CASA ARMATEI)",33,"MUNICIPIUL DEVA",86687,1,PART,PRCNCT,PRSD,PRSD_SV,"2025-05-18 21:56:39",1278,906,728,55,123,896,10,1400,494,351,545
22,HUNEDOARA,"LICEUL TEHNOLOGIC ENERGETIC ”DRAGOMIR HURMUZESCU”",34,"MUNICIPIUL DEVA",86687,1,PART,PRCNCT,PRSD,PRSD_SV,"2025-05-18 21:41:04",1411,587,527,59,1,577,10,1500,913,352,225
22,HUNEDOARA,"LICEUL TEHNOLOGIC ENERGETIC ”DRAGOMIR HURMUZESCU”",35,"MUNICIPIUL DEVA",86687,1,PART,PRCNCT,PRSD,PRSD_SV,"2025-05-18 21:30:05",1862,813,777,36,0,797,16,2000,1187,452,345
22,HUNEDOARA,"LICEUL TEHNOLOGIC ENERGETIC ”DRAGOMIR HURMUZESCU”",36,"MUNICIPIUL DEVA",86687,1,PART,PRCNCT,PRSD,PRSD_SV,"2025-05-18 21:45:53",1291,522,491,29,2,516,6,1400,878,304,212
22,HUNEDOARA,"GRADINIŢA P.N. NR.3",37,"MUNICIPIUL DEVA",86687,1,PART,PRCNCT,PRSD,PRSD_SV,"2025-05-18 21:59:23",1414,670,617,53,0,661,9,1500,830,345,316
22,HUNEDOARA,"GRADINIŢA P.N. NR.3",38,"MUNICIPIUL DEVA",86687,1,PART,PRCNCT,PRSD,PRSD_SV,"2025-05-18 21:41:26",1413,649,611,38,0,640,9,1500,851,308,332
22,HUNEDOARA,"LICEUL TEHNOLOGIC ”GRIGORE MOISIL”(FOSTUL LICEU MINIER)",39,"MUNICIPIUL DEVA",86687,1,PART,PRCNCT,PRSD,PRSD_SV,"2025-05-18 21:49:06",815,505,436,69,0,499,6,900,395,215,284
22,HUNEDOARA,"GRĂDINIȚA CU PROGRAM PRELUNGIT NR.2",40,"MUNICIPIUL DEVA",86687,1,PART,PRCNCT,PRSD,PRSD_SV,"2025-05-18 22:03:22",1103,653,496,62,95,645,8,1200,547,362,283
22,HUNEDOARA,"GRĂDINIȚA CU PROGRAM PRELUNGIT NR.2",41,"MUNICIPIUL DEVA",86687,1,PART,PRCNCT,PRSD,PRSD_SV,"2025-05-18 21:53:16",864,549,400,48,101,538,11,1000,451,270,268
22,HUNEDOARA,"GRĂDINIȚA CU PROGRAM PRELUNGIT NR.2",42,"MUNICIPIUL DEVA",86687,1,PART,PRCNCT,PRSD,PRSD_SV,"2025-05-18 21:51:55",850,501,374,24,103,488,13,900,399,242,246
22,HUNEDOARA,"ADĂPOSTUL DE URGENŢĂ PE TIMP DE NOAPTE",43,"MUNICIPIUL DEVA",86687,1,PART,PRCNCT,PRSD,PRSD_SV,"2025-05-18 22:05:39",885,502,462,40,0,495,7,900,398,290,205
22,HUNEDOARA,"CANTINA DE AJUTOR SOCIAL (FOSTA CANTINA LICEU MINER)",44,"MUNICIPIUL DEVA",86687,1,PART,PRCNCT,PRSD,PRSD_SV,"2025-05-18 21:36:00",991,560,507,53,0,551,9,1100,540,247,304
22,HUNEDOARA,"ȘCOALA PRIMARĂ CRISTUR",45,"MUNICIPIUL DEVA",86687,1,PART,PRCNCT,PRSD,PRSD_SV,"2025-05-18 22:04:50",1405,945,749,61,135,927,18,2000,1055,396,531
22,HUNEDOARA,"CĂMINUL CULTURAL SÎNTUHALM",46,"MUNICIPIUL DEVA",86687,1,PART,PRCNCT,PRSD,PRSD_SV,"2025-05-18 21:36:23",637,477,346,37,94,467,10,700,223,246,221
22,HUNEDOARA,"CASA DE CULTURA",47,"MUNICIPIUL BRAD",87291,1,PART,PRCNCT,PRSD,PRSD_SV,"2025-05-18 22:29:20",813,445,357,87,1,439,6,900,455,154,285
22,HUNEDOARA,"CASA DE CULTURA",48,"MUNICIPIUL BRAD",87291,1,PART,PRCNCT,PRSD,PRSD_SV,"2025-05-18 22:01:51",887,504,426,52,26,492,12,1100,596,226,266
22,HUNEDOARA,"ŞCOALA GIMNAZIALA „MIRCEA SÂNTIMBREANU”",49,"MUNICIPIUL BRAD",87291,1,PART,PRCNCT,PRSD,PRSD_SV,"2025-05-18 21:43:19",1397,732,664,68,0,721,11,1500,768,310,411
22,HUNEDOARA,"ŞCOALA GIMNAZIALĂ „MIRCEA SÂNTIMBREANU”",50,"MUNICIPIUL BRAD",87291,1,PART,PRCNCT,PRSD,PRSD_SV,"2025-05-18 21:34:24",1170,562,506,56,0,553,9,1300,738,264,289
22,HUNEDOARA,"ŞCOALA GIMNAZIALĂ „MIRCEA SÂNTIMBREANU”",51,"MUNICIPIUL BRAD",87291,1,PART,PRCNCT,PRSD,PRSD_SV,"2025-05-18 21:36:59",1165,545,514,31,0,527,18,1400,855,306,221
22,HUNEDOARA,"ŞCOALA GIMNAZIALĂ „MIRCEA SÂNTIMBREANU”",52,"MUNICIPIUL BRAD",87291,1,PART,PRCNCT,PRSD,PRSD_SV,"2025-05-18 21:38:10",1187,586,497,72,17,570,16,1400,814,318,252
22,HUNEDOARA,"LICEUL TEORETIC „AVRAM IANCU” BRAD",53,"MUNICIPIUL BRAD",87291,1,PART,PRCNCT,PRSD,PRSD_SV,"2025-05-18 21:47:35",928,469,429,38,2,465,4,1000,531,254,211
22,HUNEDOARA,"LICEUL TEORETIC „AVRAM IANCU” BRAD",54,"MUNICIPIUL BRAD",87291,1,PART,PRCNCT,PRSD,PRSD_SV,"2025-05-18 22:03:39",992,585,513,72,0,571,14,1100,515,321,250
22,HUNEDOARA,"GRĂDINIŢA P.P. ”FLOARE DE COLŢ”",55,"MUNICIPIUL BRAD",87291,1,PART,PRCNCT,PRSD,PRSD_SV,"2025-05-18 21:57:27",1029,570,493,46,31,564,6,1200,630,256,308
22,HUNEDOARA,"ŞCOALA GIMNAZIALĂ „HOREA CLOŞCA ŞI CRIŞAN”",56,"MUNICIPIUL BRAD",87291,1,PART,PRCNCT,PRSD,PRSD_SV,"2025-05-18 21:55:07",1034,532,426,73,33,518,14,1100,568,278,240
22,HUNEDOARA,"CĂMINUL CULTURAL MESTEACĂN",57,"MUNICIPIUL BRAD",87291,1,PART,PRCNCT,PRSD,PRSD_SV,"2025-05-18 21:36:56",417,228,207,21,0,223,5,500,272,122,101
22,HUNEDOARA,"CĂMINUL CULTURAL RUDA-BRAD",58,"MUNICIPIUL BRAD",87291,2,PART,PRCNCT,PRSD,PRSD_SV,"2025-05-18 23:40:07",149,79,60,19,0,76,3,200,121,55,21
22,HUNEDOARA,"ȘCOALA GENERALĂ ŢĂRĂŢEL",59,"MUNICIPIUL BRAD",87291,1,PART,PRCNCT,PRSD,PRSD_SV,"2025-05-18 21:16:22",562,303,274,28,1,302,1,600,297,170,132
22,HUNEDOARA,"ŞCOALA GENERALĂ VALEA BRADULUI",60,"MUNICIPIUL BRAD",87291,1,PART,PRCNCT,PRSD,PRSD_SV,"2025-05-18 21:28:06",583,286,263,23,0,284,2,650,364,168,116
22,HUNEDOARA,"ȘCOALA GIMNAZIALĂ NR. 1 ( FOSTA ȘCOALĂ GENERALĂ NR. 12)",61,"MUNICIPIUL HUNEDOARA",86810,1,PART,PRCNCT,PRSD,PRSD_SV,"2025-05-18 21:37:59",1405,544,503,41,0,522,22,1472,928,347,175
22,HUNEDOARA,"ȘCOALA GIMNAZIALĂ NR. 1 ( FOSTA ȘCOALĂ GENERALĂ NR. 12)",62,"MUNICIPIUL HUNEDOARA",86810,1,PART,PRCNCT,PRSD,PRSD_SV,"2025-05-18 21:33:48",1348,473,441,32,0,469,4,1500,1027,353,116
22,HUNEDOARA,"ȘCOALA GIMNAZIALĂ NR. 1 ( FOSTA ȘCOALĂ GENERALĂ NR. 12)",63,"MUNICIPIUL HUNEDOARA",86810,1,PART,PRCNCT,PRSD,PRSD_SV,"2025-05-18 21:28:39",1376,484,455,29,0,481,3,1500,1016,356,125
22,HUNEDOARA,"ŞCOALA GIMNAZIALĂ NR. 1 (FOSTA ȘCOALĂ GENERALĂ NR. 9)",64,"MUNICIPIUL HUNEDOARA",86810,1,PART,PRCNCT,PRSD,PRSD_SV,"2025-05-18 21:24:59",1293,492,456,36,0,479,13,1400,908,277,202
22,HUNEDOARA,"ŞCOALA GIMNAZIALĂ NR. 1 (FOSTA ŞCOALĂ GENERALĂ NR. 9)",65,"MUNICIPIUL HUNEDOARA",86810,1,PART,PRCNCT,PRSD,PRSD_SV,"2025-05-18 21:56:50",1392,464,447,17,0,458,6,1500,1036,313,145
22,HUNEDOARA,"ŞCOALA GIMNAZIALĂ NR. 1 (FOSTA ŞCOALĂ GENERALĂ NR. 9)",66,"MUNICIPIUL HUNEDOARA",86810,1,PART,PRCNCT,PRSD,PRSD_SV,"2025-05-18 21:23:04",1390,478,456,22,0,471,7,1500,1022,303,168
22,HUNEDOARA,"ŞCOALA GIMNAZIALĂ NR. 1 (FOSTA ŞCOALĂ GENERALĂ NR. 9)",67,"MUNICIPIUL HUNEDOARA",86810,1,PART,PRCNCT,PRSD,PRSD_SV,"2025-05-18 21:34:07",1379,550,527,23,0,541,9,1500,950,317,224
22,HUNEDOARA,"ŞCOALA GIMNAZIALĂ NR. 1 (FOSTA ŞCOALĂ GENERALĂ NR. 9)",68,"MUNICIPIUL HUNEDOARA",86810,1,PART,PRCNCT,PRSD,PRSD_SV,"2025-05-18 21:48:30",1202,492,470,22,0,483,9,1300,808,266,217
22,HUNEDOARA,"GRĂDINIŢA CU PROGRAM NORMAL MICRO VII PN6",69,"MUNICIPIUL HUNEDOARA",86810,1,PART,PRCNCT,PRSD,PRSD_SV,"2025-05-18 22:05:35",1196,452,425,27,0,449,3,1300,848,263,186
22,HUNEDOARA,"COLEGIUL ECONOMIC ”EMANUIL GOJDU” (FOSTUL LICEU NR. 2)",70,"MUNICIPIUL HUNEDOARA",86810,1,PART,PRCNCT,PRSD,PRSD_SV,"2025-05-18 22:40:20",1140,554,504,50,0,546,8,1200,646,226,320
22,HUNEDOARA,"COLEGIUL ECONOMIC ”EMANUIL GOJDU” (FOSTUL LICEU NR. 2)",71,"MUNICIPIUL HUNEDOARA",86810,1,PART,PRCNCT,PRSD,PRSD_SV,"2025-05-18 21:51:06",1254,600,563,35,2,591,9,1400,800,227,364
22,HUNEDOARA,"COLEGIUL NAŢIONAL DE INFORMATICĂ ”TRAIAN LALESCU” (CLĂDIREA NOUĂ)",72,"MUNICIPIUL HUNEDOARA",86810,2,PART,PRCNCT,PRSD,PRSD_SV,"2025-05-19 02:03:14",1323,744,635,54,55,732,12,1600,856,239,493
22,HUNEDOARA,"COLEGIUL NAŢIONAL DE INFORMATICĂ ”TRAIAN LALESCU” (CLĂDIREA NOUĂ)",73,"MUNICIPIUL HUNEDOARA",86810,1,PART,PRCNCT,PRSD,PRSD_SV,"2025-05-18 22:23:17",1106,727,607,52,68,717,10,1300,573,275,442
22,HUNEDOARA,"COLEGIUL NAŢIONAL DE INFORMATICĂ ”TRAIAN LALESCU” (CLĂDIREA NOUĂ)",74,"MUNICIPIUL HUNEDOARA",86810,1,PART,PRCNCT,PRSD,PRSD_SV,"2025-05-18 21:42:13",1203,601,535,36,30,596,5,1300,699,243,353
22,HUNEDOARA,"COLEGIUL NAȚIONAL ”IANCU DE HUNEDOARA” (FOSTA ȘCOALĂ GENERALĂ NR. 5)",75,"MUNICIPIUL HUNEDOARA",86810,1,PART,PRCNCT,PRSD,PRSD_SV,"2025-05-18 21:39:18",1442,652,575,54,23,640,12,1700,1048,347,293
22,HUNEDOARA,"COLEGIUL NAȚIONAL ”IANCU DE HUNEDOARA” (FOSTA ȘCOALĂ GENERALĂ NR. 5)",76,"MUNICIPIUL HUNEDOARA",86810,1,PART,PRCNCT,PRSD,PRSD_SV,"2025-05-18 22:17:52",1117,454,406,29,19,445,9,1200,746,173,272
22,HUNEDOARA,"COLEGIUL NAȚIONAL ”IANCU DE HUNEDOARA” (FOSTA ȘCOALĂ GENERALĂ NR. 5)",77,"MUNICIPIUL HUNEDOARA",86810,1,PART,PRCNCT,PRSD,PRSD_SV,"2025-05-18 21:38:20",1202,618,593,24,1,603,15,1300,682,266,337
22,HUNEDOARA,"COLEGIUL NAȚIONAL ”IANCU DE HUNEDOARA” (FOSTA ȘCOALĂ GENERALĂ NR.5)",78,"MUNICIPIUL HUNEDOARA",86810,1,PART,PRCNCT,PRSD,PRSD_SV,"2025-05-18 21:23:29",380,202,174,28,0,201,1,500,298,116,85
22,HUNEDOARA,"ŞCOALA GIMNAZIALĂ NR.6 (FOSTA ȘCOALĂ GENERALĂ NR. 6)",79,"MUNICIPIUL HUNEDOARA",86810,1,PART,PRCNCT,PRSD,PRSD_SV,"2025-05-18 21:34:05",1386,681,623,58,0,665,16,1500,819,291,374
22,HUNEDOARA,"ŞCOALA GIMNAZIALĂ NR.6 (FOSTA ȘCOALĂ GENERALĂ NR. 6)",80,"MUNICIPIUL HUNEDOARA",86810,1,PART,PRCNCT,PRSD,PRSD_SV,"2025-05-18 21:55:47",1457,684,621,61,2,679,5,1600,916,318,361
22,HUNEDOARA,"COLEGIUL TEHNIC ”MATEI CORVIN” (FOSTUL LICEU NR. 1)",81,"MUNICIPIUL HUNEDOARA",86810,1,PART,PRCNCT,PRSD,PRSD_SV,"2025-05-18 21:28:01",1012,494,455,39,0,490,4,1100,606,210,280
22,HUNEDOARA,"COLEGIUL ECONOMIC EMANUIL GOJDU (FOSTA ȘCOALĂ GENERALĂ NR. 3)",82,"MUNICIPIUL HUNEDOARA",86810,2,PART,PRCNCT,PRSD,PRSD_SV,"2025-05-19 01:52:58",1388,578,534,44,0,561,17,1500,922,266,295
22,HUNEDOARA,"COLEGIUL ECONOMIC EMANUIL GOJDU (FOSTA ŞCOALĂ GENERALĂ NR. 3)",83,"MUNICIPIUL HUNEDOARA",86810,1,PART,PRCNCT,PRSD,PRSD_SV,"2025-05-18 21:54:26",1213,606,567,36,3,593,13,1300,694,217,376
22,HUNEDOARA,"COLEGIUL ECONOMIC EMANUIL GOJDU (FOSTA ŞCOALĂ GENERALĂ NR. 3)",84,"MUNICIPIUL HUNEDOARA",86810,1,PART,PRCNCT,PRSD,PRSD_SV,"2025-05-18 21:35:33",1257,663,641,21,1,650,13,1400,737,198,452
22,HUNEDOARA,"GRĂDINIŢA CU PROGRAM PRELUNGIT ”PITICOT”",85,"MUNICIPIUL HUNEDOARA",86810,1,PART,PRCNCT,PRSD,PRSD_SV,"2025-05-18 21:29:17",813,368,330,38,0,361,7,900,532,165,196
22,HUNEDOARA,"GRĂDINIŢA CU PROGRAM PRELUNGIT ”PITICOT”",86,"MUNICIPIUL HUNEDOARA",86810,1,PART,PRCNCT,PRSD,PRSD_SV,"2025-05-18 21:24:46",1067,451,422,28,1,445,6,1200,749,204,241
22,HUNEDOARA,"ŞCOALA GIMNAZIALĂ NR. 7 (FOSTA ȘCOALĂ GENERALĂ NR. 7)",87,"MUNICIPIUL HUNEDOARA",86810,1,PART,PRCNCT,PRSD,PRSD_SV,"2025-05-18 21:29:53",1044,494,476,17,1,485,9,1100,606,222,263
22,HUNEDOARA,"ŞCOALA GIMNAZIALĂ NR. 7 (FOSTA ȘCOALĂ GENERALĂ NR. 7)",88,"MUNICIPIUL HUNEDOARA",86810,1,PART,PRCNCT,PRSD,PRSD_SV,"2025-05-18 21:31:37",1090,482,446,36,0,474,8,1200,718,204,270
22,HUNEDOARA,"ŞCOALA GIMNAZIALĂ NR. 7 (FOSTA ȘCOALĂ GENERALĂ NR. 7)",89,"MUNICIPIUL HUNEDOARA",86810,1,PART,PRCNCT,PRSD,PRSD_SV,"2025-05-18 21:25:44",1107,508,455,53,0,502,6,1200,692,222,280
22,HUNEDOARA,"GRĂDINIȚA CU PROGRAM PRELUNGIT „FLOAREA SOARELUI” HUNEDOARA",90,"MUNICIPIUL HUNEDOARA",86810,1,PART,PRCNCT,PRSD,PRSD_SV,"2025-05-18 21:52:24",1097,520,492,28,0,506,14,1200,680,277,229
22,HUNEDOARA,"GRĂDINIȚA CU PROGRAM PRELUNGIT „FLOAREA SOARELUI” HUNEDOARA",91,"MUNICIPIUL HUNEDOARA",86810,1,PART,PRCNCT,PRSD,PRSD_SV,"2025-05-18 21:37:18",950,424,397,27,0,419,5,997,573,223,196
22,HUNEDOARA,"GRĂDINIȚA CU PROGRAM PRELUNGIT „FLOAREA SOARELUI” HUNEDOARA",92,"MUNICIPIUL HUNEDOARA",86810,1,PART,PRCNCT,PRSD,PRSD_SV,"2025-05-18 21:23:04",1054,465,442,23,0,462,3,1100,635,244,218
22,HUNEDOARA,"GRĂDINIŢA CU ORAR NORMAL MICRO III PN 2 ”ZORI DE ZI”",93,"MUNICIPIUL HUNEDOARA",86810,1,PART,PRCNCT,PRSD,PRSD_SV,"2025-05-18 21:32:56",1242,588,544,44,0,575,13,1400,812,257,318
22,HUNEDOARA,"ŞCOALA GIMNAZIALĂ NR. 2 (FOSTA ŞCOALĂ GENERALĂ NR. 2)",94,"MUNICIPIUL HUNEDOARA",86810,1,PART,PRCNCT,PRSD,PRSD_SV,"2025-05-18 21:35:26",1428,661,618,43,0,644,17,1600,939,302,342
22,HUNEDOARA,"ŞCOALA GIMNAZIALĂ NR. 2 (FOSTA ŞCOALĂ GENERALĂ NR. 2)",95,"MUNICIPIUL HUNEDOARA",86810,2,PART,PRCNCT,PRSD,PRSD_SV,"2025-05-19 00:31:30",1477,676,640,35,1,666,10,1600,924,296,370
22,HUNEDOARA,"ŞCOALA GIMNAZIALĂ NR. 2 (FOSTA ŞCOALĂ GENERALĂ NR. 2)",96,"MUNICIPIUL HUNEDOARA",86810,1,PART,PRCNCT,PRSD,PRSD_SV,"2025-05-18 21:30:19",1210,586,552,34,0,575,11,1300,714,270,305
22,HUNEDOARA,"ŞCOALA GIMNAZIALĂ NR. 2 (FOSTA ŞCOALĂ GENERALĂ NR. 2)",97,"MUNICIPIUL HUNEDOARA",86810,1,PART,PRCNCT,PRSD,PRSD_SV,"2025-05-18 21:38:24",1307,537,508,29,0,525,12,1400,863,284,241
22,HUNEDOARA,"CENTRUL ŞCOLAR PENTRU EDUCAŢIE INCLUZIVĂ ”RUDOLF STEINER” (FOSTUL CENTRU DE ZI)",98,"MUNICIPIUL HUNEDOARA",86810,1,PART,PRCNCT,PRSD,PRSD_SV,"2025-05-18 21:45:02",1100,470,441,28,1,462,8,1300,830,243,219
22,HUNEDOARA,"CENTRUL ŞCOLAR PENTRU EDUCAŢIE INCLUZIVĂ ”RUDOLF STEINER” (FOSTUL CENTRU DE ZI)",99,"MUNICIPIUL HUNEDOARA",86810,1,PART,PRCNCT,PRSD,PRSD_SV,"2025-05-18 21:26:25",1098,453,433,20,0,446,7,1200,747,275,171
22,HUNEDOARA,"ȘCOALA GIMNAZIALĂ NR. 2 (FOSTA ȘCOALĂ GENERALĂ NR. 11)",100,"MUNICIPIUL HUNEDOARA",86810,2,PART,PRCNCT,PRSD,PRSD_SV,"2025-05-18 23:49:58",1187,519,479,39,1,513,6,1300,781,234,279
22,HUNEDOARA,"ȘCOALA GIMNAZIALĂ NR. 2 (FOSTA ȘCOALĂ GENERALĂ NR. 11)",101,"MUNICIPIUL HUNEDOARA",86810,1,PART,PRCNCT,PRSD,PRSD_SV,"2025-05-18 21:39:30",1407,657,624,33,0,648,9,1500,843,314,334
22,HUNEDOARA,"ȘCOALA GIMNAZIALĂ NR. 2 (FOSTA ȘCOALĂ GENERALĂ NR. 11)",102,"MUNICIPIUL HUNEDOARA",86810,1,PART,PRCNCT,PRSD,PRSD_SV,"2025-05-18 21:25:23",1174,482,456,26,0,473,9,1300,818,255,218
22,HUNEDOARA,"ȘCOALA GIMNAZIALĂ NR. 2 (FOSTA ȘCOALĂ GENERALĂ NR. 11)",103,"MUNICIPIUL HUNEDOARA",86810,1,PART,PRCNCT,PRSD,PRSD_SV,"2025-05-18 21:26:31",1266,582,560,21,1,569,13,1400,818,240,329
22,HUNEDOARA,"ȘCOALA GIMNAZIALĂ NR. 2 (FOSTA ȘCOALĂ GENERALĂ NR.11)",104,"MUNICIPIUL HUNEDOARA",86810,1,PART,PRCNCT,PRSD,PRSD_SV,"2025-05-18 21:21:07",677,369,349,20,0,359,10,800,431,189,170
22,HUNEDOARA,"SEDIUL PRIMĂRIEI MUNICIPIULUI HUNEDOARA (FOSTA B.R.D.)",105,"MUNICIPIUL HUNEDOARA",86810,1,PART,PRCNCT,PRSD,PRSD_SV,"2025-05-18 21:55:17",1541,806,721,84,1,796,10,1700,894,294,502
22,HUNEDOARA,"COLEGIUL NAȚIONAL ”IANCU DE HUNEDOARA” (FOSTA ȘCOALĂ GENERALĂ ZLAȘTI)",106,"MUNICIPIUL HUNEDOARA",86810,1,PART,PRCNCT,PRSD,PRSD_SV,"2025-05-18 21:20:11",442,280,247,32,1,280,0,500,220,144,136
22,HUNEDOARA,"CĂMIN CULTURAL BOŞ (GRĂDINIŢA)",107,"MUNICIPIUL HUNEDOARA",86810,1,PART,PRCNCT,PRSD,PRSD_SV,"2025-05-18 21:41:36",527,285,239,46,0,283,2,600,315,157,126
22,HUNEDOARA,"ŞCOALA PRIMARĂ PEŞTIŞUL MARE",108,"MUNICIPIUL HUNEDOARA",86810,1,PART,PRCNCT,PRSD,PRSD_SV,"2025-05-18 21:42:37",1025,570,527,43,0,558,12,1100,530,281,277
22,HUNEDOARA,"ŞCOALA PRIMARĂ RĂCĂŞTIA",109,"MUNICIPIUL HUNEDOARA",86810,1,PART,PRCNCT,PRSD,PRSD_SV,"2025-05-18 21:18:38",527,263,250,13,0,262,1,600,337,138,124
22,HUNEDOARA,"PALATUL CULTURAL LUPENI",110,"MUNICIPIUL LUPENI",87059,1,PART,PRCNCT,PRSD,PRSD_SV,"2025-05-18 21:47:01",1515,718,686,32,0,702,16,1700,982,556,146
22,HUNEDOARA,"ŞCOALA GIMNAZIALĂ NR. 1",111,"MUNICIPIUL LUPENI",87059,1,PART,PRCNCT,PRSD,PRSD_SV,"2025-05-18 21:52:37",1221,582,531,22,29,571,11,1500,918,320,251
22,HUNEDOARA,"ŞCOALA GIMNAZIALĂ NR. 1",112,"MUNICIPIUL LUPENI",87059,1,PART,PRCNCT,PRSD,PRSD_SV,"2025-05-18 21:39:18",993,419,409,10,0,406,13,1100,681,236,170
22,HUNEDOARA,"GRĂDINIȚA CU PROGRAM NORMAL ŞCOALA GIMNAZIALĂ NR. 1",113,"MUNICIPIUL LUPENI",87059,1,PART,PRCNCT,PRSD,PRSD_SV,"2025-05-18 21:25:01",752,296,271,25,0,294,2,800,504,188,106
22,HUNEDOARA,"SPCLEP LUPENI",114,"MUNICIPIUL LUPENI",87059,1,PART,PRCNCT,PRSD,PRSD_SV,"2025-05-18 21:57:27",1501,708,665,42,1,695,13,1600,892,356,339
22,HUNEDOARA,"ŞCOALA GIMNAZIALĂ NR. 3",115,"MUNICIPIUL LUPENI",87059,1,PART,PRCNCT,PRSD,PRSD_SV,"2025-05-18 21:46:25",928,480,455,24,1,473,7,1000,520,216,257
22,HUNEDOARA,"ŞCOALA GIMNAZIALĂ NR. 3",116,"MUNICIPIUL LUPENI",87059,1,PART,PRCNCT,PRSD,PRSD_SV,"2025-05-18 21:52:41",881,401,377,24,0,397,4,1000,599,202,195
22,HUNEDOARA,"CINEMATOGRAF CULTURAL LUPENI",117,"MUNICIPIUL LUPENI",87059,1,PART,PRCNCT,PRSD,PRSD_SV,"2025-05-18 21:43:33",1239,559,534,23,2,542,17,1300,741,289,253
22,HUNEDOARA,"GRĂDINIŢA CU PROGRAM NORMAL NR. 1 LUPENI",118,"MUNICIPIUL LUPENI",87059,1,PART,PRCNCT,PRSD,PRSD_SV,"2025-05-18 22:03:04",1455,604,571,32,1,585,19,1600,996,385,200
22,HUNEDOARA,"GRĂDINIȚA CU PROGRAM SĂPTĂMÂNAL LUMEA COPIILOR",119,"MUNICIPIUL LUPENI",87059,1,PART,PRCNCT,PRSD,PRSD_SV,"2025-05-18 21:52:38",1508,693,672,21,0,687,6,1600,907,372,315
22,HUNEDOARA,"LICEUL TEORETIC ”MIRCEA ELIADE” LUPENI",120,"MUNICIPIUL LUPENI",87059,1,PART,PRCNCT,PRSD,PRSD_SV,"2025-05-18 21:45:04",1325,528,502,26,0,515,13,1500,972,333,182
22,HUNEDOARA,"LICEUL TEORETIC ”MIRCEA ELIADE” LUPENI",121,"MUNICIPIUL LUPENI",87059,1,PART,PRCNCT,PRSD,PRSD_SV,"2025-05-18 21:36:50",833,310,293,17,0,303,7,900,590,237,66
22,HUNEDOARA,"ŞCOALA GIMNAZIALĂ NR. 2 LUPENI",122,"MUNICIPIUL LUPENI",87059,1,PART,PRCNCT,PRSD,PRSD_SV,"2025-05-18 22:00:08",1182,518,481,37,0,512,6,1300,782,310,202
22,HUNEDOARA,"ŞCOALA GIMNAZIALĂ NR. 2 LUPENI",123,"MUNICIPIUL LUPENI",87059,1,PART,PRCNCT,PRSD,PRSD_SV,"2025-05-18 22:00:15",956,438,423,15,0,425,13,1000,562,196,229
22,HUNEDOARA,"GRĂDINIŢA CU PROGRAM NORMAL NR. 2 LUPENI",124,"MUNICIPIUL LUPENI",87059,1,PART,PRCNCT,PRSD,PRSD_SV,"2025-05-18 21:37:25",904,412,379,33,0,406,6,1000,588,250,156
22,HUNEDOARA,"GRĂDINIŢA CU PROGRAM NORMAL NR. 2 LUPENI",125,"MUNICIPIUL LUPENI",87059,1,PART,PRCNCT,PRSD,PRSD_SV,"2025-05-18 21:43:12",868,334,314,20,0,331,3,900,566,238,93
22,HUNEDOARA,"GRĂDINIŢA CU PROGRAM NORMAL NR. 2 LUPENI",126,"MUNICIPIUL LUPENI",87059,1,PART,PRCNCT,PRSD,PRSD_SV,"2025-05-18 21:47:41",1184,478,462,16,0,470,8,1300,822,325,145
22,HUNEDOARA,"SC UNIVERSAL EDIL SA",127,"MUNICIPIUL LUPENI",87059,1,PART,PRCNCT,PRSD,PRSD_SV,"2025-05-18 21:48:34",813,348,330,18,0,339,9,900,552,210,129
22,HUNEDOARA,"CASA DE CULTURĂ",128,"MUNICIPIUL ORĂŞTIE",87638,1,PART,PRCNCT,PRSD,PRSD_SV,"2025-05-18 21:55:48",1528,862,760,101,1,849,13,1700,838,368,481
22,HUNEDOARA,"SALA DE SPORT A ŞCOLII GIMNAZIALE „DOMINIC STANCA”",129,"MUNICIPIUL ORĂŞTIE",87638,1,PART,PRCNCT,PRSD,PRSD_SV,"2025-05-18 22:00:33",1425,681,601,80,0,673,8,1600,919,326,347
22,HUNEDOARA,"GRĂDINIŢA „CĂSUȚA CU POVEȘTI”",130,"MUNICIPIUL ORĂŞTIE",87638,1,PART,PRCNCT,PRSD,PRSD_SV,"2025-05-18 22:44:31",1305,635,548,54,33,625,10,1600,965,340,285
22,HUNEDOARA,"ŞCOALA GIMNAZIALĂ „DOMINIC STANCA”",131,"MUNICIPIUL ORĂŞTIE",87638,1,PART,PRCNCT,PRSD,PRSD_SV,"2025-05-18 22:53:33",1312,623,546,77,0,612,11,1400,777,343,269
22,HUNEDOARA,"CENTRUL REZIDENȚIAL PENTRU VÂRSTNICI ORĂȘTIE",132,"MUNICIPIUL ORĂŞTIE",87638,1,PART,PRCNCT,PRSD,PRSD_SV,"2025-05-18 22:45:55",1479,751,640,88,23,740,11,1700,949,360,380
22,HUNEDOARA,"ŞCOALA GIMNAZIALĂ „DR. A. VLAD”",133,"MUNICIPIUL ORĂŞTIE",87638,1,PART,PRCNCT,PRSD,PRSD_SV,"2025-05-18 21:50:40",1510,759,690,69,0,738,21,1700,941,344,394
22,HUNEDOARA,"ŞCOALA CU CLASELE I-IV GARĂ",134,"MUNICIPIUL ORĂŞTIE",87638,1,PART,PRCNCT,PRSD,PRSD_SV,"2025-05-18 22:14:04",1371,678,588,89,1,669,9,1500,822,388,281
22,HUNEDOARA,"OFICIUL DE GOSPODĂRIRE A APELOR",135,"MUNICIPIUL ORĂŞTIE",87638,1,PART,PRCNCT,PRSD,PRSD_SV,"2025-05-18 21:53:20",1506,795,747,47,1,780,15,1600,805,346,434
22,HUNEDOARA,"LICEUL TEHNOLOGIC „NICOLAUS OLAHUS”",136,"MUNICIPIUL ORĂŞTIE",87638,1,PART,PRCNCT,PRSD,PRSD_SV,"2025-05-18 21:57:44",1289,625,571,54,0,618,7,1400,775,275,343
22,HUNEDOARA,"LICEUL TEORETIC „AUREL VLAICU”",137,"MUNICIPIUL ORĂŞTIE",87638,1,PART,PRCNCT,PRSD,PRSD_SV,"2025-05-18 22:15:55",1396,757,619,136,2,748,9,1500,743,457,291
22,HUNEDOARA,"PRIMĂRIA MUNICIPIULUI ORĂŞTIE",138,"MUNICIPIUL ORĂŞTIE",87638,1,PART,PRCNCT,PRSD,PRSD_SV,"2025-05-18 23:37:38",1350,685,609,74,2,675,10,1500,815,280,395
22,HUNEDOARA,"SERVICIUL PUBLIC DE ASISTENŢĂ SOCIALĂ",139,"MUNICIPIUL ORĂŞTIE",87638,1,PART,PRCNCT,PRSD,PRSD_SV,"2025-05-18 21:52:38",1547,679,645,34,0,672,7,1700,1021,305,367
22,HUNEDOARA,"ȘCOALA GIMNAZIALĂ „ION GHEORGHE DUCA” PETROȘANI- SALA DE EDUCAȚIE FIZICĂ ȘCOLARĂ",140,"MUNICIPIUL PETROŞANI",86990,1,PART,PRCNCT,PRSD,PRSD_SV,"2025-05-18 21:51:06",1581,781,746,31,4,766,15,1800,1019,288,478
22,HUNEDOARA,"ȘCOALA GIMNAZIALĂ „ION GHEORGHE DUCA” PETROȘANI- SALA DE EDUCAȚIE FIZICĂ ȘCOLARĂ",141,"MUNICIPIUL PETROŞANI",86990,1,PART,PRCNCT,PRSD,PRSD_SV,"2025-05-18 21:38:02",1424,680,641,39,0,668,12,1600,920,261,407
22,HUNEDOARA,"ȘCOALA GIMNAZIALĂ I.G. DUCA (ȘCOALA GENERALĂ NR. 1 - SEDIUL NOU)",142,"MUNICIPIUL PETROŞANI",86990,1,PART,PRCNCT,PRSD,PRSD_SV,"2025-05-18 22:05:40",1269,718,642,36,40,699,19,1400,682,293,406
22,HUNEDOARA,"AMFITEATRUL UNIVERSITĂȚII",143,"MUNICIPIUL PETROŞANI",86990,1,PART,PRCNCT,PRSD,PRSD_SV,"2025-05-18 22:53:09",1266,658,586,72,0,651,7,1400,742,266,385
22,HUNEDOARA,"CLUB SPORTIV ȘCOLAR",144,"MUNICIPIUL PETROŞANI",86990,1,PART,PRCNCT,PRSD,PRSD_SV,"2025-05-18 21:56:24",936,500,438,59,3,493,7,1000,500,190,303
22,HUNEDOARA,"ȘCOALA GIMNAZIALĂ AVRAM STANCA (ȘCOALA GENERALĂ NR.4)",145,"MUNICIPIUL PETROŞANI",86990,1,PART,PRCNCT,PRSD,PRSD_SV,"2025-05-18 21:49:14",992,543,466,75,2,536,7,1100,557,210,326
22,HUNEDOARA,"ȘCOALA GIMNAZIALĂ AVRAM STANCA (ȘCOALA GENERALĂ NR.4)",146,"MUNICIPIUL PETROŞANI",86990,1,PART,PRCNCT,PRSD,PRSD_SV,"2025-05-18 21:50:42",1599,855,813,39,3,832,23,1700,845,354,478
22,HUNEDOARA,"GRĂDINIȚA CU PROGRAM PRELUNGIT NR. 3 PETROȘANI",147,"MUNICIPIUL PETROŞANI",86990,1,PART,PRCNCT,PRSD,PRSD_SV,"2025-05-18 22:36:11",1640,788,727,55,6,778,10,1900,1112,424,354
22,HUNEDOARA,"ȘCOALA GIMNAZIALĂ „ION GHEORGHE DUCA” PETROȘANI - GRĂDINIȚA CU PROGRAM NORMAL ȘI PRELUNGIT",148,"MUNICIPIUL PETROŞANI",86990,1,PART,PRCNCT,PRSD,PRSD_SV,"2025-05-18 21:52:55",848,438,399,39,0,427,11,900,462,161,266
22,HUNEDOARA,"COLEGIUL NAȚIONAL DE INFORMATICĂ CARMEN SYLVA (LICEUL DE INFORMATICĂ)",149,"MUNICIPIUL PETROŞANI",86990,1,PART,PRCNCT,PRSD,PRSD_SV,"2025-05-18 21:38:08",1299,701,604,53,44,684,17,1400,699,323,361
22,HUNEDOARA,"COLEGIUL ECONOMIC ”HERMES ”",150,"MUNICIPIUL PETROŞANI",86990,1,PART,PRCNCT,PRSD,PRSD_SV,"2025-05-18 21:40:49",1425,756,661,50,45,750,6,1600,844,344,406
22,HUNEDOARA,"COLEGIUL NAȚIONAL DE INFORMATICĂ ”CARMEN SYLVA” (GRĂDINIȚA CU PROGRAM NORMAL NR.5)",151,"MUNICIPIUL PETROŞANI",86990,1,PART,PRCNCT,PRSD,PRSD_SV,"2025-05-18 21:46:48",1355,586,561,25,0,584,2,1500,914,285,299
22,HUNEDOARA,"COLEGIUL NAȚIONAL DE INFORMATICĂ ”CARMEN SYLVA” (GRĂDINIȚA CU PROGRAM NORMAL NR.5)",152,"MUNICIPIUL PETROŞANI",86990,1,PART,PRCNCT,PRSD,PRSD_SV,"2025-05-18 21:50:39",1339,629,589,40,0,608,21,1500,871,270,338
22,HUNEDOARA,"ȘCOALA GIMNAZIALĂ CARMEN SYLVA (ȘCOALA GENERALĂ NR.6)",153,"MUNICIPIUL PETROŞANI",86990,1,PART,PRCNCT,PRSD,PRSD_SV,"2025-05-18 22:02:19",1539,739,712,27,0,718,21,1700,961,314,404
22,HUNEDOARA,"ȘCOALA GIMNAZIALĂ CARMEN SYLVA (ȘCOALA GENERALĂ NR.6)",154,"MUNICIPIUL PETROŞANI",86990,2,PART,PRCNCT,PRSD,PRSD_SV,"2025-05-19 02:59:56",1463,584,546,38,0,580,4,1600,1016,368,212
22,HUNEDOARA,"GRĂDINIȚA CU PROGRAM PRELUNGIT AEROPORT",155,"MUNICIPIUL PETROŞANI",86990,1,PART,PRCNCT,PRSD,PRSD_SV,"2025-05-18 21:43:33",792,298,268,30,0,294,4,900,602,177,117
22,HUNEDOARA,"BIBLIOTECA MUNICIPALĂ PETROȘANI",156,"MUNICIPIUL PETROŞANI",86990,1,PART,PRCNCT,PRSD,PRSD_SV,"2025-05-18 21:34:54",1385,572,539,33,0,562,10,1500,928,338,224
22,HUNEDOARA,"BIBLIOTECA MUNICIPALĂ PETROȘANI",157,"MUNICIPIUL PETROŞANI",86990,1,PART,PRCNCT,PRSD,PRSD_SV,"2025-05-18 21:51:13",1620,656,617,23,16,635,21,1800,1144,365,270
22,HUNEDOARA,"ȘCOALA GIMNAZIALĂ NR.7",158,"MUNICIPIUL PETROŞANI",86990,1,PART,PRCNCT,PRSD,PRSD_SV,"2025-05-18 21:45:13",1590,653,609,44,0,640,13,1700,1047,403,237
22,HUNEDOARA,"ȘCOALA GIMNAZIALĂ NR.7",159,"MUNICIPIUL PETROŞANI",86990,1,PART,PRCNCT,PRSD,PRSD_SV,"2025-05-18 21:46:04",1690,652,624,28,0,643,9,1900,1248,477,166
22,HUNEDOARA,"ȘCOALA GIMNAZIALĂ NR. 7 PETROȘANI - SALA DE EDUCAȚIE FIZICĂ ȘCOLARĂ",160,"MUNICIPIUL PETROŞANI",86990,1,PART,PRCNCT,PRSD,PRSD_SV,"2025-05-18 21:29:11",611,333,306,27,0,324,9,700,367,263,61
22,HUNEDOARA,"CASA PENSIONARILOR",161,"MUNICIPIUL PETROŞANI",86990,1,PART,PRCNCT,PRSD,PRSD_SV,"2025-05-18 22:11:47",1401,642,617,25,0,637,5,1500,858,427,210
22,HUNEDOARA,"CASA PENSIONARILOR",162,"MUNICIPIUL PETROŞANI",86990,1,PART,PRCNCT,PRSD,PRSD_SV,"2025-05-18 22:43:08",1023,447,425,22,0,442,5,1100,653,322,120
22,HUNEDOARA,"ȘCOALA GIMNAZIALĂ NR. 2",163,"MUNICIPIUL PETROŞANI",86990,1,PART,PRCNCT,PRSD,PRSD_SV,"2025-05-18 21:58:51",1146,498,471,27,0,489,9,1300,802,313,176
22,HUNEDOARA,"ȘCOALA GIMNAZIALĂ NR. 2 PETROȘANI",164,"MUNICIPIUL PETROŞANI",86990,1,PART,PRCNCT,PRSD,PRSD_SV,"2025-05-18 22:03:35",1059,522,488,34,0,510,12,1100,578,348,162
22,HUNEDOARA,"COLEGIUL NAŢIONAL ”MIHAI EMINESCU” (ŞCOALA GIMNAZIALĂ DÂLJA MARE)",165,"MUNICIPIUL PETROŞANI",86990,1,PART,PRCNCT,PRSD,PRSD_SV,"2025-05-18 21:21:33",172,119,104,15,0,118,1,200,81,97,21
22,HUNEDOARA,"GRĂDINIȚA PN+PP NR. 1",166,"MUNICIPIUL VULCAN",87175,1,PART,PRCNCT,PRSD,PRSD_SV,"2025-05-18 21:56:06",1122,482,458,24,0,474,8,1200,718,221,253
22,HUNEDOARA,"ȘCOALĂ GIMNAZIALĂ NR. 4",167,"MUNICIPIUL VULCAN",87175,1,PART,PRCNCT,PRSD,PRSD_SV,"2025-05-18 22:14:19",962,403,387,16,0,394,9,1100,697,228,166
22,HUNEDOARA,"ȘCOALA GIMNAZIALĂ NR. 4",168,"MUNICIPIUL VULCAN",87175,1,PART,PRCNCT,PRSD,PRSD_SV,"2025-05-18 21:50:16",944,447,422,24,1,442,5,1000,553,260,182
22,HUNEDOARA,"CANTINA DE AJUTOR SOCIAL",169,"MUNICIPIUL VULCAN",87175,1,PART,PRCNCT,PRSD,PRSD_SV,"2025-05-18 21:44:30",1268,513,496,17,0,499,14,1400,887,354,145
22,HUNEDOARA,"LICEUL TEHNOLOGIC ”MIHAI VITEAZU” VULCAN",170,"MUNICIPIUL VULCAN",87175,1,PART,PRCNCT,PRSD,PRSD_SV,"2025-05-18 21:47:34",971,383,356,27,0,378,5,1000,617,214,164
22,HUNEDOARA,"LICEUL TEHNOLOGIC ”MIHAI VITEAZU” VULCAN",171,"MUNICIPIUL VULCAN",87175,1,PART,PRCNCT,PRSD,PRSD_SV,"2025-05-18 21:50:05",990,471,421,21,29,467,4,1200,729,272,195
22,HUNEDOARA,"ȘCOALA GIMNAZIALĂ NR. 5",172,"MUNICIPIUL VULCAN",87175,1,PART,PRCNCT,PRSD,PRSD_SV,"2025-05-18 21:53:32",1222,514,497,17,0,509,5,1300,786,303,206
22,HUNEDOARA,"ȘCOALA GIMNAZIALĂ NR. 5",173,"MUNICIPIUL VULCAN",87175,1,PART,PRCNCT,PRSD,PRSD_SV,"2025-05-18 21:55:27",1385,549,524,25,0,537,12,1500,951,333,204
22,HUNEDOARA,"STADIONUL CENTRAL",174,"MUNICIPIUL VULCAN",87175,1,PART,PRCNCT,PRSD,PRSD_SV,"2025-05-18 22:01:42",1182,508,488,19,1,495,13,1300,792,274,221
22,HUNEDOARA,"SALA DE SPORT",175,"MUNICIPIUL VULCAN",87175,1,PART,PRCNCT,PRSD,PRSD_SV,"2025-05-18 21:56:31",1371,592,562,29,1,579,13,1500,908,356,223
22,HUNEDOARA,"ȘCOALA GIMNAZIALĂ NR. 6",176,"MUNICIPIUL VULCAN",87175,1,PART,PRCNCT,PRSD,PRSD_SV,"2025-05-18 21:32:38",1149,442,419,23,0,438,4,1200,758,378,60
22,HUNEDOARA,"ȘCOALA GIMNAZIALĂ NR. 6",177,"MUNICIPIUL VULCAN",87175,1,PART,PRCNCT,PRSD,PRSD_SV,"2025-05-18 21:40:36",1246,435,417,17,1,428,7,1400,965,317,111
22,HUNEDOARA,"ȘCOALA GIMNAZIALĂ NR. 6,",178,"MUNICIPIUL VULCAN",87175,1,PART,PRCNCT,PRSD,PRSD_SV,"2025-05-18 21:33:29",1315,450,434,16,0,443,7,1400,950,327,116
22,HUNEDOARA,"GRĂDINIȚA CU PROGRAM NORMAL DIN CADRUL ȘCOLII GIMNAZIALE NR. 6",179,"MUNICIPIUL VULCAN",87175,1,PART,PRCNCT,PRSD,PRSD_SV,"2025-05-18 21:46:40",1214,458,434,24,0,450,8,1300,842,360,90
22,HUNEDOARA,"ȘCOALA GIMNAZIALĂ TEODORA LUCACIU",180,"MUNICIPIUL VULCAN",87175,1,PART,PRCNCT,PRSD,PRSD_SV,"2025-05-18 21:22:29",1090,455,438,17,0,453,2,1200,745,301,152
22,HUNEDOARA,"ȘCOALA GIMNAZIALĂ TEODORA LUCACIU",181,"MUNICIPIUL VULCAN",87175,1,PART,PRCNCT,PRSD,PRSD_SV,"2025-05-18 21:41:30",937,438,405,33,0,425,13,1000,562,243,182
22,HUNEDOARA,"CLUBUL COPIILOR ȘI ELEVILOR",182,"MUNICIPIUL VULCAN",87175,1,PART,PRCNCT,PRSD,PRSD_SV,"2025-05-18 21:40:23",1023,463,443,20,0,455,8,1100,637,298,157
22,HUNEDOARA,"ȘCOALA NR. 2",183,"MUNICIPIUL VULCAN",87175,1,PART,PRCNCT,PRSD,PRSD_SV,"2025-05-18 21:48:31",777,394,379,15,0,389,5,900,506,311,78
22,HUNEDOARA,"ȘCOALA GIMNAZIALĂ NR. 3",184,"MUNICIPIUL VULCAN",87175,1,PART,PRCNCT,PRSD,PRSD_SV,"2025-05-18 22:05:47",1301,679,652,27,0,662,17,1400,721,394,268
22,HUNEDOARA,"SCOALA GIMNAZIALA ”SF. VARVARA” ANINOASA",185,"ORAŞ ANINOASA",87219,1,PART,PRCNCT,PRSD,PRSD_SV,"2025-05-18 22:12:24",1405,649,613,36,0,636,13,1500,851,482,154
22,HUNEDOARA,"STADIONUL ”MINERUL ANINOASA”",186,"ORAŞ ANINOASA",87219,1,PART,PRCNCT,PRSD,PRSD_SV,"2025-05-18 22:03:43",831,405,383,20,2,399,6,900,495,312,87
22,HUNEDOARA,"SCOALA GIMNAZIALA ISCRONI",187,"ORAŞ ANINOASA",87219,1,PART,PRCNCT,PRSD,PRSD_SV,"2025-05-18 21:59:33",1240,593,562,31,0,585,8,1400,807,381,204
22,HUNEDOARA,"CONSILIUL LOCAL CĂLAN",188,"ORAŞ CĂLAN",87424,1,PART,PRCNCT,PRSD,PRSD_SV,"2025-05-18 21:45:55",1025,525,460,61,4,521,4,1100,575,283,238
22,HUNEDOARA,"ŞCOALA GIMNAZIALĂ",189,"ORAŞ CĂLAN",87424,1,PART,PRCNCT,PRSD,PRSD_SV,"2025-05-18 21:41:17",1027,448,410,38,0,440,8,1100,652,272,168
22,HUNEDOARA,"CASA DE CULTURĂ",190,"ORAŞ CĂLAN",87424,1,PART,PRCNCT,PRSD,PRSD_SV,"2025-05-18 21:47:47",1358,555,511,43,1,548,7,1500,945,321,227
22,HUNEDOARA,"LICEU TEHNOLOGIC OVID DENSUŞIANU",191,"ORAŞ CĂLAN",87424,1,PART,PRCNCT,PRSD,PRSD_SV,"2025-05-18 21:35:19",1426,634,595,39,0,628,6,1500,866,400,228
22,HUNEDOARA,"CENTRUL DE SĂNĂTATE MULTIFUNCŢIONAL",192,"ORAŞ CĂLAN",87424,1,PART,PRCNCT,PRSD,PRSD_SV,"2025-05-18 22:01:20",1465,721,680,38,3,710,11,1600,879,400,310
22,HUNEDOARA,"CASA CĂSĂTORIILOR",193,"ORAŞ CĂLAN",87424,1,PART,PRCNCT,PRSD,PRSD_SV,"2025-05-18 21:33:45",1268,614,550,63,1,605,9,1400,786,302,303
22,HUNEDOARA,"ŞCOALA PRIMARĂ",194,"ORAŞ CĂLAN",87424,1,PART,PRCNCT,PRSD,PRSD_SV,"2025-05-18 21:20:05",476,200,167,33,0,199,1,600,400,95,104
22,HUNEDOARA,"ŞCOALA PRIMARĂ",195,"ORAŞ CĂLAN",87424,1,PART,PRCNCT,PRSD,PRSD_SV,"2025-05-18 21:23:18",196,121,97,24,0,120,1,200,79,72,48
22,HUNEDOARA,"CĂMINUL CULTURAL",196,"ORAŞ CĂLAN",87424,1,PART,PRCNCT,PRSD,PRSD_SV,"2025-05-18 21:49:05",265,177,151,26,0,176,1,300,123,108,68
22,HUNEDOARA,"CĂMINUL CULTURAL",197,"ORAŞ CĂLAN",87424,1,PART,PRCNCT,PRSD,PRSD_SV,"2025-05-18 21:23:04",226,138,108,30,0,135,3,250,112,66,69
22,HUNEDOARA,"ŞCOALA PRIMARĂ SÎNCRAI",198,"ORAŞ CĂLAN",87424,1,PART,PRCNCT,PRSD,PRSD_SV,"2025-05-18 21:23:49",247,149,109,40,0,147,2,250,101,66,81
22,HUNEDOARA,"CĂMINUL CULTURAL SÂNTĂMĂRIA DE PIATRĂ",199,"ORAŞ CĂLAN",87424,1,PART,PRCNCT,PRSD,PRSD_SV,"2025-05-18 21:09:54",124,90,70,20,0,89,1,150,60,58,31
22,HUNEDOARA,"CĂMINUL CULTURAL",200,"ORAŞ CĂLAN",87424,1,PART,PRCNCT,PRSD,PRSD_SV,"2025-05-18 21:16:12",296,166,135,31,0,165,1,300,134,101,64
22,HUNEDOARA,"CĂMINUL CULTURAL",201,"ORAŞ CĂLAN",87424,1,PART,PRCNCT,PRSD,PRSD_SV,"2025-05-18 21:15:21",157,108,86,20,2,108,0,200,92,66,42
22,HUNEDOARA,"CĂMINUL CULTURAL STREISÎNGEORGIU",202,"ORAŞ CĂLAN",87424,1,PART,PRCNCT,PRSD,PRSD_SV,"2025-05-18 21:20:10",643,385,360,25,0,377,8,700,315,156,221
22,HUNEDOARA,"CĂMINUL CULTURAL",203,"ORAŞ CĂLAN",87424,1,PART,PRCNCT,PRSD,PRSD_SV,"2025-05-18 21:17:56",251,159,135,24,0,157,2,300,141,104,53
22,HUNEDOARA,"SEDIUL PRIMARIEI GEOAGIU",204,"ORAŞ GEOAGIU",89561,1,PART,PRCNCT,PRSD,PRSD_SV,"2025-05-18 22:02:28",1236,808,644,88,76,795,13,1500,692,423,372
22,HUNEDOARA,"GRĂDINIŢA CU PROGRAM NORMAL NR.1 GEOAGIU,",205,"ORAŞ GEOAGIU",89561,1,PART,PRCNCT,PRSD,PRSD_SV,"2025-05-18 21:57:13",1223,630,584,46,0,621,9,1300,670,384,237
22,HUNEDOARA,"CĂMINUL CULTURAL AUREL VLAICU",206,"ORAŞ GEOAGIU",89561,2,PART,PRCNCT,PRSD,PRSD_SV,"2025-05-19 02:55:26",777,463,408,55,0,459,4,850,387,287,172
22,HUNEDOARA,"CĂMINUL CULTURAL BOZES",207,"ORAŞ GEOAGIU",89561,1,PART,PRCNCT,PRSD,PRSD_SV,"2025-05-18 21:13:26",186,115,90,25,0,114,1,200,85,46,68
22,HUNEDOARA,"ŞCOALA PRIMARĂ CIGMAU",208,"ORAŞ GEOAGIU",89561,1,PART,PRCNCT,PRSD,PRSD_SV,"2025-05-18 21:34:44",76,54,31,23,0,52,2,100,46,35,17
22,HUNEDOARA,"ŞCOALA PRIMARĂ GELMAR",209,"ORAŞ GEOAGIU",89561,1,PART,PRCNCT,PRSD,PRSD_SV,"2025-05-18 21:22:07",370,234,197,37,0,231,3,400,166,136,95
22,HUNEDOARA,"SCOALA PRIMARA GEOAGIU BAI",210,"ORAŞ GEOAGIU",89561,1,PART,PRCNCT,PRSD,PRSD_SV,"2025-05-18 21:59:23",369,533,185,346,2,517,16,650,117,226,291
22,HUNEDOARA,"CĂMINUL CULTURAL HOMOROD",211,"ORAŞ GEOAGIU",89561,1,PART,PRCNCT,PRSD,PRSD_SV,"2025-05-18 21:21:15",260,158,137,18,3,156,2,300,142,85,71
22,HUNEDOARA,"CĂMINUL CULTURAL RENGHET",212,"ORAŞ GEOAGIU",89561,1,PART,PRCNCT,PRSD,PRSD_SV,"2025-05-18 21:27:38",154,102,71,31,0,100,2,150,48,65,35
22,HUNEDOARA,"ŞCOALA PRIMARĂ VĂLENI",213,"ORAŞ GEOAGIU",89561,1,PART,PRCNCT,PRSD,PRSD_SV,"2025-05-18 21:12:47",39,26,7,16,3,26,0,50,24,16,10
22,HUNEDOARA,"PRIMĂRIA ORAŞULUI HAŢEG",214,"ORAŞ HAŢEG",87576,1,PART,PRCNCT,PRSD,PRSD_SV,"2025-05-18 21:48:30",1457,974,779,191,4,957,17,1600,626,472,485
22,HUNEDOARA,"ȘCOALA GIMNAZIALĂ ”OVID DENSUȘIANU”, HAȚEG",215,"ORAŞ HAŢEG",87576,1,PART,PRCNCT,PRSD,PRSD_SV,"2025-05-18 22:10:10",1474,776,673,83,20,767,9,1600,824,372,395
22,HUNEDOARA,"ȘCOALA GIMNAZIALĂ ”ARON DENSUȘIANU”, HAȚEG",216,"ORAŞ HAŢEG",87576,1,PART,PRCNCT,PRSD,PRSD_SV,"2025-05-18 22:43:30",1533,874,710,163,1,860,14,1600,726,425,435
22,HUNEDOARA,"COLEGIUL NAŢIONAL ”I.C.BRĂTIANU” HAŢEG",217,"ORAŞ HAŢEG",87576,1,PART,PRCNCT,PRSD,PRSD_SV,"2025-05-18 22:27:11",1407,829,668,140,21,818,11,1700,871,339,479
22,HUNEDOARA,"CANTINA SOCIALĂ HAŢEG",218,"ORAŞ HAŢEG",87576,1,PART,PRCNCT,PRSD,PRSD_SV,"2025-05-18 22:10:47",1702,990,883,84,23,971,19,1900,910,384,587
22,HUNEDOARA,"ŞCOALA PRIMARĂ NĂLAŢVAD",219,"ORAŞ HAŢEG",87576,1,PART,PRCNCT,PRSD,PRSD_SV,"2025-05-18 21:35:21",337,183,168,15,0,177,6,350,167,89,88
22,HUNEDOARA,"CĂMINUL CULTURAL SILVAŞU DE JOS",220,"ORAŞ HAŢEG",87576,2,PART,PRCNCT,PRSD,PRSD_SV,"2025-05-19 01:49:42",292,346,180,158,8,338,8,400,54,162,176
22,HUNEDOARA,"CĂMINUL CULTURAL SILVAȘU DE SUS",221,"ORAŞ HAŢEG",87576,1,PART,PRCNCT,PRSD,PRSD_SV,"2025-05-18 21:56:55",242,228,143,85,0,225,3,250,22,117,108
22,HUNEDOARA,"CASA DE CULTURĂ „LADISLAU SCHMIDT”",222,"ORAŞ PETRILA",87077,1,PART,PRCNCT,PRSD,PRSD_SV,"2025-05-18 21:36:58",1350,642,594,47,1,619,23,1500,858,371,248
22,HUNEDOARA,"ȘCOALA GIMNAZIALĂ „ION DESIDERIU SÎRBU” PETRILA (GRĂDINIȚA CU PROGRAM NORMAL „I.D.SÎRBU”)",223,"ORAŞ PETRILA",87077,1,PART,PRCNCT,PRSD,PRSD_SV,"2025-05-18 21:28:11",1327,597,565,32,0,582,15,1450,853,372,210
22,HUNEDOARA,"ȘCOALA GIMNAZIALĂ „ION DESIDERIU SÎRBU” PETRILA (GRĂDINIȚA CU PROGRAM NORMAL „I.D.SÎRBU”)",224,"ORAŞ PETRILA",87077,1,PART,PRCNCT,PRSD,PRSD_SV,"2025-05-18 21:43:48",1266,563,542,21,0,557,6,1400,837,337,220
22,HUNEDOARA,"CLUBUL COPIILOR VALEA JIULUI",225,"ORAŞ PETRILA",87077,1,PART,PRCNCT,PRSD,PRSD_SV,"2025-05-18 21:32:41",1196,556,521,30,5,544,12,1400,844,316,228
22,HUNEDOARA,"CLUBUL COPIILOR VALEA JIULUI",226,"ORAŞ PETRILA",87077,1,PART,PRCNCT,PRSD,PRSD_SV,"2025-05-18 21:22:22",1281,577,544,33,0,573,4,1400,823,342,231
22,HUNEDOARA,"ȘCOALA GIMNAZIALĂ NR. 6 PETRILA",227,"ORAŞ PETRILA",87077,1,PART,PRCNCT,PRSD,PRSD_SV,"2025-05-18 21:40:13",1138,495,489,6,0,490,5,1250,755,295,195
22,HUNEDOARA,"ȘCOALA GIMNAZIALĂ NR. 6 PETRILA",228,"ORAŞ PETRILA",87077,1,PART,PRCNCT,PRSD,PRSD_SV,"2025-05-18 21:44:15",865,393,367,26,0,389,4,950,557,238,151
22,HUNEDOARA,"ȘCOALA GIMNAZIALĂ NR. 5 PETRILA",229,"ORAŞ PETRILA",87077,1,PART,PRCNCT,PRSD,PRSD_SV,"2025-05-18 21:45:58",1313,555,534,21,0,546,9,1400,845,351,195
22,HUNEDOARA,"ȘCOALA GIMNAZIALĂ NR. 5 PETRILA",230,"ORAŞ PETRILA",87077,1,PART,PRCNCT,PRSD,PRSD_SV,"2025-05-18 21:40:56",1195,523,489,32,2,518,5,1300,777,351,167
22,HUNEDOARA,"DIRECȚIA DE ASISTENȚĂ SOCIALĂ PETRILA",231,"ORAŞ PETRILA",87077,1,PART,PRCNCT,PRSD,PRSD_SV,"2025-05-18 21:44:55",1242,486,463,22,1,478,8,1400,914,337,141
22,HUNEDOARA,"COLEGIUL TEHNIC „CONSTANTIN BRÂNCUȘI” PETRILA (CORP CLĂDIRE C4)",232,"ORAŞ PETRILA",87077,1,PART,PRCNCT,PRSD,PRSD_SV,"2025-05-18 21:21:34",966,506,490,16,0,497,9,1050,544,332,165
22,HUNEDOARA,"CASA PENSIONARILOR LONEA",233,"ORAŞ PETRILA",87077,1,PART,PRCNCT,PRSD,PRSD_SV,"2025-05-18 21:34:33",1165,594,574,20,0,584,10,1300,706,432,152
22,HUNEDOARA,"COLEGIUL TEHNIC „CONSTANTIN BRÂNCUȘI” PETRILA (FOSTA ȘCOALĂ GIMNAZIALĂ „ANA COLDA”)",234,"ORAŞ PETRILA",87077,2,PART,PRCNCT,PRSD,PRSD_SV,"2025-05-19 01:45:29",1302,632,604,28,0,617,15,1400,768,443,174
22,HUNEDOARA,"STADION PARÂNGUL LONEA",235,"ORAŞ PETRILA",87077,1,PART,PRCNCT,PRSD,PRSD_SV,"2025-05-18 21:27:43",1175,636,604,32,0,630,6,1300,664,369,261
22,HUNEDOARA,"ȘCOALA PRIMARĂ NR. 3 PETRILA",236,"ORAŞ PETRILA",87077,1,PART,PRCNCT,PRSD,PRSD_SV,"2025-05-18 21:34:00",1327,792,765,27,0,782,10,1450,658,648,134
22,HUNEDOARA,"ȘCOALA PRIMARĂ NR. 4 PETRILA",237,"ORAŞ PETRILA",87077,1,PART,PRCNCT,PRSD,PRSD_SV,"2025-05-18 21:27:07",544,347,324,23,0,342,5,600,253,250,92
22,HUNEDOARA,"SCOALA GIMNAZIALA ”SIGISMUND TODUTA ” SIMERIA",238,"ORAŞ SIMERIA",87665,1,PART,PRCNCT,PRSD,PRSD_SV,"2025-05-18 21:53:09",1412,762,713,49,0,742,20,1700,938,326,416
22,HUNEDOARA,"SCOALA GIMNAZIALA ”SIGISMUND TODUTA ” SIMERIA",239,"ORAŞ SIMERIA",87665,1,PART,PRCNCT,PRSD,PRSD_SV,"2025-05-18 22:10:52",1416,830,744,86,0,819,11,1550,720,358,461
22,HUNEDOARA,"GRADINITA CU PROGRAM NORMAL NR.1 SIMERIA",240,"ORAŞ SIMERIA",87665,1,PART,PRCNCT,PRSD,PRSD_SV,"2025-05-18 22:21:52",1449,802,730,69,3,786,16,1600,798,421,365
22,HUNEDOARA,"CLĂDIRE MULTIFUNCȚIONALĂ DIN CADRUL PARCULUI DE AFACERI SIMERIA",241,"ORAŞ SIMERIA",87665,1,PART,PRCNCT,PRSD,PRSD_SV,"2025-05-18 21:54:40",1355,828,677,150,1,816,12,1500,672,354,462
22,HUNEDOARA,"CLĂDIRE MULTIFUNCȚIONALĂ DIN CADRUL PARCULUI DE AFACERI SIMERIA",242,"ORAŞ SIMERIA",87665,1,PART,PRCNCT,PRSD,PRSD_SV,"2025-05-18 22:09:43",976,583,507,76,0,575,8,1050,467,277,298
22,HUNEDOARA,"OCOLUL SILVIC SIMERIA",243,"ORAŞ SIMERIA",87665,1,PART,PRCNCT,PRSD,PRSD_SV,"2025-05-18 22:22:03",1375,792,731,60,1,780,12,1500,708,394,386
22,HUNEDOARA,"COLEGIUL TEHNIC DE TRANSPORT FEROVIAR ”ANGHEL SALIGNY” SIMERIA",244,"ORAŞ SIMERIA",87665,1,PART,PRCNCT,PRSD,PRSD_SV,"2025-05-18 21:48:19",1214,681,610,71,0,667,14,1300,619,365,302
22,HUNEDOARA,"CĂMINUL CULTURAL SÂNTANDREI",245,"ORAŞ SIMERIA",87665,2,PART,PRCNCT,PRSD,PRSD_SV,"2025-05-18 23:36:14",932,571,470,101,0,563,8,1000,429,303,260
22,HUNEDOARA,"SCOALA GENERALA SIMERIA VECHE",246,"ORAŞ SIMERIA",87665,1,PART,PRCNCT,PRSD,PRSD_SV,"2025-05-18 21:25:06",327,211,173,38,0,207,4,350,139,114,93
22,HUNEDOARA,"CASA SATULUI UROI",247,"ORAŞ SIMERIA",87665,1,PART,PRCNCT,PRSD,PRSD_SV,"2025-05-18 21:56:58",514,323,283,40,0,320,3,550,227,181,139
22,HUNEDOARA,"CENTRUL NAŢIONAL DE INFORMARE ŞI PROMOVARE TURISTICĂ",248,"ORAŞ URICANI",87139,1,PART,PRCNCT,PRSD,PRSD_SV,"2025-05-18 22:23:03",1850,852,800,52,0,839,13,2100,1248,522,317
22,HUNEDOARA,"ȘCOALA GIMNAZIALĂ NR. 2 URICANI",249,"ORAŞ URICANI",87139,1,PART,PRCNCT,PRSD,PRSD_SV,"2025-05-18 21:35:05",1714,665,630,35,0,652,13,1900,1235,410,242
22,HUNEDOARA,"LICEUL TEHNOLOGIC ”RETEZAT” URICANI",250,"ORAŞ URICANI",87139,1,PART,PRCNCT,PRSD,PRSD_SV,"2025-05-18 21:44:45",1629,587,555,32,0,581,6,1800,1213,345,236
22,HUNEDOARA,"CASA DE CULTURĂ URICANI",251,"ORAŞ URICANI",87139,1,PART,PRCNCT,PRSD,PRSD_SV,"2025-05-18 21:39:26",1657,665,630,35,0,646,19,1800,1135,411,235
22,HUNEDOARA,"ŞCOALA PRIMARĂ CÂMPU LUI NEAG",252,"ORAŞ URICANI",87139,1,PART,PRCNCT,PRSD,PRSD_SV,"2025-05-18 21:50:53",431,300,214,86,0,298,2,500,200,176,122
22,HUNEDOARA,"ŞCOALA GIMNAZIALĂ ”AVRAM IANCU” BAIA DE CRIŞ",253,"BAIA DE CRIŞ",87745,1,PART,PRCNCT,PRSD,PRSD_SV,"2025-05-18 21:40:38",573,361,283,78,0,355,6,700,339,169,186
22,HUNEDOARA,"ȘCOALA GENERALĂ CĂRĂSTĂU",254,"BAIA DE CRIŞ",87745,1,PART,PRCNCT,PRSD,PRSD_SV,"2025-05-18 21:31:03",150,79,60,19,0,75,4,150,71,40,35
22,HUNEDOARA,"ȘCOALA GENERALĂ LUNCA",255,"BAIA DE CRIŞ",87745,1,PART,PRCNCT,PRSD,PRSD_SV,"2025-05-18 21:23:46",219,129,116,13,0,128,1,250,121,73,55
22,HUNEDOARA,"CĂMINUL CULTURAL RIȘCA",256,"BAIA DE CRIŞ",87745,1,PART,PRCNCT,PRSD,PRSD_SV,"2025-05-18 21:26:11",172,113,92,21,0,111,2,200,87,51,60
22,HUNEDOARA,"ȘCOALA PRIMARĂ RIȘCULIȚA",257,"BAIA DE CRIŞ",87745,1,PART,PRCNCT,PRSD,PRSD_SV,"2025-05-18 21:29:36",364,210,151,50,9,210,0,400,190,102,108
22,HUNEDOARA,"ȘCOALA PRIMARĂ ȚEBEA",258,"BAIA DE CRIŞ",87745,1,PART,PRCNCT,PRSD,PRSD_SV,"2025-05-18 21:35:13",524,327,273,49,5,322,5,550,223,172,150
22,HUNEDOARA,"PRIMĂRIA COMUNEI BALŞA",259,BALŞA,87843,1,PART,PRCNCT,PRSD,PRSD_SV,"2025-05-18 21:27:51",231,162,115,47,0,155,7,249,87,86,69
22,HUNEDOARA,"ŞCOALA GENERALĂ ALMAŞU MIC DE MUNTE",260,BALŞA,87843,1,PART,PRCNCT,PRSD,PRSD_SV,"2025-05-18 21:18:47",50,42,22,20,0,41,1,60,18,16,25
22,HUNEDOARA,"CĂMINUL CULTURAL ARDEU",261,BALŞA,87843,1,PART,PRCNCT,PRSD,PRSD_SV,"2025-05-18 21:21:55",50,46,29,17,0,46,0,80,34,37,9
22,HUNEDOARA,"CĂMINUL CULTURAL MADA",262,BALŞA,87843,1,PART,PRCNCT,PRSD,PRSD_SV,"2025-05-18 21:29:53",88,60,33,27,0,59,1,91,31,21,38
22,HUNEDOARA,"CĂMINUL CULTURAL POIANA",263,BALŞA,87843,1,PART,PRCNCT,PRSD,PRSD_SV,"2025-05-18 21:32:44",77,63,32,30,1,63,0,90,27,27,36
22,HUNEDOARA,"CĂMINUL CULTURAL POIENIŢA",264,BALŞA,87843,1,PART,PRCNCT,PRSD,PRSD_SV,"2025-05-18 21:21:26",65,47,21,26,0,45,2,70,23,35,10
22,HUNEDOARA,"ŞCOALA GENERALĂ VĂLIŞOARA",265,BALŞA,87843,1,PART,PRCNCT,PRSD,PRSD_SV,"2025-05-18 21:12:10",52,33,11,22,0,33,0,50,17,13,20
22,HUNEDOARA,"CĂMINUL CULTURAL VOIA",266,BALŞA,87843,1,PART,PRCNCT,PRSD,PRSD_SV,"2025-05-18 21:15:56",60,57,29,27,1,56,1,90,33,25,31
22,HUNEDOARA,"SCOALA PRIMARĂ BARU",267,BARU,87996,1,PART,PRCNCT,PRSD,PRSD_SV,"2025-05-18 21:46:53",1572,933,795,123,15,925,8,1700,767,606,319
22,HUNEDOARA,"SCOALA PRIMARĂ LIVADIA",268,BARU,87996,1,PART,PRCNCT,PRSD,PRSD_SV,"2025-05-18 21:31:52",511,348,271,67,10,344,4,550,202,224,120
22,HUNEDOARA,"SCOALA PRIMARĂ VALEA LUPULUI",269,BARU,87996,1,PART,PRCNCT,PRSD,PRSD_SV,"2025-05-18 21:35:07",159,125,88,37,0,125,0,170,45,86,39
22,HUNEDOARA,"CĂMINUL CULTURAL BĂCIA",270,BĂCIA,88047,1,PART,PRCNCT,PRSD,PRSD_SV,"2025-05-18 22:16:03",847,567,438,127,2,556,11,950,383,237,319
22,HUNEDOARA,"ŞCOALA PRIMARĂ TÂMPA",271,BĂCIA,88047,1,PART,PRCNCT,PRSD,PRSD_SV,"2025-05-18 21:32:01",646,389,341,48,0,377,12,700,311,212,165
22,HUNEDOARA,"ŞCOALA PRIMARĂ TOTIA",272,BĂCIA,88047,1,PART,PRCNCT,PRSD,PRSD_SV,"2025-05-18 21:11:35",89,78,48,30,0,77,1,100,22,40,37
22,HUNEDOARA,"CĂMINUL CULTURAL BĂIȚA",273,BĂIŢA,88092,1,PART,PRCNCT,PRSD,PRSD_SV,"2025-05-18 22:02:13",988,631,502,129,0,621,10,1100,469,412,209
22,HUNEDOARA,"CĂMINUL CULTURAL BARBURA",274,BĂIŢA,88092,1,PART,PRCNCT,PRSD,PRSD_SV,"2025-05-18 21:12:59",247,135,106,29,0,133,2,260,125,67,66
22,HUNEDOARA,"CĂMINUL CULTURAL CĂINELU DE SUS",275,BĂIŢA,88092,1,PART,PRCNCT,PRSD,PRSD_SV,"2025-05-18 21:22:42",330,231,192,39,0,222,9,350,119,168,54
22,HUNEDOARA,"CĂMINUL CULTURAL HĂRŢĂGANI",276,BĂIŢA,88092,1,PART,PRCNCT,PRSD,PRSD_SV,"2025-05-18 21:28:16",606,365,292,73,0,363,2,650,285,284,79
22,HUNEDOARA,"CĂMINUL CULTURAL LUNCA",277,BĂIŢA,88092,1,PART,PRCNCT,PRSD,PRSD_SV,"2025-05-18 21:17:52",241,149,126,23,0,149,0,250,101,86,63
22,HUNEDOARA,"CĂMINUL CULTURAL ORMINDEA",278,BĂIŢA,88092,1,PART,PRCNCT,PRSD,PRSD_SV,"2025-05-18 21:32:05",434,250,206,44,0,248,2,480,230,166,82
22,HUNEDOARA,"ȘCOALA GIMNAZIALĂ BĂNIȚA",279,BĂNIŢA,87246,1,PART,PRCNCT,PRSD,PRSD_SV,"2025-05-18 21:53:39",994,583,496,82,5,575,8,1100,517,355,220
22,HUNEDOARA,"PRIMĂRIA COMUNEI BĂTRÂNA",280,BĂTRÂNA,88216,1,PART,PRCNCT,PRSD,PRSD_SV,"2025-05-18 21:07:56",87,55,35,20,0,55,0,130,75,42,13
22,HUNEDOARA,"CĂMINUL CULTURAL BERIU",281,BERIU,88261,2,PART,PRCNCT,PRSD,PRSD_SV,"2025-05-19 00:46:50",598,355,292,62,1,350,5,650,295,223,127
22,HUNEDOARA,"ȘCOALA GENERALĂ CĂSTĂU",282,BERIU,88261,1,PART,PRCNCT,PRSD,PRSD_SV,"2025-05-18 21:45:30",1166,561,513,37,11,554,7,1250,689,351,203
22,HUNEDOARA,"ȘCOALA PRIMARĂ CUCUIȘ",283,BERIU,88261,1,PART,PRCNCT,PRSD,PRSD_SV,"2025-05-18 21:58:59",113,80,59,19,2,79,1,120,40,54,25
22,HUNEDOARA,"CĂMINUL CULTURAL ORĂȘTIOARA DE JOS",284,BERIU,88261,1,PART,PRCNCT,PRSD,PRSD_SV,"2025-05-18 21:17:53",290,219,164,52,3,217,2,300,81,108,109
22,HUNEDOARA,"CĂMINUL CULTURAL SERECA",285,BERIU,88261,1,PART,PRCNCT,PRSD,PRSD_SV,"2025-05-18 21:22:56",232,131,102,29,0,130,1,250,119,88,42
22,HUNEDOARA,"CĂMINUL CULTURAL SIBIȘEL",286,BERIU,88261,1,PART,PRCNCT,PRSD,PRSD_SV,"2025-05-18 21:31:36",594,354,301,50,3,350,4,650,296,248,102
22,HUNEDOARA,"CĂMINUL CULTURAL BLĂJENI",287,BLĂJENI,88350,1,PART,PRCNCT,PRSD,PRSD_SV,"2025-05-18 21:21:37",445,256,205,47,4,253,3,500,244,133,120
22,HUNEDOARA,"ȘCOALA PRIMARĂ BLĂJENI-VULCAN",288,BLĂJENI,88350,1,PART,PRCNCT,PRSD,PRSD_SV,"2025-05-18 21:06:18",68,47,35,12,0,47,0,70,23,28,19
22,HUNEDOARA,"ȘCOALA PRIMARĂ CRIȘ",289,BLĂJENI,88350,1,PART,PRCNCT,PRSD,PRSD_SV,"2025-05-18 21:14:15",226,104,73,30,1,102,2,250,146,49,53
22,HUNEDOARA,"ȘCOALA PRIMARĂ REȚ",290,BLĂJENI,88350,1,PART,PRCNCT,PRSD,PRSD_SV,"2025-05-18 21:07:30",66,47,33,14,0,47,0,70,23,20,27
22,HUNEDOARA,"CĂMINUL CULTURAL BOŞOROD",291,BOŞOROD,88449,2,PART,PRCNCT,PRSD,PRSD_SV,"2025-05-18 23:44:31",749,470,427,41,2,467,3,800,330,324,143
22,HUNEDOARA,"CĂMINUL CULTURAL ALUN",292,BOŞOROD,88449,1,PART,PRCNCT,PRSD,PRSD_SV,"2025-05-18 21:11:19",49,36,25,11,0,36,0,70,34,27,9
22,HUNEDOARA,"CENTRUL LOCAL DE INFORMARE TURISTICĂ",293,BOŞOROD,88449,1,PART,PRCNCT,PRSD,PRSD_SV,"2025-05-18 21:26:04",424,256,218,38,0,250,6,450,194,133,117
22,HUNEDOARA,"CĂMINUL CULTURAL LUNCANI",294,BOŞOROD,88449,1,PART,PRCNCT,PRSD,PRSD_SV,"2025-05-18 21:12:11",100,48,33,15,0,48,0,100,52,31,17
22,HUNEDOARA,"CĂMINUL CULTURAL TÂRSA",295,BOŞOROD,88449,1,PART,PRCNCT,PRSD,PRSD_SV,"2025-05-18 21:09:05",142,114,85,29,0,113,1,150,36,53,60
22,HUNEDOARA,"CĂMINUL CULTURAL URSICI",296,BOŞOROD,88449,1,PART,PRCNCT,PRSD,PRSD_SV,"2025-05-18 21:06:12",46,28,14,14,0,28,0,50,22,19,9
22,HUNEDOARA,"CĂMINUL CULTURAL BRĂNIȘCA",297,BRĂNIŞCA,88546,1,PART,PRCNCT,PRSD,PRSD_SV,"2025-05-18 21:36:30",511,311,232,76,3,306,5,600,289,174,132
22,HUNEDOARA,"CĂMINUL CULTURAL BOZ",298,BRĂNIŞCA,88546,1,PART,PRCNCT,PRSD,PRSD_SV,"2025-05-18 21:28:35",345,219,163,56,0,218,1,350,131,129,89
22,HUNEDOARA,"CĂMINUL CULTURAL FURCȘOARA",299,BRĂNIŞCA,88546,1,PART,PRCNCT,PRSD,PRSD_SV,"2025-05-18 21:07:03",28,40,12,28,0,39,1,70,30,26,13
22,HUNEDOARA,"CĂMINUL CULTURAL ROVINA",300,BRĂNIŞCA,88546,1,PART,PRCNCT,PRSD,PRSD_SV,"2025-05-18 21:20:26",173,133,95,38,0,132,1,190,57,88,44
22,HUNEDOARA,"CĂMINUL CULTURAL TÂRNAVA",301,BRĂNIŞCA,88546,1,PART,PRCNCT,PRSD,PRSD_SV,"2025-05-18 21:07:15",75,53,35,18,0,52,1,80,27,37,15
22,HUNEDOARA,"CĂMINUL CULTURAL TÂRNĂVIȚA",302,BRĂNIŞCA,88546,1,PART,PRCNCT,PRSD,PRSD_SV,"2025-05-18 21:26:57",149,103,75,28,0,102,1,150,47,75,27
22,HUNEDOARA,"ȘCOALA GIMNAZIALĂ BRETEA ROMÂNĂ",303,"BRETEA ROMÂNĂ",88644,1,PART,PRCNCT,PRSD,PRSD_SV,"2025-05-18 21:22:32",210,133,104,29,0,132,1,230,97,60,72
22,HUNEDOARA,"CĂMINUL CULTURAL BĂȚĂLAR",304,"BRETEA ROMÂNĂ",88644,1,PART,PRCNCT,PRSD,PRSD_SV,"2025-05-18 21:25:52",205,133,107,26,0,131,2,220,87,76,55
22,HUNEDOARA,"CĂMINUL CULTURAL BRETEA STREIULUI",305,"BRETEA ROMÂNĂ",88644,1,PART,PRCNCT,PRSD,PRSD_SV,"2025-05-18 21:18:19",216,133,104,29,0,128,5,250,117,75,53
22,HUNEDOARA,"CĂMINUL CULTURAL COVRAGIU",306,"BRETEA ROMÂNĂ",88644,1,PART,PRCNCT,PRSD,PRSD_SV,"2025-05-18 21:16:06",124,85,67,18,0,84,1,130,45,62,22
22,HUNEDOARA,"CĂMINUL CULTURAL GÂNȚAGA",307,"BRETEA ROMÂNĂ",88644,1,PART,PRCNCT,PRSD,PRSD_SV,"2025-05-18 21:16:45",221,151,123,28,0,146,5,240,89,81,65
22,HUNEDOARA,"ȘCOALA PRIMARĂ MĂCEU",308,"BRETEA ROMÂNĂ",88644,1,PART,PRCNCT,PRSD,PRSD_SV,"2025-05-18 21:31:05",266,161,138,23,0,156,5,300,139,90,66
22,HUNEDOARA,"CĂMINUL CULTURAL OCOLIȘU MARE",309,"BRETEA ROMÂNĂ",88644,1,PART,PRCNCT,PRSD,PRSD_SV,"2025-05-18 21:34:11",174,160,109,51,0,156,4,190,30,83,73
22,HUNEDOARA,"ȘCOALA PRIMARĂ PLOPI",310,"BRETEA ROMÂNĂ",88644,1,PART,PRCNCT,PRSD,PRSD_SV,"2025-05-18 21:26:23",221,165,140,24,1,164,1,240,75,97,67
22,HUNEDOARA,"CĂMINUL CULTURAL RUȘI",311,"BRETEA ROMÂNĂ",88644,1,PART,PRCNCT,PRSD,PRSD_SV,"2025-05-18 21:22:45",190,174,113,61,0,173,1,200,26,111,62
22,HUNEDOARA,"CĂMINUL CULTURAL VÂLCELE",312,"BRETEA ROMÂNĂ",88644,1,PART,PRCNCT,PRSD,PRSD_SV,"2025-05-18 21:09:12",211,141,115,26,0,139,2,230,89,68,71
22,HUNEDOARA,"CĂMINUL CULTURAL VÂLCELELE BUNE",313,"BRETEA ROMÂNĂ",88644,1,PART,PRCNCT,PRSD,PRSD_SV,"2025-05-18 21:10:21",306,192,164,28,0,190,2,330,138,125,65
22,HUNEDOARA,"CĂMINUL CULTURAL BUCEȘ",314,BUCEŞ,88788,1,PART,PRCNCT,PRSD,PRSD_SV,"2025-05-18 21:13:41",118,104,70,34,0,104,0,120,16,63,41
22,HUNEDOARA,"ȘCOALA PRIMARĂ BUCEȘ-VULCAN",315,BUCEŞ,88788,1,PART,PRCNCT,PRSD,PRSD_SV,"2025-05-18 21:20:39",156,119,93,26,0,117,2,170,51,65,52
22,HUNEDOARA,"ȘCOALA PRIMARĂ DUPĂPIATRĂ",316,BUCEŞ,88788,1,PART,PRCNCT,PRSD,PRSD_SV,"2025-05-18 21:17:56",359,220,192,28,0,217,3,400,180,156,61
22,HUNEDOARA,"ȘCOALA PRIMARĂ GROHOȚELE",317,BUCEŞ,88788,1,PART,PRCNCT,PRSD,PRSD_SV,"2025-05-18 21:15:48",162,113,94,19,0,113,0,170,57,77,36
22,HUNEDOARA,"AFTER SCHOOL",318,BUCEŞ,88788,1,PART,PRCNCT,PRSD,PRSD_SV,"2025-05-18 21:13:04",327,205,178,27,0,204,1,350,145,153,51
22,HUNEDOARA,"ȘCOALA PRIMARĂ STĂNIJA",319,BUCEŞ,88788,1,PART,PRCNCT,PRSD,PRSD_SV,"2025-05-18 21:14:57",307,178,164,14,0,173,5,330,152,125,48
22,HUNEDOARA,"CĂMINUL CULTURAL BUCUREŞCI",320,BUCUREŞCI,88868,1,PART,PRCNCT,PRSD,PRSD_SV,"2025-05-18 21:43:22",461,320,279,36,5,315,5,500,180,172,143
22,HUNEDOARA,"CĂMINUL CULTURAL CURECHIU",321,BUCUREŞCI,88868,1,PART,PRCNCT,PRSD,PRSD_SV,"2025-05-18 21:24:55",251,179,141,38,0,179,0,270,91,113,66
22,HUNEDOARA,"CĂMINUL CULTURAL MERIŞOR",322,BUCUREŞCI,88868,1,PART,PRCNCT,PRSD,PRSD_SV,"2025-05-18 21:17:19",70,57,41,16,0,57,0,80,23,33,24
22,HUNEDOARA,"CĂMINUL CULTURAL ROVINA",323,BUCUREŞCI,88868,1,PART,PRCNCT,PRSD,PRSD_SV,"2025-05-18 21:27:35",119,73,54,19,0,72,1,130,57,32,40
22,HUNEDOARA,"CĂMINUL CULTURAL ŞESURI",324,BUCUREŞCI,88868,1,PART,PRCNCT,PRSD,PRSD_SV,"2025-05-18 21:31:21",318,206,181,25,0,205,1,340,134,136,69
22,HUNEDOARA,"PRIMĂRIA BULZEȘTII DE SUS SALA DE ȘEDINȚĂ",325,"BULZEŞTII DE SUS",88920,1,PART,PRCNCT,PRSD,PRSD_SV,"2025-05-18 21:24:34",129,89,62,27,0,86,3,150,61,56,30
22,HUNEDOARA,"COOPERATIVA DE CONSUM BULZEȘTII DE JOS",326,"BULZEŞTII DE SUS",88920,1,PART,PRCNCT,PRSD,PRSD_SV,"2025-05-18 21:16:33",105,59,31,28,0,57,2,110,51,37,20
22,HUNEDOARA,"CĂMINUL CULTURAL BUNILA",327,BUNILA,89026,1,PART,PRCNCT,PRSD,PRSD_SV,"2025-05-18 21:07:43",56,41,27,14,0,41,0,60,19,20,21
22,HUNEDOARA,"CLĂDIRE DISPENSAR MEDICAL CERNIȘOARA FLORESE",328,BUNILA,89026,1,PART,PRCNCT,PRSD,PRSD_SV,"2025-05-18 21:09:46",141,83,58,25,0,82,1,150,67,58,24
22,HUNEDOARA,"CĂMINUL CULTURAL POIENIȚA VOINII",329,BUNILA,89026,1,PART,PRCNCT,PRSD,PRSD_SV,"2025-05-18 21:11:39",65,51,34,17,0,50,1,70,19,13,37
22,HUNEDOARA,"CĂMINUL CULTURAL BURJUC",330,BURJUC,89080,1,PART,PRCNCT,PRSD,PRSD_SV,"2025-05-18 21:27:14",124,84,51,33,0,83,1,130,46,43,40
22,HUNEDOARA,"ŞCOALA PRIMARĂ BRĂDĂŢEL",331,BURJUC,89080,1,PART,PRCNCT,PRSD,PRSD_SV,"2025-05-18 21:16:59",101,52,34,18,0,52,0,110,58,28,24
22,HUNEDOARA,"ŞCOALA PRIMARĂ GLODGHILEŞTI",332,BURJUC,89080,1,PART,PRCNCT,PRSD,PRSD_SV,"2025-05-18 21:32:08",171,85,66,19,0,85,0,180,95,52,33
22,HUNEDOARA,"CĂMINUL CULTURAL TĂTĂRĂŞTI",333,BURJUC,89080,1,PART,PRCNCT,PRSD,PRSD_SV,"2025-05-18 21:28:03",153,82,47,34,1,82,0,170,88,50,32
22,HUNEDOARA,"CĂMINUL CULTURAL TISA",334,BURJUC,89080,1,PART,PRCNCT,PRSD,PRSD_SV,"2025-05-18 21:14:05",85,81,33,48,0,81,0,90,9,38,43
22,HUNEDOARA,"CĂMINUL CULTURAL CÂRJIŢI",335,CÂRJIŢI,86749,1,PART,PRCNCT,PRSD,PRSD_SV,"2025-05-18 21:14:01",100,89,54,35,0,88,1,110,21,50,38
22,HUNEDOARA,"CĂMINUL CULTURAL ALMAŞU SEC",336,CÂRJIŢI,86749,1,PART,PRCNCT,PRSD,PRSD_SV,"2025-05-18 21:18:39",169,144,103,40,1,139,5,180,36,48,91
22,HUNEDOARA,"CĂMINUL CULTURAL CHERGHEŞ",337,CÂRJIŢI,86749,1,PART,PRCNCT,PRSD,PRSD_SV,"2025-05-18 21:08:40",82,49,33,16,0,48,1,90,41,24,24
22,HUNEDOARA,"CĂMINUL CULTURAL COZIA",338,CÂRJIŢI,86749,1,PART,PRCNCT,PRSD,PRSD_SV,"2025-05-18 21:22:58",141,109,80,29,0,108,1,150,41,72,36
22,HUNEDOARA,"CĂMINUL CULTURAL POPEŞTI",339,CÂRJIŢI,86749,1,PART,PRCNCT,PRSD,PRSD_SV,"2025-05-18 21:21:06",116,108,67,41,0,105,3,130,22,55,50
22,HUNEDOARA,"CASA COMUNALĂ CERBĂL-SALA DE ŞEDINŢĂ A CONSILIULUI LOCAL CERBĂL",340,CERBĂL,89151,1,PART,PRCNCT,PRSD,PRSD_SV,"2025-05-18 21:16:32",161,111,82,29,0,110,1,169,58,76,34
22,HUNEDOARA,"ŞCOALA PRIMARĂ FEREGI",341,CERBĂL,89151,1,PART,PRCNCT,PRSD,PRSD_SV,"2025-05-18 21:11:20",90,84,48,36,0,83,1,100,16,49,34
22,HUNEDOARA,"ŞCOALA PRIMARĂ POIANA RĂCHIŢELII",342,CERBĂL,89151,1,PART,PRCNCT,PRSD,PRSD_SV,"2025-05-18 21:10:01",83,88,62,26,0,88,0,120,32,56,32
22,HUNEDOARA,"CĂMINUL CULTURAL CERTEJU DE SUS",343,"CERTEJU DE SUS",89240,1,PART,PRCNCT,PRSD,PRSD_SV,"2025-05-18 21:27:37",1171,614,555,58,1,605,9,1170,556,385,220
22,HUNEDOARA,"SPAȚIU ADMINISTRATIV BOCȘA MICĂ",344,"CERTEJU DE SUS",89240,2,PART,PRCNCT,PRSD,PRSD_SV,"2025-05-18 22:18:29",84,69,47,22,0,67,2,90,21,49,18
22,HUNEDOARA,"CĂMINUL CULTURAL HONDOL",345,"CERTEJU DE SUS",89240,1,PART,PRCNCT,PRSD,PRSD_SV,"2025-05-18 21:22:02",414,236,207,29,0,234,2,450,214,158,76
22,HUNEDOARA,"CĂMINUL CULTURAL MĂGURA-TOPLIȚA",346,"CERTEJU DE SUS",89240,1,PART,PRCNCT,PRSD,PRSD_SV,"2025-05-18 21:13:57",86,65,39,26,0,65,0,100,35,48,17
22,HUNEDOARA,"ȘCOALA GENERALĂ CU CLS. I-IV NOJAG",347,"CERTEJU DE SUS",89240,1,PART,PRCNCT,PRSD,PRSD_SV,"2025-05-18 21:17:30",205,133,100,32,1,132,1,220,87,83,49
22,HUNEDOARA,"CĂMINUL CULTURAL SĂCĂRÂMB",348,"CERTEJU DE SUS",89240,1,PART,PRCNCT,PRSD,PRSD_SV,"2025-05-18 21:14:46",155,110,69,41,0,109,1,170,60,51,58
22,HUNEDOARA,"CĂMINUL CULTURAL TOPLIȚA MUREȘULUI",349,"CERTEJU DE SUS",89240,1,PART,PRCNCT,PRSD,PRSD_SV,"2025-05-18 21:18:09",81,83,50,33,0,82,1,110,27,50,32
22,HUNEDOARA,"ȘCOALA GENERALĂ CU CLS. I-IV VĂRMAGA",350,"CERTEJU DE SUS",89240,1,PART,PRCNCT,PRSD,PRSD_SV,"2025-05-18 21:14:31",259,174,120,54,0,170,4,280,106,133,37
22,HUNEDOARA,"PRIMĂRIA COMUNEI CRIȘCIOR - CASA CĂSĂTORIILOR",351,CRIŞCIOR,87362,1,PART,PRCNCT,PRSD,PRSD_SV,"2025-05-18 21:58:05",1244,687,613,74,0,676,11,1350,663,419,257
22,HUNEDOARA,"LICEUL TEHNOLOGIC ”CRIŞAN” CRIŞCIOR",352,CRIŞCIOR,87362,1,PART,PRCNCT,PRSD,PRSD_SV,"2025-05-18 21:50:42",1159,638,587,51,0,628,10,1250,612,441,187
22,HUNEDOARA,"CĂMINUL CULTURAL ZDRAPȚI",353,CRIŞCIOR,87362,1,PART,PRCNCT,PRSD,PRSD_SV,"2025-05-18 21:34:24",697,399,348,51,0,394,5,750,351,213,181
22,HUNEDOARA,"CĂMINUL CULTURAL DENSUȘ",354,DENSUŞ,89348,1,PART,PRCNCT,PRSD,PRSD_SV,"2025-05-18 21:18:32",317,186,146,39,1,186,0,350,164,100,86
22,HUNEDOARA,"CĂMINUL CULTURAL HĂȚĂGEL",355,DENSUŞ,89348,1,PART,PRCNCT,PRSD,PRSD_SV,"2025-05-18 21:25:12",170,148,115,33,0,147,1,180,32,63,84
22,HUNEDOARA,"CĂMINUL CULTURAL PEȘTEANA",356,DENSUŞ,89348,1,PART,PRCNCT,PRSD,PRSD_SV,"2025-05-18 21:21:23",275,208,172,36,0,208,0,300,92,91,117
22,HUNEDOARA,"CĂMINUL CULTURAL PEȘTENIȚA",357,DENSUŞ,89348,1,PART,PRCNCT,PRSD,PRSD_SV,"2025-05-18 21:27:13",211,131,112,18,1,131,0,220,89,64,67
22,HUNEDOARA,"CĂMINUL CULTURAL POIENI",358,DENSUŞ,89348,1,PART,PRCNCT,PRSD,PRSD_SV,"2025-05-18 21:12:32",66,47,30,17,0,46,1,70,23,24,22
22,HUNEDOARA,"CĂMINUL CULTURAL ȘTEI",359,DENSUŞ,89348,1,PART,PRCNCT,PRSD,PRSD_SV,"2025-05-18 21:19:51",176,100,81,18,1,97,3,190,90,65,32
22,HUNEDOARA,"CĂMINUL CULTURAL DOBRA",360,DOBRA,89428,1,PART,PRCNCT,PRSD,PRSD_SV,"2025-05-18 21:30:59",1318,840,675,164,1,825,15,1450,610,488,337
22,HUNEDOARA,"CĂMINUL CULTURAL LĂPUȘNIC",361,DOBRA,89428,1,PART,PRCNCT,PRSD,PRSD_SV,"2025-05-18 21:15:45",384,236,173,63,0,233,3,400,164,150,83
22,HUNEDOARA,"CĂMINUL CULTURAL PANC",362,DOBRA,89428,1,PART,PRCNCT,PRSD,PRSD_SV,"2025-05-18 21:15:21",134,101,65,34,2,99,2,150,49,74,25
22,HUNEDOARA,"CĂMINUL CULTURAL RĂDULEȘTI",363,DOBRA,89428,1,PART,PRCNCT,PRSD,PRSD_SV,"2025-05-18 21:11:33",133,101,69,31,1,99,2,150,49,60,39
22,HUNEDOARA,"CĂMINUL CULTURAL ROȘCANI",364,DOBRA,89428,1,PART,PRCNCT,PRSD,PRSD_SV,"2025-05-18 21:19:05",541,353,291,62,0,352,1,550,197,246,106
22,HUNEDOARA,"CĂMINUL CULTURAL STÂNCEȘTI",365,DOBRA,89428,1,PART,PRCNCT,PRSD,PRSD_SV,"2025-05-18 21:06:44",94,52,33,19,0,51,1,100,48,31,20
22,HUNEDOARA,"CĂMINUL CULTURAL GENERAL BERTHELOT - CLĂDIRE ANEXĂ AFTER SCHOOL",366,"GENERAL BERTHELOT",91731,1,PART,PRCNCT,PRSD,PRSD_SV,"2025-05-18 21:34:03",512,343,290,50,3,338,5,550,207,196,142
22,HUNEDOARA,"ȘCOALA PRIMARĂ TUȘTEA",367,"GENERAL BERTHELOT",91731,1,PART,PRCNCT,PRSD,PRSD_SV,"2025-05-18 21:15:12",207,131,110,20,1,131,0,250,119,88,43
22,HUNEDOARA,"PRIMĂRIA COMUNEI GHELARI",368,GHELARI,86883,1,PART,PRCNCT,PRSD,PRSD_SV,"2025-05-18 21:45:02",591,330,281,48,1,323,7,650,320,147,176
22,HUNEDOARA,"CĂMINUL CULTURAL ”MINERUL” GHELARI",369,GHELARI,86883,1,PART,PRCNCT,PRSD,PRSD_SV,"2025-05-18 21:33:08",824,313,291,22,0,313,0,900,587,228,85
22,HUNEDOARA,"DISPENSAR GOVĂJDIA",370,GHELARI,86883,1,PART,PRCNCT,PRSD,PRSD_SV,"2025-05-18 21:21:00",86,85,32,53,0,85,0,90,5,42,43
22,HUNEDOARA,"MAGAZIN SĂTESC DIN SATUL PLOP",371,GHELARI,86883,1,PART,PRCNCT,PRSD,PRSD_SV,"2025-05-18 21:08:55",19,27,9,18,0,27,0,50,23,13,14
22,HUNEDOARA,"CĂMINUL CULTURAL RUDA",372,GHELARI,86883,1,PART,PRCNCT,PRSD,PRSD_SV,"2025-05-18 21:15:05",101,67,44,23,0,67,0,100,33,41,26
22,HUNEDOARA,"SALĂ DE ȘEDINȚE PRIMĂRIA COMUNEI GURASADA",373,GURASADA,89687,2,PART,PRCNCT,PRSD,PRSD_SV,"2025-05-19 02:30:49",602,330,246,83,1,324,6,650,320,201,123
22,HUNEDOARA,"CĂMINUL CULTURAL BOIU DE SUS",374,GURASADA,89687,1,PART,PRCNCT,PRSD,PRSD_SV,"2025-05-18 21:16:48",74,53,38,15,0,53,0,80,27,21,32
22,HUNEDOARA,"ŞCOALA GENERALĂ CĂRMĂZĂNEŞTI",375,GURASADA,89687,1,PART,PRCNCT,PRSD,PRSD_SV,"2025-05-18 21:20:29",71,54,33,21,0,54,0,80,26,20,34
22,HUNEDOARA,"CĂMINUL CULTURAL CÂMPURI-SURDUC",376,GURASADA,89687,1,PART,PRCNCT,PRSD,PRSD_SV,"2025-05-18 21:30:04",328,193,144,49,0,187,6,350,157,124,63
22,HUNEDOARA,"CĂMINUL CULTURAL HĂRĂU",377,HĂRĂU,89801,1,PART,PRCNCT,PRSD,PRSD_SV,"2025-05-18 21:16:29",691,403,330,73,0,399,4,750,347,249,150
22,HUNEDOARA,"SPAȚIU ADMINISTRATIV BANPOTOC",378,HĂRĂU,89801,1,PART,PRCNCT,PRSD,PRSD_SV,"2025-05-18 21:25:05",366,267,204,61,2,265,2,400,133,145,120
22,HUNEDOARA,"DISPENSAR UMAN BÂRSĂU",379,HĂRĂU,89801,1,PART,PRCNCT,PRSD,PRSD_SV,"2025-05-18 21:21:46",417,274,208,66,0,271,3,450,176,127,144
22,HUNEDOARA,"CĂMINUL CULTURAL CHIMINDIA",380,HĂRĂU,89801,1,PART,PRCNCT,PRSD,PRSD_SV,"2025-05-18 21:19:08",300,190,148,42,0,188,2,300,110,118,70
22,HUNEDOARA,"CĂMINUL CULTURAL ILIA",381,ILIA,89856,1,PART,PRCNCT,PRSD,PRSD_SV,"2025-05-18 21:58:37",1367,886,726,158,2,873,13,1500,614,502,371
22,HUNEDOARA,"CĂMINUL CULTURAL BACEA",382,ILIA,89856,1,PART,PRCNCT,PRSD,PRSD_SV,"2025-05-18 21:32:59",281,147,128,18,1,141,6,300,153,104,37
22,HUNEDOARA,"CĂMINUL CULTURAL BRÂZNIC",383,ILIA,89856,1,PART,PRCNCT,PRSD,PRSD_SV,"2025-05-18 21:22:31",187,145,98,47,0,141,4,200,55,57,84
22,HUNEDOARA,"CĂMINUL CULTURAL BRETEA MUREȘANĂ",384,ILIA,89856,1,PART,PRCNCT,PRSD,PRSD_SV,"2025-05-18 22:00:02",466,275,207,68,0,271,4,500,225,162,109
22,HUNEDOARA,"CĂMINUL CULTURAL SĂCĂMAȘ",385,ILIA,89856,1,PART,PRCNCT,PRSD,PRSD_SV,"2025-05-18 21:17:08",167,120,85,35,0,120,0,180,60,70,50
22,HUNEDOARA,"CĂMINUL CULTURAL SÂRBI",386,ILIA,89856,1,PART,PRCNCT,PRSD,PRSD_SV,"2025-05-18 21:28:35",352,214,178,36,0,213,1,350,136,163,50
22,HUNEDOARA,"CĂMINUL CULTURAL VALEA LUNGĂ",387,ILIA,89856,1,PART,PRCNCT,PRSD,PRSD_SV,"2025-05-18 21:08:27",92,68,47,21,0,68,0,100,32,46,22
22,HUNEDOARA,"CĂMINUL CULTURAL LĂPUGIU DE JOS",388,"LĂPUGIU DE JOS",89954,1,PART,PRCNCT,PRSD,PRSD_SV,"2025-05-18 21:29:15",367,270,180,88,2,270,0,400,130,160,110
22,HUNEDOARA,"CĂMINUL CULTURAL LĂPUGIU DE SUS",389,"LĂPUGIU DE JOS",89954,1,PART,PRCNCT,PRSD,PRSD_SV,"2025-05-18 21:18:59",293,182,141,41,0,182,0,300,118,166,16
22,HUNEDOARA,"CĂMINUL CULTURAL OHABA",390,"LĂPUGIU DE JOS",89954,1,PART,PRCNCT,PRSD,PRSD_SV,"2025-05-18 21:35:23",418,273,212,61,0,269,4,450,177,206,63
22,HUNEDOARA,"PRIMARIA COMUNEI LELESE, SALA BIBLIONET",391,LELESE,90066,1,PART,PRCNCT,PRSD,PRSD_SV,"2025-05-18 21:24:07",137,70,47,23,0,70,0,150,80,30,40
22,HUNEDOARA,"CĂMINUL CULTURAL CERIȘOR",392,LELESE,90066,1,PART,PRCNCT,PRSD,PRSD_SV,"2025-05-18 21:12:41",63,59,29,30,0,57,2,70,11,15,42
22,HUNEDOARA,"CAMIN CULTURAL RUNCU MARE",393,LELESE,90066,1,PART,PRCNCT,PRSD,PRSD_SV,"2025-05-18 21:09:06",75,52,41,11,0,51,1,80,28,37,14
22,HUNEDOARA,"ŞCOALA GIMNAZIALĂ LUNCA CERNII DE JOS",394,"LUNCA CERNII DE JOS",90119,1,PART,PRCNCT,PRSD,PRSD_SV,"2025-05-18 21:26:32",342,205,178,27,0,204,1,350,145,106,98
22,HUNEDOARA,"CĂMIN CULTURAL MERIA",395,"LUNCA CERNII DE JOS",90119,1,PART,PRCNCT,PRSD,PRSD_SV,"2025-05-18 21:20:00",186,111,95,16,0,110,1,200,89,57,53
22,HUNEDOARA,"CĂMIN CULTURAL NEGOIU",396,"LUNCA CERNII DE JOS",90119,1,PART,PRCNCT,PRSD,PRSD_SV,"2025-05-18 21:11:04",144,92,66,26,0,91,1,160,68,58,33
22,HUNEDOARA,"CENTRUL LOCAL DE INFORMARE ȘI PROMOVARE TURISTICĂ",397,"LUNCOIU DE JOS",90208,1,PART,PRCNCT,PRSD,PRSD_SV,"2025-05-18 22:07:20",818,504,445,51,8,501,3,900,396,286,215
22,HUNEDOARA,"CĂMINUL CULTURAL LUNCOIU DE SUS - MODUL CONTAINER",398,"LUNCOIU DE JOS",90208,1,PART,PRCNCT,PRSD,PRSD_SV,"2025-05-18 21:37:42",609,417,349,56,12,410,7,650,233,234,176
22,HUNEDOARA,"ȘCOALA PRIMARĂ MĂRTINEŞTI",399,MĂRTINEŞTI,90262,1,PART,PRCNCT,PRSD,PRSD_SV,"2025-05-18 21:16:25",221,156,104,52,0,155,1,240,84,81,74
22,HUNEDOARA,"CĂMINUL CULTURAL DÂNCU MARE",400,MĂRTINEŞTI,90262,1,PART,PRCNCT,PRSD,PRSD_SV,"2025-05-18 21:27:59",189,132,97,35,0,130,2,200,68,76,54
22,HUNEDOARA,"CĂMINUL CULTURAL DÂNCU MIC",401,MĂRTINEŞTI,90262,1,PART,PRCNCT,PRSD,PRSD_SV,"2025-05-18 21:13:32",85,66,32,34,0,66,0,120,54,33,33
22,HUNEDOARA,"CĂMINUL CULTURAL JELEDINŢI",402,MĂRTINEŞTI,90262,1,PART,PRCNCT,PRSD,PRSD_SV,"2025-05-18 21:18:27",207,135,100,35,0,134,1,220,85,68,66
22,HUNEDOARA,"CĂMINUL CULTURAL TĂMĂŞASA",403,MĂRTINEŞTI,90262,1,PART,PRCNCT,PRSD,PRSD_SV,"2025-05-18 21:09:19",102,64,39,25,0,64,0,110,46,34,30
22,HUNEDOARA,"CENTRUL DE SERVICII SOCIAL-CULTURALE ȘI FESTIVE",404,"ORĂŞTIOARA DE SUS",90342,1,PART,PRCNCT,PRSD,PRSD_SV,"2025-05-18 21:22:16",398,261,204,57,0,256,5,430,169,141,115
22,HUNEDOARA,"CĂMINUL CULTURAL BUCIUM",405,"ORĂŞTIOARA DE SUS",90342,1,PART,PRCNCT,PRSD,PRSD_SV,"2025-05-18 21:13:53",276,191,158,31,2,185,6,299,108,111,74
22,HUNEDOARA,"CĂMINUL CULTURAL COSTEȘTI",406,"ORĂŞTIOARA DE SUS",90342,1,PART,PRCNCT,PRSD,PRSD_SV,"2025-05-18 21:24:44",414,296,223,73,0,294,2,450,154,156,138
22,HUNEDOARA,"CĂMINUL CULTURAL GRĂDIȘTEA DE MUNTE",407,"ORĂŞTIOARA DE SUS",90342,1,PART,PRCNCT,PRSD,PRSD_SV,"2025-05-18 21:13:20",126,79,49,30,0,75,4,130,51,37,38
22,HUNEDOARA,"CĂMINUL CULTURAL LUDEŞTII DE JOS",408,"ORĂŞTIOARA DE SUS",90342,1,PART,PRCNCT,PRSD,PRSD_SV,"2025-05-18 21:19:45",264,189,140,48,1,189,0,300,111,106,83
22,HUNEDOARA,"CĂMINUL CULTURAL OCOLIŞU MIC",409,"ORĂŞTIOARA DE SUS",90342,1,PART,PRCNCT,PRSD,PRSD_SV,"2025-05-18 21:20:11",309,195,159,36,0,194,1,330,135,124,70
22,HUNEDOARA,"CĂMINUL CULTURAL PESTIȘU MIC",410,"PESTIŞU MIC",90431,1,PART,PRCNCT,PRSD,PRSD_SV,"2025-05-18 21:31:54",199,163,121,42,0,163,0,210,47,87,76
22,HUNEDOARA,"CĂMINUL CULTURAL ALMAŞU MIC",411,"PESTIŞU MIC",90431,1,PART,PRCNCT,PRSD,PRSD_SV,"2025-05-18 21:42:12",68,82,39,43,0,82,0,110,28,38,44
22,HUNEDOARA,"CĂMINUL CULTURAL CIULPĂZ",412,"PESTIŞU MIC",90431,1,PART,PRCNCT,PRSD,PRSD_SV,"2025-05-18 21:14:03",87,77,43,34,0,75,2,90,13,47,28
22,HUNEDOARA,"CĂMINUL CULTURAL JOSANI",413,"PESTIŞU MIC",90431,1,PART,PRCNCT,PRSD,PRSD_SV,"2025-05-18 21:22:25",184,134,104,30,0,133,1,196,62,76,57
22,HUNEDOARA,"ȘCOALA PRIMARĂ MĂNERĂU",414,"PESTIŞU MIC",90431,1,PART,PRCNCT,PRSD,PRSD_SV,"2025-05-18 21:18:22",231,152,127,22,3,151,1,250,98,78,73
22,HUNEDOARA,"ȘCOALA PRIMARĂ NANDRU",415,"PESTIŞU MIC",90431,1,PART,PRCNCT,PRSD,PRSD_SV,"2025-05-18 21:18:05",137,94,68,26,0,94,0,150,56,49,45
22,HUNEDOARA,"ȘCOALA PRIMARĂ VALEA NANDRULUI",416,"PESTIŞU MIC",90431,1,PART,PRCNCT,PRSD,PRSD_SV,"2025-05-18 21:20:35",131,121,77,43,1,119,2,140,19,57,62
22,HUNEDOARA,"ŞCOALA GIMNAZIALĂ PUI",417,PUI,90538,1,PART,PRCNCT,PRSD,PRSD_SV,"2025-05-18 22:03:52",653,457,319,136,2,451,6,700,243,247,204
22,HUNEDOARA,"ŞCOALA GIMNAZIALĂ BĂIEŞTI (CORP CLS. I-IV)",418,PUI,90538,1,PART,PRCNCT,PRSD,PRSD_SV,"2025-05-18 21:23:41",193,152,108,44,0,150,2,200,48,73,77
22,HUNEDOARA,"ŞCOALA PRIMARĂ FEDERI",419,PUI,90538,1,PART,PRCNCT,PRSD,PRSD_SV,"2025-05-18 21:11:45",176,73,63,10,0,72,1,200,127,55,17
22,HUNEDOARA,"ŞCOALA PRIMARĂ NR. 1 FIZEŞTI",420,PUI,90538,1,PART,PRCNCT,PRSD,PRSD_SV,"2025-05-18 21:17:08",237,131,115,16,0,130,1,250,119,89,41
22,HUNEDOARA,"ŞCOALA PRIMARĂ GALAŢI",421,PUI,90538,1,PART,PRCNCT,PRSD,PRSD_SV,"2025-05-18 21:34:13",381,220,180,40,0,217,3,400,180,150,67
22,HUNEDOARA,"ŞCOALA PRIMARĂ HOBIŢA",422,PUI,90538,1,PART,PRCNCT,PRSD,PRSD_SV,"2025-05-18 21:28:21",158,103,84,19,0,102,1,170,67,71,31
22,HUNEDOARA,"ŞCOALA PRIMARĂ OHABA PONOR",423,PUI,90538,1,PART,PRCNCT,PRSD,PRSD_SV,"2025-05-18 21:21:28",192,104,85,19,0,101,3,210,106,72,29
22,HUNEDOARA,"ŞCOALA PRIMARĂ PONOR",424,PUI,90538,1,PART,PRCNCT,PRSD,PRSD_SV,"2025-05-18 21:20:58",358,198,164,19,15,197,1,450,252,119,78
22,HUNEDOARA,"CĂMINUL CULTURAL RÂU BĂRBAT",425,PUI,90538,1,PART,PRCNCT,PRSD,PRSD_SV,"2025-05-18 21:25:05",149,105,78,13,14,105,0,160,55,56,49
22,HUNEDOARA,"ŞCOALA PRIMARĂ RUŞOR",426,PUI,90538,1,PART,PRCNCT,PRSD,PRSD_SV,"2025-05-18 21:28:01",262,144,129,15,0,144,0,300,156,96,48
22,HUNEDOARA,"ŞCOALA PRIMARĂ ŞEREL",427,PUI,90538,1,PART,PRCNCT,PRSD,PRSD_SV,"2025-05-18 21:33:55",344,202,173,29,0,201,1,350,148,148,53
22,HUNEDOARA,"ŞCOALA PRIMARĂ URIC",428,PUI,90538,1,PART,PRCNCT,PRSD,PRSD_SV,"2025-05-18 21:19:54",242,151,132,16,3,149,2,250,99,102,47
22,HUNEDOARA,"PRIMĂRIA COMUNEI RAPOLTU MARE",429,"RAPOLTU MARE",90663,1,PART,PRCNCT,PRSD,PRSD_SV,"2025-05-18 21:43:11",787,443,403,40,0,436,7,850,407,305,131
22,HUNEDOARA,"CĂMINUL CULTURAL BOBÂLNA",430,"RAPOLTU MARE",90663,1,PART,PRCNCT,PRSD,PRSD_SV,"2025-05-18 21:44:36",372,211,181,30,0,208,3,400,189,142,66
22,HUNEDOARA,"CĂMINUL CULTURAL BOIU",431,"RAPOLTU MARE",90663,1,PART,PRCNCT,PRSD,PRSD_SV,"2025-05-18 21:16:06",116,84,59,25,0,83,1,120,36,50,33
22,HUNEDOARA,"CĂMINUL CULTURAL FOLT",432,"RAPOLTU MARE",90663,1,PART,PRCNCT,PRSD,PRSD_SV,"2025-05-18 21:25:26",129,109,74,35,0,107,2,140,31,47,60
22,HUNEDOARA,"CĂMINUL CULTURAL RAPOLŢEL",433,"RAPOLTU MARE",90663,1,PART,PRCNCT,PRSD,PRSD_SV,"2025-05-18 21:11:21",182,133,100,32,1,131,2,200,67,84,47
22,HUNEDOARA,"CAMINUL CULTURAL RĂCHITOVA",434,RĂCHITOVA,90725,1,PART,PRCNCT,PRSD,PRSD_SV,"2025-05-18 21:15:12",485,253,220,33,0,253,0,500,247,130,123
22,HUNEDOARA,"CĂMINUL CULTURAL BOIȚA",435,RĂCHITOVA,90725,1,PART,PRCNCT,PRSD,PRSD_SV,"2025-05-18 21:28:17",324,196,156,40,0,194,2,350,154,125,69
22,HUNEDOARA,"SCOALA PRIMARA VĂLIOARA",436,RĂCHITOVA,90725,1,PART,PRCNCT,PRSD,PRSD_SV,"2025-05-18 21:25:53",192,115,88,27,0,111,4,200,85,68,43
22,HUNEDOARA,"ŞCOALA GENERALĂ RÎU DE MORI",437,"RÂU DE MORI",90878,1,PART,PRCNCT,PRSD,PRSD_SV,"2025-05-18 22:11:36",830,514,430,79,5,510,4,900,386,297,213
22,HUNEDOARA,"ȘCOALA PRIMARĂ CLOPOTIVA",438,"RÂU DE MORI",90878,1,PART,PRCNCT,PRSD,PRSD_SV,"2025-05-18 21:38:48",690,457,376,80,1,456,1,750,293,234,222
22,HUNEDOARA,"CĂMINUL CULTURAL OSTROV",439,"RÂU DE MORI",90878,1,PART,PRCNCT,PRSD,PRSD_SV,"2025-05-18 21:14:51",351,223,26,197,0,219,4,380,157,119,100
22,HUNEDOARA,"ȘCOALA PRIMARĂ SIBIȘEL",440,"RÂU DE MORI",90878,1,PART,PRCNCT,PRSD,PRSD_SV,"2025-05-18 21:34:11",315,196,164,32,0,190,6,350,154,162,28
22,HUNEDOARA,"ȘCOALA PRIMARĂ UNCIUC",441,"RÂU DE MORI",90878,1,PART,PRCNCT,PRSD,PRSD_SV,"2025-05-18 21:17:21",175,134,109,25,0,132,2,190,56,98,34
22,HUNEDOARA,"CĂMINUL CULTURAL VALEA DÎLJII",442,"RÂU DE MORI",90878,1,PART,PRCNCT,PRSD,PRSD_SV,"2025-05-18 21:19:49",185,144,122,22,0,142,2,200,56,102,40
22,HUNEDOARA,"CĂMINUL CULTURAL RIBIŢA",443,RIBIŢA,90805,1,PART,PRCNCT,PRSD,PRSD_SV,"2025-05-18 21:21:31",497,336,292,39,5,328,8,550,214,176,152
22,HUNEDOARA,"CĂMINUL CULTURAL ”VIOREL BRANA” CRIŞAN",444,RIBIŢA,90805,1,PART,PRCNCT,PRSD,PRSD_SV,"2025-05-18 21:22:10",305,202,173,28,1,198,4,300,98,119,79
22,HUNEDOARA,"CĂMINUL CULTURAL DUMBRAVA DE JOS",445,RIBIŢA,90805,1,PART,PRCNCT,PRSD,PRSD_SV,"2025-05-18 21:21:32",128,80,52,28,0,80,0,140,60,54,26
22,HUNEDOARA,"ŞCOALA PRIMARĂ DUMBRAVA DE SUS",446,RIBIŢA,90805,1,PART,PRCNCT,PRSD,PRSD_SV,"2025-05-18 21:10:44",51,33,11,20,2,33,0,60,27,20,13
22,HUNEDOARA,"CĂMINUL CULTURAL UIBĂREŞTI",447,RIBIŢA,90805,1,PART,PRCNCT,PRSD,PRSD_SV,"2025-05-18 21:21:07",46,54,27,27,0,52,2,80,26,33,19
22,HUNEDOARA,"CĂMINUL CULTURAL ROMOS",448,ROMOS,90994,1,PART,PRCNCT,PRSD,PRSD_SV,"2025-05-18 22:09:26",976,569,510,55,4,557,12,1100,531,230,327
22,HUNEDOARA,"CĂMINUL CULTURAL PIȘCHINȚI",449,ROMOS,90994,1,PART,PRCNCT,PRSD,PRSD_SV,"2025-05-18 21:19:17",172,111,91,20,0,111,0,200,89,49,62
22,HUNEDOARA,"CĂMINUL CULTURAL ROMOȘEL",450,ROMOS,90994,1,PART,PRCNCT,PRSD,PRSD_SV,"2025-05-18 21:33:44",582,343,301,40,2,343,0,640,297,220,123
22,HUNEDOARA,"CĂMINUL CULTURAL VAIDEI",451,ROMOS,90994,1,PART,PRCNCT,PRSD,PRSD_SV,"2025-05-18 21:42:43",540,324,258,66,0,322,2,600,276,218,104
22,HUNEDOARA,"CAMINUL CULTURAL SARMIZEGETUSA",452,SARMIZEGETUSA,91054,1,PART,PRCNCT,PRSD,PRSD_SV,"2025-05-18 21:32:46",431,312,244,61,7,310,2,450,138,157,153
22,HUNEDOARA,"SCOALA PRIMARA BREAZOVA",453,SARMIZEGETUSA,91054,1,PART,PRCNCT,PRSD,PRSD_SV,"2025-05-18 21:15:24",142,99,90,9,0,98,1,150,51,64,34
22,HUNEDOARA,"SCOALA PRIMARA HOBITA-GRADISTE",454,SARMIZEGETUSA,91054,1,PART,PRCNCT,PRSD,PRSD_SV,"2025-05-18 21:22:44",94,82,64,17,1,82,0,100,18,37,45
22,HUNEDOARA,"CAMINUL CULTURAL PAUCINESTI",455,SARMIZEGETUSA,91054,1,PART,PRCNCT,PRSD,PRSD_SV,"2025-05-18 21:14:37",144,104,88,15,1,104,0,150,46,65,39
22,HUNEDOARA,"ASOCIAȚIA COMPOSESORALĂ ”NOBIL” ZEICANI - MAGAZIN ZEICANI",456,SARMIZEGETUSA,91054,1,PART,PRCNCT,PRSD,PRSD_SV,"2025-05-18 21:16:40",91,67,44,19,4,67,0,100,33,32,35
22,HUNEDOARA,"CĂMINUL CULTURAL SĂLAȘU DE SUS",457,"SĂLAŞU DE SUS",91116,1,PART,PRCNCT,PRSD,PRSD_SV,"2025-05-18 21:44:13",407,283,207,76,0,278,5,450,167,143,135
22,HUNEDOARA,"CĂMINUL CULTURAL COROIEŞTI",458,"SĂLAŞU DE SUS",91116,1,PART,PRCNCT,PRSD,PRSD_SV,"2025-05-18 21:19:57",157,116,96,19,1,114,2,170,54,77,37
22,HUNEDOARA,"CĂMINUL CULTURAL MĂLĂIEŞTI",459,"SĂLAŞU DE SUS",91116,1,PART,PRCNCT,PRSD,PRSD_SV,"2025-05-18 21:32:19",116,94,79,15,0,94,0,120,26,61,33
22,HUNEDOARA,"CĂMINUL CULTURAL NUCȘOARA",460,"SĂLAŞU DE SUS",91116,1,PART,PRCNCT,PRSD,PRSD_SV,"2025-05-18 21:30:36",224,167,128,38,1,163,4,240,73,96,67
22,HUNEDOARA,"ŞCOALA GENERALĂ OHABA DE SUB PIATRĂ",461,"SĂLAŞU DE SUS",91116,1,PART,PRCNCT,PRSD,PRSD_SV,"2025-05-18 21:20:38",164,124,92,32,0,122,2,170,46,56,66
22,HUNEDOARA,"ŞCOALA GENERALĂ PAROŞ",462,"SĂLAŞU DE SUS",91116,1,PART,PRCNCT,PRSD,PRSD_SV,"2025-05-18 21:24:34",247,165,142,23,0,164,1,250,85,76,88
22,HUNEDOARA,"ŞCOALA GENERALĂ RÂU ALB",463,"SĂLAŞU DE SUS",91116,1,PART,PRCNCT,PRSD,PRSD_SV,"2025-05-18 21:28:46",158,114,87,27,0,114,0,170,56,52,62
22,HUNEDOARA,"CĂMINUL CULTURAL RÂU MIC",464,"SĂLAŞU DE SUS",91116,1,PART,PRCNCT,PRSD,PRSD_SV,"2025-05-18 21:21:11",138,108,89,19,0,108,0,150,42,69,39
22,HUNEDOARA,"ŞCOALA GENERALĂ SĂLAŞU DE JOS",465,"SĂLAŞU DE SUS",91116,1,PART,PRCNCT,PRSD,PRSD_SV,"2025-05-18 21:25:21",175,123,99,24,0,120,3,190,67,85,35
22,HUNEDOARA,"CĂMINUL CULTURAL ZĂVOI",466,"SĂLAŞU DE SUS",91116,1,PART,PRCNCT,PRSD,PRSD_SV,"2025-05-18 21:12:31",103,76,63,13,0,76,0,100,24,47,29
22,HUNEDOARA,"CĂMINUL CULTURAL SÂNTĂMĂRIA-ORLEA",467,SÂNTĂMĂRIA-ORLEA,91232,1,PART,PRCNCT,PRSD,PRSD_SV,"2025-05-18 21:51:31",629,414,359,54,1,410,4,800,386,241,169
22,HUNEDOARA,"CĂMINUL CULTURAL BALOMIR",468,SÂNTĂMĂRIA-ORLEA,91232,1,PART,PRCNCT,PRSD,PRSD_SV,"2025-05-18 21:48:29",261,174,153,21,0,171,3,280,106,132,39
22,HUNEDOARA,"ŞCOALA PRIMARĂ BĂRĂŞTII-HAŢEGULUI",469,SÂNTĂMĂRIA-ORLEA,91232,1,PART,PRCNCT,PRSD,PRSD_SV,"2025-05-18 21:35:34",286,161,138,22,1,156,5,300,139,79,77
22,HUNEDOARA,"CĂMINUL CULTURAL BUCIUM-ORLEA",470,SÂNTĂMĂRIA-ORLEA,91232,1,PART,PRCNCT,PRSD,PRSD_SV,"2025-05-18 21:39:47",170,108,91,17,0,102,6,180,72,53,49
22,HUNEDOARA,"ŞCOALA PRIMARĂ CIOPEIA",471,SÂNTĂMĂRIA-ORLEA,91232,1,PART,PRCNCT,PRSD,PRSD_SV,"2025-05-18 21:50:19",346,156,129,26,1,154,2,380,224,89,65
22,HUNEDOARA,"ŞCOALA SĂCEL",472,SÂNTĂMĂRIA-ORLEA,91232,1,PART,PRCNCT,PRSD,PRSD_SV,"2025-05-18 21:38:49",227,126,113,13,0,121,5,250,124,58,63
22,HUNEDOARA,"CĂMINUL CULTURAL SÂNPETRU",473,SÂNTĂMĂRIA-ORLEA,91232,1,PART,PRCNCT,PRSD,PRSD_SV,"2025-05-18 21:47:33",203,159,124,34,1,152,7,220,61,68,84
22,HUNEDOARA,"ŞCOALA PRIMARĂ SUBCETATE",474,SÂNTĂMĂRIA-ORLEA,91232,1,PART,PRCNCT,PRSD,PRSD_SV,"2025-05-18 21:43:58",458,288,253,33,2,287,1,500,212,191,96
22,HUNEDOARA,"CĂMINUL CULTURAL ŞOIMUŞ",475,ŞOIMUŞ,91330,1,PART,PRCNCT,PRSD,PRSD_SV,"2025-05-18 21:51:33",1109,760,604,154,2,751,9,1200,440,443,308
22,HUNEDOARA,"CĂMINUL CULTURAL BĂLATA",476,ŞOIMUŞ,91330,1,PART,PRCNCT,PRSD,PRSD_SV,"2025-05-18 21:31:04",364,279,221,58,0,276,3,400,121,174,102
22,HUNEDOARA,"CĂMINUL CULTURAL BOHOLT",477,ŞOIMUŞ,91330,1,PART,PRCNCT,PRSD,PRSD_SV,"2025-05-18 21:19:23",279,188,147,41,0,186,2,300,112,107,79
22,HUNEDOARA,"CĂMINUL CULTURAL CHIŞCĂDAGA",478,ŞOIMUŞ,91330,1,PART,PRCNCT,PRSD,PRSD_SV,"2025-05-18 21:29:57",296,227,185,42,0,224,3,300,73,120,104
22,HUNEDOARA,"CĂMINUL CULTURAL FORNĂDIA",479,ŞOIMUŞ,91330,1,PART,PRCNCT,PRSD,PRSD_SV,"2025-05-18 21:15:33",173,143,94,49,0,138,5,191,48,79,59
22,HUNEDOARA,"CĂMINUL CULTURAL PĂULIŞ",480,ŞOIMUŞ,91330,1,PART,PRCNCT,PRSD,PRSD_SV,"2025-05-18 21:37:58",564,361,315,46,0,355,6,600,239,212,143
22,HUNEDOARA,"ŞCOALA GENERALĂ SULIGHETE",481,ŞOIMUŞ,91330,1,PART,PRCNCT,PRSD,PRSD_SV,"2025-05-18 21:24:49",222,155,127,28,0,154,1,250,95,94,60
22,HUNEDOARA,"CĂMINUL CULTURAL TELIUCU INFERIOR",482,"TELIUCU INFERIOR",86936,1,PART,PRCNCT,PRSD,PRSD_SV,"2025-05-18 22:04:14",1203,621,547,67,7,608,13,1300,679,384,224
22,HUNEDOARA,"CASA TINERETULUI CINCIȘAN",483,"TELIUCU INFERIOR",86936,1,PART,PRCNCT,PRSD,PRSD_SV,"2025-05-18 23:03:52",534,339,269,70,0,326,13,600,261,159,167
22,HUNEDOARA,"CĂMINUL CULTURAL IZVOARELE",484,"TELIUCU INFERIOR",86936,1,PART,PRCNCT,PRSD,PRSD_SV,"2025-05-18 21:27:54",73,67,37,30,0,66,1,80,13,30,36
22,HUNEDOARA,"CENTRUL CULTURAL RECREATIV PLOSCA",485,"TELIUCU INFERIOR",86936,2,PART,PRCNCT,PRSD,PRSD_SV,"2025-05-19 00:43:01",262,141,108,32,1,141,0,280,139,82,59
22,HUNEDOARA,"CĂMINUL CULTURAL TOMEŞTI",486,TOMEŞTI,91447,1,PART,PRCNCT,PRSD,PRSD_SV,"2025-05-18 21:16:28",202,146,104,42,0,145,1,220,74,68,77
22,HUNEDOARA,"CĂMINUL CULTURAL DOBROȚ",487,TOMEŞTI,91447,1,PART,PRCNCT,PRSD,PRSD_SV,"2025-05-18 21:26:49",317,200,161,39,0,198,2,350,150,126,72
22,HUNEDOARA,"ȘCOALA GENERALĂ CLS.1-4 ȘTEIA",488,TOMEŞTI,91447,1,PART,PRCNCT,PRSD,PRSD_SV,"2025-05-18 21:13:06",298,156,141,15,0,155,1,320,164,96,59
22,HUNEDOARA,"CĂMINUL CULTURAL TOPLIȚA",489,TOPLIŢA,91535,1,PART,PRCNCT,PRSD,PRSD_SV,"2025-05-18 21:22:15",147,152,84,68,0,150,2,200,48,72,78
22,HUNEDOARA,"CĂMINUL CULTURAL DĂBÂCA",490,TOPLIŢA,91535,1,PART,PRCNCT,PRSD,PRSD_SV,"2025-05-18 21:26:10",109,75,49,26,0,74,1,120,45,46,28
22,HUNEDOARA,"CĂMINUL CULTURAL DEALU MIC",491,TOPLIŢA,91535,1,PART,PRCNCT,PRSD,PRSD_SV,"2025-05-18 21:11:52",36,29,15,14,0,29,0,70,41,22,7
22,HUNEDOARA,"ȘCOALA PRIMARĂ HĂȘDĂU",492,TOPLIŢA,91535,1,PART,PRCNCT,PRSD,PRSD_SV,"2025-05-18 21:46:31",276,155,142,13,0,154,1,250,95,85,69
22,HUNEDOARA,"CĂMINUL CULTURAL VĂLARI",493,TOPLIŢA,91535,1,PART,PRCNCT,PRSD,PRSD_SV,"2025-05-18 21:12:43",26,40,12,28,0,39,1,60,20,19,20
22,HUNEDOARA,"CĂMINUL CULTURAL TOTEȘTI",494,TOTEŞTI,91624,1,PART,PRCNCT,PRSD,PRSD_SV,"2025-05-18 21:16:44",279,252,188,61,3,247,5,300,48,88,159
22,HUNEDOARA,"ȘCOALA PRIMARĂ CÂRNEȘTI",495,TOTEŞTI,91624,1,PART,PRCNCT,PRSD,PRSD_SV,"2025-05-18 21:19:37",351,272,216,48,8,266,6,350,78,116,150
22,HUNEDOARA,"ȘCOALA PRIMARĂ PĂCLIȘA",496,TOTEŞTI,91624,1,PART,PRCNCT,PRSD,PRSD_SV,"2025-05-18 21:41:20",485,367,290,54,23,362,5,550,183,115,247
22,HUNEDOARA,"ȘCOALA PRIMARĂ REEA",497,TOTEŞTI,91624,1,PART,PRCNCT,PRSD,PRSD_SV,"2025-05-18 21:24:29",355,250,208,34,8,248,2,400,150,133,115
22,HUNEDOARA,"CĂMINUL CULTURAL TURDAŞ",498,TURDAŞ,91688,1,PART,PRCNCT,PRSD,PRSD_SV,"2025-05-18 21:57:26",406,240,192,47,1,236,4,450,210,119,117
22,HUNEDOARA,"CĂMINUL CULTURAL PRICAZ",499,TURDAŞ,91688,1,PART,PRCNCT,PRSD,PRSD_SV,"2025-05-18 21:54:03",1092,581,530,50,1,575,6,1200,619,404,171
22,HUNEDOARA,"ŞCOALA PRIMARĂ SPINI",500,TURDAŞ,91688,1,PART,PRCNCT,PRSD,PRSD_SV,"2025-05-18 21:25:53",234,117,91,26,0,116,1,250,133,52,64
22,HUNEDOARA,"ȘCOALA GIMNAZIALĂ VAȚA DE JOS",501,"VAŢA DE JOS",91795,1,PART,PRCNCT,PRSD,PRSD_SV,"2025-05-18 22:03:42",786,465,362,103,0,459,6,1100,635,237,222
22,HUNEDOARA,"ȘCOALA PRIMARĂ BIRTIN",502,"VAŢA DE JOS",91795,1,PART,PRCNCT,PRSD,PRSD_SV,"2025-05-18 21:16:49",224,122,105,17,0,122,0,250,128,77,45
22,HUNEDOARA,"ȘCOALA PRIMARĂ CĂZĂNEȘTI",503,"VAŢA DE JOS",91795,1,PART,PRCNCT,PRSD,PRSD_SV,"2025-05-18 21:17:01",164,85,75,10,0,82,3,170,85,56,26
22,HUNEDOARA,"ŞCOALA PRIMARĂ CIUNGANI",504,"VAŢA DE JOS",91795,1,PART,PRCNCT,PRSD,PRSD_SV,"2025-05-18 21:37:13",176,94,76,16,2,92,2,200,106,53,39
22,HUNEDOARA,"ŞCOALA PRIMARĂ OCIU",505,"VAŢA DE JOS",91795,1,PART,PRCNCT,PRSD,PRSD_SV,"2025-05-18 21:38:09",366,172,142,30,0,169,3,400,228,92,77
22,HUNEDOARA,"ŞCOALA PRIMARĂ PRĂVĂLENI",506,"VAŢA DE JOS",91795,1,PART,PRCNCT,PRSD,PRSD_SV,"2025-05-18 21:30:11",230,117,103,14,0,117,0,250,133,60,57
22,HUNEDOARA,"ŞCOALA PRIMARĂ PRIHODIȘTE",507,"VAŢA DE JOS",91795,1,PART,PRCNCT,PRSD,PRSD_SV,"2025-05-18 21:18:36",268,132,120,12,0,130,2,292,160,98,32
22,HUNEDOARA,"ŞCOALA PRIMARĂ TÂRNAVA DE CRIȘ",508,"VAŢA DE JOS",91795,1,PART,PRCNCT,PRSD,PRSD_SV,"2025-05-18 22:04:03",647,364,325,39,0,355,9,700,336,206,149
22,HUNEDOARA,"CĂMINUL CULTURAL VĂLIŞOARA",509,VĂLIŞOARA,91937,1,PART,PRCNCT,PRSD,PRSD_SV,"2025-05-18 21:38:19",580,426,301,125,0,417,9,630,204,256,161
22,HUNEDOARA,"CĂMINUL CULTURAL DEALU MARE",510,VĂLIŞOARA,91937,1,PART,PRCNCT,PRSD,PRSD_SV,"2025-05-18 21:18:09",145,102,78,24,0,101,1,160,58,58,43
22,HUNEDOARA,"CĂMINUL CULTURAL SĂLIŞTIOARA",511,VĂLIŞOARA,91937,1,PART,PRCNCT,PRSD,PRSD_SV,"2025-05-18 21:21:33",233,156,120,36,0,152,4,250,94,95,57
22,HUNEDOARA,"CĂMINUL CULTURAL VEŢEL",512,VEŢEL,91982,1,PART,PRCNCT,PRSD,PRSD_SV,"2025-05-18 21:32:20",921,609,476,131,2,606,3,1000,391,355,251
22,HUNEDOARA,"CĂMINUL CULTURAL LEȘNIC",513,VEŢEL,91982,1,PART,PRCNCT,PRSD,PRSD_SV,"2025-05-18 21:27:39",437,314,243,70,1,311,3,480,166,179,132
22,HUNEDOARA,"CĂMINUL CULTURAL MINTIA",514,VEŢEL,91982,1,PART,PRCNCT,PRSD,PRSD_SV,"2025-05-18 21:22:59",945,541,472,69,0,530,11,1000,459,347,183
22,HUNEDOARA,"CĂMIN CULTURAL MUNCELU MARE",515,VEŢEL,91982,1,PART,PRCNCT,PRSD,PRSD_SV,"2025-05-18 21:09:34",55,42,18,24,0,40,2,60,18,31,9
22,HUNEDOARA,"ŞCOALA PRIMARĂ MUNCELU MIC",516,VEŢEL,91982,1,PART,PRCNCT,PRSD,PRSD_SV,"2025-05-18 21:14:51",89,73,51,22,0,72,1,100,27,44,28
22,HUNEDOARA,"CENTRUL DE INFORMARE TURISTICĂ VORŢA",517,VORŢA,92097,1,PART,PRCNCT,PRSD,PRSD_SV,"2025-05-18 21:22:03",120,93,58,35,0,91,2,160,67,58,33
22,HUNEDOARA,"IMOBILUL NR 9 DIN SATUL COAJA",518,VORŢA,92097,1,PART,PRCNCT,PRSD,PRSD_SV,"2025-05-18 21:24:07",97,82,53,29,0,80,2,140,58,28,52
22,HUNEDOARA,"CĂMINUL CULTURAL VALEA POIENII",519,VORŢA,92097,1,PART,PRCNCT,PRSD,PRSD_SV,"2025-05-18 21:22:11",110,74,54,20,0,73,1,100,26,55,18
22,HUNEDOARA,"CĂMINUL CULTURAL VISCA",520,VORŢA,92097,1,PART,PRCNCT,PRSD,PRSD_SV,"2025-05-18 21:46:05",286,186,158,28,0,179,7,300,114,138,41
22,HUNEDOARA,"CĂMINUL CULTURAL ZAM",521,ZAM,92177,1,PART,PRCNCT,PRSD,PRSD_SV,"2025-05-18 21:33:53",508,358,253,104,1,355,3,560,202,208,147
22,HUNEDOARA,"CĂMINUL CULTURAL ALMAŞ SĂLIŞTE",522,ZAM,92177,1,PART,PRCNCT,PRSD,PRSD_SV,"2025-05-18 21:15:37",100,63,42,21,0,60,3,100,37,22,38
22,HUNEDOARA,"CĂMINUL CULTURAL GODINEŞTI",523,ZAM,92177,1,PART,PRCNCT,PRSD,PRSD_SV,"2025-05-18 21:15:50",87,50,34,16,0,50,0,90,40,24,26
22,HUNEDOARA,"CĂMINUL CULTURAL POGĂNEȘTI",524,ZAM,92177,1,PART,PRCNCT,PRSD,PRSD_SV,"2025-05-18 21:14:53",186,122,90,32,0,122,0,200,78,82,40
22,HUNEDOARA,"CĂMINUL CULTURAL SĂLCIVA",525,ZAM,92177,1,PART,PRCNCT,PRSD,PRSD_SV,"2025-05-18 21:18:50",376,230,183,47,0,228,2,400,170,162,66
23,IALOMIŢA,"LICEUL TEHNOLOGIC”ALEXANDRU IOAN CUZA”(FOSTUL LICEU DE CONSTRUCȚII)",1,"MUNICIPIUL SLOBOZIA",92658,1,PART,PRCNCT,PRSD,PRSD_SV,"2025-05-18 21:44:52",1513,810,673,43,94,795,15,1650,840,460,335
23,IALOMIŢA,"LICEUL TEHNOLOGIC”ALEXANDRU IOAN CUZA”(FOSTUL LICEU DE CONSTRUCȚII)",2,"MUNICIPIUL SLOBOZIA",92658,1,PART,PRCNCT,PRSD,PRSD_SV,"2025-05-18 22:05:38",1373,858,698,65,95,852,6,1500,642,448,404
23,IALOMIŢA,"ȘCOALA GIMNAZIALĂ NR. 3",3,"MUNICIPIUL SLOBOZIA",92658,1,PART,PRCNCT,PRSD,PRSD_SV,"2025-05-18 21:52:37",1024,637,491,54,92,629,8,1150,513,307,322
23,IALOMIŢA,"ȘCOALA GIMNAZIALĂ NR. 3",4,"MUNICIPIUL SLOBOZIA",92658,1,PART,PRCNCT,PRSD,PRSD_SV,"2025-05-18 21:54:09",861,544,407,44,93,539,5,950,406,268,271
23,IALOMIŢA,"COLEGIUL NAȚIONAL „MIHAI VITEAZUL” (FOST LICEU DE MATEMATICĂ-FIZICĂ)",5,"MUNICIPIUL SLOBOZIA",92658,1,PART,PRCNCT,PRSD,PRSD_SV,"2025-05-18 22:14:13",1104,608,546,62,0,601,7,1250,642,202,399
23,IALOMIŢA,"LICEUL PEDAGOGIC ”MATEI BASARAB” (FOSTĂ ȘCOALA NORMALĂ)",6,"MUNICIPIUL SLOBOZIA",92658,1,PART,PRCNCT,PRSD,PRSD_SV,"2025-05-18 22:01:04",1395,775,706,69,0,769,6,1550,775,286,483
23,IALOMIŢA,"MUZEUL NAȚIONAL AL AGRICULTURII",7,"MUNICIPIUL SLOBOZIA",92658,1,PART,PRCNCT,PRSD,PRSD_SV,"2025-05-18 21:52:01",1431,742,689,53,0,736,6,1600,858,299,437
23,IALOMIŢA,"LICEUL TEHNOLOGIC „ÎNĂLȚAREA DOMNULUI” (FOSTA ȘCOALA GENERALĂ NR. 6)",8,"MUNICIPIUL SLOBOZIA",92658,1,PART,PRCNCT,PRSD,PRSD_SV,"2025-05-18 21:48:58",1416,749,690,59,0,742,7,1550,801,363,379
23,IALOMIŢA,"LICEUL TEHNOLOGIC „ÎNĂLȚAREA DOMNULUI” (FOSTA ȘCOALA GENERALĂ NR. 6)",9,"MUNICIPIUL SLOBOZIA",92658,1,PART,PRCNCT,PRSD,PRSD_SV,"2025-05-18 22:15:02",1254,629,575,54,0,618,11,1400,771,301,317
23,IALOMIŢA,"CENTRUL DE EDUCAȚIE NON-FORMALĂ",10,"MUNICIPIUL SLOBOZIA",92658,1,PART,PRCNCT,PRSD,PRSD_SV,"2025-05-18 21:50:32",1347,732,679,53,0,716,16,1500,768,282,434
23,IALOMIŢA,"DIRECȚIA PENTRU AGRICULTURĂ JUDEȚEANĂ IALOMIȚA",11,"MUNICIPIUL SLOBOZIA",92658,1,PART,PRCNCT,PRSD,PRSD_SV,"2025-05-18 21:31:11",897,444,400,44,0,440,4,1000,556,200,240
23,IALOMIŢA,"SEMINARUL TEOLOGIC ORTODOX ”SF. IOAN GURĂ DE AUR”,",12,"MUNICIPIUL SLOBOZIA",92658,1,PART,PRCNCT,PRSD,PRSD_SV,"2025-05-18 22:02:24",884,541,471,51,19,536,5,1000,459,202,334
23,IALOMIŢA,"CASA MUNICIPALĂ DE CULTURĂ „NICOLAE ROTARU”",13,"MUNICIPIUL SLOBOZIA",92658,1,PART,PRCNCT,PRSD,PRSD_SV,"2025-05-18 22:20:02",1259,611,530,80,1,607,4,1400,789,288,319
23,IALOMIŢA,"LICEUL TEHNOLOGIC ”MIHAI EMINESCU” (LICEUL DE CHIMIE)",14,"MUNICIPIUL SLOBOZIA",92658,1,PART,PRCNCT,PRSD,PRSD_SV,"2025-05-18 21:44:34",1010,511,474,37,0,502,9,1100,589,266,236
23,IALOMIŢA,"ŞCOALA GIMNAZIALÃ ”GHEORGHE LAZĂR”",15,"MUNICIPIUL SLOBOZIA",92658,1,PART,PRCNCT,PRSD,PRSD_SV,"2025-05-18 21:43:38",1440,828,719,73,36,814,14,1600,772,411,403
23,IALOMIŢA,"ŞCOALA GIMNAZIALĂ ”GHEORGHE LAZĂR”",16,"MUNICIPIUL SLOBOZIA",92658,1,PART,PRCNCT,PRSD,PRSD_SV,"2025-05-18 21:59:10",1349,673,610,28,35,664,9,1500,827,348,316
23,IALOMIŢA,"GRĂDINIȚA CU PROGRAM PRELUNGIT „ PITICOT”",17,"MUNICIPIUL SLOBOZIA",92658,1,PART,PRCNCT,PRSD,PRSD_SV,"2025-05-18 22:01:12",1423,823,778,44,1,814,9,1600,777,258,556
23,IALOMIŢA,"AGENȚIA NAȚIONALĂ DE ÎMBUNĂTĂȚIRI FUNCIARE – FILIALA IALOMIȚA",18,"MUNICIPIUL SLOBOZIA",92658,1,PART,PRCNCT,PRSD,PRSD_SV,"2025-05-18 21:47:21",1316,730,671,59,0,723,7,1450,720,265,458
23,IALOMIŢA,"ŞCOALA GIMNAZIALĂ ”SF. ANDREI”",19,"MUNICIPIUL SLOBOZIA",92658,1,PART,PRCNCT,PRSD,PRSD_SV,"2025-05-18 22:54:48",1414,831,745,85,1,820,11,1550,719,299,521
23,IALOMIŢA,"ȘCOALA GIMNAZIALĂ „SF. ANDREI”",20,"MUNICIPIUL SLOBOZIA",92658,1,PART,PRCNCT,PRSD,PRSD_SV,"2025-05-18 22:05:20",1265,733,681,52,0,721,12,1400,667,259,462
23,IALOMIŢA,"S.C. DRUMURI ŞI PODURI IALOMIŢA",21,"MUNICIPIUL SLOBOZIA",92658,1,PART,PRCNCT,PRSD,PRSD_SV,"2025-05-18 22:34:03",1668,999,930,68,1,989,10,1850,851,311,678
23,IALOMIŢA,"PALATUL COPIILOR SLOBOZIA",22,"MUNICIPIUL SLOBOZIA",92658,1,PART,PRCNCT,PRSD,PRSD_SV,"2025-05-18 22:12:34",1390,794,745,49,0,785,9,1550,756,303,482
23,IALOMIŢA,"PALATUL COPIILOR SLOBOZIA",23,"MUNICIPIUL SLOBOZIA",92658,1,PART,PRCNCT,PRSD,PRSD_SV,"2025-05-18 21:48:19",1135,679,614,65,0,673,6,1250,571,211,462
23,IALOMIŢA,"LICEUL DE ARTE „IONEL PERLEA” (FOSTA ȘCOALA GENERALĂ NR. 1)",24,"MUNICIPIUL SLOBOZIA",92658,1,PART,PRCNCT,PRSD,PRSD_SV,"2025-05-18 21:41:01",1036,640,568,72,0,633,7,1150,510,229,404
23,IALOMIŢA,"LICEUL DE ARTE „IONEL PERLEA” (FOSTA ȘCOALA GENERALĂ NR. 1)",25,"MUNICIPIUL SLOBOZIA",92658,1,PART,PRCNCT,PRSD,PRSD_SV,"2025-05-18 21:28:22",961,571,532,39,0,563,8,1050,479,204,359
23,IALOMIŢA,"LICEUL DE ARTE ”IONEL PERLEA”",26,"MUNICIPIUL SLOBOZIA",92658,1,PART,PRCNCT,PRSD,PRSD_SV,"2025-05-18 21:45:32",1107,643,577,66,0,632,11,1250,607,225,407
23,IALOMIŢA,"LICEUL DE ARTE ”IONEL PERLEA”",27,"MUNICIPIUL SLOBOZIA",92658,1,PART,PRCNCT,PRSD,PRSD_SV,"2025-05-18 22:10:40",1362,750,723,27,0,746,4,1500,750,279,467
23,IALOMIŢA,"GRÃDINIŢA CU PROGRAM PRELUNGIT ”DUMBRAVA MINUNATĂ”",28,"MUNICIPIUL SLOBOZIA",92658,1,PART,PRCNCT,PRSD,PRSD_SV,"2025-05-18 21:53:16",1286,748,668,79,1,736,12,1450,702,275,461
23,IALOMIŢA,"LICEUL DE ARTE „IONEL PERLEA” - ATELIERELE DE CREAȚIE",29,"MUNICIPIUL SLOBOZIA",92658,1,PART,PRCNCT,PRSD,PRSD_SV,"2025-05-18 22:04:42",1810,1067,1025,42,0,1057,10,2000,933,450,607
23,IALOMIŢA,"ȘCOALA GIMNAZIALĂ BORA",30,"MUNICIPIUL SLOBOZIA",92658,1,PART,PRCNCT,PRSD,PRSD_SV,"2025-05-18 21:37:33",753,297,269,28,0,292,5,850,553,196,96
23,IALOMIŢA,"ŞCOALA GIMNAZIALÃ BORA",31,"MUNICIPIUL SLOBOZIA",92658,1,PART,PRCNCT,PRSD,PRSD_SV,"2025-05-18 21:38:18",1010,391,372,19,0,380,11,1100,709,294,86
23,IALOMIŢA,"ŞCOALA GIMNAZIALÃ NR.5 SLOBOZIA NOUÃ",32,"MUNICIPIUL SLOBOZIA",92658,1,PART,PRCNCT,PRSD,PRSD_SV,"2025-05-18 21:35:09",1030,537,505,32,0,530,7,1150,613,273,257
23,IALOMIŢA,"ŞCOALA GIMNAZIALÃ NR.5 SLOBOZIA NOUÃ",33,"MUNICIPIUL SLOBOZIA",92658,1,PART,PRCNCT,PRSD,PRSD_SV,"2025-05-18 21:34:43",1017,589,549,40,0,584,5,1150,561,310,274
23,IALOMIŢA,"FOSTĂ ȘCOALA GIMNAZIALĂ”MIHAI VITEAZUL” - LOCAL BULIGA",34,"MUNICIPIUL FETEŞTI",92701,1,PART,PRCNCT,PRSD,PRSD_SV,"2025-05-18 21:25:38",859,444,416,28,0,438,6,950,506,241,197
23,IALOMIŢA,"ŞCOALA GIMNAZIALĂ ”MIHAI VITEAZUL” - CORP A",35,"MUNICIPIUL FETEŞTI",92701,1,PART,PRCNCT,PRSD,PRSD_SV,"2025-05-18 21:41:00",1412,537,510,27,0,535,2,1550,1013,426,109
23,IALOMIŢA,"ȘCOALA GIMNAZIALĂ ”MIHAI VITEAZUL” - CORP B",36,"MUNICIPIUL FETEŞTI",92701,1,PART,PRCNCT,PRSD,PRSD_SV,"2025-05-18 21:41:27",956,444,413,31,0,440,4,1050,606,293,147
23,IALOMIŢA,"ȘCOALA GIMNAZIALĂ ”MIHAI VITEAZUL” - CORP B",37,"MUNICIPIUL FETEŞTI",92701,1,PART,PRCNCT,PRSD,PRSD_SV,"2025-05-18 21:44:28",941,438,415,23,0,434,4,1050,612,283,151
23,IALOMIŢA,"ȘCOALA GIMNAZIALĂ ”MIHAI VITEAZUL” - CORP D",38,"MUNICIPIUL FETEŞTI",92701,1,PART,PRCNCT,PRSD,PRSD_SV,"2025-05-18 21:21:00",836,421,380,41,0,415,6,950,529,227,188
23,IALOMIŢA,"PROTOPOPIATUL FETEȘTI",39,"MUNICIPIUL FETEŞTI",92701,1,PART,PRCNCT,PRSD,PRSD_SV,"2025-05-18 21:29:52",1088,543,499,44,0,533,10,1200,657,338,195
23,IALOMIŢA,"ȘCOALA GIMNAZIALĂ ”RADU VODĂ”",40,"MUNICIPIUL FETEŞTI",92701,1,PART,PRCNCT,PRSD,PRSD_SV,"2025-05-18 21:26:57",943,399,358,40,1,396,3,1050,651,245,151
23,IALOMIŢA,"ȘCOALA GIMNAZIALĂ ”RADU VODĂ” - GRĂDINIŢA ŞCOLII GIMNAZIALE NR.4",41,"MUNICIPIUL FETEŞTI",92701,1,PART,PRCNCT,PRSD,PRSD_SV,"2025-05-18 21:17:43",789,374,352,22,0,367,7,850,476,232,135
23,IALOMIŢA,"ȘCOALA GIMNAZIALĂ ”RADU VODĂ” - GRĂDINIŢA ŞCOLII GIMNAZIALE NR.4",42,"MUNICIPIUL FETEŞTI",92701,1,PART,PRCNCT,PRSD,PRSD_SV,"2025-05-18 21:33:08",960,391,359,32,0,375,16,1050,659,270,105
23,IALOMIŢA,"LICEUL TEHNOLOGIC ”ANGHEL SALIGNY”",43,"MUNICIPIUL FETEŞTI",92701,1,PART,PRCNCT,PRSD,PRSD_SV,"2025-05-18 21:37:39",923,529,442,57,30,527,2,1000,471,266,261
23,IALOMIŢA,"LICEUL TEORETIC ”CAROL I”",44,"MUNICIPIUL FETEŞTI",92701,1,PART,PRCNCT,PRSD,PRSD_SV,"2025-05-18 21:39:47",1330,668,614,54,0,661,7,1450,782,337,324
23,IALOMIŢA,"ŞCOALA GIMNAZIALĂ ”AUREL VLAICU”",45,"MUNICIPIUL FETEŞTI",92701,1,PART,PRCNCT,PRSD,PRSD_SV,"2025-05-18 21:31:27",1006,605,539,66,0,600,5,1100,495,252,348
23,IALOMIŢA,"LICEUL TEHNOLOGIC DE INDUSTRIE ALIMENTARĂ",46,"MUNICIPIUL FETEŞTI",92701,1,PART,PRCNCT,PRSD,PRSD_SV,"2025-05-18 21:28:47",1361,691,621,70,0,682,9,1500,809,333,349
23,IALOMIŢA,"GRĂDINIŢA CU PROGRAM PRELUNGIT ”ALBĂ CA ZĂPADA”",47,"MUNICIPIUL FETEŞTI",92701,1,PART,PRCNCT,PRSD,PRSD_SV,"2025-05-18 21:49:59",1001,501,469,32,0,499,2,1100,599,261,238
23,IALOMIŢA,"SALA DE SPORT",48,"MUNICIPIUL FETEŞTI",92701,1,PART,PRCNCT,PRSD,PRSD_SV,"2025-05-18 21:37:45",1206,643,599,44,0,640,3,1350,707,265,375
23,IALOMIŢA,"LICEUL TEHNOLOGIC DE INDUSTRIE ALIMENTARĂ - CORP C 1",49,"MUNICIPIUL FETEŞTI",92701,1,PART,PRCNCT,PRSD,PRSD_SV,"2025-05-18 21:39:08",826,418,381,35,2,416,2,900,482,211,205
23,IALOMIŢA,"LICEUL TEHNOLOGIC DE INDUSTRIE ALIMENTARĂ - CORP C1",50,"MUNICIPIUL FETEŞTI",92701,1,PART,PRCNCT,PRSD,PRSD_SV,"2025-05-18 21:34:10",945,466,444,20,2,460,6,1050,584,250,210
23,IALOMIŢA,"GRĂDINIŢA ȘCOLII GIMNAZIALE ”DIMITRIE CANTEMIR”",51,"MUNICIPIUL FETEŞTI",92701,1,PART,PRCNCT,PRSD,PRSD_SV,"2025-05-18 21:31:18",1078,616,544,71,1,609,7,1200,584,263,346
23,IALOMIŢA,"ŞCOALA GIMNAZIALĂ ”DIMITRIE CANTEMIR”",52,"MUNICIPIUL FETEŞTI",92701,1,PART,PRCNCT,PRSD,PRSD_SV,"2025-05-18 21:55:32",1153,551,530,21,0,543,8,1300,749,243,300
23,IALOMIŢA,"ŞCOALA GIMNAZIALĂ ”DIMITRIE CANTEMIR”",53,"MUNICIPIUL FETEŞTI",92701,1,PART,PRCNCT,PRSD,PRSD_SV,"2025-05-18 21:29:42",877,494,466,28,0,491,3,1000,506,191,300
23,IALOMIŢA,"ŞCOALA GIMNAZIALĂ ”DIMITRIE CANTEMIR”",54,"MUNICIPIUL FETEŞTI",92701,1,PART,PRCNCT,PRSD,PRSD_SV,"2025-05-18 21:34:52",931,477,452,25,0,474,3,1000,523,220,254
23,IALOMIŢA,"CENTRUL SOCIAL AL PAROHIEI FETEȘTI GARĂ II",55,"MUNICIPIUL FETEŞTI",92701,1,PART,PRCNCT,PRSD,PRSD_SV,"2025-05-18 21:27:06",1286,495,461,34,0,494,1,1400,905,298,196
23,IALOMIŢA,"LICEUL TEHNOLOGIC ”ANGHEL SALIGNY”( FOSTA ȘCOALĂ NR.5)",56,"MUNICIPIUL FETEŞTI",92701,1,PART,PRCNCT,PRSD,PRSD_SV,"2025-05-18 21:25:00",1266,456,423,33,0,454,2,1400,944,287,167
23,IALOMIŢA,"LICEUL TEHNOLOGIC ”ANGHEL SALIGNY” (FOSTA ȘCOALĂ NR. 5)",57,"MUNICIPIUL FETEŞTI",92701,2,PART,PRCNCT,PRSD,PRSD_SV,"2025-05-19 00:04:10",1407,560,546,14,0,551,9,1550,990,395,156
23,IALOMIŢA,"LICEUL TEHNOLOGIC ”ANGHEL SALIGNY” (FOSTA ȘCOALĂ NR. 5)",58,"MUNICIPIUL FETEŞTI",92701,1,PART,PRCNCT,PRSD,PRSD_SV,"2025-05-18 21:43:53",1067,438,419,19,0,432,6,1150,712,306,126
23,IALOMIŢA,"GRĂDINIŢA CU PROGRAM PRELUNGIT",59,"MUNICIPIUL URZICENI",100683,1,PART,PRCNCT,PRSD,PRSD_SV,"2025-05-18 21:44:08",661,381,333,48,0,376,5,700,319,143,233
23,IALOMIŢA,"ŞCOALA CU CLASELE I-VIII NR.3 DIN URZICENI",60,"MUNICIPIUL URZICENI",100683,1,PART,PRCNCT,PRSD,PRSD_SV,"2025-05-18 21:43:48",1270,636,574,62,0,626,10,1400,764,341,285
23,IALOMIŢA,"GRĂDINIŢA DE COPII",61,"MUNICIPIUL URZICENI",100683,1,PART,PRCNCT,PRSD,PRSD_SV,"2025-05-18 22:09:58",935,532,471,61,0,529,3,1050,518,205,324
23,IALOMIŢA,"CASA DE CULTURĂ",62,"MUNICIPIUL URZICENI",100683,1,PART,PRCNCT,PRSD,PRSD_SV,"2025-05-18 21:55:25",1101,579,522,57,0,575,4,1200,621,241,334
23,IALOMIŢA,"GRUPUL ŞCOLAR ’’SF. ECATERINA’’",63,"MUNICIPIUL URZICENI",100683,1,PART,PRCNCT,PRSD,PRSD_SV,"2025-05-18 21:36:42",1253,702,640,62,0,696,6,1400,698,255,441
23,IALOMIŢA,"SCOALA GENERALA ALEXANDRU ODOBESCU",64,"MUNICIPIUL URZICENI",100683,1,PART,PRCNCT,PRSD,PRSD_SV,"2025-05-18 21:45:38",1085,630,580,50,0,624,6,1200,570,222,402
23,IALOMIŢA,"CLUBUL SINDICATELOR",65,"MUNICIPIUL URZICENI",100683,1,PART,PRCNCT,PRSD,PRSD_SV,"2025-05-18 21:58:52",1528,854,732,122,0,841,13,1700,846,374,467
23,IALOMIŢA,"ŞCOALA GENERALĂ ION HELIADE RADULESCU",66,"MUNICIPIUL URZICENI",100683,1,PART,PRCNCT,PRSD,PRSD_SV,"2025-05-18 21:46:16",1374,819,708,111,0,815,4,1500,681,333,482
23,IALOMIŢA,"ŞCOALA GENERALĂ ION HELIADE RADULESCU",67,"MUNICIPIUL URZICENI",100683,1,PART,PRCNCT,PRSD,PRSD_SV,"2025-05-18 21:33:14",1151,593,533,60,0,583,10,1250,657,251,332
23,IALOMIŢA,"INTERNATUL COLEGIULUI NATIONAL GRIGORE MOISIL",68,"MUNICIPIUL URZICENI",100683,1,PART,PRCNCT,PRSD,PRSD_SV,"2025-05-18 22:08:03",1039,572,506,40,26,570,2,1150,578,259,311
23,IALOMIŢA,"LICEUL TEHNOLOGIC URZICENI",69,"MUNICIPIUL URZICENI",100683,1,PART,PRCNCT,PRSD,PRSD_SV,"2025-05-18 21:45:37",1641,825,756,69,0,815,10,1800,975,447,368
23,IALOMIŢA,"GRĂDINIȚA CU PROGRAM PRELUNGIT ”PRICHINDEL”",70,"ORAŞ AMARA",92836,1,PART,PRCNCT,PRSD,PRSD_SV,"2025-05-18 21:54:15",1291,654,601,53,0,649,5,1451,797,377,272
23,IALOMIŢA,"GRĂDINIȚA CU PROGRAM PRELUNGIT ”PRICHINDEL ”",71,"ORAŞ AMARA",92836,1,PART,PRCNCT,PRSD,PRSD_SV,"2025-05-18 21:38:06",1057,563,508,55,0,562,1,1150,587,328,234
23,IALOMIŢA,"ȘCOALA GIMNAZIALĂ ”GEORGE VÂLSAN”",72,"ORAŞ AMARA",92836,1,PART,PRCNCT,PRSD,PRSD_SV,"2025-05-18 22:07:04",1388,793,690,103,0,782,11,1492,699,416,366
23,IALOMIŢA,"ȘCOALA GIMNAZIALĂ ”GEORGE VÂLSAN”",73,"ORAŞ AMARA",92836,1,PART,PRCNCT,PRSD,PRSD_SV,"2025-05-18 22:25:03",1409,823,695,128,0,813,10,1550,727,416,397
23,IALOMIŢA,"ȘCOALA GIMNAZIALĂ ”GEORGE VÂLSAN”- CORP C1",74,"ORAŞ AMARA",92836,1,PART,PRCNCT,PRSD,PRSD_SV,"2025-05-18 22:17:14",1469,941,700,241,0,921,20,1600,659,507,414
23,IALOMIŢA,"LICEUL TEHNOLOGIC, CORP B",75,"ORAŞ CĂZĂNEŞTI",93067,1,PART,PRCNCT,PRSD,PRSD_SV,"2025-05-18 21:34:03",1367,574,501,73,0,559,15,1500,926,294,265
23,IALOMIŢA,"LICEUL TEHNOLOGI CĂZĂNEȘTI",76,"ORAŞ CĂZĂNEŞTI",93067,1,PART,PRCNCT,PRSD,PRSD_SV,"2025-05-18 21:46:48",1342,542,488,54,0,538,4,1450,908,358,180
23,IALOMIŢA,"SEDIU PRIMĂRIE",77,"ORAŞ FIERBINŢI-TÂRG",102749,1,PART,PRCNCT,PRSD,PRSD_SV,"2025-05-18 22:06:43",1298,886,631,255,0,875,11,1400,514,498,377
23,IALOMIŢA,"ŞCOALA GENERALĂ CU CLASELE I-IV FIRBINŢI DE JOS",78,"ORAŞ FIERBINŢI-TÂRG",102749,1,PART,PRCNCT,PRSD,PRSD_SV,"2025-05-18 21:47:11",864,543,455,88,0,542,1,950,407,318,224
23,IALOMIŢA,"ŞCOALA GENERALĂ CU CLASELE I-IV FIRBINŢI DE SUS",79,"ORAŞ FIERBINŢI-TÂRG",102749,1,PART,PRCNCT,PRSD,PRSD_SV,"2025-05-18 21:43:24",1459,856,692,148,16,850,6,1600,744,481,369
23,IALOMIŢA,"LICEUL TEHNOLOGIC ȚĂNDĂREI",80,"ORAŞ ŢĂNDĂREI",92765,1,PART,PRCNCT,PRSD,PRSD_SV,"2025-05-18 21:52:17",1378,535,497,38,0,530,5,1416,881,272,258
23,IALOMIŢA,"LICEUL TEORETIC ’’PAUL GEORGESCU’’",81,"ORAŞ ŢĂNDĂREI",92765,1,PART,PRCNCT,PRSD,PRSD_SV,"2025-05-18 21:28:03",1164,352,295,41,16,350,2,1250,898,214,136
23,IALOMIŢA,"LICEUL TEORETIC ’’PAUL GEORGESCU’’",82,"ORAŞ ŢĂNDĂREI",92765,1,PART,PRCNCT,PRSD,PRSD_SV,"2025-05-18 21:48:23",812,328,308,20,0,325,3,900,572,147,178
23,IALOMIŢA,"ȘCOALA GIMNAZIALĂ ”SPIRU HARET” ȚĂNDĂREI",83,"ORAŞ ŢĂNDĂREI",92765,1,PART,PRCNCT,PRSD,PRSD_SV,"2025-05-18 21:46:10",1397,592,551,41,0,588,4,1550,958,285,303
23,IALOMIŢA,"ȘCOALA GIMNAZIALĂ ”SPIRU HARET” ȚĂNDĂREI",84,"ORAŞ ŢĂNDĂREI",92765,1,PART,PRCNCT,PRSD,PRSD_SV,"2025-05-18 21:43:12",1613,465,436,29,0,457,8,1750,1285,282,175
23,IALOMIŢA,"LICEUL TEHNOLOGIC ȚĂNDĂREI (ȘCOALA GIMNAZIALĂ NR. 1)",85,"ORAŞ ŢĂNDĂREI",92765,1,PART,PRCNCT,PRSD,PRSD_SV,"2025-05-18 21:42:45",1554,444,416,28,0,430,14,1700,1256,257,173
23,IALOMIŢA,"LICEUL TEHNOLOGIC ȚĂNDĂREI (ȘCOALA GIMNAZIALĂ NR. 1)",86,"ORAŞ ŢĂNDĂREI",92765,1,PART,PRCNCT,PRSD,PRSD_SV,"2025-05-18 21:19:48",986,104,76,28,0,101,3,1100,996,70,31
23,IALOMIŢA,"SALĂ DE SPORT CLUB SPORTIV VICTORIA ȚĂNDĂREI",87,"ORAŞ ŢĂNDĂREI",92765,1,PART,PRCNCT,PRSD,PRSD_SV,"2025-05-18 21:50:32",1605,490,435,55,0,481,9,1750,1260,251,230
23,IALOMIŢA,"FOSTA ŞCOALA NR. 1",88,"ORAŞ ŢĂNDĂREI",92765,1,PART,PRCNCT,PRSD,PRSD_SV,"2025-05-18 21:41:56",1114,181,155,26,0,176,5,1200,1019,118,58
23,IALOMIŢA,"SALA DE SPORT DE LÂNGĂ PRIMARIA COMUNEI ADÂNCATA",89,ADÂNCATA,100754,1,PART,PRCNCT,PRSD,PRSD_SV,"2025-05-18 21:53:45",1317,787,594,190,3,778,9,1450,663,487,291
23,IALOMIŢA,"ŞCOALA GENERALĂ ADÂNCATA",90,ADÂNCATA,100754,1,PART,PRCNCT,PRSD,PRSD_SV,"2025-05-18 21:49:20",551,383,246,137,0,380,3,600,217,230,150
23,IALOMIŢA,"SCOALA GIMNAZIALA ”CONSTANTIN STEFAN”",91,ALBEŞTI,92783,1,PART,PRCNCT,PRSD,PRSD_SV,"2025-05-18 21:40:09",503,320,244,68,8,314,6,550,230,207,107
23,IALOMIŢA,"CONTAINER(SITUAT IN CURTEA GRĂDINIȚEI CU PROGRAM NORMAL MARSILIENI)",92,ALBEŞTI,92783,1,PART,PRCNCT,PRSD,PRSD_SV,"2025-05-18 21:33:02",401,282,225,53,4,276,6,450,168,193,83
23,IALOMIŢA,"ŞCOALA GIMNAZIALĂ ”ALEXANDRU ALDEA VOIEVOD” - CORP A (ȘCOALA NOUĂ)",93,ALEXENI,100852,1,PART,PRCNCT,PRSD,PRSD_SV,"2025-05-18 21:51:17",807,442,363,77,2,439,3,900,458,274,165
23,IALOMIŢA,"ŞCOALA GIMNAZIALĂ ”ALEXANDRU ALDEA VOIEVOD” - CORP A (ȘCOALA NOUĂ)",94,ALEXENI,100852,1,PART,PRCNCT,PRSD,PRSD_SV,"2025-05-18 21:56:41",1027,505,442,61,2,504,1,1100,595,342,162
23,IALOMIŢA,"ŞCOALA GENERALA ANDRĂŞEŞTI",95,ANDRĂŞEŞTI,92872,1,PART,PRCNCT,PRSD,PRSD_SV,"2025-05-18 22:08:17",1380,714,600,114,0,706,8,1500,786,401,305
23,IALOMIŢA,"ŞCOALA ORBOEŞTI",96,ANDRĂŞEŞTI,92872,1,PART,PRCNCT,PRSD,PRSD_SV,"2025-05-18 21:29:08",251,162,108,54,0,161,1,261,99,91,70
23,IALOMIŢA,"ȘCOALA GENERALĂ ARMĂȘEȘTI",97,ARMĂŞEŞTI,100870,1,PART,PRCNCT,PRSD,PRSD_SV,"2025-05-18 21:46:22",575,329,248,80,1,327,2,600,271,203,124
23,IALOMIŢA,"ŞCOALA GENERALĂ MALU ROȘU",98,ARMĂŞEŞTI,100870,1,PART,PRCNCT,PRSD,PRSD_SV,"2025-05-18 21:30:07",1055,483,384,99,0,478,5,1150,667,309,169
23,IALOMIŢA,"ȘCOALA GIMNAZIALĂ ”ROMAN IALOMIȚEANUL”",99,AXINTELE,100923,1,PART,PRCNCT,PRSD,PRSD_SV,"2025-05-18 21:45:11",500,346,220,126,0,342,4,550,204,234,108
23,IALOMIŢA,"GRĂDINIȚA CU PROGRAM NORMAL FRUMUȘICA",100,AXINTELE,100923,1,PART,PRCNCT,PRSD,PRSD_SV,"2025-05-18 22:01:02",756,393,312,81,0,390,3,800,407,302,88
23,IALOMIŢA,"ȘCOALA PRIMARĂ HORIA",101,AXINTELE,100923,1,PART,PRCNCT,PRSD,PRSD_SV,"2025-05-18 21:37:32",449,209,144,65,0,205,4,500,291,130,75
23,IALOMIŢA,"CĂMIN CULTURAL",102,BALACIU,92907,1,PART,PRCNCT,PRSD,PRSD_SV,"2025-05-18 21:36:48",366,269,150,89,30,266,3,400,131,139,127
23,IALOMIŢA,"ŞCOALA GIMNAZIALĂ ”ARHIMANDRIT TEOFIL” BALACIU",103,BALACIU,92907,1,PART,PRCNCT,PRSD,PRSD_SV,"2025-05-18 21:29:56",314,184,125,58,1,181,3,350,166,118,63
23,IALOMIŢA,"CONTAINER MODULAR(TEREN FOSTA GRĂDINIŢĂ COPUZU)",104,BALACIU,92907,1,PART,PRCNCT,PRSD,PRSD_SV,"2025-05-18 21:35:33",222,144,82,62,0,142,2,250,106,82,60
23,IALOMIŢA,"SALĂ FESTIVITĂŢI",105,BALACIU,92907,1,PART,PRCNCT,PRSD,PRSD_SV,"2025-05-18 21:28:57",223,137,89,48,0,133,4,250,113,68,65
23,IALOMIŢA,"ŞCOALA GIMNAZIALĂ BĂRBULEŞTI",106,BĂRBULEŞTI,180064,1,PART,PRCNCT,PRSD,PRSD_SV,"2025-05-18 21:29:29",1070,225,202,23,0,218,7,1150,925,196,22
23,IALOMIŢA,"ŞCOALA GIMNAZIALĂ BĂRBULEŞTI",107,BĂRBULEŞTI,180064,1,PART,PRCNCT,PRSD,PRSD_SV,"2025-05-18 21:14:38",1172,204,190,14,0,201,3,1300,1096,174,27
23,IALOMIŢA,"ŞCOALA GIMNAZIALĂ BĂRBULEŞTI",108,BĂRBULEŞTI,180064,1,PART,PRCNCT,PRSD,PRSD_SV,"2025-05-18 21:21:37",1166,204,194,10,0,199,5,1300,1096,173,26
23,IALOMIŢA,"ŞCOALA GIMNAZIALĂ BĂRBULEŞTI",109,BĂRBULEŞTI,180064,1,PART,PRCNCT,PRSD,PRSD_SV,"2025-05-18 21:15:33",1354,213,213,0,0,208,5,1500,1287,186,22
23,IALOMIŢA,"ŞCOALA GIMNAZIALĂ BĂRCĂNEŞTI-CORP A",110,BĂRCĂNEŞTI,101056,1,PART,PRCNCT,PRSD,PRSD_SV,"2025-05-18 21:47:02",1216,690,500,188,2,683,7,1350,660,399,284
23,IALOMIŢA,"ŞCOALA PRIMARĂ CONDEEŞTI",111,BĂRCĂNEŞTI,101056,1,PART,PRCNCT,PRSD,PRSD_SV,"2025-05-18 21:55:09",1389,485,408,77,0,475,10,1550,1065,339,136
23,IALOMIŢA,"ŞCOALA GIMNAZIALĂ",112,BORĂNEŞTI,179784,1,PART,PRCNCT,PRSD,PRSD_SV,"2025-05-18 21:52:54",975,445,393,52,0,430,15,1050,605,328,102
23,IALOMIŢA,"ŞCOALA GIMNAZIALĂ",113,BORĂNEŞTI,179784,1,PART,PRCNCT,PRSD,PRSD_SV,"2025-05-18 21:45:13",561,285,250,35,0,278,7,600,315,223,55
23,IALOMIŢA,"CĂMIN CULTURAL, SAT SINTEŞTI",114,BORĂNEŞTI,179784,1,PART,PRCNCT,PRSD,PRSD_SV,"2025-05-18 21:38:06",308,218,165,53,0,217,1,350,132,146,71
23,IALOMIŢA,"LOCALUL ŞCOLII VECHI DIN CENTRUL SATULUI",115,BORDUŞANI,92989,1,PART,PRCNCT,PRSD,PRSD_SV,"2025-05-18 21:41:22",1373,614,507,106,1,609,5,1500,886,455,154
23,IALOMIŢA,"LOCALUL GRUPULUI ŞCOLAR BORDUŞANI (ZONA „MOARĂ”)",116,BORDUŞANI,92989,1,PART,PRCNCT,PRSD,PRSD_SV,"2025-05-18 21:38:05",1376,604,547,56,1,598,6,1500,896,436,162
23,IALOMIŢA,"LOCALUL ŞCOLII CU CLASELE I- VIII CEGANI",117,BORDUŞANI,92989,1,PART,PRCNCT,PRSD,PRSD_SV,"2025-05-18 21:49:02",1118,523,483,40,0,515,8,1200,677,410,105
23,IALOMIŢA,"CĂMINUL CULTURAL",118,BUCU,93021,1,PART,PRCNCT,PRSD,PRSD_SV,"2025-05-18 21:52:10",1014,549,483,66,0,544,5,1100,551,305,239
23,IALOMIŢA,"CĂMINUL CULTURAL",119,BUCU,93021,1,PART,PRCNCT,PRSD,PRSD_SV,"2025-05-18 21:56:14",988,544,466,78,0,540,4,1100,556,286,254
23,IALOMIŢA,"ŞCOALA CU CLASELE I – IV BUEŞTI",120,BUEŞTI,179793,1,PART,PRCNCT,PRSD,PRSD_SV,"2025-05-18 21:28:25",768,505,402,76,27,503,2,850,345,245,258
23,IALOMIŢA,"ŞCOALA GENERALĂ CIOCÂRLIA",121,CIOCÂRLIA,100709,1,PART,PRCNCT,PRSD,PRSD_SV,"2025-05-18 21:34:42",595,363,270,93,0,358,5,650,287,214,144
23,IALOMIŢA,"ȘCOALA GIMNAZIALĂ CIOCHINA",122,CIOCHINA,93101,1,PART,PRCNCT,PRSD,PRSD_SV,"2025-05-18 21:30:59",1176,658,511,147,0,654,4,1300,642,371,283
23,IALOMIŢA,"GRĂDINIȚA CU PROGRAM NORMAL BORDUȘELU",123,CIOCHINA,93101,1,PART,PRCNCT,PRSD,PRSD_SV,"2025-05-18 21:40:26",550,330,240,90,0,326,4,600,270,176,150
23,IALOMIŢA,"GRĂDINIȚA CU PROGRAM NORMAL OREZU",124,CIOCHINA,93101,1,PART,PRCNCT,PRSD,PRSD_SV,"2025-05-18 21:38:14",571,322,261,61,0,322,0,650,328,197,125
23,IALOMIŢA,"ȘCOALA GIMNAZIALĂ CIULNIȚA",125,CIULNIŢA,93156,1,PART,PRCNCT,PRSD,PRSD_SV,"2025-05-18 21:41:22",996,546,456,90,0,544,2,1100,554,271,273
23,IALOMIŢA,"CĂMIN CULTURAL ION GHICA",126,CIULNIŢA,93156,1,PART,PRCNCT,PRSD,PRSD_SV,"2025-05-18 21:24:13",456,255,201,54,0,254,1,500,245,150,104
23,IALOMIŢA,"CĂMIN CULTURAL POIANA - SALA DE FESTIVITĂȚI",127,CIULNIŢA,93156,1,PART,PRCNCT,PRSD,PRSD_SV,"2025-05-18 21:29:21",399,206,173,33,0,206,0,450,244,134,72
23,IALOMIŢA,"CĂMIN CULTURAL GHIMPAŢI",128,CIULNIŢA,93156,1,PART,PRCNCT,PRSD,PRSD_SV,"2025-05-18 21:18:27",149,112,75,37,0,111,1,150,38,50,61
23,IALOMIŢA,"ŞCOALA GIMNAZIALĂ COCORA",129,COCORA,93209,1,PART,PRCNCT,PRSD,PRSD_SV,"2025-05-18 21:41:38",755,337,294,42,1,335,2,800,463,252,83
23,IALOMIŢA,"PRIMARIA COCORA",130,COCORA,93209,1,PART,PRCNCT,PRSD,PRSD_SV,"2025-05-18 21:37:52",772,323,279,43,1,314,9,850,527,205,109
23,IALOMIŢA,"SALĂ DE EDUCAȚIE FIZICĂ ȘCOLARĂ",131,COLELIA,179971,1,PART,PRCNCT,PRSD,PRSD_SV,"2025-05-18 21:43:23",840,446,350,96,0,438,8,950,504,219,219
23,IALOMIŢA,"CĂMINUL CULTURAL COSÂMBEŞTI",132,COSÂMBEŞTI,93236,1,PART,PRCNCT,PRSD,PRSD_SV,"2025-05-18 21:51:05",808,491,403,76,12,487,4,900,409,302,185
23,IALOMIŢA,"GRADINIȚA CU PROGRAM NORMAL GIMBĂŞANI",133,COSÂMBEŞTI,93236,1,PART,PRCNCT,PRSD,PRSD_SV,"2025-05-18 22:05:09",726,438,370,59,9,435,3,800,362,275,160
23,IALOMIŢA,"CAMINUL CULTURAL COSERENI",134,COŞERENI,102240,2,PART,PRCNCT,PRSD,PRSD_SV,"2025-05-19 00:56:48",1217,827,625,202,0,815,12,1350,523,428,387
23,IALOMIŢA,"ŞCOALA GENERALĂ COSERENI",135,COŞERENI,102240,1,PART,PRCNCT,PRSD,PRSD_SV,"2025-05-18 21:51:50",1234,733,616,117,0,729,4,1350,617,476,253
23,IALOMIŢA,"GRADINIŢA PĂTRIME",136,COŞERENI,102240,1,PART,PRCNCT,PRSD,PRSD_SV,"2025-05-18 21:57:46",1019,611,517,94,0,603,8,1100,489,399,204
23,IALOMIŢA,"CĂMINUL CULTURAL DRĂGOEŞTI",137,DRĂGOEŞTI,102641,1,PART,PRCNCT,PRSD,PRSD_SV,"2025-05-18 21:44:21",722,574,341,233,0,569,5,800,226,327,242
23,IALOMIŢA,"ŞCOALA GIMNAZIALĂ DRIDU - CORP C1",138,DRIDU,102703,1,PART,PRCNCT,PRSD,PRSD_SV,"2025-05-18 22:25:47",931,688,486,199,3,686,2,1050,362,413,273
23,IALOMIŢA,"GRĂDINIŢA DRIDU – MOARĂ",139,DRIDU,102703,1,PART,PRCNCT,PRSD,PRSD_SV,"2025-05-18 22:19:03",799,544,406,137,1,535,9,850,306,288,247
23,IALOMIŢA,"GRĂDINIŢA DRIDU – MOVILA",140,DRIDU,102703,1,PART,PRCNCT,PRSD,PRSD_SV,"2025-05-18 21:59:38",505,363,214,149,0,356,7,550,187,199,157
23,IALOMIŢA,"GRĂDINIŢA DRIDU –SNAGOV",141,DRIDU,102703,1,PART,PRCNCT,PRSD,PRSD_SV,"2025-05-18 21:39:30",297,213,141,72,0,207,6,300,87,129,78
23,IALOMIŢA,"ȘCOALA GIMNAZIALĂ FĂCĂENI - CLĂDIRE C1",142,FĂCĂENI,93575,1,PART,PRCNCT,PRSD,PRSD_SV,"2025-05-18 22:06:36",1165,646,531,113,2,636,10,1250,604,434,202
23,IALOMIŢA,"ȘCOALA GIMNAZIALĂ FĂCĂENI - CLĂDIRE C2",143,FĂCĂENI,93575,1,PART,PRCNCT,PRSD,PRSD_SV,"2025-05-18 21:56:55",1576,722,650,72,0,718,4,1750,1028,556,162
23,IALOMIŢA,"ȘCOALA GIMNAZIALĂ FĂCĂENI - CLĂDIRE C3",144,FĂCĂENI,93575,1,PART,PRCNCT,PRSD,PRSD_SV,"2025-05-18 21:50:34",897,465,397,68,0,460,5,1000,535,326,134
23,IALOMIŢA,"GRĂDINIȚA CU PROGRAM NORMAL PROGRESU",145,FĂCĂENI,93575,1,PART,PRCNCT,PRSD,PRSD_SV,"2025-05-18 21:36:22",499,247,201,46,0,244,3,550,303,178,66
23,IALOMIŢA,"GRĂDINIȚA CU PROGRAM NORMAL GÂRBOVI",146,GÂRBOVI,103283,1,PART,PRCNCT,PRSD,PRSD_SV,"2025-05-18 22:08:01",929,483,344,139,0,478,5,1000,517,261,217
23,IALOMIŢA,"GRĂDINIȚA CU PROGRAM NORMAL GÂRBOVI",147,GÂRBOVI,103283,1,PART,PRCNCT,PRSD,PRSD_SV,"2025-05-18 21:53:42",924,468,398,70,0,462,6,1000,532,267,195
23,IALOMIŢA,"GRĂDINIȚA CU PROGRAM NORMAL GÂRBOVI",148,GÂRBOVI,103283,1,PART,PRCNCT,PRSD,PRSD_SV,"2025-05-18 21:56:05",1013,504,402,102,0,501,3,1100,596,280,221
23,IALOMIŢA,"ŞCOALA GIMNAZIALĂ GHEORGHE DOJA SITUATĂ ÎN GHEORGHE DOJA",149,"GHEORGHE DOJA",93600,2,PART,PRCNCT,PRSD,PRSD_SV,"2025-05-18 22:53:26",999,490,385,102,3,485,5,1100,610,266,219
23,IALOMIŢA,"ŞCOALA GIMNAZIALĂ GHEORGHE DOJA SITUATĂ ÎN GHEORGHE DOJA",150,"GHEORGHE DOJA",93600,1,PART,PRCNCT,PRSD,PRSD_SV,"2025-05-18 21:46:00",1064,505,439,61,5,502,3,1150,645,225,277
23,IALOMIŢA,"ŞCOALA GENERALĂ GHEORGHE LAZĂR",151,"GHEORGHE LAZĂR",93628,1,PART,PRCNCT,PRSD,PRSD_SV,"2025-05-18 22:05:25",1017,574,506,68,0,570,4,1100,526,379,191
23,IALOMIŢA,"ŞCOALA GENERALĂ GHEORGHE LAZĂR",152,"GHEORGHE LAZĂR",93628,1,PART,PRCNCT,PRSD,PRSD_SV,"2025-05-18 22:05:35",759,461,374,87,0,456,5,850,389,270,186
23,IALOMIŢA,"ŞCOALA GIMNAZIALĂ GIURGENI",153,GIURGENI,93646,1,PART,PRCNCT,PRSD,PRSD_SV,"2025-05-18 22:47:30",1068,602,529,49,24,594,8,1150,548,377,217
23,IALOMIŢA,"CĂMINUL CULTURAL",154,GRINDU,93717,1,PART,PRCNCT,PRSD,PRSD_SV,"2025-05-18 21:56:44",711,416,307,109,0,413,3,800,384,230,183
23,IALOMIŢA,"CĂMINUL CULTURAL",155,GRINDU,93717,1,PART,PRCNCT,PRSD,PRSD_SV,"2025-05-18 21:52:01",711,407,317,90,0,405,2,750,343,224,181
23,IALOMIŢA,"ȘCOALA PROFESIONALĂ ” ARETA TEODORESCU”",156,GRIVIŢA,93735,1,PART,PRCNCT,PRSD,PRSD_SV,"2025-05-18 21:43:49",892,485,397,67,21,478,7,950,465,268,210
23,IALOMIŢA,"ȘCOALA PROFESIONALĂ” ARETA TEODORESCU”",157,GRIVIŢA,93735,1,PART,PRCNCT,PRSD,PRSD_SV,"2025-05-18 21:25:49",893,438,351,50,37,430,8,950,512,228,202
23,IALOMIŢA,"GRĂDINIȚA CU PROGRAM NORMAL SMIRNA",158,GRIVIŢA,93735,1,PART,PRCNCT,PRSD,PRSD_SV,"2025-05-18 21:23:30",701,359,300,58,1,357,2,750,391,234,123
23,IALOMIŢA,"SCOALA GIMNAZIALA CONSTANTIN GURGU NR. 1",159,"GURA IALOMIŢEI",180046,1,PART,PRCNCT,PRSD,PRSD_SV,"2025-05-18 21:29:25",924,563,481,82,0,559,4,1000,437,340,219
23,IALOMIŢA,"ŞCOALA GENERALA LUCIU",160,"GURA IALOMIŢEI",180046,1,PART,PRCNCT,PRSD,PRSD_SV,"2025-05-18 21:28:50",1048,513,451,62,0,508,5,1150,637,292,216
23,IALOMIŢA,"ŞCOALA GIMNAZIALA ION ROATA",161,"ION ROATĂ",103862,1,PART,PRCNCT,PRSD,PRSD_SV,"2025-05-18 21:26:28",830,451,368,83,0,448,3,900,449,275,173
23,IALOMIŢA,"GRADINITA ION ROATA (LOCALUL VECHI COLINELE)",162,"ION ROATĂ",103862,1,PART,PRCNCT,PRSD,PRSD_SV,"2025-05-18 21:34:57",742,374,320,54,0,371,3,800,426,242,129
23,IALOMIŢA,"ŞCOALA GIMNAZIALA ION ROATA(STRUCTURA BROSTENI)",163,"ION ROATĂ",103862,1,PART,PRCNCT,PRSD,PRSD_SV,"2025-05-18 21:34:20",1181,548,496,52,0,543,5,1300,752,390,153
23,IALOMIŢA,"ŞCOALA GIMNAZIALĂ ” CĂPITAN AVIATOR CONSTANTIN M. CANTACUZINO JILAVELE ”, CORP CLĂDIRE C1",164,JILAVELE,103960,1,PART,PRCNCT,PRSD,PRSD_SV,"2025-05-18 21:45:50",1109,537,424,111,2,533,4,1250,713,293,240
23,IALOMIŢA,"ŞCOALA GIMNAZIALĂ ” CĂPITAN AVIATOR CONSTANTIN M. CANTACUZINO JILAVELE ”, (FOSTA ȘCOALĂ NR.3 CU CLASELE I-VIII JILAVELE)",165,JILAVELE,103960,1,PART,PRCNCT,PRSD,PRSD_SV,"2025-05-18 21:42:21",1148,578,465,113,0,574,4,1250,672,336,238
23,IALOMIŢA,"FOSTA ȘCOALĂ DIN SATUL SLĂTIOARELE",166,JILAVELE,103960,1,PART,PRCNCT,PRSD,PRSD_SV,"2025-05-18 21:26:59",278,167,115,52,0,164,3,300,133,95,69
23,IALOMIŢA,"ŞCOALA CU CLASELE I-VIII, ”BARBU CATARGIU”, MAIA",167,MAIA,179800,1,PART,PRCNCT,PRSD,PRSD_SV,"2025-05-18 21:59:10",1260,961,684,263,14,952,9,1400,439,535,417
23,IALOMIŢA,"ŞCOALA NOUĂ",168,MANASIA,100736,1,PART,PRCNCT,PRSD,PRSD_SV,"2025-05-18 21:33:26",1276,681,612,68,1,672,9,1400,719,383,289
23,IALOMIŢA,"ŞCOALA NOUĂ",169,MANASIA,100736,1,PART,PRCNCT,PRSD,PRSD_SV,"2025-05-18 21:40:47",1225,615,568,47,0,611,4,1350,735,333,278
23,IALOMIŢA,"ŞCOALA NOUĂ",170,MANASIA,100736,1,PART,PRCNCT,PRSD,PRSD_SV,"2025-05-18 21:36:38",1127,598,534,64,0,589,9,1250,652,288,301
23,IALOMIŢA,"ŞCOALA GIMNAZIALĂ ” ALEXANDRU RĂDULESCU ” MĂRCULEŞTI",171,MĂRCULEŞTI,179980,1,PART,PRCNCT,PRSD,PRSD_SV,"2025-05-18 22:08:59",1288,657,578,62,17,651,6,1400,743,438,213
23,IALOMIŢA,"CĂMIN CULTURAL MIHAIL KOGĂLNICEANU",172,"MIHAIL KOGĂLNICEANU",93995,1,PART,PRCNCT,PRSD,PRSD_SV,"2025-05-18 21:46:54",1332,674,591,82,1,663,11,1450,776,424,239
23,IALOMIŢA,"ȘCOALA GIMNAZIALĂ „MIHAIL KOGĂLNICEANU” - SALA DE SPORT",173,"MIHAIL KOGĂLNICEANU",93995,1,PART,PRCNCT,PRSD,PRSD_SV,"2025-05-18 22:03:59",1218,559,497,59,3,556,3,1350,791,324,232
23,IALOMIŢA,"ŞCOALA GIMNAZIALA MILOŞEŞTI",174,MILOŞEŞTI,94045,1,PART,PRCNCT,PRSD,PRSD_SV,"2025-05-18 21:52:24",1343,653,536,106,11,643,10,1500,847,353,290
23,IALOMIŢA,"ŞCOALA GENERALĂ NICOLEŞTI",175,MILOŞEŞTI,94045,1,PART,PRCNCT,PRSD,PRSD_SV,"2025-05-18 21:27:07",305,135,111,23,1,134,1,350,215,75,59
23,IALOMIŢA,"ŞCOALA GENERALA TOVĂRĂŞIA",176,MILOŞEŞTI,94045,1,PART,PRCNCT,PRSD,PRSD_SV,"2025-05-18 21:42:48",268,188,120,66,2,186,2,300,112,75,111
23,IALOMIŢA,"ŞCOALA CU CLASELE I-VIII MOLDOVENI",177,MOLDOVENI,179999,1,PART,PRCNCT,PRSD,PRSD_SV,"2025-05-18 21:44:17",831,612,428,178,6,606,6,900,288,335,271
23,IALOMIŢA,"ŞCOALA CU CLASELE I-VIII, MOVILA",178,MOVILA,94081,1,PART,PRCNCT,PRSD,PRSD_SV,"2025-05-18 21:37:40",1509,799,694,90,15,789,10,1650,851,471,318
23,IALOMIŢA,"SCOALA GIMNAZIALA MOVILITA",179,MOVILIŢA,104270,1,PART,PRCNCT,PRSD,PRSD_SV,"2025-05-18 21:42:10",1136,695,506,189,0,691,4,1250,555,474,217
23,IALOMIŢA,"SCOALA GIMNAZIALA MOVILITA",180,MOVILIŢA,104270,1,PART,PRCNCT,PRSD,PRSD_SV,"2025-05-18 21:32:17",820,546,361,184,1,539,7,900,354,341,198
23,IALOMIŢA,"ŞCOALA GENERALĂ NR. 1",181,MUNTENI-BUZĂU,94107,1,PART,PRCNCT,PRSD,PRSD_SV,"2025-05-18 21:57:52",1435,813,641,171,1,804,9,1600,787,428,376
23,IALOMIŢA,"ŞCOALA GENERALĂ NR. 2",182,MUNTENI-BUZĂU,94107,1,PART,PRCNCT,PRSD,PRSD_SV,"2025-05-18 21:47:58",1202,637,528,106,3,630,7,1300,663,331,299
23,IALOMIŢA,"ȘCOALA GIMNAZIALĂ ”IONEL PERLEA” OGRADA",183,OGRADA,179819,1,PART,PRCNCT,PRSD,PRSD_SV,"2025-05-18 21:44:11",1177,583,500,66,17,576,7,1300,717,374,202
23,IALOMIŢA,"SALĂ EDUCAȚIE FIZICĂ ȘCOLARĂ",184,OGRADA,179819,1,PART,PRCNCT,PRSD,PRSD_SV,"2025-05-18 21:48:31",1075,510,454,37,19,506,4,1200,690,341,165
23,IALOMIŢA,"ȘCOALA GIMNAZIALĂ PERIEȚI",185,PERIEŢI,94161,1,PART,PRCNCT,PRSD,PRSD_SV,"2025-05-18 21:33:09",1034,543,461,82,0,541,2,1150,607,323,218
23,IALOMIŢA,"FOSTA GRĂDINIȚĂ CU PROGRAM NORMAL FUNDATA",186,PERIEŢI,94161,1,PART,PRCNCT,PRSD,PRSD_SV,"2025-05-18 21:54:58",406,239,169,70,0,239,0,450,211,133,106
23,IALOMIŢA,"ȘCOALA PRIMARĂ MISLEANU",187,PERIEŢI,94161,1,PART,PRCNCT,PRSD,PRSD_SV,"2025-05-18 21:47:05",684,384,321,62,1,383,1,750,366,263,120
23,IALOMIŢA,"ȘCOALA PRIMARĂ PĂLTINIȘU",188,PERIEŢI,94161,1,PART,PRCNCT,PRSD,PRSD_SV,"2025-05-18 21:40:09",932,520,460,59,1,512,8,1000,480,311,201
23,IALOMIŢA,"CAMIN CULTURAL PLATONEŞTI",189,PLATONEŞTI,180000,1,PART,PRCNCT,PRSD,PRSD_SV,"2025-05-18 21:21:10",731,351,288,63,0,346,5,800,449,165,181
23,IALOMIŢA,"ȘCOALA GIMNAZIALĂ PLATONEȘTI",190,PLATONEŞTI,180000,1,PART,PRCNCT,PRSD,PRSD_SV,"2025-05-18 21:21:30",728,378,343,35,0,375,3,800,422,272,103
23,IALOMIŢA,"SCOALA GIMNAZIALA RADULESTI",191,RĂDULEŞTI,101243,1,PART,PRCNCT,PRSD,PRSD_SV,"2025-05-18 21:54:30",680,445,328,117,0,440,5,750,305,238,202
23,IALOMIŢA,"ŞCOALA GENERALĂ CU CLASELE I-IV RĂSIMNICEA",192,RĂDULEŞTI,101243,1,PART,PRCNCT,PRSD,PRSD_SV,"2025-05-18 21:38:09",199,165,92,73,0,165,0,200,35,93,72
23,IALOMIŢA,"ŞCOALA REVIGA",193,REVIGA,94269,1,PART,PRCNCT,PRSD,PRSD_SV,"2025-05-18 21:30:38",1012,464,355,109,0,461,3,1100,636,247,214
23,IALOMIŢA,"ŞCOALA CRUNŢI",194,REVIGA,94269,1,PART,PRCNCT,PRSD,PRSD_SV,"2025-05-18 21:17:13",313,140,106,34,0,138,2,350,210,88,50
23,IALOMIŢA,"ŞCOALA ROVINE",195,REVIGA,94269,1,PART,PRCNCT,PRSD,PRSD_SV,"2025-05-18 21:25:32",697,316,246,70,0,312,4,750,434,140,172
23,IALOMIŢA,"SCOALA CU CLASELE I-VIII ROŞIORI",196,ROŞIORI,179828,1,PART,PRCNCT,PRSD,PRSD_SV,"2025-05-18 21:53:09",882,508,396,109,3,498,10,950,442,308,190
23,IALOMIŢA,"ŞCOALA CU CLASELE I-VIII ROŞIORI",197,ROŞIORI,179828,1,PART,PRCNCT,PRSD,PRSD_SV,"2025-05-18 21:34:36",624,379,270,106,3,376,3,700,321,222,154
23,IALOMIŢA,"ŞCOALA GIMNAZIALĂ",198,SĂLCIOARA,94330,1,PART,PRCNCT,PRSD,PRSD_SV,"2025-05-18 22:00:16",814,471,362,109,0,470,1,900,429,273,197
23,IALOMIŢA,"ŞCOALA PRIMARĂ",199,SĂLCIOARA,94330,1,PART,PRCNCT,PRSD,PRSD_SV,"2025-05-18 22:09:45",787,506,387,101,18,501,5,850,344,358,143
23,IALOMIŢA,"SCOALA PRIMARA SARATENI",200,SĂRĂŢENI,180019,1,PART,PRCNCT,PRSD,PRSD_SV,"2025-05-18 21:42:18",883,497,381,110,6,490,7,950,453,275,215
23,IALOMIŢA,"ŞCOALA GIMNAZIALĂ SĂVENI",201,SĂVENI,94376,1,PART,PRCNCT,PRSD,PRSD_SV,"2025-05-18 21:52:40",1208,585,507,75,3,577,8,1350,765,355,222
23,IALOMIŢA,"GRĂDINIŢA SĂVENI",202,SĂVENI,94376,1,PART,PRCNCT,PRSD,PRSD_SV,"2025-05-18 21:46:15",1197,563,516,47,0,554,9,1300,737,346,208
23,IALOMIŢA,"CĂMIN CULTURAL FRĂȚILEȘTI",203,SĂVENI,94376,1,PART,PRCNCT,PRSD,PRSD_SV,"2025-05-18 21:35:05",345,191,164,27,0,189,2,400,209,130,59
23,IALOMIŢA,"GRĂDINIȚA SCÂNTEIA",204,SCÂNTEIA,94429,1,PART,PRCNCT,PRSD,PRSD_SV,"2025-05-18 22:00:10",1103,536,494,41,1,531,5,1200,664,339,192
23,IALOMIŢA,"ŞCOALA GIMNAZIALĂ SCÂNTEIA",205,SCÂNTEIA,94429,1,PART,PRCNCT,PRSD,PRSD_SV,"2025-05-18 21:54:15",1011,535,454,81,0,531,4,1100,565,325,206
23,IALOMIŢA,"GRĂDINIȚA CU PROGRAM NORMAL IAZU",206,SCÂNTEIA,94429,1,PART,PRCNCT,PRSD,PRSD_SV,"2025-05-18 21:43:04",769,374,307,67,0,370,4,850,476,223,147
23,IALOMIŢA,"CENTRU SOCIAL DE ZI VIITORUL",207,"SFÂNTU GHEORGHE",94456,1,PART,PRCNCT,PRSD,PRSD_SV,"2025-05-18 22:22:11",589,375,290,85,0,370,5,650,275,195,175
23,IALOMIŢA,"CĂMINUL CULTURAL MALU,SALONUL DE NUNŢI SITUATĂ ÎN MALU",208,"SFÂNTU GHEORGHE",94456,1,PART,PRCNCT,PRSD,PRSD_SV,"2025-05-18 21:48:50",830,500,386,114,0,496,4,900,400,287,209
23,IALOMIŢA,"CĂMINUL CULTURAL SITUATĂ ÎN SATUL SINEŞTI, SINEŞTI",209,SINEŞTI,105026,1,PART,PRCNCT,PRSD,PRSD_SV,"2025-05-18 22:03:18",1294,754,515,239,0,744,10,1400,646,504,240
23,IALOMIŢA,"CĂMINUL CULTURAL SAT LILIECI",210,SINEŞTI,105026,1,PART,PRCNCT,PRSD,PRSD_SV,"2025-05-18 21:41:38",899,624,361,263,0,619,5,1000,376,401,218
23,IALOMIŢA,"PRIMĂRIA STELNICA",211,STELNICA,94492,1,PART,PRCNCT,PRSD,PRSD_SV,"2025-05-18 21:53:59",1436,671,613,58,0,663,8,1600,929,457,206
23,IALOMIŢA,"ȘCOALA GIMNAZIALĂ ”APOSTOL D. CULEA”",212,SUDIŢI,94535,1,PART,PRCNCT,PRSD,PRSD_SV,"2025-05-18 21:29:36",765,419,364,47,8,411,8,850,431,282,129
23,IALOMIŢA,"ȘCOALA GIMNAZIALĂ ”APOSTOL D. CULEA”",213,SUDIŢI,94535,1,PART,PRCNCT,PRSD,PRSD_SV,"2025-05-18 21:37:09",827,416,361,47,8,410,6,900,484,269,141
23,IALOMIŢA,"GRĂDINIŢA CU PROGRAM NORMAL TRAIAN",214,TRAIAN,179702,1,PART,PRCNCT,PRSD,PRSD_SV,"2025-05-18 21:46:38",1132,496,434,60,2,490,6,1250,754,296,194
23,IALOMIŢA,"ŞCOLA PROFESIONALĂ TRAIAN",215,TRAIAN,179702,1,PART,PRCNCT,PRSD,PRSD_SV,"2025-05-18 21:55:58",1251,506,454,52,0,501,5,1400,894,365,136
23,IALOMIŢA,"CENTRUL COMUNITAR MULTIFUNCȚIONAL VALEA CIORII",216,"VALEA CIORII",94688,2,PART,PRCNCT,PRSD,PRSD_SV,"2025-05-18 22:50:47",1387,626,573,53,0,621,5,1550,924,421,200
23,IALOMIŢA,"CĂMIN CULTURAL",217,"VALEA MĂCRIŞULUI",105794,1,PART,PRCNCT,PRSD,PRSD_SV,"2025-05-18 21:48:51",875,482,360,94,28,475,7,950,468,241,234
23,IALOMIŢA,"CĂMIN CULTURAL",218,"VALEA MĂCRIŞULUI",105794,1,PART,PRCNCT,PRSD,PRSD_SV,"2025-05-18 21:54:29",353,193,132,58,3,192,1,400,207,106,86
23,IALOMIŢA,"CĂMINUL CULTURAL",219,VLĂDENI,94795,1,PART,PRCNCT,PRSD,PRSD_SV,"2025-05-18 22:00:27",844,462,412,49,1,455,7,950,488,276,179
23,IALOMIŢA,"CĂMINUL CULTURAL",220,VLĂDENI,94795,1,PART,PRCNCT,PRSD,PRSD_SV,"2025-05-18 21:45:45",734,435,394,40,1,432,3,800,365,281,151
24,IAŞI,"CENTRUL TEHNOLOGIC REGIONAL",1,"MUNICIPIUL IAŞI",95060,1,PART,PRCNCT,PRSD,PRSD_SV,"2025-05-18 21:47:29",751,659,406,253,0,652,7,800,141,163,489
24,IAŞI,"CENTRUL TEHNOLOGIC REGIONAL",2,"MUNICIPIUL IAŞI",95060,1,PART,PRCNCT,PRSD,PRSD_SV,"2025-05-18 21:42:00",1257,946,743,202,1,934,12,1400,454,268,666
24,IAŞI,"PT 27 - TATARASI",3,"MUNICIPIUL IAŞI",95060,2,PART,PRCNCT,PRSD,PRSD_SV,"2025-05-18 22:35:27",1543,245,8,113,124,241,4,1700,1455,101,140
24,IAŞI,"GRĂDINIŢA CU PROGRAM NORMAL NR. 15",4,"MUNICIPIUL IAŞI",95060,1,PART,PRCNCT,PRSD,PRSD_SV,"2025-05-18 21:57:48",1577,1073,869,204,0,1059,14,1700,627,248,811
24,IAŞI,"GRĂDINIŢA CU PROGRAM NORMAL NR. 15",5,"MUNICIPIUL IAŞI",95060,1,PART,PRCNCT,PRSD,PRSD_SV,"2025-05-18 21:54:53",1376,972,733,239,0,958,14,1500,528,325,633
24,IAŞI,"ŞCOALA GIMNAZIALĂ ”ELENA CUZA”",6,"MUNICIPIUL IAŞI",95060,1,PART,PRCNCT,PRSD,PRSD_SV,"2025-05-18 21:52:10",1259,912,697,215,0,893,19,1400,488,233,660
24,IAŞI,"ŞCOALA GIMNAZIALĂ ”ELENA CUZA”",7,"MUNICIPIUL IAŞI",95060,1,PART,PRCNCT,PRSD,PRSD_SV,"2025-05-18 21:33:05",1029,777,559,218,0,762,15,1100,323,175,587
24,IAŞI,"ŞCOALA GIMNAZIALĂ ”ELENA CUZA”",8,"MUNICIPIUL IAŞI",95060,1,PART,PRCNCT,PRSD,PRSD_SV,"2025-05-18 21:56:54",1439,959,729,228,2,937,22,1600,641,254,683
24,IAŞI,"ŞCOALA GIMNAZIALĂ ”ELENA CUZA”",9,"MUNICIPIUL IAŞI",95060,1,PART,PRCNCT,PRSD,PRSD_SV,"2025-05-18 21:36:39",1394,911,695,216,0,896,15,1500,589,211,685
24,IAŞI,"GRĂDINIŢA CU PROGRAM PRELUNGIT NR. 14",10,"MUNICIPIUL IAŞI",95060,1,PART,PRCNCT,PRSD,PRSD_SV,"2025-05-18 21:55:31",1211,750,668,80,2,741,9,1300,550,162,579
24,IAŞI,"GRĂDINIŢA CU PROGRAM PRELUNGIT NR. 14",11,"MUNICIPIUL IAŞI",95060,1,PART,PRCNCT,PRSD,PRSD_SV,"2025-05-18 21:48:01",1305,789,644,145,0,781,8,1400,611,224,557
24,IAŞI,"GRĂDINIŢA CU PROGRAM PRELUNGIT NR. 14",12,"MUNICIPIUL IAŞI",95060,1,PART,PRCNCT,PRSD,PRSD_SV,"2025-05-18 21:54:24",1465,902,777,124,1,897,5,1600,698,222,675
24,IAŞI,"GRĂDINIŢA CU PROGRAM PRELUNGIT NR. 14",13,"MUNICIPIUL IAŞI",95060,1,PART,PRCNCT,PRSD,PRSD_SV,"2025-05-18 22:37:17",1682,1046,881,165,0,1032,14,1800,754,275,757
24,IAŞI,"ŞCOALA GIMNAZIALĂ ”ION CREANGĂ”",14,"MUNICIPIUL IAŞI",95060,1,PART,PRCNCT,PRSD,PRSD_SV,"2025-05-18 22:03:14",1715,1103,968,133,2,1093,10,1900,797,247,846
24,IAŞI,"ŞCOALA GIMNAZIALĂ ”ION CREANGĂ”",15,"MUNICIPIUL IAŞI",95060,1,PART,PRCNCT,PRSD,PRSD_SV,"2025-05-18 22:01:21",1222,933,686,246,1,922,11,1300,367,209,713
24,IAŞI,"ŞCOALA GIMNAZIALĂ ”ION CREANGĂ”",16,"MUNICIPIUL IAŞI",95060,1,PART,PRCNCT,PRSD,PRSD_SV,"2025-05-18 21:47:37",1175,894,644,250,0,883,11,1300,406,237,646
24,IAŞI,"ŞCOALA GIMNAZIALĂ ”ION CREANGĂ”",17,"MUNICIPIUL IAŞI",95060,1,PART,PRCNCT,PRSD,PRSD_SV,"2025-05-18 22:07:48",1237,886,698,188,0,877,9,1400,514,263,614
24,IAŞI,"ŞCOALA GIMNAZIALĂ ”PETRU PONI”",18,"MUNICIPIUL IAŞI",95060,1,PART,PRCNCT,PRSD,PRSD_SV,"2025-05-18 21:41:32",1207,877,689,102,86,864,13,1300,423,250,614
24,IAŞI,"ŞCOALA GIMNAZIALĂ ”PETRU PONI”",19,"MUNICIPIUL IAŞI",95060,1,PART,PRCNCT,PRSD,PRSD_SV,"2025-05-18 21:55:01",1212,934,584,172,178,922,12,1300,366,329,593
24,IAŞI,"ŞCOALA GIMNAZIALĂ ”PETRU PONI”",20,"MUNICIPIUL IAŞI",95060,1,PART,PRCNCT,PRSD,PRSD_SV,"2025-05-18 21:32:32",1124,1012,633,226,153,1001,11,1200,188,306,695
24,IAŞI,"ŞCOALA GIMNAZIALĂ ”PETRU PONI”",21,"MUNICIPIUL IAŞI",95060,1,PART,PRCNCT,PRSD,PRSD_SV,"2025-05-18 22:32:34",1110,956,594,227,135,949,7,1200,244,275,674
24,IAŞI,"ŞCOALA GIMNAZIALĂ ”ŞTEFAN BÂRSĂNESCU”",22,"MUNICIPIUL IAŞI",95060,1,PART,PRCNCT,PRSD,PRSD_SV,"2025-05-18 22:02:58",1124,983,668,315,0,975,8,1200,217,218,757
24,IAŞI,"ŞCOALA GIMNAZIALĂ ”ŞTEFAN BÂRSĂNESCU”",23,"MUNICIPIUL IAŞI",95060,1,PART,PRCNCT,PRSD,PRSD_SV,"2025-05-18 21:58:59",1364,705,525,178,2,696,9,1500,795,130,566
24,IAŞI,"ŞCOALA GIMNAZIALĂ ”ŞTEFAN BÂRSĂNESCU”",24,"MUNICIPIUL IAŞI",95060,1,PART,PRCNCT,PRSD,PRSD_SV,"2025-05-18 21:39:39",726,582,379,202,1,576,6,800,218,144,432
24,IAŞI,"ŞCOALA GIMNAZIALĂ ”ŞTEFAN BÂRSĂNESCU”",25,"MUNICIPIUL IAŞI",95060,1,PART,PRCNCT,PRSD,PRSD_SV,"2025-05-18 22:03:46",857,672,486,185,1,662,10,900,228,155,507
24,IAŞI,"ŞCOALA GIMNAZIALĂ ”ŞTEFAN BÂRSĂNESCU”",26,"MUNICIPIUL IAŞI",95060,1,PART,PRCNCT,PRSD,PRSD_SV,"2025-05-18 21:46:33",843,383,177,206,0,379,4,900,517,96,283
24,IAŞI,"COLEGIUL NAŢIONAL",27,"MUNICIPIUL IAŞI",95060,1,PART,PRCNCT,PRSD,PRSD_SV,"2025-05-18 21:47:00",1217,996,659,337,0,988,8,1300,304,198,790
24,IAŞI,"COLEGIUL NAŢIONAL",28,"MUNICIPIUL IAŞI",95060,1,PART,PRCNCT,PRSD,PRSD_SV,"2025-05-18 22:07:22",899,858,507,350,1,853,5,1400,542,185,668
24,IAŞI,"COLEGIUL NAŢIONAL",29,"MUNICIPIUL IAŞI",95060,1,PART,PRCNCT,PRSD,PRSD_SV,"2025-05-18 21:36:01",765,676,383,289,4,665,11,800,124,133,532
24,IAŞI,"COLEGIUL NAŢIONAL",30,"MUNICIPIUL IAŞI",95060,1,PART,PRCNCT,PRSD,PRSD_SV,"2025-05-18 21:34:31",1163,590,466,121,3,586,4,1300,710,148,438
24,IAŞI,"COLEGIUL NAŢIONAL",31,"MUNICIPIUL IAŞI",95060,1,PART,PRCNCT,PRSD,PRSD_SV,"2025-05-18 22:17:18",1262,832,648,183,1,818,14,1400,568,197,621
24,IAŞI,"LICEUL TEHNOLOGIC ECONOMIC ”VIRGIL MADGEARU” - CORP A",32,"MUNICIPIUL IAŞI",95060,1,PART,PRCNCT,PRSD,PRSD_SV,"2025-05-18 22:12:28",1383,885,747,138,0,874,11,1500,615,285,589
24,IAŞI,"ŞCOALA PRIMARĂ ”GHEORGHE ASACHI”",33,"MUNICIPIUL IAŞI",95060,1,PART,PRCNCT,PRSD,PRSD_SV,"2025-05-18 22:49:12",882,1969,360,1609,0,1945,24,3000,1031,435,1510
24,IAŞI,"COLEGIUL NATIONAL ”COSTACHE NEGRUZZI’’",34,"MUNICIPIUL IAŞI",95060,1,PART,PRCNCT,PRSD,PRSD_SV,"2025-05-18 23:16:00",856,1173,494,591,88,1153,20,2000,827,219,934
24,IAŞI,"COLEGIUL NATIONAL ”COSTACHE NEGRUZZI’’",35,"MUNICIPIUL IAŞI",95060,1,PART,PRCNCT,PRSD,PRSD_SV,"2025-05-18 22:34:41",770,1045,451,566,28,1038,7,2000,955,135,903
24,IAŞI,"COLEGIUL NATIONAL ”GARABET IBRĂILEANU”",36,"MUNICIPIUL IAŞI",95060,1,PART,PRCNCT,PRSD,PRSD_SV,"2025-05-18 22:20:29",1024,946,524,330,92,932,14,1500,554,242,690
24,IAŞI,"COLEGIUL NATIONAL ”GARABET IBRĂILEANU”",37,"MUNICIPIUL IAŞI",95060,1,PART,PRCNCT,PRSD,PRSD_SV,"2025-05-18 22:03:43",1102,865,612,177,76,852,13,1200,335,193,659
24,IAŞI,"COLEGIUL NATIONAL ”GARABET IBRĂILEANU”",38,"MUNICIPIUL IAŞI",95060,1,PART,PRCNCT,PRSD,PRSD_SV,"2025-05-18 22:15:45",1031,1320,578,687,55,1306,14,2400,1080,221,1085
24,IAŞI,"COLEGIUL NATIONAL ”GARABET IBRĂILEANU”",39,"MUNICIPIUL IAŞI",95060,1,PART,PRCNCT,PRSD,PRSD_SV,"2025-05-18 21:44:25",1564,563,175,297,91,561,2,1700,1137,178,383
24,IAŞI,"UNIVERSITATEA DE STIINTE AGRICOLE SI MEDICINA VETERINARĂ ”ION IONESCU DE LA BRAD”",40,"MUNICIPIUL IAŞI",95060,1,PART,PRCNCT,PRSD,PRSD_SV,"2025-05-18 22:04:00",1562,1848,826,1021,1,1829,19,2400,552,358,1471
24,IAŞI,"UNIVERSITATEA DE STIINTE AGRICOLE SI MEDICINA VETERINARĂ ”ION IONESCU DE LA BRAD”",41,"MUNICIPIUL IAŞI",95060,1,PART,PRCNCT,PRSD,PRSD_SV,"2025-05-18 22:15:41",1189,1308,748,557,3,1294,14,1800,492,242,1052
24,IAŞI,"LICEUL TEORETIC DE INFORMATICĂ ”GRIGORE MOISIL”",42,"MUNICIPIUL IAŞI",95060,1,PART,PRCNCT,PRSD,PRSD_SV,"2025-05-18 22:46:52",1890,2175,996,1141,38,2155,20,2800,625,435,1720
24,IAŞI,"COLEGIUL NAŢIONAL ”MIHAI EMINESCU”",43,"MUNICIPIUL IAŞI",95060,1,PART,PRCNCT,PRSD,PRSD_SV,"2025-05-18 21:59:06",956,689,533,135,21,686,3,1000,311,147,539
24,IAŞI,"COLEGIUL NAŢIONAL ”MIHAI EMINESCU”",44,"MUNICIPIUL IAŞI",95060,1,PART,PRCNCT,PRSD,PRSD_SV,"2025-05-18 21:49:43",932,657,529,68,60,652,5,1000,343,161,491
24,IAŞI,"ŞCOALA GIMNAZIALĂ”MIHAI CODREANU”",45,"MUNICIPIUL IAŞI",95060,1,PART,PRCNCT,PRSD,PRSD_SV,"2025-05-18 22:04:27",395,429,197,99,133,420,9,800,371,113,307
24,IAŞI,"ŞCOALA GIMNAZIALĂ”MIHAI CODREANU”",46,"MUNICIPIUL IAŞI",95060,1,PART,PRCNCT,PRSD,PRSD_SV,"2025-05-18 22:20:15",457,462,252,72,138,455,7,800,338,157,298
24,IAŞI,"LICEUL TEHNOLOGIC UCECOM ”SPIRU HARET”",47,"MUNICIPIUL IAŞI",95060,1,PART,PRCNCT,PRSD,PRSD_SV,"2025-05-18 21:47:03",1156,677,562,113,2,669,8,1300,623,248,421
24,IAŞI,"LICEUL TEHNOLOGIC UCECOM ”SPIRU HARET”",48,"MUNICIPIUL IAŞI",95060,1,PART,PRCNCT,PRSD,PRSD_SV,"2025-05-18 21:43:12",934,651,477,174,0,648,3,1000,349,192,456
24,IAŞI,"LICEUL TEHNOLOGIC UCECOM ”SPIRU HARET”",49,"MUNICIPIUL IAŞI",95060,1,PART,PRCNCT,PRSD,PRSD_SV,"2025-05-18 21:55:25",1431,855,796,59,0,845,10,1600,745,254,591
24,IAŞI,"COLEGIUL ECONOMIC ADMINISTRATIV",50,"MUNICIPIUL IAŞI",95060,1,PART,PRCNCT,PRSD,PRSD_SV,"2025-05-18 21:45:05",865,587,435,152,0,580,7,900,313,162,418
24,IAŞI,"COLEGIUL ECONOMIC ADMINISTRATIV",51,"MUNICIPIUL IAŞI",95060,1,PART,PRCNCT,PRSD,PRSD_SV,"2025-05-18 21:25:15",891,633,539,94,0,623,10,1000,367,160,463
24,IAŞI,"LICEUL TEORETIC ‘’VASILE ALECSANDRI’’",52,"MUNICIPIUL IAŞI",95060,1,PART,PRCNCT,PRSD,PRSD_SV,"2025-05-18 22:38:51",1037,935,575,358,2,926,9,1098,163,237,689
24,IAŞI,"LICEUL TEORETIC ‘’VASILE ALECSANDRI’’",53,"MUNICIPIUL IAŞI",95060,1,PART,PRCNCT,PRSD,PRSD_SV,"2025-05-18 21:40:56",519,594,288,305,1,585,9,1400,806,145,440
24,IAŞI,"LICEUL TEORETIC ‘’VASILE ALECSANDRI’’",54,"MUNICIPIUL IAŞI",95060,1,PART,PRCNCT,PRSD,PRSD_SV,"2025-05-18 21:49:38",1069,784,575,206,3,769,15,1200,416,164,605
24,IAŞI,"COLEGIUL NATIONAL DE ARTĂ ”OCTACV BĂNCILĂ”",55,"MUNICIPIUL IAŞI",95060,1,PART,PRCNCT,PRSD,PRSD_SV,"2025-05-18 22:26:34",700,439,344,94,1,429,10,800,361,113,316
24,IAŞI,"COLEGIUL NATIONAL DE ARTĂ ”OCTACV BĂNCILĂ”",56,"MUNICIPIUL IAŞI",95060,1,PART,PRCNCT,PRSD,PRSD_SV,"2025-05-18 21:42:12",554,499,285,131,83,495,4,600,101,130,365
24,IAŞI,"COLEGIUL NATIONAL DE ARTĂ ”OCTACV BĂNCILĂ”",57,"MUNICIPIUL IAŞI",95060,1,PART,PRCNCT,PRSD,PRSD_SV,"2025-05-18 22:02:20",578,474,322,151,1,472,2,600,126,114,358
24,IAŞI,"COLEGIUL NATIONAL DE ARTĂ ”OCTAV BĂNCILĂ”",58,"MUNICIPIUL IAŞI",95060,1,PART,PRCNCT,PRSD,PRSD_SV,"2025-05-18 21:43:22",656,462,310,109,43,452,10,700,238,161,291
24,IAŞI,"ŞCOALA GIMNAZIALĂ ”ION SIMIONESCU”",59,"MUNICIPIUL IAŞI",95060,1,PART,PRCNCT,PRSD,PRSD_SV,"2025-05-18 22:41:33",1484,924,795,128,1,911,13,1600,676,315,596
24,IAŞI,"ŞCOALA GIMNAZIALĂ ”ION SIMIONESCU”",60,"MUNICIPIUL IAŞI",95060,1,PART,PRCNCT,PRSD,PRSD_SV,"2025-05-18 22:13:29",1399,913,726,185,2,903,10,1500,587,268,635
24,IAŞI,"ŞCOALA GIMNAZIALĂ ”ION SIMIONESCU”",61,"MUNICIPIUL IAŞI",95060,1,PART,PRCNCT,PRSD,PRSD_SV,"2025-05-18 21:45:37",1488,886,786,100,0,871,15,1600,714,282,589
24,IAŞI,"ŞCOALA GIMNAZIALĂ ”ION SIMIONESCU”",62,"MUNICIPIUL IAŞI",95060,1,PART,PRCNCT,PRSD,PRSD_SV,"2025-05-18 22:10:34",1530,949,854,94,1,937,12,1700,751,322,615
24,IAŞI,"ŞCOALA GIMNAZIALĂ ”ION SIMIONESCU”",63,"MUNICIPIUL IAŞI",95060,1,PART,PRCNCT,PRSD,PRSD_SV,"2025-05-18 22:11:20",1611,963,872,91,0,954,9,1800,837,335,619
24,IAŞI,"ŞCOALA GIMNAZIALĂ ”ION SIMIONESCU”",64,"MUNICIPIUL IAŞI",95060,1,PART,PRCNCT,PRSD,PRSD_SV,"2025-05-18 21:52:38",1647,987,808,76,103,979,8,1800,813,278,701
24,IAŞI,"GRĂDINIŢA CU PROGRAM PRELUNGIT NR. 24",65,"MUNICIPIUL IAŞI",95060,1,PART,PRCNCT,PRSD,PRSD_SV,"2025-05-18 21:49:11",1175,647,599,47,1,638,9,1300,653,225,413
24,IAŞI,"GRĂDINIŢA CU PROGRAM PRELUNGIT NR. 24",66,"MUNICIPIUL IAŞI",95060,1,PART,PRCNCT,PRSD,PRSD_SV,"2025-05-18 22:17:42",1255,697,620,77,0,686,11,1300,603,242,444
24,IAŞI,"GRĂDINIŢA CU PROGRAM PRELUNGIT NR. 24",67,"MUNICIPIUL IAŞI",95060,1,PART,PRCNCT,PRSD,PRSD_SV,"2025-05-18 21:53:14",1078,596,534,62,0,587,9,1200,604,175,412
24,IAŞI,"GRĂDINIŢA CU PROGRAM PRELUNGIT NR. 24",68,"MUNICIPIUL IAŞI",95060,1,PART,PRCNCT,PRSD,PRSD_SV,"2025-05-18 23:26:17",1214,627,595,32,0,618,9,1300,673,214,404
24,IAŞI,"LICEUL TEHNOLOGIC ECONOMIC DE TURISM - CORP B",69,"MUNICIPIUL IAŞI",95060,1,PART,PRCNCT,PRSD,PRSD_SV,"2025-05-18 21:51:23",1172,686,610,76,0,678,8,1300,614,189,489
24,IAŞI,"LICEUL TEHNOLOGIC ECONOMIC DE TURISM - CORP B",70,"MUNICIPIUL IAŞI",95060,1,PART,PRCNCT,PRSD,PRSD_SV,"2025-05-18 22:22:54",1424,697,630,67,0,694,3,1600,903,291,403
24,IAŞI,"LICEUL TEHNOLOGIC ECONOMIC DE TURISM - CORP B",71,"MUNICIPIUL IAŞI",95060,1,PART,PRCNCT,PRSD,PRSD_SV,"2025-05-18 21:29:39",1117,638,570,68,0,629,9,1200,562,204,425
24,IAŞI,"LICEUL TEHNOLOGIC ECONOMIC DE TURISM - CORP B",72,"MUNICIPIUL IAŞI",95060,1,PART,PRCNCT,PRSD,PRSD_SV,"2025-05-18 21:36:41",1217,674,620,54,0,665,9,1300,626,205,460
24,IAŞI,"GRĂDINIŢA CU PROGRAM PRELUNGIT NR. 25",73,"MUNICIPIUL IAŞI",95060,1,PART,PRCNCT,PRSD,PRSD_SV,"2025-05-18 21:58:57",1472,979,861,118,0,970,9,1600,621,285,685
24,IAŞI,"GRĂDINIŢA CU PROGRAM PRELUNGIT NR. 25",74,"MUNICIPIUL IAŞI",95060,1,PART,PRCNCT,PRSD,PRSD_SV,"2025-05-18 21:48:56",1069,614,490,123,1,608,6,1200,586,200,408
24,IAŞI,"GRĂDINIŢA CU PROGRAM NORMAL NR.21",75,"MUNICIPIUL IAŞI",95060,1,PART,PRCNCT,PRSD,PRSD_SV,"2025-05-18 21:41:02",805,520,435,85,0,513,7,900,380,144,369
24,IAŞI,"GRĂDINIŢA CU PROGRAM NORMAL NR.21",76,"MUNICIPIUL IAŞI",95060,1,PART,PRCNCT,PRSD,PRSD_SV,"2025-05-18 21:53:21",709,447,368,79,0,441,6,800,353,119,322
24,IAŞI,"GRĂDINIŢA CU PROGRAM NORMAL NR.21",77,"MUNICIPIUL IAŞI",95060,1,PART,PRCNCT,PRSD,PRSD_SV,"2025-05-18 21:48:15",783,489,401,88,0,482,7,900,411,129,353
24,IAŞI,"GRĂDINIŢA CU PROGRAM NORMAL NR.21",78,"MUNICIPIUL IAŞI",95060,1,PART,PRCNCT,PRSD,PRSD_SV,"2025-05-18 21:46:28",772,495,398,97,0,488,7,800,305,146,342
24,IAŞI,"GRĂDINIŢA CU PROGRAM PRELUNGIT NR.21",79,"MUNICIPIUL IAŞI",95060,1,PART,PRCNCT,PRSD,PRSD_SV,"2025-05-18 21:48:22",985,580,507,73,0,567,13,1100,520,150,417
24,IAŞI,"GRĂDINIŢA CU PROGRAM PRELUNGIT NR.21",80,"MUNICIPIUL IAŞI",95060,1,PART,PRCNCT,PRSD,PRSD_SV,"2025-05-18 22:04:40",845,522,467,55,0,515,7,900,378,125,390
24,IAŞI,"LICEUL TEHNOLOGIC ECONOMIC ”VIRGIL MADGEARU” - CORP B",81,"MUNICIPIUL IAŞI",95060,1,PART,PRCNCT,PRSD,PRSD_SV,"2025-05-18 21:31:14",617,428,323,104,1,426,2,700,272,128,298
24,IAŞI,"LICEUL TEHNOLOGIC ECONOMIC ”VIRGIL MADGEARU” - CORP B",82,"MUNICIPIUL IAŞI",95060,1,PART,PRCNCT,PRSD,PRSD_SV,"2025-05-18 21:36:14",978,529,449,80,0,523,6,1100,571,201,322
24,IAŞI,"LICEUL TEHNOLOGIC ECONOMIC ”VIRGIL MADGEARU” - CORP B",83,"MUNICIPIUL IAŞI",95060,1,PART,PRCNCT,PRSD,PRSD_SV,"2025-05-18 21:24:05",1056,561,451,110,0,555,6,1200,639,168,387
24,IAŞI,"LICEUL TEHNOLOGIC ECONOMIC ”VIRGIL MADGEARU” - CORP B",84,"MUNICIPIUL IAŞI",95060,1,PART,PRCNCT,PRSD,PRSD_SV,"2025-05-18 21:27:54",1214,582,514,68,0,577,5,1300,718,160,417
24,IAŞI,"LICEUL TEHNOLOGIC ECONOMIC ”VIRGIL MADGEARU” - CORP B",85,"MUNICIPIUL IAŞI",95060,1,PART,PRCNCT,PRSD,PRSD_SV,"2025-05-18 21:39:26",1100,616,534,82,0,607,9,1200,584,207,400
24,IAŞI,"LICEUL TEHNOLOGIC ECONOMIC ”VIRGIL MADGEARU” - CORP B",86,"MUNICIPIUL IAŞI",95060,1,PART,PRCNCT,PRSD,PRSD_SV,"2025-05-18 21:39:42",1153,618,565,53,0,615,3,1300,682,201,414
24,IAŞI,"GRĂDINIŢA CU PROGRAM NORMAL NR. 7",87,"MUNICIPIUL IAŞI",95060,2,PART,PRCNCT,PRSD,PRSD_SV,"2025-05-19 01:36:30",780,452,316,136,0,445,7,900,448,154,291
24,IAŞI,"ŞCOALA GIMNAZIALĂ ”ALEXANDRU CEL BUN”",88,"MUNICIPIUL IAŞI",95060,1,PART,PRCNCT,PRSD,PRSD_SV,"2025-05-18 21:46:58",993,696,480,215,1,687,9,1100,404,202,485
24,IAŞI,"ŞCOALA GIMNAZIALĂ ”ALEXANDRU CEL BUN”",89,"MUNICIPIUL IAŞI",95060,1,PART,PRCNCT,PRSD,PRSD_SV,"2025-05-18 21:38:21",1163,695,640,55,0,686,9,1300,605,163,523
24,IAŞI,"ŞCOALA GIMNAZIALĂ ”ALEXANDRU CEL BUN”",90,"MUNICIPIUL IAŞI",95060,1,PART,PRCNCT,PRSD,PRSD_SV,"2025-05-18 21:51:28",1199,712,656,55,1,702,9,1300,588,181,521
24,IAŞI,"ŞCOALA GIMNAZIALĂ ”ALEXANDRU CEL BUN”",91,"MUNICIPIUL IAŞI",95060,1,PART,PRCNCT,PRSD,PRSD_SV,"2025-05-18 22:08:49",1108,569,515,54,0,557,12,1200,631,178,379
24,IAŞI,"LICEUL TEORETIC ”MIRON COSTIN”",92,"MUNICIPIUL IAŞI",95060,1,PART,PRCNCT,PRSD,PRSD_SV,"2025-05-18 22:04:27",980,604,446,158,0,597,7,1100,496,227,370
24,IAŞI,"LICEUL TEORETIC ”MIRON COSTIN”",93,"MUNICIPIUL IAŞI",95060,1,PART,PRCNCT,PRSD,PRSD_SV,"2025-05-18 22:09:51",1313,894,691,203,0,888,6,1400,505,296,592
24,IAŞI,"LICEUL TEORETIC ”MIRON COSTIN”",94,"MUNICIPIUL IAŞI",95060,1,PART,PRCNCT,PRSD,PRSD_SV,"2025-05-18 21:52:21",1131,772,654,117,1,759,13,1200,428,180,579
24,IAŞI,"LICEUL TEORETIC ”MIRON COSTIN”",95,"MUNICIPIUL IAŞI",95060,1,PART,PRCNCT,PRSD,PRSD_SV,"2025-05-18 21:21:14",1209,639,567,72,0,629,10,1300,661,214,415
24,IAŞI,"LICEUL TEORETIC ”MIRON COSTIN”",96,"MUNICIPIUL IAŞI",95060,1,PART,PRCNCT,PRSD,PRSD_SV,"2025-05-18 21:40:39",1365,765,693,72,0,759,6,1500,735,227,532
24,IAŞI,"LICEUL TEHNOLOGIC ECONOMIC DE TURISM - CORP A",97,"MUNICIPIUL IAŞI",95060,1,PART,PRCNCT,PRSD,PRSD_SV,"2025-05-18 21:46:06",898,443,416,26,1,438,5,1000,557,150,288
24,IAŞI,"LICEUL TEHNOLOGIC ECONOMIC DE TURISM - CORP A",98,"MUNICIPIUL IAŞI",95060,1,PART,PRCNCT,PRSD,PRSD_SV,"2025-05-18 22:20:10",1232,664,597,66,1,655,9,1400,736,220,435
24,IAŞI,"LICEUL TEHNOLOGIC ECONOMIC DE TURISM - CORP A",99,"MUNICIPIUL IAŞI",95060,1,PART,PRCNCT,PRSD,PRSD_SV,"2025-05-18 22:17:00",973,642,529,113,0,633,9,1100,458,172,461
24,IAŞI,"LICEUL TEHNOLOGIC ECONOMIC DE TURISM - CORP A",100,"MUNICIPIUL IAŞI",95060,1,PART,PRCNCT,PRSD,PRSD_SV,"2025-05-18 21:42:58",923,500,445,54,1,491,9,1000,500,142,349
24,IAŞI,"ŞCOALA GIMNAZIALĂ ”GEORGE COŞBUC”",101,"MUNICIPIUL IAŞI",95060,1,PART,PRCNCT,PRSD,PRSD_SV,"2025-05-18 21:25:53",978,569,527,42,0,562,7,1100,531,196,366
24,IAŞI,"ŞCOALA GIMNAZIALĂ ”GEORGE COŞBUC”",102,"MUNICIPIUL IAŞI",95060,1,PART,PRCNCT,PRSD,PRSD_SV,"2025-05-18 22:11:23",1082,637,570,67,0,620,17,1200,563,180,440
24,IAŞI,"ŞCOALA GIMNAZIALĂ ”GEORGE COŞBUC”",103,"MUNICIPIUL IAŞI",95060,1,PART,PRCNCT,PRSD,PRSD_SV,"2025-05-18 22:21:14",905,450,375,75,0,442,8,1000,550,136,306
24,IAŞI,"ŞCOALA GIMNAZIALĂ ”GEORGE COŞBUC”",104,"MUNICIPIUL IAŞI",95060,1,PART,PRCNCT,PRSD,PRSD_SV,"2025-05-18 21:47:48",1044,687,528,159,0,672,15,1100,413,207,465
24,IAŞI,"ŞCOALA GIMNAZIALĂ ”GEORGE COŞBUC”",105,"MUNICIPIUL IAŞI",95060,1,PART,PRCNCT,PRSD,PRSD_SV,"2025-05-18 21:34:57",1035,612,534,78,0,603,9,1100,488,193,410
24,IAŞI,"ŞCOALA GIMNAZIALĂ ”GEORGE COŞBUC”",106,"MUNICIPIUL IAŞI",95060,1,PART,PRCNCT,PRSD,PRSD_SV,"2025-05-18 22:17:42",1117,597,547,50,0,592,5,1200,603,214,378
24,IAŞI,"ŞCOALA GIMNAZIALĂ ”GEORGE COŞBUC”",107,"MUNICIPIUL IAŞI",95060,1,PART,PRCNCT,PRSD,PRSD_SV,"2025-05-18 22:23:51",1055,542,510,29,3,534,8,1200,658,176,358
24,IAŞI,"ŞCOALA GIMNAZIALĂ ”GEORGE COŞBUC”",108,"MUNICIPIUL IAŞI",95060,1,PART,PRCNCT,PRSD,PRSD_SV,"2025-05-18 21:32:47",949,527,497,30,0,521,6,1000,473,156,365
24,IAŞI,"ŞCOALA GIMNAZIALĂ ”GEORGE COŞBUC”",109,"MUNICIPIUL IAŞI",95060,1,PART,PRCNCT,PRSD,PRSD_SV,"2025-05-18 21:34:58",940,496,476,20,0,490,6,1000,504,153,337
24,IAŞI,"ŞCOALA GIMNAZIALĂ ”GEORGE CĂLINESCU”",110,"MUNICIPIUL IAŞI",95060,1,PART,PRCNCT,PRSD,PRSD_SV,"2025-05-18 21:51:13",1495,632,524,108,0,616,16,1600,968,214,402
24,IAŞI,"ŞCOALA GIMNAZIALĂ ”GEORGE CĂLINESCU”",111,"MUNICIPIUL IAŞI",95060,1,PART,PRCNCT,PRSD,PRSD_SV,"2025-05-18 22:01:39",1624,884,663,220,1,874,10,1800,916,229,645
24,IAŞI,"ŞCOALA GIMNAZIALĂ ”GEORGE CĂLINESCU”",112,"MUNICIPIUL IAŞI",95060,1,PART,PRCNCT,PRSD,PRSD_SV,"2025-05-18 22:01:05",1452,760,682,78,0,749,11,1600,840,205,544
24,IAŞI,"ŞCOALA GIMNAZIALĂ ”GEORGE CĂLINESCU”",113,"MUNICIPIUL IAŞI",95060,1,PART,PRCNCT,PRSD,PRSD_SV,"2025-05-18 21:21:55",1469,663,602,61,0,652,11,1600,937,159,493
24,IAŞI,"ŞCOALA GIMNAZIALĂ ”GEORGE CĂLINESCU”",114,"MUNICIPIUL IAŞI",95060,1,PART,PRCNCT,PRSD,PRSD_SV,"2025-05-18 22:18:46",1489,748,717,30,1,738,10,1600,852,200,538
24,IAŞI,"ŞCOALA GIMNAZIALĂ ”GEORGE CĂLINESCU”",115,"MUNICIPIUL IAŞI",95060,1,PART,PRCNCT,PRSD,PRSD_SV,"2025-05-18 21:54:40",1556,741,709,32,0,731,10,1700,959,227,504
24,IAŞI,"ŞCOALA GIMNAZIALĂ ”GEORGE CĂLINESCU”",116,"MUNICIPIUL IAŞI",95060,1,PART,PRCNCT,PRSD,PRSD_SV,"2025-05-18 21:46:53",1493,616,519,97,0,608,8,1600,984,155,453
24,IAŞI,"ŞCOALA GIMNAZIALĂ ”GEORGE CĂLINESCU”",117,"MUNICIPIUL IAŞI",95060,1,PART,PRCNCT,PRSD,PRSD_SV,"2025-05-18 21:26:31",1488,686,632,54,0,680,6,1600,914,207,473
24,IAŞI,"ŞCOALA GIMNAZIALĂ ”GEORGE CĂLINESCU”",118,"MUNICIPIUL IAŞI",95060,2,PART,PRCNCT,PRSD,PRSD_SV,"2025-05-18 23:19:13",1541,824,733,91,0,813,11,1700,876,247,566
24,IAŞI,"PT MIRCEA CEL BĂTRÂN",119,"MUNICIPIUL IAŞI",95060,1,PART,PRCNCT,PRSD,PRSD_SV,"2025-05-18 21:40:17",1346,638,579,56,3,633,5,1500,862,280,353
24,IAŞI,"PT MIRCEA CEL BĂTRÂN",120,"MUNICIPIUL IAŞI",95060,1,PART,PRCNCT,PRSD,PRSD_SV,"2025-05-18 21:19:44",1054,484,423,60,1,482,2,1200,716,186,296
24,IAŞI,"ŞCOALA GIMNAZIALĂ ”CARMEN SYLVA”",121,"MUNICIPIUL IAŞI",95060,1,PART,PRCNCT,PRSD,PRSD_SV,"2025-05-18 22:16:19",1218,828,624,204,0,816,12,1300,472,183,633
24,IAŞI,"ŞCOALA GIMNAZIALĂ ”CARMEN SYLVA”",122,"MUNICIPIUL IAŞI",95060,1,PART,PRCNCT,PRSD,PRSD_SV,"2025-05-18 22:00:38",928,864,498,354,12,853,11,1000,136,182,671
24,IAŞI,"ŞCOALA GIMNAZIALĂ ”CALISTRAT HOGAŞ”",123,"MUNICIPIUL IAŞI",95060,1,PART,PRCNCT,PRSD,PRSD_SV,"2025-05-18 22:06:46",1017,592,564,26,2,585,7,1100,508,151,434
24,IAŞI,"ŞCOALA GIMNAZIALĂ ”CALISTRAT HOGAŞ”",124,"MUNICIPIUL IAŞI",95060,1,PART,PRCNCT,PRSD,PRSD_SV,"2025-05-18 21:39:18",1161,135,60,75,0,135,0,1300,1165,27,108
24,IAŞI,"ŞCOALA GIMNAZIALĂ ”CALISTRAT HOGAŞ”",125,"MUNICIPIUL IAŞI",95060,1,PART,PRCNCT,PRSD,PRSD_SV,"2025-05-18 22:49:14",983,566,490,76,0,561,5,1100,534,120,441
24,IAŞI,"ŞCOALA GIMNAZIALĂ ”CALISTRAT HOGAŞ”",126,"MUNICIPIUL IAŞI",95060,1,PART,PRCNCT,PRSD,PRSD_SV,"2025-05-18 21:48:54",1021,417,376,41,0,409,8,1100,683,164,245
24,IAŞI,"ŞCOALA GIMNAZIALĂ ”CALISTRAT HOGAŞ”",127,"MUNICIPIUL IAŞI",95060,1,PART,PRCNCT,PRSD,PRSD_SV,"2025-05-18 22:08:52",973,529,490,39,0,519,10,1100,571,200,319
24,IAŞI,"ŞCOALA GIMNAZIALĂ ”CALISTRAT HOGAŞ”",128,"MUNICIPIUL IAŞI",95060,1,PART,PRCNCT,PRSD,PRSD_SV,"2025-05-18 21:26:14",676,206,195,11,0,203,3,700,494,80,123
24,IAŞI,"ŞCOALA PRIMARĂ ”COSTACHE NEGRI”",129,"MUNICIPIUL IAŞI",95060,1,PART,PRCNCT,PRSD,PRSD_SV,"2025-05-18 21:36:30",1696,896,840,54,2,886,10,1900,1004,204,682
24,IAŞI,"ŞCOALA PRIMARĂ ”COSTACHE NEGRI”",130,"MUNICIPIUL IAŞI",95060,1,PART,PRCNCT,PRSD,PRSD_SV,"2025-05-18 21:55:30",1682,680,390,290,0,669,11,1800,1120,149,520
24,IAŞI,"ŞCOALA GIMNAZIALĂ ”BOGDAN PETRICEICU HAŞDEU”",131,"MUNICIPIUL IAŞI",95060,1,PART,PRCNCT,PRSD,PRSD_SV,"2025-05-18 21:51:30",1277,893,642,248,3,885,8,1400,507,245,640
24,IAŞI,"ŞCOALA GIMNAZIALĂ ”BOGDAN PETRICEICU HAŞDEU”",132,"MUNICIPIUL IAŞI",95060,1,PART,PRCNCT,PRSD,PRSD_SV,"2025-05-18 22:03:58",933,471,213,231,27,465,6,1000,529,141,324
24,IAŞI,"ŞCOALA GIMNAZIALĂ ”BOGDAN PETRICEICU HAŞDEU”",133,"MUNICIPIUL IAŞI",95060,1,PART,PRCNCT,PRSD,PRSD_SV,"2025-05-18 21:34:34",1158,642,511,131,0,638,4,1300,658,206,432
24,IAŞI,"ŞCOALA GIMNAZIALĂ ”BOGDAN PETRICEICU HAŞDEU”",134,"MUNICIPIUL IAŞI",95060,1,PART,PRCNCT,PRSD,PRSD_SV,"2025-05-18 21:48:49",1469,962,726,130,106,954,8,1600,638,242,712
24,IAŞI,"LICEUL TEORETIC ”ALEXANDRU IOAN CUZA”",135,"MUNICIPIUL IAŞI",95060,1,PART,PRCNCT,PRSD,PRSD_SV,"2025-05-18 22:14:42",1366,430,308,122,0,418,12,1500,1070,114,304
24,IAŞI,"LICEUL TEORETIC ”ALEXANDRU IOAN CUZA”",136,"MUNICIPIUL IAŞI",95060,1,PART,PRCNCT,PRSD,PRSD_SV,"2025-05-18 21:24:44",1485,257,206,51,0,249,8,1600,1343,60,189
24,IAŞI,"LICEUL TEORETIC ”ALEXANDRU IOAN CUZA”",137,"MUNICIPIUL IAŞI",95060,1,PART,PRCNCT,PRSD,PRSD_SV,"2025-05-18 21:21:11",1437,297,252,45,0,296,1,1600,1303,62,234
24,IAŞI,"LICEUL TEORETIC ”ALEXANDRU IOAN CUZA”",138,"MUNICIPIUL IAŞI",95060,1,PART,PRCNCT,PRSD,PRSD_SV,"2025-05-18 21:45:46",1521,284,264,20,0,283,1,1700,1416,59,224
24,IAŞI,"LICEUL TEORETIC ”ALEXANDRU IOAN CUZA”",139,"MUNICIPIUL IAŞI",95060,1,PART,PRCNCT,PRSD,PRSD_SV,"2025-05-18 21:35:19",1407,292,265,27,0,290,2,1500,1208,110,180
24,IAŞI,"LICEUL TEORETIC ”ALEXANDRU IOAN CUZA”",140,"MUNICIPIUL IAŞI",95060,1,PART,PRCNCT,PRSD,PRSD_SV,"2025-05-18 21:31:16",1361,368,339,29,0,365,3,1500,1132,85,280
24,IAŞI,"LICEUL TEORETIC ”ALEXANDRU IOAN CUZA”",141,"MUNICIPIUL IAŞI",95060,1,PART,PRCNCT,PRSD,PRSD_SV,"2025-05-18 22:06:28",1199,601,574,27,0,594,7,1300,699,171,423
24,IAŞI,"ŞCOALA PRIMARA ”COSTACHE CONACHI”",142,"MUNICIPIUL IAŞI",95060,1,PART,PRCNCT,PRSD,PRSD_SV,"2025-05-18 21:36:58",1125,775,556,218,1,766,9,1200,425,164,602
24,IAŞI,"ŞCOALA PRIMARA ”COSTACHE CONACHI”",143,"MUNICIPIUL IAŞI",95060,1,PART,PRCNCT,PRSD,PRSD_SV,"2025-05-18 21:51:09",1776,1156,934,222,0,1138,18,1900,744,338,800
24,IAŞI,"ŞCOALA PRIMARA ”COSTACHE CONACHI”",144,"MUNICIPIUL IAŞI",95060,2,PART,PRCNCT,PRSD,PRSD_SV,"2025-05-19 00:58:53",1650,984,788,196,0,977,7,1800,816,286,691
24,IAŞI,"ŞCOALA PRIMARA ”COSTACHE CONACHI”",145,"MUNICIPIUL IAŞI",95060,1,PART,PRCNCT,PRSD,PRSD_SV,"2025-05-18 21:24:37",1319,812,627,181,4,796,16,1500,688,235,561
24,IAŞI,"ŞCOALA PRIMARA ”COSTACHE CONACHI”",146,"MUNICIPIUL IAŞI",95060,1,PART,PRCNCT,PRSD,PRSD_SV,"2025-05-18 21:41:04",1242,652,472,180,0,643,9,1400,748,171,472
24,IAŞI,"DIRECTIA JUDETEANA PENTRU SPORT SI TINERET - COMPLEX SPORTIV GRADINARI",147,"MUNICIPIUL IAŞI",95060,1,PART,PRCNCT,PRSD,PRSD_SV,"2025-05-18 22:08:45",1550,923,537,386,0,918,5,1700,777,251,667
24,IAŞI,"DIRECTIA JUDETEANA PENTRU SPORT SI TINERET - COMPLEX SPORTIV GRADINARI",148,"MUNICIPIUL IAŞI",95060,1,PART,PRCNCT,PRSD,PRSD_SV,"2025-05-18 22:05:51",1240,894,615,264,15,885,9,1400,506,217,668
24,IAŞI,"DIRECTIA JUDETEANA PENTRU SPORT SI TINERET - COMPLEX SPORTIV GRADINARI",149,"MUNICIPIUL IAŞI",95060,1,PART,PRCNCT,PRSD,PRSD_SV,"2025-05-18 22:07:15",1834,1000,750,250,0,987,13,2000,1000,287,700
24,IAŞI,"DIRECTIA JUDETEANA PENTRU SPORT SI TINERET - COMPLEX SPORTIV GRADINARI",150,"MUNICIPIUL IAŞI",95060,1,PART,PRCNCT,PRSD,PRSD_SV,"2025-05-18 21:36:33",1401,915,706,209,0,905,10,1500,585,229,676
24,IAŞI,"DIRECTIA JUDETEANA PENTRU SPORT SI TINERET - COMPLEX SPORTIV GRADINARI",151,"MUNICIPIUL IAŞI",95060,1,PART,PRCNCT,PRSD,PRSD_SV,"2025-05-18 22:15:24",1324,730,585,145,0,725,5,1500,770,228,497
24,IAŞI,"DIRECTIA JUDETEANA PENTRU SPORT SI TINERET - COMPLEX SPORTIV GRADINARI",152,"MUNICIPIUL IAŞI",95060,1,PART,PRCNCT,PRSD,PRSD_SV,"2025-05-18 21:56:24",1484,1372,699,673,0,1354,18,2600,1228,344,1010
24,IAŞI,"ŞCOALA GIMNAZIALĂ ”IONEL TEODOREANU”",153,"MUNICIPIUL IAŞI",95060,1,PART,PRCNCT,PRSD,PRSD_SV,"2025-05-18 22:02:34",1483,810,703,107,0,800,10,1600,790,198,602
24,IAŞI,"ŞCOALA GIMNAZIALĂ ”IONEL TEODOREANU”",154,"MUNICIPIUL IAŞI",95060,1,PART,PRCNCT,PRSD,PRSD_SV,"2025-05-18 22:02:15",1360,840,646,194,0,830,10,1500,660,221,609
24,IAŞI,"ŞCOALA GIMNAZIALĂ ”IONEL TEODOREANU”",155,"MUNICIPIUL IAŞI",95060,1,PART,PRCNCT,PRSD,PRSD_SV,"2025-05-18 21:44:17",1335,766,607,159,0,758,8,1500,734,243,515
24,IAŞI,"ŞCOALA GIMNAZIALĂ ”IONEL TEODOREANU”",156,"MUNICIPIUL IAŞI",95060,1,PART,PRCNCT,PRSD,PRSD_SV,"2025-05-18 21:36:29",1428,730,611,119,0,718,12,1600,870,231,487
24,IAŞI,"ŞCOALA GIMNAZIALĂ ”IONEL TEODOREANU”",157,"MUNICIPIUL IAŞI",95060,1,PART,PRCNCT,PRSD,PRSD_SV,"2025-05-18 21:38:30",1584,391,97,294,0,389,2,1700,1309,72,317
24,IAŞI,"ŞCOALA GIMNAZIALĂ ”GHEORGHE I. BRĂTIANU”",158,"MUNICIPIUL IAŞI",95060,2,PART,PRCNCT,PRSD,PRSD_SV,"2025-05-19 02:26:08",1553,764,744,19,1,759,5,1700,936,228,531
24,IAŞI,"ŞCOALA GIMNAZIALĂ ”GHEORGHE I. BRĂTIANU”",159,"MUNICIPIUL IAŞI",95060,1,PART,PRCNCT,PRSD,PRSD_SV,"2025-05-18 21:47:06",1503,756,573,178,5,747,9,1700,944,184,563
24,IAŞI,"ŞCOALA GIMNAZIALĂ ”GHEORGHE I. BRĂTIANU”",160,"MUNICIPIUL IAŞI",95060,1,PART,PRCNCT,PRSD,PRSD_SV,"2025-05-18 21:29:25",1420,264,10,254,0,262,2,1600,1336,52,210
24,IAŞI,"ŞCOALA GIMNAZIALĂ ”GHEORGHE I. BRĂTIANU”",161,"MUNICIPIUL IAŞI",95060,1,PART,PRCNCT,PRSD,PRSD_SV,"2025-05-18 22:00:01",1443,445,375,70,0,443,2,1600,1155,78,365
24,IAŞI,"ŞCOALA GIMNAZIALĂ ”GHEORGHE I. BRĂTIANU”",162,"MUNICIPIUL IAŞI",95060,1,PART,PRCNCT,PRSD,PRSD_SV,"2025-05-18 21:32:19",1575,379,358,21,0,378,1,1700,1321,68,310
24,IAŞI,"ŞCOALA GIMNAZIALĂ ”GHEORGHE I. BRĂTIANU”",163,"MUNICIPIUL IAŞI",95060,1,PART,PRCNCT,PRSD,PRSD_SV,"2025-05-18 21:43:00",1604,637,587,49,1,624,13,1800,1162,172,452
24,IAŞI,"ŞCOALA GIMNAZIALĂ ”GHEORGHE I. BRĂTIANU”",164,"MUNICIPIUL IAŞI",95060,1,PART,PRCNCT,PRSD,PRSD_SV,"2025-05-18 21:28:13",1607,469,445,24,0,461,8,1800,1331,81,380
24,IAŞI,"UNIVERSITATEA TEHNICĂ ”GHEORGHE ASACHI”",165,"MUNICIPIUL IAŞI",95060,1,PART,PRCNCT,PRSD,PRSD_SV,"2025-05-19 00:23:50",1114,1963,407,1553,3,1949,14,3000,1037,367,1582
24,IAŞI,"UNIVERSITATEA TEHNICĂ ”GHEORGHE ASACHI”",166,"MUNICIPIUL IAŞI",95060,1,PART,PRCNCT,PRSD,PRSD_SV,"2025-05-18 22:21:02",947,722,493,227,2,715,7,1000,278,143,572
24,IAŞI,"UNIVERSITATEA TEHNICĂ ”GHEORGHE ASACHI”",167,"MUNICIPIUL IAŞI",95060,1,PART,PRCNCT,PRSD,PRSD_SV,"2025-05-18 21:54:53",1028,669,516,148,5,667,2,1900,1231,143,524
24,IAŞI,"UNIVERSITATEA TEHNICĂ ”GHEORGHE ASACHI”",168,"MUNICIPIUL IAŞI",95060,1,PART,PRCNCT,PRSD,PRSD_SV,"2025-05-18 21:27:32",1052,708,569,137,2,699,9,1200,492,168,531
24,IAŞI,"ŞCOALA GIMNAZIALĂ ”ION GHICA”",169,"MUNICIPIUL IAŞI",95060,1,PART,PRCNCT,PRSD,PRSD_SV,"2025-05-18 22:20:57",1327,750,635,115,0,743,7,1500,750,212,531
24,IAŞI,"ŞCOALA GIMNAZIALĂ ”ION GHICA”",170,"MUNICIPIUL IAŞI",95060,1,PART,PRCNCT,PRSD,PRSD_SV,"2025-05-18 22:19:35",513,527,263,264,0,515,12,800,273,104,411
24,IAŞI,"ŞCOALA GIMNAZIALĂ ”ION GHICA”",171,"MUNICIPIUL IAŞI",95060,1,PART,PRCNCT,PRSD,PRSD_SV,"2025-05-18 21:33:48",615,446,315,131,0,440,6,700,254,122,318
24,IAŞI,"LICEUL TEHNOLOGIC DE MECATRONICA SI AUTOMATIZARI",172,"MUNICIPIUL IAŞI",95060,1,PART,PRCNCT,PRSD,PRSD_SV,"2025-05-18 21:54:25",1522,300,251,49,0,299,1,1700,1400,131,168
24,IAŞI,"LICEUL TEHNOLOGIC DE MECATRONICA SI AUTOMATIZARI",173,"MUNICIPIUL IAŞI",95060,1,PART,PRCNCT,PRSD,PRSD_SV,"2025-05-18 21:28:15",1332,93,34,59,0,91,2,800,707,34,57
24,IAŞI,"LICEUL TEHNOLOGIC DE MECATRONICA SI AUTOMATIZARI",174,"MUNICIPIUL IAŞI",95060,1,PART,PRCNCT,PRSD,PRSD_SV,"2025-05-18 21:43:03",1444,453,407,46,0,451,2,1600,1147,162,289
24,IAŞI,"LICEUL TEHNOLOGIC DE MECATRONICA SI AUTOMATIZARI",175,"MUNICIPIUL IAŞI",95060,1,PART,PRCNCT,PRSD,PRSD_SV,"2025-05-18 21:36:39",1608,333,252,80,1,330,3,1800,1467,133,197
24,IAŞI,"LICEUL TEHNOLOGIC DE MECATRONICA SI AUTOMATIZARI",176,"MUNICIPIUL IAŞI",95060,1,PART,PRCNCT,PRSD,PRSD_SV,"2025-05-18 21:30:25",1503,381,329,52,0,374,7,1600,1219,135,239
24,IAŞI,"COLEGIUL TEHNIC ”IOAN C.ŞTEFĂNESCU”",177,"MUNICIPIUL IAŞI",95060,1,PART,PRCNCT,PRSD,PRSD_SV,"2025-05-18 21:52:28",1372,566,403,162,1,558,8,1500,934,174,384
24,IAŞI,"COLEGIUL TEHNIC ”IOAN C.ŞTEFĂNESCU”",178,"MUNICIPIUL IAŞI",95060,1,PART,PRCNCT,PRSD,PRSD_SV,"2025-05-18 22:10:33",1614,460,306,154,0,458,2,1800,1340,192,266
24,IAŞI,"COLEGIUL TEHNIC ”IOAN C.ŞTEFĂNESCU”",179,"MUNICIPIUL IAŞI",95060,2,PART,PRCNCT,PRSD,PRSD_SV,"2025-05-18 22:22:26",1059,498,346,151,1,493,5,1200,702,192,301
24,IAŞI,"LICEUL TEHNOLOGIC ”PETRU PONI”",180,"MUNICIPIUL IAŞI",95060,1,PART,PRCNCT,PRSD,PRSD_SV,"2025-05-18 21:46:22",922,652,397,255,0,644,8,1000,348,243,401
24,IAŞI,"LICEUL TEHNOLOGIC ”PETRU PONI”",181,"MUNICIPIUL IAŞI",95060,1,PART,PRCNCT,PRSD,PRSD_SV,"2025-05-18 22:07:53",857,614,394,220,0,605,9,900,286,198,407
24,IAŞI,"LICEUL TEHNOLOGIC ”PETRU PONI”",182,"MUNICIPIUL IAŞI",95060,1,PART,PRCNCT,PRSD,PRSD_SV,"2025-05-18 21:54:38",754,553,340,188,25,549,4,800,247,176,373
24,IAŞI,"LICEUL TEHNOLOGIC ”PETRU PONI”",183,"MUNICIPIUL IAŞI",95060,1,PART,PRCNCT,PRSD,PRSD_SV,"2025-05-18 22:19:14",920,956,439,517,0,946,10,1400,441,193,753
24,IAŞI,"COLEGIUL TEHNIC ELECTRONICĂ ŞI TELECOMUNICAŢII ”GHEORGHE MÂRZESCU”",184,"MUNICIPIUL IAŞI",95060,1,PART,PRCNCT,PRSD,PRSD_SV,"2025-05-18 21:38:37",1282,839,617,222,0,830,9,1400,561,243,587
24,IAŞI,"COLEGIUL TEHNIC ELECTRONICĂ ŞI TELECOMUNICAŢII ”GHEORGHE MÂRZESCU”",185,"MUNICIPIUL IAŞI",95060,2,PART,PRCNCT,PRSD,PRSD_SV,"2025-05-19 00:40:36",1583,550,409,141,0,544,6,1700,1150,271,273
24,IAŞI,"GRĂDINIŢA CU PROGRAM NORMAL NR. 26",186,"MUNICIPIUL IAŞI",95060,2,PART,PRCNCT,PRSD,PRSD_SV,"2025-05-19 01:01:08",1412,428,288,140,0,425,3,1500,1072,93,332
24,IAŞI,"GRĂDINIŢA CU PROGRAM PRELUNGIT NR. 1 ”CENTENAR”-CORP B ”SFÂNTA MARIA”",187,"MUNICIPIUL IAŞI",95060,1,PART,PRCNCT,PRSD,PRSD_SV,"2025-05-18 22:25:51",1684,1108,915,191,2,1094,14,1900,792,277,817
24,IAŞI,"GRĂDINIŢA CU PROGRAM PRELUNGIT NR. 1 ”CENTENAR”-CORP B ”SFÂNTA MARIA”",188,"MUNICIPIUL IAŞI",95060,1,PART,PRCNCT,PRSD,PRSD_SV,"2025-05-18 21:46:49",1492,910,766,144,0,902,8,1600,690,269,633
24,IAŞI,"ŞCOALA GIMNAZIALĂ ”NICOLAE IORGA”",189,"MUNICIPIUL IAŞI",95060,1,PART,PRCNCT,PRSD,PRSD_SV,"2025-05-18 21:37:42",1640,632,400,232,0,626,6,1800,1168,169,457
24,IAŞI,"ŞCOALA GIMNAZIALĂ ”NICOLAE IORGA”",190,"MUNICIPIUL IAŞI",95060,1,PART,PRCNCT,PRSD,PRSD_SV,"2025-05-18 21:48:08",1684,397,265,131,1,394,3,1800,1403,97,297
24,IAŞI,"ŞCOALA GIMNAZIALĂ ”NICOLAE IORGA”",191,"MUNICIPIUL IAŞI",95060,1,PART,PRCNCT,PRSD,PRSD_SV,"2025-05-18 22:44:44",1701,627,500,126,1,622,5,1900,1273,189,433
24,IAŞI,"ŞCOALA GIMNAZIALĂ ”NICOLAE IORGA”",192,"MUNICIPIUL IAŞI",95060,1,PART,PRCNCT,PRSD,PRSD_SV,"2025-05-18 21:59:30",1726,593,546,47,0,586,7,1900,1307,177,409
24,IAŞI,"ŞCOALA GIMNAZIALĂ ”NICOLAE IORGA”",193,"MUNICIPIUL IAŞI",95060,1,PART,PRCNCT,PRSD,PRSD_SV,"2025-05-18 21:47:50",1702,468,438,30,0,460,8,1900,1432,130,330
24,IAŞI,"ŞCOALA GIMNAZIALĂ ”NICOLAE IORGA”",194,"MUNICIPIUL IAŞI",95060,1,PART,PRCNCT,PRSD,PRSD_SV,"2025-05-18 22:02:09",1783,459,430,29,0,452,7,2000,1541,112,340
24,IAŞI,"ŞCOALA GIMNAZIALĂ ”NICOLAE IORGA”",195,"MUNICIPIUL IAŞI",95060,1,PART,PRCNCT,PRSD,PRSD_SV,"2025-05-18 22:10:56",1715,525,466,33,26,514,11,1900,1375,162,352
24,IAŞI,"ŞCOALA GIMNAZIALĂ ”NICOLAE IORGA”",196,"MUNICIPIUL IAŞI",95060,1,PART,PRCNCT,PRSD,PRSD_SV,"2025-05-18 21:47:37",1649,305,283,22,0,298,7,1800,1495,93,205
24,IAŞI,"ŞCOALA GIMNAZIALĂ ”NICOLAE IORGA”",197,"MUNICIPIUL IAŞI",95060,1,PART,PRCNCT,PRSD,PRSD_SV,"2025-05-18 21:48:55",1607,758,715,41,2,754,4,1800,1042,186,568
24,IAŞI,"ŞCOALA GIMNAZIALĂ ”VERONICA MICLE”",198,"MUNICIPIUL IAŞI",95060,1,PART,PRCNCT,PRSD,PRSD_SV,"2025-05-18 22:04:34",1699,1385,1051,302,32,1369,16,1900,515,421,948
24,IAŞI,"ŞCOALA GIMNAZIALĂ ”VERONICA MICLE”",199,"MUNICIPIUL IAŞI",95060,1,PART,PRCNCT,PRSD,PRSD_SV,"2025-05-18 21:38:20",1689,1172,973,199,0,1161,11,1900,728,325,836
24,IAŞI,"ŞCOALA GIMNAZIALĂ ”VERONICA MICLE”",200,"MUNICIPIUL IAŞI",95060,1,PART,PRCNCT,PRSD,PRSD_SV,"2025-05-18 22:32:45",1723,1149,1054,94,1,1138,11,1900,751,291,847
24,IAŞI,"ŞCOALA GIMNAZIALĂ ”VERONICA MICLE”",201,"MUNICIPIUL IAŞI",95060,1,PART,PRCNCT,PRSD,PRSD_SV,"2025-05-18 22:54:42",1832,1183,1080,103,0,1174,9,2000,817,285,889
24,IAŞI,"ŞCOALA GIMNAZIALĂ ”VERONICA MICLE”",202,"MUNICIPIUL IAŞI",95060,1,PART,PRCNCT,PRSD,PRSD_SV,"2025-05-19 00:02:24",1692,1218,1036,138,44,1214,4,1900,682,259,955
24,IAŞI,"CENTRUL DE CARTIER FRUMOASA",203,"MUNICIPIUL IAŞI",95060,1,PART,PRCNCT,PRSD,PRSD_SV,"2025-05-18 22:11:17",1280,919,788,131,0,914,5,1400,481,252,662
24,IAŞI,"ŞCOALA GIMNAZIALĂ ”DIMITRIE A. STURDZA”",204,"MUNICIPIUL IAŞI",95060,1,PART,PRCNCT,PRSD,PRSD_SV,"2025-05-18 21:30:03",958,495,429,65,1,489,6,1100,605,221,268
24,IAŞI,"ŞCOALA GIMNAZIALĂ ”DIMITRIE A. STURDZA”",205,"MUNICIPIUL IAŞI",95060,1,PART,PRCNCT,PRSD,PRSD_SV,"2025-05-18 21:41:18",882,468,377,91,0,460,8,1000,532,192,268
24,IAŞI,"ŞCOALA GIMNAZIALĂ ”DIMITRIE A. STURDZA”",206,"MUNICIPIUL IAŞI",95060,1,PART,PRCNCT,PRSD,PRSD_SV,"2025-05-18 21:21:43",679,372,202,66,104,365,7,700,328,189,176
24,IAŞI,"ŞCOALA GIMNAZIALĂ ”DIMITRIE A. STURDZA”",207,"MUNICIPIUL IAŞI",95060,1,PART,PRCNCT,PRSD,PRSD_SV,"2025-05-18 21:23:43",1438,600,548,52,0,595,5,1600,1000,217,378
24,IAŞI,"ŞCOALA GIMNAZIALĂ ”DIMITRIE A. STURDZA”",208,"MUNICIPIUL IAŞI",95060,1,PART,PRCNCT,PRSD,PRSD_SV,"2025-05-18 21:51:00",960,445,386,59,0,435,10,1100,655,173,262
24,IAŞI,"ŞCOALA GIMNAZIALĂ ”DIMITRIE A.STURDZA”",209,"MUNICIPIUL IAŞI",95060,1,PART,PRCNCT,PRSD,PRSD_SV,"2025-05-18 21:41:21",809,507,442,65,0,501,6,900,393,146,355
24,IAŞI,"ŞCOALA GIMNAZIALĂ ”DIMITRIE A.STURDZA”",210,"MUNICIPIUL IAŞI",95060,1,PART,PRCNCT,PRSD,PRSD_SV,"2025-05-18 21:30:42",967,544,467,77,0,536,8,1100,556,184,352
24,IAŞI,"ŞCOALA GIMNAZIALĂ ”DIMITRIE A.STURDZA”",211,"MUNICIPIUL IAŞI",95060,1,PART,PRCNCT,PRSD,PRSD_SV,"2025-05-18 22:33:44",1168,659,607,51,1,653,6,1300,641,209,444
24,IAŞI,"ŞCOALA GIMNAZIALĂ ”DIMITRIE A.STURDZA”",212,"MUNICIPIUL IAŞI",95060,1,PART,PRCNCT,PRSD,PRSD_SV,"2025-05-18 21:41:44",1372,790,725,65,0,778,12,1500,710,256,522
24,IAŞI,"ŞCOALA GIMNAZIALĂ ”ALECU RUSSO”",213,"MUNICIPIUL IAŞI",95060,1,PART,PRCNCT,PRSD,PRSD_SV,"2025-05-18 21:39:18",1026,601,526,75,0,591,10,1100,499,169,422
24,IAŞI,"ŞCOALA GIMNAZIALĂ ”ALECU RUSSO”",214,"MUNICIPIUL IAŞI",95060,1,PART,PRCNCT,PRSD,PRSD_SV,"2025-05-18 21:37:06",1124,678,604,74,0,668,10,1200,522,239,429
24,IAŞI,"ŞCOALA GIMNAZIALĂ ”ALECU RUSSO”",215,"MUNICIPIUL IAŞI",95060,1,PART,PRCNCT,PRSD,PRSD_SV,"2025-05-18 21:44:13",1249,647,574,72,1,641,6,1400,753,191,450
24,IAŞI,"ŞCOALA GIMNAZIALĂ ”ALECU RUSSO”",216,"MUNICIPIUL IAŞI",95060,1,PART,PRCNCT,PRSD,PRSD_SV,"2025-05-18 21:47:36",1178,678,601,76,1,675,3,1300,622,196,479
24,IAŞI,"ŞCOALA GIMNAZIALĂ ”ALECU RUSSO”",217,"MUNICIPIUL IAŞI",95060,1,PART,PRCNCT,PRSD,PRSD_SV,"2025-05-18 21:44:39",1059,478,357,120,1,478,0,1200,722,148,330
24,IAŞI,"ŞCOALA GIMNAZIALĂ ” ALECU RUSSO”",218,"MUNICIPIUL IAŞI",95060,1,PART,PRCNCT,PRSD,PRSD_SV,"2025-05-18 21:48:42",952,562,485,77,0,547,15,1000,438,151,396
24,IAŞI,"ŞCOALA PRIMARA ”GHEORGHE GHIBANESCU”",219,"MUNICIPIUL IAŞI",95060,1,PART,PRCNCT,PRSD,PRSD_SV,"2025-05-18 21:57:35",1063,732,532,200,0,724,8,1200,468,221,503
24,IAŞI,"ŞCOALA PRIMARA ”GHEORGHE GHIBANESCU”",220,"MUNICIPIUL IAŞI",95060,1,PART,PRCNCT,PRSD,PRSD_SV,"2025-05-18 21:37:31",1101,707,576,131,0,694,13,1200,493,188,506
24,IAŞI,"ŞCOALA PRIMARA ”GHEORGHE GHIBANESCU”",221,"MUNICIPIUL IAŞI",95060,1,PART,PRCNCT,PRSD,PRSD_SV,"2025-05-18 21:56:34",1058,638,574,64,0,625,13,1200,562,144,481
24,IAŞI,"ŞCOALA PRIMARA ”GHEORGHE GHIBANESCU”",222,"MUNICIPIUL IAŞI",95060,1,PART,PRCNCT,PRSD,PRSD_SV,"2025-05-18 21:21:25",1185,657,621,35,1,651,6,1300,643,173,478
24,IAŞI,"ŞCOALA PRIMARA ”GHEORGHE GHIBANESCU”",223,"MUNICIPIUL IAŞI",95060,1,PART,PRCNCT,PRSD,PRSD_SV,"2025-05-18 21:36:27",1116,626,581,45,0,616,10,1200,574,187,429
24,IAŞI,"GRĂDINIŢA CU PROGRAM PRELUNGIT NR.1",224,"MUNICIPIUL IAŞI",95060,1,PART,PRCNCT,PRSD,PRSD_SV,"2025-05-18 21:37:00",772,576,404,172,0,568,8,800,224,146,422
24,IAŞI,"GRĂDINIŢA CU PROGRAM PRELUNGIT NR.1",225,"MUNICIPIUL IAŞI",95060,1,PART,PRCNCT,PRSD,PRSD_SV,"2025-05-18 21:56:44",946,669,509,160,0,664,5,1000,331,172,492
24,IAŞI,"ŞCOALA GIMNAZIALĂ ”OTILIA CAZIMIR”",226,"MUNICIPIUL IAŞI",95060,1,PART,PRCNCT,PRSD,PRSD_SV,"2025-05-18 21:42:26",1050,663,494,169,0,658,5,1200,537,173,485
24,IAŞI,"ŞCOALA GIMNAZIALĂ ”OTILIA CAZIMIR”",227,"MUNICIPIUL IAŞI",95060,1,PART,PRCNCT,PRSD,PRSD_SV,"2025-05-18 21:47:40",1230,806,660,146,0,799,7,1400,594,184,615
24,IAŞI,"ŞCOALA GIMNAZIALĂ ”OTILIA CAZIMIR”",228,"MUNICIPIUL IAŞI",95060,1,PART,PRCNCT,PRSD,PRSD_SV,"2025-05-18 21:33:33",1023,612,458,154,0,602,10,1100,488,174,428
24,IAŞI,"ŞCOALA GIMNAZIALĂ ”OTILIA CAZIMIR”",229,"MUNICIPIUL IAŞI",95060,1,PART,PRCNCT,PRSD,PRSD_SV,"2025-05-18 21:54:34",1172,736,587,145,4,726,10,1300,564,172,554
24,IAŞI,"COLEGIUL NAŢIONAL ”EMIL RACOVIŢĂ”",230,"MUNICIPIUL IAŞI",95060,1,PART,PRCNCT,PRSD,PRSD_SV,"2025-05-18 21:39:52",1657,214,114,99,1,210,4,1400,1186,65,145
24,IAŞI,"COLEGIUL NAŢIONAL ”EMIL RACOVIŢĂ”",231,"MUNICIPIUL IAŞI",95060,1,PART,PRCNCT,PRSD,PRSD_SV,"2025-05-18 21:33:13",1667,182,138,44,0,180,2,1400,1218,60,120
24,IAŞI,"COLEGIUL NAŢIONAL ”EMIL RACOVIŢĂ”",232,"MUNICIPIUL IAŞI",95060,1,PART,PRCNCT,PRSD,PRSD_SV,"2025-05-18 21:36:14",1436,504,479,23,2,493,11,1600,1096,144,349
24,IAŞI,"COLEGIUL NAŢIONAL ”EMIL RACOVIŢĂ”",233,"MUNICIPIUL IAŞI",95060,1,PART,PRCNCT,PRSD,PRSD_SV,"2025-05-18 21:26:40",1570,303,247,55,1,297,6,1700,1397,83,214
24,IAŞI,"COLEGIUL NAŢIONAL ”EMIL RACOVIŢĂ”",234,"MUNICIPIUL IAŞI",95060,1,PART,PRCNCT,PRSD,PRSD_SV,"2025-05-18 21:46:09",1575,412,225,187,0,404,8,1700,1288,95,309
24,IAŞI,"COLEGIUL NAŢIONAL ”EMIL RACOVIŢĂ”",235,"MUNICIPIUL IAŞI",95060,1,PART,PRCNCT,PRSD,PRSD_SV,"2025-05-18 21:35:13",1567,213,112,101,0,212,1,1700,1487,54,158
24,IAŞI,"COLEGIUL NAŢIONAL ”EMIL RACOVIŢĂ”",236,"MUNICIPIUL IAŞI",95060,1,PART,PRCNCT,PRSD,PRSD_SV,"2025-05-18 21:39:18",975,416,297,119,0,406,10,1100,684,105,301
24,IAŞI,"COLEGIUL NAŢIONAL ”EMIL RACOVIŢĂ”",237,"MUNICIPIUL IAŞI",95060,1,PART,PRCNCT,PRSD,PRSD_SV,"2025-05-18 21:58:03",1424,274,185,89,0,271,3,1600,1326,57,214
24,IAŞI,"COLEGIUL NAŢIONAL ”EMIL RACOVIŢĂ”",238,"MUNICIPIUL IAŞI",95060,2,PART,PRCNCT,PRSD,PRSD_SV,"2025-05-19 01:32:41",1405,171,124,47,0,166,5,1100,929,40,126
24,IAŞI,"COLEGIUL NAŢIONAL ”EMIL RACOVIŢĂ”",239,"MUNICIPIUL IAŞI",95060,1,PART,PRCNCT,PRSD,PRSD_SV,"2025-05-18 21:30:51",2006,103,21,82,0,102,1,800,697,33,69
24,IAŞI,"LICEUL TEORETIC ”DIMITRIE CANTEMIR”",240,"MUNICIPIUL IAŞI",95060,1,PART,PRCNCT,PRSD,PRSD_SV,"2025-05-18 22:20:11",1251,862,647,215,0,848,14,1400,538,194,654
24,IAŞI,"LICEUL TEORETIC ”DIMITRIE CANTEMIR”",241,"MUNICIPIUL IAŞI",95060,1,PART,PRCNCT,PRSD,PRSD_SV,"2025-05-18 21:40:36",1274,747,623,124,0,734,13,1400,653,184,550
24,IAŞI,"LICEUL TEORETIC ”DIMITRIE CANTEMIR”",242,"MUNICIPIUL IAŞI",95060,1,PART,PRCNCT,PRSD,PRSD_SV,"2025-05-18 21:49:53",1090,724,591,133,0,709,15,1200,476,191,518
24,IAŞI,"LICEUL TEORETIC ”DIMITRIE CANTEMIR”",243,"MUNICIPIUL IAŞI",95060,1,PART,PRCNCT,PRSD,PRSD_SV,"2025-05-18 22:04:46",1303,703,630,71,2,693,10,1400,697,181,512
24,IAŞI,"ŞCOALA GIMNAZIALĂ ”TITU MAIORESCU”",244,"MUNICIPIUL IAŞI",95060,1,PART,PRCNCT,PRSD,PRSD_SV,"2025-05-18 21:30:57",724,500,312,188,0,499,1,800,300,110,389
24,IAŞI,"ŞCOALA GIMNAZIALĂ ”TITU MAIORESCU”",245,"MUNICIPIUL IAŞI",95060,1,PART,PRCNCT,PRSD,PRSD_SV,"2025-05-18 21:27:49",690,466,329,137,0,462,4,800,333,120,342
24,IAŞI,"ŞCOALA GIMNAZIALĂ ”TITU MAIORESCU”",246,"MUNICIPIUL IAŞI",95060,1,PART,PRCNCT,PRSD,PRSD_SV,"2025-05-18 21:59:41",1009,445,395,50,0,439,6,1100,655,107,332
24,IAŞI,"GRĂDINIŢA CU PROGRAM PRELUNGIT ”CUV. PARASCHEVA”",247,"MUNICIPIUL IAŞI",95060,1,PART,PRCNCT,PRSD,PRSD_SV,"2025-05-18 21:37:11",757,667,391,276,0,655,12,800,133,136,519
24,IAŞI,"ŞCOALA GIMNAZIALĂ ”ION NECULCE”",248,"MUNICIPIUL IAŞI",95060,1,PART,PRCNCT,PRSD,PRSD_SV,"2025-05-18 21:53:13",1140,549,462,84,3,546,3,1300,751,175,371
24,IAŞI,"ŞCOALA GIMNAZIALĂ ”ION NECULCE”",249,"MUNICIPIUL IAŞI",95060,1,PART,PRCNCT,PRSD,PRSD_SV,"2025-05-18 21:44:08",934,576,491,85,0,565,11,1000,424,157,408
24,IAŞI,"ŞCOALA GIMNAZIALĂ ”ION NECULCE”",250,"MUNICIPIUL IAŞI",95060,1,PART,PRCNCT,PRSD,PRSD_SV,"2025-05-18 21:48:26",1054,670,600,67,3,659,11,1200,530,181,478
24,IAŞI,"ŞCOALA GIMNAZIALĂ ”ION NECULCE”",251,"MUNICIPIUL IAŞI",95060,1,PART,PRCNCT,PRSD,PRSD_SV,"2025-05-18 22:55:08",851,388,351,37,0,382,6,900,512,172,210
24,IAŞI,"ŞCOALA PRIMARA NR.1 ”VASILE CONTA”",252,"MUNICIPIUL IAŞI",95060,1,PART,PRCNCT,PRSD,PRSD_SV,"2025-05-18 21:53:26",654,487,313,174,0,485,2,700,213,119,366
24,IAŞI,"ŞCOALA PRIMARA NR.1 ”VASILE CONTA”",253,"MUNICIPIUL IAŞI",95060,1,PART,PRCNCT,PRSD,PRSD_SV,"2025-05-18 22:32:25",1062,639,560,79,0,632,7,1200,561,185,447
24,IAŞI,"ŞCOALA PRIMARA NR.1 ”VASILE CONTA”",254,"MUNICIPIUL IAŞI",95060,1,PART,PRCNCT,PRSD,PRSD_SV,"2025-05-18 21:42:41",1424,700,625,75,0,687,13,1600,900,214,473
24,IAŞI,"ŞCOALA GIMNAZIALĂ ”VASILE CONTA”",255,"MUNICIPIUL IAŞI",95060,1,PART,PRCNCT,PRSD,PRSD_SV,"2025-05-18 21:57:47",1274,810,636,174,0,800,10,1400,590,217,583
24,IAŞI,"ŞCOALA GIMNAZIALĂ ”VASILE CONTA”",256,"MUNICIPIUL IAŞI",95060,1,PART,PRCNCT,PRSD,PRSD_SV,"2025-05-18 21:53:57",1269,807,640,167,0,799,8,1400,593,192,607
24,IAŞI,"ŞCOALA GIMNAZIALĂ ”VASILE CONTA”",257,"MUNICIPIUL IAŞI",95060,1,PART,PRCNCT,PRSD,PRSD_SV,"2025-05-18 21:38:53",1204,691,555,136,0,681,10,1300,609,163,518
24,IAŞI,"ŞCOALA GIMNAZIALĂ ”VASILE CONTA”",258,"MUNICIPIUL IAŞI",95060,1,PART,PRCNCT,PRSD,PRSD_SV,"2025-05-18 22:37:42",1370,851,709,142,0,829,22,1500,649,272,557
24,IAŞI,"COLEGIUL TEHNIC ”ION HOLBAN”",259,"MUNICIPIUL IAŞI",95060,2,PART,PRCNCT,PRSD,PRSD_SV,"2025-05-19 03:10:12",1425,935,723,113,99,922,13,1600,665,314,608
24,IAŞI,"COLEGIUL TEHNIC ”ION HOLBAN”",260,"MUNICIPIUL IAŞI",95060,1,PART,PRCNCT,PRSD,PRSD_SV,"2025-05-18 22:10:59",1272,887,625,179,83,873,14,1400,512,265,608
24,IAŞI,"COLEGIUL TEHNIC ”ION HOLBAN”",261,"MUNICIPIUL IAŞI",95060,1,PART,PRCNCT,PRSD,PRSD_SV,"2025-05-18 22:28:33",1234,803,520,205,78,790,13,1400,597,272,518
24,IAŞI,"CASA DE CULTURA MIHAIL SADOVEANU",262,"MUNICIPIUL PAŞCANI",95391,1,PART,PRCNCT,PRSD,PRSD_SV,"2025-05-18 22:28:54",1147,598,537,60,1,585,13,1300,702,237,348
24,IAŞI,"CASA DE CULTURA MIHAIL SADOVEANU",263,"MUNICIPIUL PAŞCANI",95391,1,PART,PRCNCT,PRSD,PRSD_SV,"2025-05-18 22:21:38",1215,660,555,105,0,646,14,1300,640,298,348
24,IAŞI,"SCOALA ION CREANGA",264,"MUNICIPIUL PAŞCANI",95391,1,PART,PRCNCT,PRSD,PRSD_SV,"2025-05-18 22:14:22",1275,672,616,56,0,664,8,1400,728,308,356
24,IAŞI,"GRADINITA NR. 1",265,"MUNICIPIUL PAŞCANI",95391,1,PART,PRCNCT,PRSD,PRSD_SV,"2025-05-18 21:52:52",1081,508,475,32,1,501,7,1200,692,266,235
24,IAŞI,"ȘCOALA GIMNAZIALĂ ”IORDACHE CANTACUZINO”",266,"MUNICIPIUL PAŞCANI",95391,1,PART,PRCNCT,PRSD,PRSD_SV,"2025-05-18 21:56:51",1436,771,684,87,0,760,11,1600,829,315,445
24,IAŞI,"ȘCOALA GIMNAZIALĂ ”IORDACHE CANTACUZINO”",267,"MUNICIPIUL PAŞCANI",95391,1,PART,PRCNCT,PRSD,PRSD_SV,"2025-05-18 21:54:24",1120,537,475,62,0,528,9,1200,663,219,309
24,IAŞI,"GRADINITA VATRA",268,"MUNICIPIUL PAŞCANI",95391,1,PART,PRCNCT,PRSD,PRSD_SV,"2025-05-18 21:59:50",1404,763,615,45,103,748,15,1500,737,390,358
24,IAŞI,"COLEGIUL NAȚIONAL MIHAIL SADOVEANU",269,"MUNICIPIUL PAŞCANI",95391,1,PART,PRCNCT,PRSD,PRSD_SV,"2025-05-18 21:58:34",1596,532,516,16,0,521,11,1800,1268,218,303
24,IAŞI,"COLEGIUL NAȚIONAL MIHAIL SADOVEANU",270,"MUNICIPIUL PAŞCANI",95391,1,PART,PRCNCT,PRSD,PRSD_SV,"2025-05-18 22:01:18",1866,632,624,8,0,621,11,2000,1368,256,365
24,IAŞI,"COLEGIUL NAȚIONAL MIHAIL SADOVEANU",271,"MUNICIPIUL PAŞCANI",95391,1,PART,PRCNCT,PRSD,PRSD_SV,"2025-05-18 21:43:17",1699,61,0,61,0,61,0,800,739,27,34
24,IAŞI,"COLEGIUL NAȚIONAL MIHAIL SADOVEANU",272,"MUNICIPIUL PAŞCANI",95391,1,PART,PRCNCT,PRSD,PRSD_SV,"2025-05-18 21:32:09",1740,51,0,51,0,49,2,800,749,22,27
24,IAŞI,"LICEUL TEHNOLOGIC ECONOMIC ”NICOLAE IORGA”",273,"MUNICIPIUL PAŞCANI",95391,1,PART,PRCNCT,PRSD,PRSD_SV,"2025-05-18 21:52:08",1404,632,556,76,0,621,11,1500,868,318,303
24,IAŞI,"LICEUL TEHNOLOGIC ECONOMIC ”NICOLAE IORGA”",274,"MUNICIPIUL PAŞCANI",95391,1,PART,PRCNCT,PRSD,PRSD_SV,"2025-05-18 22:05:48",1722,940,870,46,24,927,13,1900,960,421,506
24,IAŞI,"SCOALA SPECIALA",275,"MUNICIPIUL PAŞCANI",95391,1,PART,PRCNCT,PRSD,PRSD_SV,"2025-05-18 22:17:04",1565,773,711,62,0,753,20,1700,927,437,316
24,IAŞI,"COLEGIU TEHNIC DE CAI FERATE UNIREA",276,"MUNICIPIUL PAŞCANI",95391,2,PART,PRCNCT,PRSD,PRSD_SV,"2025-05-19 03:32:29",1486,761,655,106,0,739,22,3200,2439,362,377
24,IAŞI,"COLEGIU TEHNIC DE CAI FERATE UNIREA",277,"MUNICIPIUL PAŞCANI",95391,1,PART,PRCNCT,PRSD,PRSD_SV,"2025-05-18 21:55:35",1038,547,476,70,1,524,23,2700,2153,258,266
24,IAŞI,"GRADINITA CU PROGRAM PRELUNGIT NR. 3",278,"MUNICIPIUL PAŞCANI",95391,1,PART,PRCNCT,PRSD,PRSD_SV,"2025-05-18 21:44:45",1000,502,446,56,0,496,6,1100,598,243,253
24,IAŞI,"GRADINITA CU PROGRAM PRELUNGIT NR. 3",279,"MUNICIPIUL PAŞCANI",95391,2,PART,PRCNCT,PRSD,PRSD_SV,"2025-05-19 03:30:09",1143,485,448,37,0,479,6,1300,815,249,230
24,IAŞI,"LICEUL MIRON COSTIN",280,"MUNICIPIUL PAŞCANI",95391,1,PART,PRCNCT,PRSD,PRSD_SV,"2025-05-18 21:51:47",1174,514,453,61,0,500,14,1300,786,252,248
24,IAŞI,"LICEUL MIRON COSTIN",281,"MUNICIPIUL PAŞCANI",95391,1,PART,PRCNCT,PRSD,PRSD_SV,"2025-05-18 22:01:16",1144,579,510,69,0,566,13,1300,721,261,305
24,IAŞI,"GRUP SCOLAR MIHAI BUSUIOC",282,"MUNICIPIUL PAŞCANI",95391,1,PART,PRCNCT,PRSD,PRSD_SV,"2025-05-18 22:15:10",1174,609,547,61,1,598,11,1300,691,230,368
24,IAŞI,"GRUP SCOLAR MIHAI BUSUIOC",283,"MUNICIPIUL PAŞCANI",95391,1,PART,PRCNCT,PRSD,PRSD_SV,"2025-05-18 21:45:44",1047,551,501,50,0,540,11,1100,549,284,256
24,IAŞI,"SCOALA BLAGESTI",284,"MUNICIPIUL PAŞCANI",95391,1,PART,PRCNCT,PRSD,PRSD_SV,"2025-05-18 22:01:34",1094,510,474,36,0,503,7,1200,690,274,229
24,IAŞI,"SCOALA BOSTENI",285,"MUNICIPIUL PAŞCANI",95391,1,PART,PRCNCT,PRSD,PRSD_SV,"2025-05-18 21:50:47",1267,580,553,27,0,568,12,1400,820,332,236
24,IAŞI,"SCOALA GISTESTI",286,"MUNICIPIUL PAŞCANI",95391,1,PART,PRCNCT,PRSD,PRSD_SV,"2025-05-18 21:43:02",1008,475,459,16,0,470,5,1100,625,327,143
24,IAŞI,"GRADINITA GISTESTI",287,"MUNICIPIUL PAŞCANI",95391,1,PART,PRCNCT,PRSD,PRSD_SV,"2025-05-18 21:45:40",1367,624,593,31,0,620,4,1500,876,434,186
24,IAŞI,"SCOALA LUNCA",288,"MUNICIPIUL PAŞCANI",95391,1,PART,PRCNCT,PRSD,PRSD_SV,"2025-05-18 21:45:16",1080,480,457,23,0,474,6,1200,720,316,158
24,IAŞI,"SCOALA LUNCA",289,"MUNICIPIUL PAŞCANI",95391,1,PART,PRCNCT,PRSD,PRSD_SV,"2025-05-18 22:06:40",1028,510,491,19,0,501,9,1100,590,325,176
24,IAŞI,"SCOALA SODOMENI",290,"MUNICIPIUL PAŞCANI",95391,1,PART,PRCNCT,PRSD,PRSD_SV,"2025-05-18 21:54:04",887,453,420,33,0,446,7,1000,547,292,154
24,IAŞI,"LICEUL TEHNOLOGIC HÎRLĂU",291,"ORAŞ HÂRLĂU",95355,1,PART,PRCNCT,PRSD,PRSD_SV,"2025-05-18 21:54:23",1505,416,355,61,0,413,3,1600,1184,271,142
24,IAŞI,"LICEUL TEHNOLOGIC HÂRLĂU",292,"ORAŞ HÂRLĂU",95355,1,PART,PRCNCT,PRSD,PRSD_SV,"2025-05-18 21:51:28",1800,476,414,39,23,469,7,2000,1524,243,226
24,IAŞI,"ŞCOALA GIMNAZIALĂ PETRU RAREŞ - CORP VECHI",293,"ORAŞ HÂRLĂU",95355,1,PART,PRCNCT,PRSD,PRSD_SV,"2025-05-18 22:17:19",1814,549,499,50,0,541,8,2000,1451,215,326
24,IAŞI,"ŞCOALA GIMNAZIALĂ ”PETRU RAREŞ” - CORP A",294,"ORAŞ HÂRLĂU",95355,1,PART,PRCNCT,PRSD,PRSD_SV,"2025-05-18 22:02:14",1839,472,419,53,0,466,6,2000,1528,203,263
24,IAŞI,"ŞCOALA GIMNAZIALĂ PETRU RAREŞ - SALA DE SPORT",295,"ORAŞ HÂRLĂU",95355,1,PART,PRCNCT,PRSD,PRSD_SV,"2025-05-18 21:56:52",1517,534,501,33,0,523,11,1700,1166,333,190
24,IAŞI,"ŞCOALA GIMNAZIALĂ ”PETRU RAREŞ” - CORP C",296,"ORAŞ HÂRLĂU",95355,1,PART,PRCNCT,PRSD,PRSD_SV,"2025-05-18 22:08:08",1783,457,423,34,0,446,11,2000,1543,247,199
24,IAŞI,"CĂMIN CULTURAL PÂRCOVACI",297,"ORAŞ HÂRLĂU",95355,1,PART,PRCNCT,PRSD,PRSD_SV,"2025-05-18 21:49:12",1501,698,673,25,0,695,3,1600,902,467,228
24,IAŞI,"ŞCOALA GIMNAZIALĂ PÎRCOVACI - CORP ŞCOALĂ",298,"ORAŞ HÂRLĂU",95355,1,PART,PRCNCT,PRSD,PRSD_SV,"2025-05-18 22:02:46",1331,602,568,34,0,592,10,1500,898,419,173
24,IAŞI,"ŞCOALA GIMNAZIALĂ AL. I. CUZA",299,"ORAŞ PODU ILOAIEI",98373,1,PART,PRCNCT,PRSD,PRSD_SV,"2025-05-18 21:35:05",711,275,232,26,17,270,5,800,525,138,132
24,IAŞI,"ŞCOALA GIMNAZIALĂ AL. I. CUZA",300,"ORAŞ PODU ILOAIEI",98373,1,PART,PRCNCT,PRSD,PRSD_SV,"2025-05-18 21:35:42",1126,368,335,33,0,362,6,1200,832,276,86
24,IAŞI,"ŞCOALA GIMNAZIALĂ AL. I. CUZA",301,"ORAŞ PODU ILOAIEI",98373,1,PART,PRCNCT,PRSD,PRSD_SV,"2025-05-18 21:33:28",912,358,338,20,0,354,4,1000,642,212,142
24,IAŞI,"ŞCOALA GIMNAZIALĂ AL. I. CUZA",302,"ORAŞ PODU ILOAIEI",98373,1,PART,PRCNCT,PRSD,PRSD_SV,"2025-05-18 21:46:22",1015,440,408,32,0,437,3,1100,660,245,192
24,IAŞI,"ȘCOALA GIMNAZIALĂ AL.I. CUZA",303,"ORAŞ PODU ILOAIEI",98373,1,PART,PRCNCT,PRSD,PRSD_SV,"2025-05-18 21:39:51",1626,538,517,21,0,525,13,1800,1262,253,272
24,IAŞI,"ȘCOALA GIMNAZIALĂ AL.I.CUZA",304,"ORAŞ PODU ILOAIEI",98373,1,PART,PRCNCT,PRSD,PRSD_SV,"2025-05-18 22:04:44",1171,532,479,53,0,524,8,1300,768,286,238
24,IAŞI,"ŞCOALA HENCI",305,"ORAŞ PODU ILOAIEI",98373,1,PART,PRCNCT,PRSD,PRSD_SV,"2025-05-18 21:39:33",492,219,195,24,0,217,2,500,281,136,81
24,IAŞI,"ŞCOALA GIMNAZIALĂ BUDĂI",306,"ORAŞ PODU ILOAIEI",98373,1,PART,PRCNCT,PRSD,PRSD_SV,"2025-05-18 22:18:36",807,373,320,36,17,366,7,900,527,200,166
24,IAŞI,"ŞCOALA COSIŢENI",307,"ORAŞ PODU ILOAIEI",98373,1,PART,PRCNCT,PRSD,PRSD_SV,"2025-05-18 21:33:58",274,147,123,24,0,144,3,300,153,113,31
24,IAŞI,"ŞCOALA HOLM",308,"ORAŞ PODU ILOAIEI",98373,1,PART,PRCNCT,PRSD,PRSD_SV,"2025-05-18 21:28:46",251,120,103,17,0,120,0,300,180,83,37
24,IAŞI,"ȘCOALA SCOBÂLȚENI",309,"ORAŞ PODU ILOAIEI",98373,1,PART,PRCNCT,PRSD,PRSD_SV,"2025-05-18 21:34:22",1017,412,386,25,1,408,4,1100,688,288,120
24,IAŞI,"SCOALA GENERALA ION CREANGA",310,"ORAŞ TÂRGU FRUMOS",95471,1,PART,PRCNCT,PRSD,PRSD_SV,"2025-05-18 22:02:40",1559,787,691,96,0,778,9,1700,913,405,373
24,IAŞI,"SCOALA GENERALA ION CREANGA",311,"ORAŞ TÂRGU FRUMOS",95471,1,PART,PRCNCT,PRSD,PRSD_SV,"2025-05-18 21:43:21",831,329,266,63,0,324,5,900,571,170,154
24,IAŞI,"SCOALA GENERALA GARABET IBRAILEANU",312,"ORAŞ TÂRGU FRUMOS",95471,1,PART,PRCNCT,PRSD,PRSD_SV,"2025-05-18 21:39:09",1190,452,415,37,0,442,10,1300,848,235,207
24,IAŞI,"SCOALA GENERALA GARABET IBRAILEANU",313,"ORAŞ TÂRGU FRUMOS",95471,1,PART,PRCNCT,PRSD,PRSD_SV,"2025-05-18 21:51:46",1026,508,449,59,0,500,8,1100,592,250,250
24,IAŞI,"ȘCOALA PROFESIONALĂ SPECIALĂ ” TRINITAS” -SALA DE FESTIVITĂȚI",314,"ORAŞ TÂRGU FRUMOS",95471,1,PART,PRCNCT,PRSD,PRSD_SV,"2025-05-18 21:53:25",1536,804,755,46,3,797,7,1700,896,438,359
24,IAŞI,"CASA DE CULTURA ”GARABET IBRAILEANU”",315,"ORAŞ TÂRGU FRUMOS",95471,1,PART,PRCNCT,PRSD,PRSD_SV,"2025-05-18 21:46:10",1481,664,609,55,0,655,9,1600,936,365,290
24,IAŞI,"CASA DE CULTURA ”GARABET IBRAILEANU”",316,"ORAŞ TÂRGU FRUMOS",95471,1,PART,PRCNCT,PRSD,PRSD_SV,"2025-05-18 21:57:15",1938,761,700,61,0,755,6,2100,1339,460,295
24,IAŞI,"LICEUL TEORETIC ”ION NECULCE”",317,"ORAŞ TÂRGU FRUMOS",95471,1,PART,PRCNCT,PRSD,PRSD_SV,"2025-05-18 22:36:25",1589,814,671,131,12,801,13,1700,886,380,421
24,IAŞI,"ȘCOALA PRIMARĂ AL. I. CUZA",318,"ALEXANDRU I. CUZA",95612,1,PART,PRCNCT,PRSD,PRSD_SV,"2025-05-18 21:53:43",634,305,261,44,0,301,4,700,395,186,115
24,IAŞI,"SCOALA GIMNAZIALA SCHEIA",319,"ALEXANDRU I. CUZA",95612,1,PART,PRCNCT,PRSD,PRSD_SV,"2025-05-18 21:24:08",1030,439,380,55,4,432,7,1100,661,227,205
24,IAŞI,"SCOALA PRIMARA VOLINTIRESTI",320,"ALEXANDRU I. CUZA",95612,1,PART,PRCNCT,PRSD,PRSD_SV,"2025-05-18 21:31:49",595,299,256,43,0,296,3,700,401,181,115
24,IAŞI,"SCOALA GIMNAZIALA GH. CIOBANU ANDRIESENI",321,ANDRIEŞENI,95667,1,PART,PRCNCT,PRSD,PRSD_SV,"2025-05-18 21:29:42",1325,558,506,52,0,544,14,1500,942,292,252
24,IAŞI,"SCOALA PRIMARA BUHAENI",322,ANDRIEŞENI,95667,1,PART,PRCNCT,PRSD,PRSD_SV,"2025-05-18 21:25:15",490,198,169,29,0,196,2,500,302,117,79
24,IAŞI,"SCOALA GIMNAZIALA GLAVANESTI",323,ANDRIEŞENI,95667,1,PART,PRCNCT,PRSD,PRSD_SV,"2025-05-18 21:21:30",517,179,155,24,0,178,1,600,421,114,64
24,IAŞI,"SCOALA GIMNAZIALA SPINENI",324,ANDRIEŞENI,95667,1,PART,PRCNCT,PRSD,PRSD_SV,"2025-05-18 21:34:54",756,285,249,36,0,281,4,800,515,173,108
24,IAŞI,"ȘCOALA GIMNAZIALĂ ARON-VODA DIN SAT ARONEANU",325,ARONEANU,95747,1,PART,PRCNCT,PRSD,PRSD_SV,"2025-05-18 21:52:07",1870,1468,1163,291,14,1455,13,2100,632,408,1047
24,IAŞI,"ȘCOALA GIMNAZIALĂ ARON-VODĂ DIN SAT DOROBANȚ",326,ARONEANU,95747,1,PART,PRCNCT,PRSD,PRSD_SV,"2025-05-18 22:36:48",1320,848,696,140,12,842,6,1400,552,422,420
24,IAŞI,"ȘCOALA GIMNAZIALĂ ARON-VODĂ DIN SAT REDIU ALDEI",327,ARONEANU,95747,1,PART,PRCNCT,PRSD,PRSD_SV,"2025-05-18 21:47:09",402,251,210,34,7,248,3,500,249,110,138
24,IAŞI,"BAZA SPORTIVĂ MULTIFUNCȚIONALĂ - ȘOROGARI",328,ARONEANU,95747,1,PART,PRCNCT,PRSD,PRSD_SV,"2025-05-18 21:50:07",394,288,205,75,8,286,2,400,112,71,215
24,IAŞI,"SCOALA GIMNAZIALA CLASELE I-VIII BALS",329,BALŞ,100273,1,PART,PRCNCT,PRSD,PRSD_SV,"2025-05-18 21:38:54",1224,590,527,58,5,587,3,1300,710,465,122
24,IAŞI,"SCOALA GIMNAZIALA CLASELE I-VIII BOURENI",330,BALŞ,100273,1,PART,PRCNCT,PRSD,PRSD_SV,"2025-05-18 22:02:02",1399,659,616,43,0,652,7,1500,841,454,198
24,IAŞI,"SCOALA PRIMARA CLASELE I-IV COASTA MAGURII",331,BALŞ,100273,1,PART,PRCNCT,PRSD,PRSD_SV,"2025-05-18 21:42:16",179,92,69,23,0,91,1,200,108,53,38
24,IAŞI,"CĂMIN CULTURAL BĂLȚAȚI",332,BĂLŢAŢI,95792,1,PART,PRCNCT,PRSD,PRSD_SV,"2025-05-18 22:11:15",1673,776,701,68,7,771,5,1800,1024,464,307
24,IAŞI,"ȘCOALA PRIMARĂ MĂDÂRJEȘTI",333,BĂLŢAŢI,95792,1,PART,PRCNCT,PRSD,PRSD_SV,"2025-05-18 21:36:25",915,393,318,57,18,389,4,1000,607,192,197
24,IAŞI,"ȘCOALA PRIMARĂ - SAT PODIȘU",334,BĂLŢAŢI,95792,1,PART,PRCNCT,PRSD,PRSD_SV,"2025-05-18 21:35:59",512,217,193,24,0,215,2,600,383,154,61
24,IAŞI,"ȘCOALA GIMNAZIALĂ - SAT SÎRCA",335,BĂLŢAŢI,95792,1,PART,PRCNCT,PRSD,PRSD_SV,"2025-05-18 21:50:47",884,427,381,44,2,423,4,1000,573,239,184
24,IAŞI,"ȘCOALA GIMNAZIALĂ - SAT VALEA OILOR",336,BĂLŢAŢI,95792,1,PART,PRCNCT,PRSD,PRSD_SV,"2025-05-18 21:27:27",516,224,207,17,0,223,1,600,376,157,66
24,IAŞI,"CAMIN CULTURAL BIRNOVA",337,BÂRNOVA,95088,2,PART,PRCNCT,PRSD,PRSD_SV,"2025-05-19 00:27:09",1305,952,702,238,12,939,13,1400,448,418,521
24,IAŞI,"SCOALA PRIMARA CERCU",338,BÂRNOVA,95088,1,PART,PRCNCT,PRSD,PRSD_SV,"2025-05-18 21:17:13",693,405,341,63,1,401,4,800,395,202,199
24,IAŞI,"SCOALA PRIMARA PAUN",339,BÂRNOVA,95088,1,PART,PRCNCT,PRSD,PRSD_SV,"2025-05-18 21:58:07",1206,896,657,238,1,890,6,1300,404,388,502
24,IAŞI,"SCOALA PRIMARA PIETRARIA",340,BÂRNOVA,95088,1,PART,PRCNCT,PRSD,PRSD_SV,"2025-05-18 21:39:14",1084,789,601,187,1,780,9,1200,411,252,528
24,IAŞI,"SCOALA PRIMARA TODIREL",341,BÂRNOVA,95088,1,PART,PRCNCT,PRSD,PRSD_SV,"2025-05-18 21:23:07",450,247,216,31,0,246,1,500,253,190,56
24,IAŞI,"ȘCOALA PRIMARĂ VIȘAN",342,BÂRNOVA,95088,1,PART,PRCNCT,PRSD,PRSD_SV,"2025-05-18 22:10:11",1181,744,545,198,1,740,4,1300,556,268,472
24,IAŞI,"SCOALA PRIMARA VISAN",343,BÂRNOVA,95088,1,PART,PRCNCT,PRSD,PRSD_SV,"2025-05-18 21:42:08",1669,1021,830,191,0,1015,6,1800,779,320,695
24,IAŞI,"SCOALA BELCEŞTI",344,BELCEŞTI,95872,1,PART,PRCNCT,PRSD,PRSD_SV,"2025-05-18 21:44:04",938,395,342,53,0,392,3,1000,605,225,167
24,IAŞI,"SCOALA BELCEŞTI",345,BELCEŞTI,95872,1,PART,PRCNCT,PRSD,PRSD_SV,"2025-05-18 21:50:43",1294,490,444,46,0,488,2,1400,910,293,195
24,IAŞI,"SCOALA RUSI",346,BELCEŞTI,95872,1,PART,PRCNCT,PRSD,PRSD_SV,"2025-05-18 21:34:37",1265,515,462,53,0,509,6,1400,885,336,173
24,IAŞI,"ŞCOALA LITENI",347,BELCEŞTI,95872,1,PART,PRCNCT,PRSD,PRSD_SV,"2025-05-18 21:55:07",1092,410,357,53,0,405,5,1200,790,314,91
24,IAŞI,"ŞCOALA MUNTENI",348,BELCEŞTI,95872,1,PART,PRCNCT,PRSD,PRSD_SV,"2025-05-18 21:54:54",775,300,261,39,0,296,4,900,600,185,111
24,IAŞI,"ŞCOALA SATU – NOU",349,BELCEŞTI,95872,1,PART,PRCNCT,PRSD,PRSD_SV,"2025-05-18 21:38:14",1585,686,627,59,0,684,2,1700,1014,499,185
24,IAŞI,"ȘCOALA PRIMARĂ TANSA",350,BELCEŞTI,95872,1,PART,PRCNCT,PRSD,PRSD_SV,"2025-05-18 21:47:36",796,363,324,39,0,358,5,900,537,232,126
24,IAŞI,"SCOALA ULMI",351,BELCEŞTI,95872,1,PART,PRCNCT,PRSD,PRSD_SV,"2025-05-18 21:42:23",486,215,181,34,0,214,1,500,285,139,75
24,IAŞI,"ȘCOALA GIMNAZIALĂ BIVOLARI CORP A",352,BIVOLARI,95943,1,PART,PRCNCT,PRSD,PRSD_SV,"2025-05-18 21:24:20",887,350,299,39,12,349,1,1000,650,202,147
24,IAŞI,"ȘCOALA GIMNAZIALĂ BIVOLARI CORP A",353,BIVOLARI,95943,1,PART,PRCNCT,PRSD,PRSD_SV,"2025-05-18 21:28:25",906,345,274,57,14,341,4,1000,655,173,168
24,IAŞI,"ŞCOALA CU CLASELE I - IV SOLONEŢ",354,BIVOLARI,95943,1,PART,PRCNCT,PRSD,PRSD_SV,"2025-05-18 21:32:12",428,192,153,39,0,190,2,500,308,134,56
24,IAŞI,"CĂMIN CULTURAL TABĂRA",355,BIVOLARI,95943,1,PART,PRCNCT,PRSD,PRSD_SV,"2025-05-18 21:30:15",842,373,300,72,1,370,3,900,527,228,142
24,IAŞI,"GRADINIȚA CU PROGRAM SCURT TRAIAN",356,BIVOLARI,95943,1,PART,PRCNCT,PRSD,PRSD_SV,"2025-05-18 21:32:28",177,73,59,14,0,71,2,200,127,59,12
24,IAŞI,"LICEUL TEHNOLOGIC BRAESTI",357,BRĂEŞTI,96058,1,PART,PRCNCT,PRSD,PRSD_SV,"2025-05-18 21:30:26",909,406,342,39,25,404,2,1000,594,219,185
24,IAŞI,"SCOALA CU CLASELE I-IV",358,BRĂEŞTI,96058,1,PART,PRCNCT,PRSD,PRSD_SV,"2025-05-18 21:29:25",211,90,75,15,0,90,0,302,212,46,44
24,IAŞI,"ŞCOALA GENERALĂ CRISTEŞTI",359,BRĂEŞTI,96058,1,PART,PRCNCT,PRSD,PRSD_SV,"2025-05-18 21:36:09",786,337,290,31,16,336,1,900,563,213,123
24,IAŞI,"CASA DE PRĂZNUIRE PAROHIA ALBEȘTI-REDIU",360,BRĂEŞTI,96058,1,PART,PRCNCT,PRSD,PRSD_SV,"2025-05-18 21:30:00",577,246,221,17,8,238,8,600,354,152,86
24,IAŞI,"SEDIUL PRIMARIEI COMUNEI BUTEA",361,BUTEA,96110,1,PART,PRCNCT,PRSD,PRSD_SV,"2025-05-18 21:42:20",1593,501,432,69,0,499,2,1700,1199,171,328
24,IAŞI,"GRADINIŢA CU PROGRAM NORMAL BUTEA, COMUNA BUTEA, JUDEŢUL IAŞI",362,BUTEA,96110,1,PART,PRCNCT,PRSD,PRSD_SV,"2025-05-18 21:32:36",1555,463,420,43,0,455,8,1700,1237,204,251
24,IAŞI,"SCOALA PRIMARA MICLAUSENI",363,BUTEA,96110,1,PART,PRCNCT,PRSD,PRSD_SV,"2025-05-18 21:30:30",353,170,119,51,0,170,0,400,230,107,63
24,IAŞI,"SCOALA GIMNAZIALA ”GRIGORE URECHE” CEPLENITA",364,CEPLENIŢA,96147,1,PART,PRCNCT,PRSD,PRSD_SV,"2025-05-18 21:51:36",1308,453,419,34,0,451,2,1400,947,275,176
24,IAŞI,"SCOALA GIMNAZIALA ”NICOLAE IORGA” BUHALNITA",365,CEPLENIŢA,96147,1,PART,PRCNCT,PRSD,PRSD_SV,"2025-05-18 22:09:03",1212,488,444,43,1,486,2,1300,812,272,214
24,IAŞI,"ȘCOALA PRIMARĂ POIANA MĂRULUI",366,CEPLENIŢA,96147,1,PART,PRCNCT,PRSD,PRSD_SV,"2025-05-18 21:40:07",825,341,312,29,0,339,2,900,559,235,104
24,IAŞI,"GRADINITA CU PROGRAM NORMAL ZLODICA",367,CEPLENIŢA,96147,1,PART,PRCNCT,PRSD,PRSD_SV,"2025-05-18 21:42:15",250,122,94,28,0,120,2,300,178,58,62
24,IAŞI,"SALĂ DE EDUCAȚIE FIZICĂ ȘCOLARĂ",368,CIOHORĂNI,100362,1,PART,PRCNCT,PRSD,PRSD_SV,"2025-05-18 21:34:58",1455,550,486,64,0,535,15,1600,1050,298,237
24,IAŞI,"ȘCOALA GIMNAZIALĂ CIORTEȘTI",369,CIORTEŞTI,96192,1,PART,PRCNCT,PRSD,PRSD_SV,"2025-05-18 21:36:17",770,384,318,66,0,379,5,800,416,206,173
24,IAŞI,"CĂMIN CULTURAL COROPCENI",370,CIORTEŞTI,96192,1,PART,PRCNCT,PRSD,PRSD_SV,"2025-05-18 21:29:48",818,377,337,40,0,373,4,900,523,187,186
24,IAŞI,"ŞCOALA PRIMARĂ DELENI",371,CIORTEŞTI,96192,1,PART,PRCNCT,PRSD,PRSD_SV,"2025-05-18 21:24:41",366,182,159,23,0,181,1,400,218,73,108
24,IAŞI,"ŞCOALA PRIMARĂ ROTĂRIA",372,CIORTEŞTI,96192,1,PART,PRCNCT,PRSD,PRSD_SV,"2025-05-18 21:30:05",309,163,139,24,0,163,0,400,237,115,48
24,IAŞI,"GRĂDINIȚA CU PROGRAM NORMAL ŞERBEŞTI",373,CIORTEŞTI,96192,1,PART,PRCNCT,PRSD,PRSD_SV,"2025-05-18 21:29:01",593,265,233,32,0,260,5,700,435,111,149
24,IAŞI,"SCOALA GIMNAZIALA CIUREA",374,CIUREA,96254,1,PART,PRCNCT,PRSD,PRSD_SV,"2025-05-18 22:02:46",1262,626,577,49,0,621,5,1400,774,334,287
24,IAŞI,"SCOALA GIMNAZIALA CIUREA",375,CIUREA,96254,1,PART,PRCNCT,PRSD,PRSD_SV,"2025-05-18 21:59:12",1231,616,541,74,1,612,4,1400,784,345,267
24,IAŞI,"GRĂDINIȚA CU PROGRAM PRELUNGIT NR. 3 CURĂTURI",376,CIUREA,96254,1,PART,PRCNCT,PRSD,PRSD_SV,"2025-05-18 21:28:21",273,185,143,41,1,183,2,300,115,99,84
24,IAŞI,"CORP A ŞCOALA GIMNAZIALĂ DUMBRAVA",377,CIUREA,96254,1,PART,PRCNCT,PRSD,PRSD_SV,"2025-05-18 21:45:23",1271,729,617,112,0,719,10,1400,671,465,254
24,IAŞI,"ȘCOALA PRIMARĂ HLINCEA",378,CIUREA,96254,1,PART,PRCNCT,PRSD,PRSD_SV,"2025-05-18 22:04:31",1327,1028,726,301,1,1015,13,1483,455,294,721
24,IAŞI,"ŞCOALA GIMNAZIALĂ ” COMANDOR ALEXANDRU CĂTUNEANU” LUNCA CETĂŢUII",379,CIUREA,96254,1,PART,PRCNCT,PRSD,PRSD_SV,"2025-05-18 22:07:31",1980,1154,982,171,1,1143,11,2200,1046,434,709
24,IAŞI,"ŞCOALA GIMNAZIALĂ ” COMANDOR ALEXANDRU CĂTUNEANU” LUNCA CETĂŢUII",380,CIUREA,96254,1,PART,PRCNCT,PRSD,PRSD_SV,"2025-05-18 21:57:10",1946,1310,1074,234,2,1290,20,2100,790,439,851
24,IAŞI,"ŞCOALA GIMNAZIALĂ ” COMANDOR ALEXANDRU CĂTUNEANU” LUNCA CETĂŢUII",381,CIUREA,96254,1,PART,PRCNCT,PRSD,PRSD_SV,"2025-05-18 22:01:46",1851,1270,981,289,0,1255,15,2000,730,494,761
24,IAŞI,"ŞCOALA GIMNAZIALĂ ” COMANDOR ALEXANDRU CĂTUNEANU” LUNCA CETĂŢUII",382,CIUREA,96254,1,PART,PRCNCT,PRSD,PRSD_SV,"2025-05-18 21:55:26",1999,1158,1011,147,0,1145,13,2200,1042,370,775
24,IAŞI,"ȘCOALA GIMNAZIALĂ ” COMANDOR ALEXANDRU CĂTUNEANU” LUNCA CETĂȚUII",383,CIUREA,96254,1,PART,PRCNCT,PRSD,PRSD_SV,"2025-05-18 22:35:00",1837,1163,1062,101,0,1152,11,2000,837,417,735
24,IAŞI,"SCOALA PRIMARA NR.2 LUNCA CETAŢUII ( ZANEA)",384,CIUREA,96254,1,PART,PRCNCT,PRSD,PRSD_SV,"2025-05-18 21:28:58",602,275,253,22,0,266,9,700,425,161,105
24,IAŞI,"ȘCOALA GIMNAZIALĂ PICIORU LUPULUI",385,CIUREA,96254,1,PART,PRCNCT,PRSD,PRSD_SV,"2025-05-18 21:32:54",470,253,203,50,0,247,6,500,247,89,158
24,IAŞI,"ȘCOALA PRIMARĂ NR. 2 SLOBOZIA ( CORP CLĂDIRE NOU)",386,CIUREA,96254,1,PART,PRCNCT,PRSD,PRSD_SV,"2025-05-18 21:23:33",339,195,159,36,0,193,2,400,205,112,81
24,IAŞI,"SCOALA GENERALA NR.1. SAT.COARNELE CAPREI",387,"COARNELE CAPREI",96334,1,PART,PRCNCT,PRSD,PRSD_SV,"2025-05-18 21:35:42",921,430,357,46,27,421,9,1000,570,229,192
24,IAŞI,"SCOALA GENERALA NR. 1. SAT.COARNELE CAPREI",388,"COARNELE CAPREI",96334,1,PART,PRCNCT,PRSD,PRSD_SV,"2025-05-18 21:42:21",768,388,312,36,40,385,3,800,412,246,139
24,IAŞI,"ŞCOALA GENERALA SAT. ARAMA",389,"COARNELE CAPREI",96334,1,PART,PRCNCT,PRSD,PRSD_SV,"2025-05-18 21:34:13",502,207,177,13,17,205,2,600,393,122,83
24,IAŞI,"ŞCOALA GENERALA SAT. PETROSICA",390,"COARNELE CAPREI",96334,1,PART,PRCNCT,PRSD,PRSD_SV,"2025-05-18 21:14:20",54,38,22,15,1,38,0,100,62,9,29
24,IAŞI,"ŞCOALA OSOI",391,COMARNA,96370,1,PART,PRCNCT,PRSD,PRSD_SV,"2025-05-18 21:37:23",1576,832,719,112,1,822,10,1700,868,428,394
24,IAŞI,"ȘCOALA GIMNAZIALA NR. 1 COMARNA -CORP A",392,COMARNA,96370,1,PART,PRCNCT,PRSD,PRSD_SV,"2025-05-18 21:26:17",736,151,112,33,6,150,1,800,649,78,72
24,IAŞI,"SCOALA CLASELE I-IV COMARNA II",393,COMARNA,96370,1,PART,PRCNCT,PRSD,PRSD_SV,"2025-05-18 21:35:57",990,371,286,50,35,367,4,1100,729,194,173
24,IAŞI,"GRĂDINIȚA CU PROGRAM NORMAL COMARNA NR.1",394,COMARNA,96370,1,PART,PRCNCT,PRSD,PRSD_SV,"2025-05-18 21:45:20",1518,394,313,57,24,390,4,1700,1306,214,176
24,IAŞI,"ŞCOALA CURAGĂU",395,COMARNA,96370,1,PART,PRCNCT,PRSD,PRSD_SV,"2025-05-18 21:35:59",124,66,51,15,0,65,1,200,134,26,39
24,IAŞI,"ŞCOALA STÂNCA",396,COMARNA,96370,1,PART,PRCNCT,PRSD,PRSD_SV,"2025-05-18 21:24:33",200,142,118,24,0,141,1,300,158,83,58
24,IAŞI,"ȘCOALA GIMNAZIALA NR. 1 COSTEȘTI-CORP A",397,COSTEŞTI,100282,1,PART,PRCNCT,PRSD,PRSD_SV,"2025-05-18 21:20:42",1052,561,506,55,0,547,14,1200,639,356,191
24,IAŞI,"ȘCOALA PRIMARA GIURGESTI",398,COSTEŞTI,100282,2,PART,PRCNCT,PRSD,PRSD_SV,"2025-05-18 23:48:01",387,218,176,42,0,215,3,400,182,125,90
24,IAŞI,"SCOALA GIMNAZIALĂ COSTULENI",399,COSTULENI,96423,1,PART,PRCNCT,PRSD,PRSD_SV,"2025-05-18 21:23:11",1288,529,463,66,0,522,7,1400,871,318,204
24,IAŞI,"ȘCOALA GIMNAZIALĂ COVASNA",400,COSTULENI,96423,1,PART,PRCNCT,PRSD,PRSD_SV,"2025-05-18 21:36:58",917,398,322,76,0,391,7,1000,602,206,185
24,IAŞI,"ȘCOALA GIMNAZIALĂ COZIA",401,COSTULENI,96423,1,PART,PRCNCT,PRSD,PRSD_SV,"2025-05-18 21:17:10",1366,154,123,31,0,151,3,1500,1346,87,64
24,IAŞI,"ȘCOALA GIMNAZIALĂ COZIA",402,COSTULENI,96423,2,PART,PRCNCT,PRSD,PRSD_SV,"2025-05-18 23:06:43",1235,72,56,16,0,70,2,400,328,28,42
24,IAŞI,"ȘCOALA GIMNAZIALĂ COZIA",403,COSTULENI,96423,1,PART,PRCNCT,PRSD,PRSD_SV,"2025-05-18 21:14:54",1469,129,106,23,0,129,0,1600,1471,69,60
24,IAŞI,"SCOALA PRIMARĂ HILIȚA",404,COSTULENI,96423,1,PART,PRCNCT,PRSD,PRSD_SV,"2025-05-18 21:23:55",591,349,287,62,0,342,7,700,351,210,132
24,IAŞI,"ŞCOALA PROFESIONALÃ „ŞTEFAN CEL MARE”",405,COTNARI,96478,1,PART,PRCNCT,PRSD,PRSD_SV,"2025-05-18 22:04:37",1401,616,555,61,0,613,3,1501,885,331,282
24,IAŞI,"CASA DE PRAZNUIRE BAHLUI",406,COTNARI,96478,1,PART,PRCNCT,PRSD,PRSD_SV,"2025-05-18 21:53:41",255,122,110,12,0,121,1,300,178,78,43
24,IAŞI,"SCOALA CIRJOAIA",407,COTNARI,96478,1,PART,PRCNCT,PRSD,PRSD_SV,"2025-05-18 21:30:27",1302,534,489,45,0,530,4,1400,866,354,176
24,IAŞI,"SCOALA HODORA",408,COTNARI,96478,1,PART,PRCNCT,PRSD,PRSD_SV,"2025-05-18 21:51:15",1291,521,485,36,0,511,10,1400,879,323,188
24,IAŞI,"SCOALA HORODISTEA",409,COTNARI,96478,1,PART,PRCNCT,PRSD,PRSD_SV,"2025-05-18 21:31:52",435,196,160,36,0,194,2,500,304,127,67
24,IAŞI,"SCOALA LUPARIA",410,COTNARI,96478,1,PART,PRCNCT,PRSD,PRSD_SV,"2025-05-18 21:33:07",268,142,113,29,0,139,3,300,158,72,67
24,IAŞI,"SCOALA VALEA RACULUI",411,COTNARI,96478,1,PART,PRCNCT,PRSD,PRSD_SV,"2025-05-18 21:41:58",251,113,100,13,0,112,1,300,187,75,37
24,IAŞI,"SCOALA ZBERENI",412,COTNARI,96478,1,PART,PRCNCT,PRSD,PRSD_SV,"2025-05-18 21:40:20",604,245,216,29,0,242,3,700,455,186,56
24,IAŞI,"ȘCOALA PROFESIONALĂ COZMEȘTI",413,COZMEŞTI,96593,1,PART,PRCNCT,PRSD,PRSD_SV,"2025-05-18 21:19:51",1295,198,175,22,1,189,9,1400,1202,109,80
24,IAŞI,"ȘCOALA PROFESIONALĂ COZMEȘTI",414,COZMEŞTI,96593,1,PART,PRCNCT,PRSD,PRSD_SV,"2025-05-18 21:23:47",1356,277,248,28,1,271,6,1500,1223,168,103
24,IAŞI,"GRĂDINIȚA CU PROGRAM NORMAL PODOLENII DE JOS",415,COZMEŞTI,96593,1,PART,PRCNCT,PRSD,PRSD_SV,"2025-05-18 21:17:56",419,115,97,18,0,115,0,500,385,83,32
24,IAŞI,"GRĂDINIȚA CU PROGRAM NORMAL PODOLENII DE SUS",416,COZMEŞTI,96593,1,PART,PRCNCT,PRSD,PRSD_SV,"2025-05-18 21:26:06",1550,291,255,36,0,290,1,1700,1409,182,108
24,IAŞI,"SCOALA PROFESIONALA CRISTEŞTI",417,CRISTEŞTI,96637,1,PART,PRCNCT,PRSD,PRSD_SV,"2025-05-18 21:22:49",1273,600,552,47,1,593,7,1400,800,361,232
24,IAŞI,"SCOALA PROFESIONALA CRISTEŞTI",418,CRISTEŞTI,96637,1,PART,PRCNCT,PRSD,PRSD_SV,"2025-05-18 21:36:30",1098,465,419,46,0,463,2,1200,735,271,192
24,IAŞI,"ŞCOALA PRIMARA HEREŞTI",419,CRISTEŞTI,96637,1,PART,PRCNCT,PRSD,PRSD_SV,"2025-05-18 21:21:09",496,295,208,86,1,293,2,500,205,159,134
24,IAŞI,"ŞCOALA HOMIŢA",420,CRISTEŞTI,96637,1,PART,PRCNCT,PRSD,PRSD_SV,"2025-05-18 21:27:37",304,148,121,27,0,142,6,400,252,73,69
24,IAŞI,"GRĂDINIŢA CUCUTENI",421,CUCUTENI,96664,1,PART,PRCNCT,PRSD,PRSD_SV,"2025-05-18 21:42:19",738,320,287,33,0,320,0,800,480,222,98
24,IAŞI,"CLĂDIRE SOCIALĂ BĂRBĂTEȘTI",422,CUCUTENI,96664,1,PART,PRCNCT,PRSD,PRSD_SV,"2025-05-18 21:32:28",143,84,64,20,0,84,0,200,116,50,34
24,IAŞI,"CASA DE PRĂZNUIRE PAROHIA” SF. ÎMPĂRAȚI CONSTANTIN ȘI ELENA”",423,CUCUTENI,96664,1,PART,PRCNCT,PRSD,PRSD_SV,"2025-05-18 21:25:15",223,113,85,28,0,109,4,300,187,81,28
24,IAŞI,"ȘCOALA PROFESIONALA DAGÎȚA - CORP NOU",424,DAGÂŢA,96717,1,PART,PRCNCT,PRSD,PRSD_SV,"2025-05-18 21:31:43",1320,599,542,54,3,598,1,1400,801,313,285
24,IAŞI,"ȘCOALA GIMNAZIALĂ BĂLUȘEȘTI",425,DAGÂŢA,96717,1,PART,PRCNCT,PRSD,PRSD_SV,"2025-05-18 21:14:15",141,82,57,25,0,82,0,200,118,54,28
24,IAŞI,"SCOALA PRIMARĂ BOATCA",426,DAGÂŢA,96717,1,PART,PRCNCT,PRSD,PRSD_SV,"2025-05-18 21:27:23",216,103,94,9,0,103,0,300,197,86,17
24,IAŞI,"SCOALA GENERALĂ MĂNĂSTIREA",427,DAGÂŢA,96717,1,PART,PRCNCT,PRSD,PRSD_SV,"2025-05-18 21:24:22",846,322,293,24,5,322,0,900,578,216,106
24,IAŞI,"SCOALA PRIMARĂ PISCU RUSULUI-SEDIUL NOU",428,DAGÂŢA,96717,1,PART,PRCNCT,PRSD,PRSD_SV,"2025-05-18 21:17:42",372,174,149,24,1,174,0,400,226,123,51
24,IAŞI,"CENTRU DE ORGANIZARE PENTRU INTEGRARE SI INFORMARE - C.O.P.I.I. PENTRU COMUNITATEA POIENILE",429,DAGÂŢA,96717,1,PART,PRCNCT,PRSD,PRSD_SV,"2025-05-18 21:23:41",242,112,92,20,0,112,0,300,188,73,39
24,IAŞI,"SCOALA PRIMARĂ ZECE PRAJINI",430,DAGÂŢA,96717,1,PART,PRCNCT,PRSD,PRSD_SV,"2025-05-18 21:23:24",386,175,150,24,1,172,3,400,225,148,24
24,IAŞI,"SCOALA GIMNAZIALA DELENI",431,DELENI,96815,1,PART,PRCNCT,PRSD,PRSD_SV,"2025-05-18 21:32:08",1617,648,613,35,0,642,6,1800,1152,445,197
24,IAŞI,"GRADINITA CU PROGRAM NORMAL DELENI ( SEDIUL NOU)",432,DELENI,96815,1,PART,PRCNCT,PRSD,PRSD_SV,"2025-05-18 21:26:48",1979,730,684,46,0,720,10,2200,1470,521,199
24,IAŞI,"SCOALA GIMNAZIALA FEREDENI",433,DELENI,96815,1,PART,PRCNCT,PRSD,PRSD_SV,"2025-05-18 21:38:22",604,265,237,28,0,259,6,700,435,187,72
24,IAŞI,"ȘCOALA GIMNAZIALĂ MAXUT CORP A",434,DELENI,96815,1,PART,PRCNCT,PRSD,PRSD_SV,"2025-05-18 21:26:41",1084,518,480,38,0,512,6,1200,682,296,216
24,IAŞI,"GRADINITA CU PROGRAM NORMAL MAXUT",435,DELENI,96815,1,PART,PRCNCT,PRSD,PRSD_SV,"2025-05-18 21:36:11",764,375,343,31,1,375,0,800,425,225,150
24,IAŞI,"GRADINITA CU PROGRAM NORMAL POIANA",436,DELENI,96815,1,PART,PRCNCT,PRSD,PRSD_SV,"2025-05-18 21:44:28",866,359,331,28,0,353,6,900,541,224,129
24,IAŞI,"SCOALA GIMNAZIALA SLOBOZIA",437,DELENI,96815,1,PART,PRCNCT,PRSD,PRSD_SV,"2025-05-18 21:39:11",892,369,339,30,0,364,5,1000,631,260,104
24,IAŞI,"ŞCOALA GENERALĂ NR.1 MOLDOVENI",438,DOBROVĂŢ,96888,1,PART,PRCNCT,PRSD,PRSD_SV,"2025-05-18 21:40:05",1070,507,406,101,0,501,6,1200,693,256,245
24,IAŞI,"CENTRU DE ZI AFTER SCHOOL RUSI",439,DOBROVĂŢ,96888,1,PART,PRCNCT,PRSD,PRSD_SV,"2025-05-18 21:35:42",764,346,285,61,0,343,3,800,454,209,134
24,IAŞI,"ȘCOALA DOLHEȘTI",440,DOLHEŞTI,96904,1,PART,PRCNCT,PRSD,PRSD_SV,"2025-05-18 21:25:28",543,239,219,20,0,237,2,600,361,124,113
24,IAŞI,"ȘCOALA BRĂDICEȘTI",441,DOLHEŞTI,96904,1,PART,PRCNCT,PRSD,PRSD_SV,"2025-05-18 21:34:51",710,292,260,32,0,288,4,800,508,157,131
24,IAŞI,"GRĂDINIȚA CU PROGRAM NORMAL PIETRIȘ",442,DOLHEŞTI,96904,1,PART,PRCNCT,PRSD,PRSD_SV,"2025-05-18 21:36:06",950,271,247,24,0,266,5,1000,729,222,44
24,IAŞI,"CĂMINUL CULTURAL DRĂGUŞENI",443,DRĂGUŞENI,100308,1,PART,PRCNCT,PRSD,PRSD_SV,"2025-05-18 21:36:05",720,278,236,42,0,270,8,800,522,160,110
24,IAŞI,"ŞCOALA FRENCIUGI",444,DRĂGUŞENI,100308,1,PART,PRCNCT,PRSD,PRSD_SV,"2025-05-18 21:47:05",411,193,159,34,0,191,2,500,307,119,72
24,IAŞI,"LICEUL TEHNOLOGIC DUMESTI",445,DUMEŞTI,96940,1,PART,PRCNCT,PRSD,PRSD_SV,"2025-05-18 21:26:35",1327,603,542,61,0,591,12,1500,897,366,225
24,IAŞI,"CASA DE PRAZNUIRE PAROHIA BANU",446,DUMEŞTI,96940,1,PART,PRCNCT,PRSD,PRSD_SV,"2025-05-18 21:17:48",330,195,159,36,0,193,2,400,205,130,63
24,IAŞI,"GRADINITA CU PROGRAM NORMAL CHILISOAIA",447,DUMEŞTI,96940,1,PART,PRCNCT,PRSD,PRSD_SV,"2025-05-18 21:20:52",168,99,85,14,0,99,0,200,101,69,30
24,IAŞI,"SCOALA PRIMARA HOISESTI",448,DUMEŞTI,96940,1,PART,PRCNCT,PRSD,PRSD_SV,"2025-05-18 21:34:38",614,279,238,41,0,278,1,700,421,209,69
24,IAŞI,"SCOALA GIMNAZIALA PAUSESTI",449,DUMEŞTI,96940,1,PART,PRCNCT,PRSD,PRSD_SV,"2025-05-18 21:34:11",1451,631,584,47,0,627,4,1600,969,476,151
24,IAŞI,"SCOALA GENERALA ERBICENI CORP CLADIRE",450,ERBICENI,97009,1,PART,PRCNCT,PRSD,PRSD_SV,"2025-05-18 21:50:57",939,430,372,58,0,425,5,1000,570,254,171
24,IAŞI,"SCOALA GENERALA ERBICENI CORP CLADIRE",451,ERBICENI,97009,1,PART,PRCNCT,PRSD,PRSD_SV,"2025-05-18 21:51:45",1038,410,381,29,0,405,5,1100,690,214,191
24,IAŞI,"SCOALA GENERALA BIRLESTI",452,ERBICENI,97009,1,PART,PRCNCT,PRSD,PRSD_SV,"2025-05-18 22:06:33",626,272,228,43,1,270,2,700,428,167,103
24,IAŞI,"SCOALA NR. 2 SPINOASA",453,ERBICENI,97009,1,PART,PRCNCT,PRSD,PRSD_SV,"2025-05-18 21:45:09",227,122,87,35,0,121,1,301,179,37,84
24,IAŞI,"SCOALA NR. 2 SPRANCEANA",454,ERBICENI,97009,1,PART,PRCNCT,PRSD,PRSD_SV,"2025-05-18 21:48:29",308,155,127,28,0,154,1,400,245,72,82
24,IAŞI,"SCOALA GENERALA TOTOESTI",455,ERBICENI,97009,1,PART,PRCNCT,PRSD,PRSD_SV,"2025-05-18 22:11:51",1354,572,512,60,0,568,4,1500,928,334,234
24,IAŞI,"GRĂDINIŢA NR.1 FÂNTÂNELE",456,FÂNTÂNELE,100317,1,PART,PRCNCT,PRSD,PRSD_SV,"2025-05-18 21:32:18",1535,693,648,45,0,688,5,1700,1007,452,236
24,IAŞI,"CĂMINUL CULTURAL",457,FOCURI,97063,1,PART,PRCNCT,PRSD,PRSD_SV,"2025-05-18 21:26:48",1447,550,477,73,0,546,4,1600,1050,351,195
24,IAŞI,"GRĂDINIŢA NR. 2, PĂŞCĂNENI",458,FOCURI,97063,1,PART,PRCNCT,PRSD,PRSD_SV,"2025-05-18 21:37:15",1527,542,502,40,0,537,5,1700,1158,365,172
24,IAŞI,"SCOALA GIMNAZIALA GOLAIESTI",459,GOLĂIEŞTI,97090,1,PART,PRCNCT,PRSD,PRSD_SV,"2025-05-18 21:33:54",1581,706,638,68,0,702,4,1700,994,451,251
24,IAŞI,"SCOALA PRIMARA CILIBIU",460,GOLĂIEŞTI,97090,1,PART,PRCNCT,PRSD,PRSD_SV,"2025-05-18 21:30:23",414,216,186,30,0,214,2,500,284,148,66
24,IAŞI,"SCOALA PRIMARA COTU LUI IVAN",461,GOLĂIEŞTI,97090,1,PART,PRCNCT,PRSD,PRSD_SV,"2025-05-18 21:25:38",299,144,119,25,0,141,3,300,156,88,53
24,IAŞI,"CASA DE PRĂZNUIRE GRĂDINARI",462,GOLĂIEŞTI,97090,1,PART,PRCNCT,PRSD,PRSD_SV,"2025-05-18 21:31:12",312,165,131,34,0,164,1,400,235,90,74
24,IAŞI,"CANTONUL PETREŞTI ADMINISTRAT DE CĂTRE ADMINISTRAŢIA BAZINALĂ DE APĂ PRUT-BÂRLAD",463,GOLĂIEŞTI,97090,1,PART,PRCNCT,PRSD,PRSD_SV,"2025-05-18 21:28:14",230,119,94,25,0,117,2,300,181,74,43
24,IAŞI,"CASA DE PRĂZNUIRE PAROHIA SFÂNTUL PROOROC ILIE TESVITEANUL",464,GOLĂIEŞTI,97090,1,PART,PRCNCT,PRSD,PRSD_SV,"2025-05-18 21:32:58",215,115,99,16,0,115,0,300,185,73,42
24,IAŞI,"SCOALA GIMNAZIALA",465,GORBAN,97189,1,PART,PRCNCT,PRSD,PRSD_SV,"2025-05-18 21:32:38",623,245,198,47,0,242,3,700,455,117,125
24,IAŞI,"ȘCOALA GIMNAZIALĂ GURA BOHOTIN",466,GORBAN,97189,1,PART,PRCNCT,PRSD,PRSD_SV,"2025-05-18 21:22:30",642,219,198,21,0,217,2,700,481,134,83
24,IAŞI,"ȘCOALA GIMNAZIALĂ GURA BOHOTIN",467,GORBAN,97189,1,PART,PRCNCT,PRSD,PRSD_SV,"2025-05-18 21:24:44",404,163,148,15,0,163,0,500,337,114,49
24,IAŞI,"ȘCOALA PRIMARĂ",468,GORBAN,97189,1,PART,PRCNCT,PRSD,PRSD_SV,"2025-05-18 21:33:48",503,213,183,30,0,212,1,600,387,121,91
24,IAŞI,"ȘCOALA PRIMARĂ",469,GORBAN,97189,1,PART,PRCNCT,PRSD,PRSD_SV,"2025-05-18 21:20:26",280,129,111,18,0,128,1,297,168,92,36
24,IAŞI,"SCOALA GIMNAZIALA GRAJDURI CORP A",470,GRAJDURI,97241,1,PART,PRCNCT,PRSD,PRSD_SV,"2025-05-18 21:36:44",1118,243,200,42,1,242,1,1200,957,155,87
24,IAŞI,"SCOALA GIMNAZIALA GRAJDURI CORP A",471,GRAJDURI,97241,1,PART,PRCNCT,PRSD,PRSD_SV,"2025-05-18 21:50:54",1637,218,205,12,1,214,4,1800,1582,167,47
24,IAŞI,"SCOALA PRIMARA CARBUNARI",472,GRAJDURI,97241,1,PART,PRCNCT,PRSD,PRSD_SV,"2025-05-18 21:34:45",727,102,94,8,0,102,0,800,698,75,27
24,IAŞI,"SCOALA PRIMARA PADURENI",473,GRAJDURI,97241,1,PART,PRCNCT,PRSD,PRSD_SV,"2025-05-18 21:20:25",731,117,83,34,0,115,2,800,683,60,55
24,IAŞI,"SCOALA PRIMARA PADURENI",474,GRAJDURI,97241,1,PART,PRCNCT,PRSD,PRSD_SV,"2025-05-18 21:17:03",564,125,105,20,0,125,0,600,475,73,52
24,IAŞI,"SCOALA PRIMARA POIANA CU CETATE",475,GRAJDURI,97241,1,PART,PRCNCT,PRSD,PRSD_SV,"2025-05-18 21:21:19",183,95,63,32,0,93,2,200,105,52,41
24,IAŞI,"SCOALA PRIMARA VALEA SATULUI",476,GRAJDURI,97241,1,PART,PRCNCT,PRSD,PRSD_SV,"2025-05-18 21:33:03",1024,113,88,25,0,113,0,1100,987,87,26
24,IAŞI,"SCOALA PRIMARA VALEA SATULUI",477,GRAJDURI,97241,1,PART,PRCNCT,PRSD,PRSD_SV,"2025-05-18 21:24:04",1270,166,153,13,0,163,3,1400,1234,115,48
24,IAŞI,"ȘCOALA PROFESIONALĂ GROPNIȚA",478,GROPNIŢA,97321,1,PART,PRCNCT,PRSD,PRSD_SV,"2025-05-18 21:39:03",326,146,129,17,0,144,2,400,254,72,72
24,IAŞI,"SEDIUL PRIMĂRIEI",479,GROPNIŢA,97321,1,PART,PRCNCT,PRSD,PRSD_SV,"2025-05-18 21:23:10",512,261,215,46,0,257,4,600,339,135,122
24,IAŞI,"CĂMIN CULTURAL FORĂŞTI",480,GROPNIŢA,97321,1,PART,PRCNCT,PRSD,PRSD_SV,"2025-05-18 21:33:49",423,225,193,32,0,223,2,500,275,137,86
24,IAŞI,"ȘCOALA PRIMARĂ MĂLĂEȘTI",481,GROPNIŢA,97321,1,PART,PRCNCT,PRSD,PRSD_SV,"2025-05-18 21:26:10",347,188,156,32,0,186,2,400,212,112,74
24,IAŞI,"ȘCOALA GIMNAZIALĂ SĂVENI",482,GROPNIŢA,97321,1,PART,PRCNCT,PRSD,PRSD_SV,"2025-05-18 21:16:28",608,286,253,33,0,283,3,700,414,146,137
24,IAŞI,"ŞCOALA PRIMARĂ SÂNGERI",483,GROPNIŢA,97321,1,PART,PRCNCT,PRSD,PRSD_SV,"2025-05-18 21:23:00",330,161,134,27,0,158,3,400,239,121,37
24,IAŞI,"SC. GIMNAZIALA GROZESTI",484,GROZEŞTI,97394,1,PART,PRCNCT,PRSD,PRSD_SV,"2025-05-18 21:36:49",1136,355,296,59,0,348,7,1200,845,227,121
24,IAŞI,"GRADINITA COLTU-CORNII",485,GROZEŞTI,97394,1,PART,PRCNCT,PRSD,PRSD_SV,"2025-05-18 21:26:52",536,174,150,24,0,174,0,600,426,100,74
24,IAŞI,"CAMIN CULTURAL HALAUCESTI",486,HĂLĂUCEŞTI,97438,1,PART,PRCNCT,PRSD,PRSD_SV,"2025-05-18 21:39:30",1311,553,462,90,1,548,5,1400,847,231,317
24,IAŞI,"CAMIN CULTURAL HALAUCESTI",487,HĂLĂUCEŞTI,97438,1,PART,PRCNCT,PRSD,PRSD_SV,"2025-05-18 21:43:05",1189,465,439,26,0,460,5,1300,835,192,268
24,IAŞI,"GRADINITA CU PROGRAM NORMAL HALAUCESTI",488,HĂLĂUCEŞTI,97438,1,PART,PRCNCT,PRSD,PRSD_SV,"2025-05-18 21:57:24",1411,569,518,50,1,566,3,1500,931,265,301
24,IAŞI,"SCOALA GENERALA LUNCASI",489,HĂLĂUCEŞTI,97438,1,PART,PRCNCT,PRSD,PRSD_SV,"2025-05-18 22:02:34",746,297,263,34,0,291,6,800,503,140,151
24,IAŞI,"ȘCOALA GIMNAZIALĂ HĂRMĂNEȘTII VECHI",490,HĂRMĂNEŞTI,100326,1,PART,PRCNCT,PRSD,PRSD_SV,"2025-05-18 21:57:38",1317,580,534,46,0,571,9,1400,820,359,212
24,IAŞI,"ŞCOALA HĂRMĂNEŞTII NOI",491,HĂRMĂNEŞTI,100326,1,PART,PRCNCT,PRSD,PRSD_SV,"2025-05-18 21:33:32",757,333,300,32,1,328,5,800,467,209,119
24,IAŞI,"SCOALA GIMNAZIALA HELESTENI",492,HELEŞTENI,97465,1,PART,PRCNCT,PRSD,PRSD_SV,"2025-05-18 21:42:58",653,346,298,47,1,340,6,700,354,227,113
24,IAŞI,"CENTRUL EDUCATIV PENTRU COPII SARACI HARMANEASA",493,HELEŞTENI,97465,1,PART,PRCNCT,PRSD,PRSD_SV,"2025-05-18 21:47:44",579,281,249,32,0,273,8,600,319,175,98
24,IAŞI,"CASA DE PRAZNUIRE",494,HELEŞTENI,97465,1,PART,PRCNCT,PRSD,PRSD_SV,"2025-05-18 21:18:01",165,88,68,20,0,88,0,200,112,53,35
24,IAŞI,"SCOALA GIMNAZIALA OBOROCENI",495,HELEŞTENI,97465,1,PART,PRCNCT,PRSD,PRSD_SV,"2025-05-18 21:29:41",574,235,207,24,4,234,1,600,365,147,87
24,IAŞI,"CĂMINUL CULTURAL HOLBOCA",496,HOLBOCA,95159,1,PART,PRCNCT,PRSD,PRSD_SV,"2025-05-18 21:48:39",1775,1052,924,125,3,1039,13,1900,848,423,616
24,IAŞI,"CĂMINUL CULTURAL HOLBOCA",497,HOLBOCA,95159,1,PART,PRCNCT,PRSD,PRSD_SV,"2025-05-18 21:50:10",1808,1081,978,102,1,1068,13,2000,919,479,589
24,IAŞI,"GRĂDINIȚA CU PROGRAM NORMAL CRISTEȘTI",498,HOLBOCA,95159,1,PART,PRCNCT,PRSD,PRSD_SV,"2025-05-18 21:22:41",642,303,264,39,0,303,0,700,397,178,125
24,IAŞI,"GRĂDINIȚA CU PROGRAM NORMAL DANCU",499,HOLBOCA,95159,1,PART,PRCNCT,PRSD,PRSD_SV,"2025-05-18 21:32:11",1294,720,639,81,0,720,0,1400,680,336,384
24,IAŞI,"GRĂDINIȚA CU PROGRAM NORMAL DANCU",500,HOLBOCA,95159,1,PART,PRCNCT,PRSD,PRSD_SV,"2025-05-18 21:33:04",1406,772,694,78,0,759,13,1500,728,351,408
24,IAŞI,"ȘCOALA GIMNAZIALĂ ” STEFAN CEL MARE” DANCU",501,HOLBOCA,95159,1,PART,PRCNCT,PRSD,PRSD_SV,"2025-05-18 21:39:25",1232,735,635,99,1,729,6,1400,665,328,401
24,IAŞI,"ȘCOALA GIMNAZIALĂ ” ȘTEFAN CEL MARE” DANCU",502,HOLBOCA,95159,1,PART,PRCNCT,PRSD,PRSD_SV,"2025-05-18 22:24:13",1497,810,718,90,2,793,17,1600,790,352,441
24,IAŞI,"ȘCOALA GIMNAZIALĂ ”ȘTEFAN CEL MARE” DANCU",503,HOLBOCA,95159,1,PART,PRCNCT,PRSD,PRSD_SV,"2025-05-18 22:35:55",1427,753,700,53,0,743,10,1600,847,316,427
24,IAŞI,"SPAȚIU COMERCIAL PROPRIETATE GOLĂESCU MARIA",504,HOLBOCA,95159,1,PART,PRCNCT,PRSD,PRSD_SV,"2025-05-18 22:03:50",616,314,277,37,0,309,5,700,386,189,120
24,IAŞI,"SCOALA CU CLASELE I-IV",505,HOLBOCA,95159,1,PART,PRCNCT,PRSD,PRSD_SV,"2025-05-18 21:13:58",347,194,172,22,0,192,2,400,206,117,75
24,IAŞI,"ȘCOALA PRIMARĂ RUSENII VECHI",506,HOLBOCA,95159,1,PART,PRCNCT,PRSD,PRSD_SV,"2025-05-18 21:20:21",534,253,220,33,0,249,4,600,347,126,123
24,IAŞI,"SCAOALA VALEA LUNGA",507,HOLBOCA,95159,1,PART,PRCNCT,PRSD,PRSD_SV,"2025-05-18 21:31:11",291,203,144,59,0,201,2,300,97,82,119
24,IAŞI,"ŞCOALA GIMNAZIALĂ HORLEŞTI CORP B",508,HORLEŞTI,97517,1,PART,PRCNCT,PRSD,PRSD_SV,"2025-05-18 21:52:24",878,386,333,52,1,383,3,1000,614,222,161
24,IAŞI,"ŞCOALA GIMNAZIALĂ HORLEŞTI CORP B",509,HORLEŞTI,97517,1,PART,PRCNCT,PRSD,PRSD_SV,"2025-05-18 21:34:11",687,255,232,23,0,255,0,800,545,150,105
24,IAŞI,"GRĂDINIȚA BOGDĂNEŞTI",510,HORLEŞTI,97517,1,PART,PRCNCT,PRSD,PRSD_SV,"2025-05-18 22:04:15",524,265,201,64,0,260,5,600,335,140,120
24,IAŞI,"FOSTA ŞCOALĂ SATUL SCOPOSENI",511,HORLEŞTI,97517,1,PART,PRCNCT,PRSD,PRSD_SV,"2025-05-18 22:13:49",232,118,102,16,0,118,0,300,182,93,25
24,IAŞI,"SCOALA GIMNAZIALA BUZNEA",512,"ION NECULCE",95499,1,PART,PRCNCT,PRSD,PRSD_SV,"2025-05-18 21:38:36",1489,699,644,55,0,687,12,1600,901,448,239
24,IAŞI,"SCOALA PRIMARA DADESTI",513,"ION NECULCE",95499,1,PART,PRCNCT,PRSD,PRSD_SV,"2025-05-18 21:21:40",205,124,97,27,0,123,1,300,176,80,43
24,IAŞI,"SCOALA GĂNEŞTI",514,"ION NECULCE",95499,1,PART,PRCNCT,PRSD,PRSD_SV,"2025-05-18 21:15:04",616,243,223,20,0,239,4,700,457,170,69
24,IAŞI,"CASA SOCIALA ION NECULCE",515,"ION NECULCE",95499,1,PART,PRCNCT,PRSD,PRSD_SV,"2025-05-18 21:20:47",168,91,70,21,0,90,1,200,109,69,21
24,IAŞI,"SCOALA PRIMARA PRIGORENI",516,"ION NECULCE",95499,1,PART,PRCNCT,PRSD,PRSD_SV,"2025-05-18 21:29:13",526,236,211,25,0,234,2,600,364,154,80
24,IAŞI,"SCOALA GIMNAZIALĂ ”CONSTANTIN TEODORESCU” RAZBOIENI",517,"ION NECULCE",95499,1,PART,PRCNCT,PRSD,PRSD_SV,"2025-05-18 21:40:50",1711,875,794,81,0,858,17,1900,1025,513,345
24,IAŞI,"SCOLA GIMNAZIALA”ION HAULICA”IPATELE",518,IPATELE,97553,1,PART,PRCNCT,PRSD,PRSD_SV,"2025-05-18 21:22:22",503,233,179,54,0,230,3,600,367,116,114
24,IAŞI,"CĂMIN CULTURAL BÎCU",519,IPATELE,97553,1,PART,PRCNCT,PRSD,PRSD_SV,"2025-05-18 21:42:30",404,232,182,50,0,227,5,500,268,136,91
24,IAŞI,"CĂMIN CULTURAL CUZA-VODĂ",520,IPATELE,97553,1,PART,PRCNCT,PRSD,PRSD_SV,"2025-05-18 21:33:46",394,210,168,33,9,207,3,400,190,94,113
24,IAŞI,"LICEUL TEHNOLOGIC LESPEZI",521,LESPEZI,97606,1,PART,PRCNCT,PRSD,PRSD_SV,"2025-05-18 21:40:03",786,324,290,34,0,321,3,900,576,188,133
24,IAŞI,"ȘCOALA GIMNAZIALĂ BUDA",522,LESPEZI,97606,3,PART,PRCNCT,PRSD,PRSD_SV,"2025-05-19 03:51:07",912,383,330,53,0,380,3,1000,617,287,93
24,IAŞI,"CĂMIN CULTURAL BERSUC DEAL",523,LESPEZI,97606,1,PART,PRCNCT,PRSD,PRSD_SV,"2025-05-18 21:31:28",666,323,285,38,0,320,3,700,377,219,101
24,IAŞI,"CONTAINER MODULAR",524,LESPEZI,97606,1,PART,PRCNCT,PRSD,PRSD_SV,"2025-05-18 21:36:31",598,258,233,25,0,256,2,700,442,190,66
24,IAŞI,"SCOALA GIMNAZIALA HECI",525,LESPEZI,97606,1,PART,PRCNCT,PRSD,PRSD_SV,"2025-05-18 21:36:46",904,386,351,35,0,383,3,1000,614,237,146
24,IAŞI,"SCOALA GIMNAZIALA HECI",526,LESPEZI,97606,1,PART,PRCNCT,PRSD,PRSD_SV,"2025-05-18 21:20:58",824,368,341,27,0,367,1,900,532,247,120
24,IAŞI,"SCOALA GIMNAZIALA LETCANI",527,LEŢCANI,97679,1,PART,PRCNCT,PRSD,PRSD_SV,"2025-05-18 22:39:28",2029,1151,1053,97,1,1145,6,2200,1049,539,606
24,IAŞI,"SCOALA GIMNAZIALA LETCANI",528,LEŢCANI,97679,1,PART,PRCNCT,PRSD,PRSD_SV,"2025-05-18 22:27:11",1866,1040,917,123,0,1025,15,2000,960,487,538
24,IAŞI,"SCOALA PRIMARA BOGONOS",529,LEŢCANI,97679,1,PART,PRCNCT,PRSD,PRSD_SV,"2025-05-18 21:39:08",601,344,302,40,2,342,2,700,356,197,145
24,IAŞI,"SCOALA GIMNAZIALA COGEASCA",530,LEŢCANI,97679,1,PART,PRCNCT,PRSD,PRSD_SV,"2025-05-18 22:00:44",1622,734,666,68,0,723,11,1800,1066,418,305
24,IAŞI,"SCOALA PRIMARA CUCUTENI",531,LEŢCANI,97679,1,PART,PRCNCT,PRSD,PRSD_SV,"2025-05-18 21:40:06",389,207,169,38,0,203,4,400,193,126,77
24,IAŞI,"LICEUL TEHNOLOGIC LUNGANI",532,LUNGANI,97722,1,PART,PRCNCT,PRSD,PRSD_SV,"2025-05-18 21:49:42",898,406,363,43,0,405,1,1000,594,230,175
24,IAŞI,"SCOALA GIMNAZIALA CRUCEA",533,LUNGANI,97722,1,PART,PRCNCT,PRSD,PRSD_SV,"2025-05-18 21:37:01",1313,383,364,19,0,367,16,1400,1017,202,165
24,IAŞI,"GRADINITA DIN CADRUL SCOLII GIMNAZIALE GOESTI",534,LUNGANI,97722,1,PART,PRCNCT,PRSD,PRSD_SV,"2025-05-18 21:48:30",693,318,292,26,0,312,6,800,482,219,93
24,IAŞI,"SCOALA GIMNAZIALA ZMEU",535,LUNGANI,97722,1,PART,PRCNCT,PRSD,PRSD_SV,"2025-05-18 21:55:22",1499,636,605,31,0,631,5,1600,964,285,346
24,IAŞI,"IMOBIL CRESA",536,MĂDÂRJAC,97777,1,PART,PRCNCT,PRSD,PRSD_SV,"2025-05-18 21:41:12",1139,470,406,55,9,466,4,1300,830,344,122
24,IAŞI,"ŞCOALA GIMNAZIALA VASILE ALECSANDRI MIRCESTI",537,MIRCEŞTI,97811,1,PART,PRCNCT,PRSD,PRSD_SV,"2025-05-18 22:05:10",1208,482,431,40,11,471,11,1300,818,248,223
24,IAŞI,"ŞCOALA GIMNAZIALĂ IUGANI - ŞCOALA NOUĂ",538,MIRCEŞTI,97811,1,PART,PRCNCT,PRSD,PRSD_SV,"2025-05-18 22:01:00",1361,599,566,33,0,594,5,1500,901,237,357
24,IAŞI,"ŞCOALA GIMNAZIALĂ IUGANI - ŞCOALA NOUĂ",539,MIRCEŞTI,97811,1,PART,PRCNCT,PRSD,PRSD_SV,"2025-05-18 21:26:49",516,234,217,17,0,233,1,600,366,79,154
24,IAŞI,"SCOALA GIMNAZIALA MIRONEASA",540,MIRONEASA,97875,1,PART,PRCNCT,PRSD,PRSD_SV,"2025-05-18 21:30:43",1273,293,261,32,0,292,1,1400,1107,188,104
24,IAŞI,"SCOALA GIMNAZIALA MIRONEASA",541,MIRONEASA,97875,1,PART,PRCNCT,PRSD,PRSD_SV,"2025-05-18 22:00:04",1265,384,354,28,2,378,6,1400,1016,250,128
24,IAŞI,"SCOALA GIMNAZIALA MIRONEASA",542,MIRONEASA,97875,1,PART,PRCNCT,PRSD,PRSD_SV,"2025-05-18 21:37:07",1038,332,315,17,0,328,4,1100,768,200,128
24,IAŞI,"SCOALA GIMNAZIALA URSITA",543,MIRONEASA,97875,1,PART,PRCNCT,PRSD,PRSD_SV,"2025-05-18 21:55:45",515,239,208,31,0,236,3,600,361,152,84
24,IAŞI,"GRĂDINIȚA CU PROGRAM NORMAL MIROSLAVA (CORP A)",544,MIROSLAVA,97919,1,PART,PRCNCT,PRSD,PRSD_SV,"2025-05-18 22:54:45",1713,1276,928,348,0,1263,13,1900,624,354,909
24,IAŞI,"GRĂDINIȚA CU PROGRAM NORMAL MIROSLAVA (CORP B)",545,MIROSLAVA,97919,1,PART,PRCNCT,PRSD,PRSD_SV,"2025-05-18 22:35:24",1570,1094,861,233,0,1090,4,1700,606,344,746
24,IAŞI,"GRĂDINIȚA CU PROGRAM NORMAL MIROSLAVA (CORP B)",546,MIROSLAVA,97919,1,PART,PRCNCT,PRSD,PRSD_SV,"2025-05-18 22:13:10",1738,1167,1006,160,1,1145,22,1900,733,338,807
24,IAŞI,"SALA DE SPORT -MIROSLAVA",547,MIROSLAVA,97919,1,PART,PRCNCT,PRSD,PRSD_SV,"2025-05-18 22:21:26",1883,1604,1147,456,1,1589,15,2100,496,440,1149
24,IAŞI,"SCOALA CU CLASELE I-IV BRĂTULENI",548,MIROSLAVA,97919,1,PART,PRCNCT,PRSD,PRSD_SV,"2025-05-18 22:37:02",342,222,167,55,0,220,2,400,178,116,104
24,IAŞI,"GRĂDINIȚA CU PROGRAM NORMAL CIURBEȘTI",549,MIROSLAVA,97919,1,PART,PRCNCT,PRSD,PRSD_SV,"2025-05-18 22:10:23",1126,659,555,104,0,650,9,1200,541,320,330
24,IAŞI,"CENTRU DE ZI NUMĂRUL 1 SAT CORNEȘTI",550,MIROSLAVA,97919,1,PART,PRCNCT,PRSD,PRSD_SV,"2025-05-18 22:13:41",1455,764,678,86,0,760,4,1600,836,438,322
24,IAŞI,"GRADINITA CU PROGRAM NORMAL -HORPAZ",551,MIROSLAVA,97919,3,PART,PRCNCT,PRSD,PRSD_SV,"2025-05-19 02:24:11",1812,1255,1028,227,0,1230,18,2000,745,294,936
24,IAŞI,"GRĂDINIŢA CU PROGRAM NORMAL",552,MIROSLAVA,97919,1,PART,PRCNCT,PRSD,PRSD_SV,"2025-05-18 21:52:10",1778,1290,1042,248,0,1282,8,2000,710,440,842
24,IAŞI,"SCOALA GIMNAZIALA ”MIRON BARNOVSCHI”-URICANI",553,MIROSLAVA,97919,1,PART,PRCNCT,PRSD,PRSD_SV,"2025-05-18 21:54:35",1255,800,626,174,0,793,7,1400,600,291,502
24,IAŞI,"GRĂDINIȚA CU PROGRAM NORMAL-VALEA ADÂNCĂ ( CORP A)",554,MIROSLAVA,97919,1,PART,PRCNCT,PRSD,PRSD_SV,"2025-05-18 22:25:34",1638,992,847,143,2,986,6,1800,808,268,718
24,IAŞI,"GRĂDINIȚA CU PROGRAM NORMAL-VALEA ADÂNCĂ (CORP B)",555,MIROSLAVA,97919,1,PART,PRCNCT,PRSD,PRSD_SV,"2025-05-18 22:06:13",1694,1068,898,169,1,1054,14,1900,832,267,787
24,IAŞI,"GRADINITA CU PROGRAM NORMAL-VALEA ADINCA",556,MIROSLAVA,97919,1,PART,PRCNCT,PRSD,PRSD_SV,"2025-05-18 22:38:16",1524,1068,945,122,1,1058,10,1700,632,299,759
24,IAŞI,"GRADINITA CU PROGRAM NORMAL-VALEA ADINCA",557,MIROSLAVA,97919,1,PART,PRCNCT,PRSD,PRSD_SV,"2025-05-18 22:08:46",1580,1010,872,135,3,1007,3,1700,690,292,715
24,IAŞI,"IMOBIL ACHIȚEI-VALEA ADÂNCĂ",558,MIROSLAVA,97919,1,PART,PRCNCT,PRSD,PRSD_SV,"2025-05-18 22:35:56",1856,1416,1144,272,0,1409,7,2000,584,408,1001
24,IAŞI,"IMOBIL ACHIȚEI-VALEA ADÂNCĂ",559,MIROSLAVA,97919,1,PART,PRCNCT,PRSD,PRSD_SV,"2025-05-18 22:39:24",1448,1275,858,417,0,1266,9,1600,325,360,906
24,IAŞI,"SCOALA PRIMARA-VOROVESTI",560,MIROSLAVA,97919,1,PART,PRCNCT,PRSD,PRSD_SV,"2025-05-18 22:16:27",1679,1141,939,202,0,1133,8,1800,659,308,825
24,IAŞI,"SCOALA GIMNAZIALA MIROSLOVESTI",561,MIROSLOVEŞTI,98051,1,PART,PRCNCT,PRSD,PRSD_SV,"2025-05-18 22:06:06",1497,637,556,80,1,631,6,1600,963,330,301
24,IAŞI,"SCOALA GIMNAZIALA SOCI",562,MIROSLOVEŞTI,98051,1,PART,PRCNCT,PRSD,PRSD_SV,"2025-05-18 21:59:45",978,424,371,53,0,419,5,1100,676,221,198
24,IAŞI,"SCOALA GIMNAZIALA VERSENI",563,MIROSLOVEŞTI,98051,1,PART,PRCNCT,PRSD,PRSD_SV,"2025-05-18 21:34:09",907,415,361,54,0,409,6,1000,585,282,127
24,IAŞI,"ȘCOALA PROFESIONALĂ MOGOȘEȘTI",564,MOGOŞEŞTI,98113,1,PART,PRCNCT,PRSD,PRSD_SV,"2025-05-18 21:37:23",1364,632,565,67,0,626,6,1500,868,448,178
24,IAŞI,"ȘCOALA PROFESIONALĂ MOGOȘEȘTI",565,MOGOŞEŞTI,98113,1,PART,PRCNCT,PRSD,PRSD_SV,"2025-05-18 21:40:49",1022,420,381,39,0,416,4,1100,680,284,132
24,IAŞI,"ȘCOALA PRIMARĂ BUDEȘTI",566,MOGOŞEŞTI,98113,1,PART,PRCNCT,PRSD,PRSD_SV,"2025-05-18 22:10:13",330,141,114,27,0,139,2,400,259,94,45
24,IAŞI,"ȘCOALA GIMNAZIALĂ HADÂMBU",567,MOGOŞEŞTI,98113,1,PART,PRCNCT,PRSD,PRSD_SV,"2025-05-18 21:27:33",807,354,271,83,0,347,7,900,546,233,114
24,IAŞI,"ŞCOALA GIMNAZIALĂ MÎNJEȘTI, CORP CLĂDIRE NR. 2",568,MOGOŞEŞTI,98113,1,PART,PRCNCT,PRSD,PRSD_SV,"2025-05-18 22:04:40",500,247,215,32,0,244,3,600,353,159,85
24,IAŞI,"SCOALA GIMNAZIALA MOGOSESTI-SIRET",569,MOGOŞEŞTI-SIRET,98168,1,PART,PRCNCT,PRSD,PRSD_SV,"2025-05-18 22:00:00",1221,583,510,73,0,576,7,1300,717,336,240
24,IAŞI,"SCOALA GIMNAZIALA MUNCELU DE SUS",570,MOGOŞEŞTI-SIRET,98168,1,PART,PRCNCT,PRSD,PRSD_SV,"2025-05-18 21:46:53",904,411,372,38,1,403,8,1000,589,261,142
24,IAŞI,"SCOALA GIMNAZIALA MUNCELU DE SUS",571,MOGOŞEŞTI-SIRET,98168,1,PART,PRCNCT,PRSD,PRSD_SV,"2025-05-18 21:50:18",865,400,366,34,0,396,4,900,500,254,142
24,IAŞI,"ŞCOALA GIMNAZIALĂ MOŞNA",572,MOŞNA,98202,1,PART,PRCNCT,PRSD,PRSD_SV,"2025-05-18 21:26:15",1231,101,101,0,0,100,1,1300,1199,71,29
24,IAŞI,"ȘCOALA GIMNAZIALĂ MOȘNA",573,MOŞNA,98202,1,PART,PRCNCT,PRSD,PRSD_SV,"2025-05-18 21:45:59",1239,256,256,0,0,251,5,1300,1044,125,126
24,IAŞI,"ȘCOALA GIMNAZIALĂ MOȘNA",574,MOŞNA,98202,1,PART,PRCNCT,PRSD,PRSD_SV,"2025-05-18 21:37:54",1284,214,212,1,1,211,3,1400,1186,111,100
24,IAŞI,"ȘCOALA GIMNAZIALĂ MOȘNA",575,MOŞNA,98202,1,PART,PRCNCT,PRSD,PRSD_SV,"2025-05-18 21:35:20",1008,43,0,43,0,42,1,400,357,18,24
24,IAŞI,"ȘCOALA GIMNAZIALĂ MOȘNA",576,MOŞNA,98202,1,PART,PRCNCT,PRSD,PRSD_SV,"2025-05-18 21:32:40",1309,41,35,6,0,40,1,400,359,23,17
24,IAŞI,"CĂMIN CULTURAL",577,MOŢCA,98220,1,PART,PRCNCT,PRSD,PRSD_SV,"2025-05-18 22:55:27",1490,731,693,37,1,719,12,1600,869,482,237
24,IAŞI,"CĂMIN CULTURAL",578,MOŢCA,98220,1,PART,PRCNCT,PRSD,PRSD_SV,"2025-05-18 22:23:39",1459,648,596,52,0,642,6,1600,952,434,208
24,IAŞI,"CĂMINUL CULTURAL BOURENI",579,MOŢCA,98220,1,PART,PRCNCT,PRSD,PRSD_SV,"2025-05-18 22:00:46",1147,450,404,46,0,440,10,1300,850,304,136
24,IAŞI,"CASA DE PRĂZNUIRE PAROHIA MOVILENI",580,MOVILENI,98257,1,PART,PRCNCT,PRSD,PRSD_SV,"2025-05-18 21:36:51",421,220,188,32,0,219,1,500,280,119,100
24,IAŞI,"CASA DE PRĂZNUIRE PAROHIA IEPURENI",581,MOVILENI,98257,1,PART,PRCNCT,PRSD,PRSD_SV,"2025-05-18 21:35:13",669,313,272,41,0,310,3,700,387,159,151
24,IAŞI,"SCOALA GIMNAZIALA LARGA JIJIA",582,MOVILENI,98257,1,PART,PRCNCT,PRSD,PRSD_SV,"2025-05-18 21:23:26",573,292,249,43,0,287,5,600,308,128,159
24,IAŞI,"GRĂDINIȚA CU PROGRAM NORMAL POTÂNGENI",583,MOVILENI,98257,1,PART,PRCNCT,PRSD,PRSD_SV,"2025-05-18 21:47:33",743,329,285,44,0,319,10,800,471,206,113
24,IAŞI,"CĂMIN CULTURAL - SALA I OTELENI",584,OŢELENI,98300,1,PART,PRCNCT,PRSD,PRSD_SV,"2025-05-18 22:01:57",968,428,377,50,1,423,5,1100,672,221,202
24,IAŞI,"CĂMIN CULTURAL - SALA II OTELENI",585,OŢELENI,98300,1,PART,PRCNCT,PRSD,PRSD_SV,"2025-05-18 21:49:12",1033,376,351,21,4,372,4,1100,724,183,189
24,IAŞI,"SCOALA GIMNAZIALA HINDRESTI",586,OŢELENI,98300,1,PART,PRCNCT,PRSD,PRSD_SV,"2025-05-18 21:44:35",866,354,304,50,0,350,4,900,546,239,111
24,IAŞI,"LICEUL TEHNOLOGIC PLUGARI",587,PLUGARI,98337,1,PART,PRCNCT,PRSD,PRSD_SV,"2025-05-18 21:56:53",1493,640,532,70,38,635,5,1600,960,350,285
24,IAŞI,"SCOALA GIMNAZIALA BOROSOAIA",588,PLUGARI,98337,1,PART,PRCNCT,PRSD,PRSD_SV,"2025-05-18 21:57:12",1173,481,419,42,20,479,2,1300,819,242,237
24,IAŞI,"SCOALA GENERALA ” DIMITRIE STURDZA ”POPESTI",589,POPEŞTI,98435,1,PART,PRCNCT,PRSD,PRSD_SV,"2025-05-18 21:41:09",920,392,358,34,0,391,1,1000,608,262,129
24,IAŞI,"SCOALA GENERALA ”DIMITRIE STURDZA”POPESTI",590,POPEŞTI,98435,1,PART,PRCNCT,PRSD,PRSD_SV,"2025-05-18 21:33:48",871,392,343,48,1,390,2,1000,608,273,117
24,IAŞI,"ŞCOALA PRIMARA DOROSCANI",591,POPEŞTI,98435,1,PART,PRCNCT,PRSD,PRSD_SV,"2025-05-18 21:37:32",440,210,183,27,0,209,1,500,290,129,80
24,IAŞI,"ŞCOALA GIMNAZIALA HARPASESTI,CORP CLADIRE NOU,SALA DIN PARTEA DREAPTA,PARTER",592,POPEŞTI,98435,1,PART,PRCNCT,PRSD,PRSD_SV,"2025-05-18 22:10:09",786,298,278,18,2,295,3,900,602,224,71
24,IAŞI,"ŞCOALA PRIMARA ”NICOLAIE BUTESCU” OBRIJENI",593,POPEŞTI,98435,1,PART,PRCNCT,PRSD,PRSD_SV,"2025-05-18 21:45:54",1559,73,56,17,0,73,0,400,327,43,30
24,IAŞI,"ŞCOALA PRIMARA ”NICOLAIE BUTESCU” OBRIJENI",594,POPEŞTI,98435,1,PART,PRCNCT,PRSD,PRSD_SV,"2025-05-18 21:48:16",1320,50,35,15,0,50,0,400,350,24,26
24,IAŞI,"SCOALA GIMNAZIALA POPRICANI",595,POPRICANI,98505,1,PART,PRCNCT,PRSD,PRSD_SV,"2025-05-18 21:43:01",1376,780,673,106,1,775,5,1500,720,384,391
24,IAŞI,"SCOALA GIMNAZIALA POPRICANI",596,POPRICANI,98505,1,PART,PRCNCT,PRSD,PRSD_SV,"2025-05-18 21:49:19",1263,652,603,48,1,647,5,1400,748,317,330
24,IAŞI,"SCOALA PRIMARA CIRLIG",597,POPRICANI,98505,1,PART,PRCNCT,PRSD,PRSD_SV,"2025-05-18 22:17:11",773,463,364,99,0,458,5,800,337,238,220
24,IAŞI,"SCOALA PRIMARA COTU MORII",598,POPRICANI,98505,1,PART,PRCNCT,PRSD,PRSD_SV,"2025-05-18 21:18:55",218,132,97,35,0,132,0,300,168,76,56
24,IAŞI,"SCOALA PRIMARA CUZA- VODA",599,POPRICANI,98505,1,PART,PRCNCT,PRSD,PRSD_SV,"2025-05-18 21:43:56",540,244,219,25,0,242,2,600,356,106,136
24,IAŞI,"SCOALA GIMNAZIALA POPRICANI",600,POPRICANI,98505,1,PART,PRCNCT,PRSD,PRSD_SV,"2025-05-18 21:24:37",418,226,202,24,0,224,2,500,274,140,84
24,IAŞI,"SCOALA PRIMARA TIPILESTI",601,POPRICANI,98505,1,PART,PRCNCT,PRSD,PRSD_SV,"2025-05-18 21:33:10",302,197,146,51,0,196,1,400,203,102,94
24,IAŞI,"SCOALA GIMNAZIALA VINATORI",602,POPRICANI,98505,1,PART,PRCNCT,PRSD,PRSD_SV,"2025-05-18 21:56:27",1395,768,661,106,1,757,11,1500,732,406,351
24,IAŞI,"SCOALA GIMNAZIALA VINATORI",603,POPRICANI,98505,1,PART,PRCNCT,PRSD,PRSD_SV,"2025-05-18 21:52:05",863,498,420,75,3,496,2,900,402,271,225
24,IAŞI,"GRADINITA CU PROGRAM NORMAL PRISĂCANI",604,PRISĂCANI,98603,1,PART,PRCNCT,PRSD,PRSD_SV,"2025-05-18 22:03:19",1326,667,589,77,1,661,6,1500,833,298,363
24,IAŞI,"ȘCOALA PRIMARĂ MĂCĂREȘTI",605,PRISĂCANI,98603,1,PART,PRCNCT,PRSD,PRSD_SV,"2025-05-18 21:11:46",1615,32,1,31,0,32,0,400,368,16,16
24,IAŞI,"SCOALA GIMNAZIALA MACARESTI",606,PRISĂCANI,98603,1,PART,PRCNCT,PRSD,PRSD_SV,"2025-05-18 21:26:09",1283,202,184,18,0,202,0,1400,1198,118,84
24,IAŞI,"SCOALA GIMNAZIALA MACARESTI",607,PRISĂCANI,98603,1,PART,PRCNCT,PRSD,PRSD_SV,"2025-05-18 21:10:24",1462,20,1,19,0,20,0,400,380,6,14
24,IAŞI,"CASA PAROHIALĂ MORENI",608,PRISĂCANI,98603,1,PART,PRCNCT,PRSD,PRSD_SV,"2025-05-18 21:38:26",801,429,377,50,2,425,4,900,471,226,199
24,IAŞI,"SCOLA GIMNAZIALA”PETRU ANGHEL”PROBOTA",609,PROBOTA,98649,1,PART,PRCNCT,PRSD,PRSD_SV,"2025-05-18 21:27:13",980,410,368,41,1,409,1,1100,690,268,141
24,IAŞI,"ȘCOALA PRIMARĂ BĂLTENI",610,PROBOTA,98649,1,PART,PRCNCT,PRSD,PRSD_SV,"2025-05-18 21:33:33",624,320,281,39,0,317,3,700,380,215,102
24,IAŞI,"SCOLA GIMNAZIALA PERIENI",611,PROBOTA,98649,1,PART,PRCNCT,PRSD,PRSD_SV,"2025-05-18 21:38:19",1198,541,469,72,0,536,5,1300,759,274,262
24,IAŞI,"SCOALA NOUA RACHITENI",612,RĂCHITENI,100335,1,PART,PRCNCT,PRSD,PRSD_SV,"2025-05-18 21:53:25",1555,509,454,52,3,507,2,1700,1191,244,263
24,IAŞI,"SCOALA IZVOARELE",613,RĂCHITENI,100335,1,PART,PRCNCT,PRSD,PRSD_SV,"2025-05-18 21:31:36",1127,380,352,28,0,374,6,1200,820,169,205
24,IAŞI,"ȘCOALA GENERALĂ RĂDUCĂNENI",614,RĂDUCĂNENI,98685,1,PART,PRCNCT,PRSD,PRSD_SV,"2025-05-18 21:24:20",1287,476,403,28,45,476,0,1400,924,177,299
24,IAŞI,"ȘCOALA GENERALĂ RĂDUCĂNENI",615,RĂDUCĂNENI,98685,1,PART,PRCNCT,PRSD,PRSD_SV,"2025-05-18 22:01:30",1650,452,393,59,0,451,1,1800,1348,288,163
24,IAŞI,"ŞCOALA GENERALA RADUCANENI",616,RĂDUCĂNENI,98685,1,PART,PRCNCT,PRSD,PRSD_SV,"2025-05-18 21:48:32",1300,423,376,47,0,417,6,1400,977,181,236
24,IAŞI,"ȘCOALA PRIMARĂ BAZGA",617,RĂDUCĂNENI,98685,1,PART,PRCNCT,PRSD,PRSD_SV,"2025-05-18 21:46:38",1242,456,416,40,0,448,8,1400,944,228,220
24,IAŞI,"SCOALA GENERALA BOHOTIN",618,RĂDUCĂNENI,98685,1,PART,PRCNCT,PRSD,PRSD_SV,"2025-05-18 21:44:13",1327,504,426,77,1,502,2,1500,996,267,235
24,IAŞI,"ŞCOALA GENERALĂ ISAIIA",619,RĂDUCĂNENI,98685,1,PART,PRCNCT,PRSD,PRSD_SV,"2025-05-18 21:19:08",277,123,92,31,0,123,0,300,177,76,47
24,IAŞI,"ȘCOALA GIMNAZIALĂ ROȘU",620,RĂDUCĂNENI,98685,1,PART,PRCNCT,PRSD,PRSD_SV,"2025-05-18 21:33:37",601,138,123,14,1,136,2,700,562,75,61
24,IAŞI,"GRĂDINIȚA CU PROGRAM NORMAL REDIU",621,REDIU,95239,2,PART,PRCNCT,PRSD,PRSD_SV,"2025-05-19 03:07:52",1420,751,669,80,2,749,2,1600,849,227,522
24,IAŞI,"ȘCOALĂ GIMNAZIALĂ REDIU",622,REDIU,95239,1,PART,PRCNCT,PRSD,PRSD_SV,"2025-05-18 22:28:25",1688,1097,892,205,0,1091,6,1800,703,257,834
24,IAŞI,"ȘCOALA GIMNAZIALĂ REDIU",623,REDIU,95239,1,PART,PRCNCT,PRSD,PRSD_SV,"2025-05-18 21:54:42",1220,764,499,265,0,760,4,1300,536,222,538
24,IAŞI,"SALA DE CONFERINȚĂ",624,REDIU,95239,1,PART,PRCNCT,PRSD,PRSD_SV,"2025-05-18 22:30:19",1550,974,853,120,1,966,8,1700,726,282,684
24,IAŞI,"SALA DE CONFERINȚĂ",625,REDIU,95239,1,PART,PRCNCT,PRSD,PRSD_SV,"2025-05-18 22:06:03",1037,808,589,219,0,803,5,1100,292,220,583
24,IAŞI,"SCOALA GIMNAZIALA HORLESTI",626,REDIU,95239,2,PART,PRCNCT,PRSD,PRSD_SV,"2025-05-19 00:24:46",1064,502,408,94,0,501,1,1200,698,261,240
24,IAŞI,"SCOALA GIMNAZIALA ”IOANID ROMANESCU” ROMANESTI",627,ROMÂNEŞTI,98738,1,PART,PRCNCT,PRSD,PRSD_SV,"2025-05-18 21:52:28",705,390,314,66,10,385,5,800,410,231,154
24,IAŞI,"SCOALA PRIMARA AVINTU",628,ROMÂNEŞTI,98738,1,PART,PRCNCT,PRSD,PRSD_SV,"2025-05-18 22:06:34",345,214,147,60,7,211,3,400,186,116,95
24,IAŞI,"SCOALA GIMNAZIALA URSOAIA",629,ROMÂNEŞTI,98738,1,PART,PRCNCT,PRSD,PRSD_SV,"2025-05-18 22:04:41",340,195,144,51,0,194,1,400,205,116,78
24,IAŞI,"GRĂDINIȚA CU PROGRAM NORMAL RĂDENI",630,ROŞCANI,100344,1,PART,PRCNCT,PRSD,PRSD_SV,"2025-05-18 21:33:45",607,309,267,42,0,304,5,700,391,205,99
24,IAŞI,"ȘCOALA PRIMARĂ ROȘCANI, NR. 1",631,ROŞCANI,100344,1,PART,PRCNCT,PRSD,PRSD_SV,"2025-05-18 21:20:39",550,238,211,27,0,237,1,600,362,166,71
24,IAŞI,"ŞCOALA GIMNAZIALĂ RUGINOASA",632,RUGINOASA,98774,1,PART,PRCNCT,PRSD,PRSD_SV,"2025-05-18 21:50:25",828,440,376,64,0,435,5,900,460,275,160
24,IAŞI,"ŞCOALA GIMNAZIALĂ RUGINOASA",633,RUGINOASA,98774,1,PART,PRCNCT,PRSD,PRSD_SV,"2025-05-18 21:47:40",696,345,282,63,0,340,5,800,455,215,125
24,IAŞI,"ŞCOALA GIMNAZIALĂ DUMBRĂVIŢA",634,RUGINOASA,98774,1,PART,PRCNCT,PRSD,PRSD_SV,"2025-05-18 21:58:02",1144,502,473,29,0,496,6,1300,798,364,132
24,IAŞI,"ŞCOALA GIMNAZIALĂ DUMBRĂVIŢA",635,RUGINOASA,98774,1,PART,PRCNCT,PRSD,PRSD_SV,"2025-05-18 21:45:20",859,372,332,40,0,369,3,900,528,277,92
24,IAŞI,"ŞCOALA GIMNAZIALĂ REDIU",636,RUGINOASA,98774,1,PART,PRCNCT,PRSD,PRSD_SV,"2025-05-18 21:39:55",952,396,374,22,0,393,3,1000,604,273,120
24,IAŞI,"ŞCOALA VASCANI",637,RUGINOASA,98774,1,PART,PRCNCT,PRSD,PRSD_SV,"2025-05-18 21:49:43",383,191,158,32,1,190,1,400,209,113,77
24,IAŞI,"ȘCOALA GIMNAZIALĂ ”AXINTE URICARIUL” SCÂNTEIA, CORP A",638,SCÂNTEIA,98916,1,PART,PRCNCT,PRSD,PRSD_SV,"2025-05-18 21:18:02",1596,199,184,15,0,199,0,1700,1501,125,74
24,IAŞI,"ȘCOALA GIMNAZIALĂ ”AXINTE URICARIUL” SCÂNTEIA, CORP A",639,SCÂNTEIA,98916,1,PART,PRCNCT,PRSD,PRSD_SV,"2025-05-18 21:18:16",1589,142,122,20,0,141,1,1700,1558,84,57
24,IAŞI,"ȘCOALA GIMNAZIALĂ ”AXINTE URICARIUL” SCÂNTEIA, CORP A",640,SCÂNTEIA,98916,1,PART,PRCNCT,PRSD,PRSD_SV,"2025-05-18 21:19:16",1595,105,96,9,0,105,0,400,295,68,37
24,IAŞI,"ȘCOALA GIMNAZIALĂ ”AXINTE URICARIUL” SCÂNTEIA, CORP A",641,SCÂNTEIA,98916,1,PART,PRCNCT,PRSD,PRSD_SV,"2025-05-18 21:18:52",1575,102,93,9,0,102,0,400,298,73,29
24,IAŞI,"GRĂDINIȚA CU PROGRAM NORMAL SCÂNTEIA",642,SCÂNTEIA,98916,1,PART,PRCNCT,PRSD,PRSD_SV,"2025-05-18 21:23:10",1704,54,35,19,0,53,1,400,346,31,22
24,IAŞI,"GRĂDINIȚA CU PROGRAM NORMAL SCÂNTEIA",643,SCÂNTEIA,98916,1,PART,PRCNCT,PRSD,PRSD_SV,"2025-05-18 21:38:29",1460,167,144,21,2,165,2,1600,1433,123,42
24,IAŞI,"ŞCOALA GIMNAZIALĂ BODEŞTI",644,SCÂNTEIA,98916,1,PART,PRCNCT,PRSD,PRSD_SV,"2025-05-18 21:16:15",356,147,127,20,0,144,3,400,253,100,44
24,IAŞI,"CĂMINUL CULTURAL BOROSEŞTI",645,SCÂNTEIA,98916,2,PART,PRCNCT,PRSD,PRSD_SV,"2025-05-18 23:01:18",652,280,248,32,0,275,5,700,420,190,85
24,IAŞI,"ŞCOALA PRIMARĂ CIOCÂRLEŞTI",646,SCÂNTEIA,98916,1,PART,PRCNCT,PRSD,PRSD_SV,"2025-05-18 21:30:55",245,126,110,16,0,126,0,300,174,65,61
24,IAŞI,"ȘCOALA PRIMARĂ LUNCA RATEŞ",647,SCÂNTEIA,98916,1,PART,PRCNCT,PRSD,PRSD_SV,"2025-05-18 21:25:49",297,134,106,28,0,132,2,300,166,99,33
24,IAŞI,"ŞCOALA PRIMARĂ REDIU",648,SCÂNTEIA,98916,1,PART,PRCNCT,PRSD,PRSD_SV,"2025-05-18 21:24:23",167,81,55,26,0,81,0,200,119,55,26
24,IAŞI,"ŞCOALA PRIMARĂ TUFEŞTII DE SUS",649,SCÂNTEIA,98916,1,PART,PRCNCT,PRSD,PRSD_SV,"2025-05-18 21:28:17",184,89,73,16,0,87,2,200,111,53,34
24,IAŞI,"SCOALA PRIMARA SCHITU DUCA",650,"SCHITU DUCA",98827,1,PART,PRCNCT,PRSD,PRSD_SV,"2025-05-18 21:34:59",456,258,183,75,0,255,3,500,242,145,110
24,IAŞI,"SCOALA GIMNAZIALA DUMITRESTII GALATII",651,"SCHITU DUCA",98827,1,PART,PRCNCT,PRSD,PRSD_SV,"2025-05-18 21:24:17",516,268,236,32,0,264,4,600,332,139,125
24,IAŞI,"CĂMIN CULTURAL POCREACA",652,"SCHITU DUCA",98827,1,PART,PRCNCT,PRSD,PRSD_SV,"2025-05-18 21:13:52",310,177,140,37,0,174,3,400,223,82,92
24,IAŞI,"SCOALA PRIMARA POIANA",653,"SCHITU DUCA",98827,1,PART,PRCNCT,PRSD,PRSD_SV,"2025-05-18 21:33:20",335,167,118,49,0,164,3,400,233,80,84
24,IAŞI,"SCOALA GIMNAZIALA POIENI",654,"SCHITU DUCA",98827,1,PART,PRCNCT,PRSD,PRSD_SV,"2025-05-18 21:22:59",688,346,277,67,2,344,2,800,454,147,197
24,IAŞI,"SCOALA GIMNAZIALA SATU NOU",655,"SCHITU DUCA",98827,1,PART,PRCNCT,PRSD,PRSD_SV,"2025-05-18 21:30:14",425,219,177,42,0,217,2,500,281,123,94
24,IAŞI,"SCOALA PRIMARA SLOBOZIA",656,"SCHITU DUCA",98827,1,PART,PRCNCT,PRSD,PRSD_SV,"2025-05-18 21:20:12",361,144,124,20,0,143,1,400,256,59,84
24,IAŞI,"SAT SCOBINTI, SEDIU SCOALA VECHE SCOBINTI",657,SCOBINŢI,98998,1,PART,PRCNCT,PRSD,PRSD_SV,"2025-05-18 21:29:09",1367,533,491,42,0,524,9,1500,967,327,197
24,IAŞI,"SAT SCOBINTI, SEDIU SCOALA ZVARICI- SCOBINTI",658,SCOBINŢI,98998,1,PART,PRCNCT,PRSD,PRSD_SV,"2025-05-18 21:25:06",239,106,89,17,0,105,1,300,194,52,53
24,IAŞI,"SAT BADENI, SEDIU SCOALA BADENI",659,SCOBINŢI,98998,1,PART,PRCNCT,PRSD,PRSD_SV,"2025-05-18 21:34:04",1034,477,425,52,0,471,6,1100,623,293,178
24,IAŞI,"SAT FETESTI, SEDIU SCOALA COORD.",660,SCOBINŢI,98998,1,PART,PRCNCT,PRSD,PRSD_SV,"2025-05-18 21:54:14",1095,436,390,46,0,431,5,1200,764,267,164
24,IAŞI,"SAT STICLARIA, SEDIU SCOALA STICLARIA",661,SCOBINŢI,98998,1,PART,PRCNCT,PRSD,PRSD_SV,"2025-05-18 21:50:56",1265,526,475,51,0,522,4,1400,874,357,165
24,IAŞI,"SAT STICLARIA, SEDIU SCOALA REDIU",662,SCOBINŢI,98998,1,PART,PRCNCT,PRSD,PRSD_SV,"2025-05-18 21:27:41",282,134,95,39,0,132,2,300,166,90,42
24,IAŞI,"SAT .ZAGAVIA ,CU SEDIUL LA SCOALA ZAGAVIA",663,SCOBINŢI,98998,1,PART,PRCNCT,PRSD,PRSD_SV,"2025-05-18 21:47:04",953,432,382,50,0,427,5,1000,568,288,139
24,IAŞI,"SALA DE SPORT SINEŞTI",664,SINEŞTI,99058,1,PART,PRCNCT,PRSD,PRSD_SV,"2025-05-18 21:36:56",1282,582,527,55,0,567,15,1400,818,313,254
24,IAŞI,"ŞCOALA PRIMARA BOCNIŢA",665,SINEŞTI,99058,1,PART,PRCNCT,PRSD,PRSD_SV,"2025-05-18 21:21:25",276,167,132,35,0,166,1,300,133,82,84
24,IAŞI,"ŞCOALA GIMNAZIALA OSOI",666,SINEŞTI,99058,1,PART,PRCNCT,PRSD,PRSD_SV,"2025-05-18 21:23:44",820,152,129,23,0,149,3,900,748,100,49
24,IAŞI,"ŞCOALA GIMNAZIALA STORNEŞTI",667,SINEŞTI,99058,1,PART,PRCNCT,PRSD,PRSD_SV,"2025-05-18 21:18:12",833,360,327,33,0,355,5,900,540,219,136
24,IAŞI,"ŞCOALA GENERALĂ",668,SIREŢEL,99101,1,PART,PRCNCT,PRSD,PRSD_SV,"2025-05-18 22:23:38",1045,356,333,23,0,355,1,1100,744,255,100
24,IAŞI,"ŞCOALA GENERALĂ",669,SIREŢEL,99101,1,PART,PRCNCT,PRSD,PRSD_SV,"2025-05-18 21:57:31",1114,366,350,16,0,363,3,1200,834,281,82
24,IAŞI,"ŞCOALA GENERALĂ HUMOSU",670,SIREŢEL,99101,1,PART,PRCNCT,PRSD,PRSD_SV,"2025-05-18 22:07:41",690,203,184,19,0,200,3,800,597,144,56
24,IAŞI,"ŞCOALA GENERALĂ SLOBOZIA",671,SIREŢEL,99101,1,PART,PRCNCT,PRSD,PRSD_SV,"2025-05-18 21:57:51",744,272,241,31,0,268,4,800,528,183,85
24,IAŞI,"BIBLIOTECA MATEI MILLO",672,STOLNICENI-PRĂJESCU,99165,1,PART,PRCNCT,PRSD,PRSD_SV,"2025-05-18 21:35:27",1205,555,502,53,0,545,10,1300,745,356,189
24,IAŞI,"SCOALA CU CLASELE I-IV SALA 1",673,STOLNICENI-PRĂJESCU,99165,1,PART,PRCNCT,PRSD,PRSD_SV,"2025-05-18 21:32:29",759,339,329,10,0,333,6,800,461,222,111
24,IAŞI,"SCOALA CU CLASELE I-VIII SALA NR.1",674,STOLNICENI-PRĂJESCU,99165,1,PART,PRCNCT,PRSD,PRSD_SV,"2025-05-18 21:26:01",538,278,258,20,0,270,8,600,322,180,90
24,IAŞI,"SCOALA GIMNAZIALA COZMESTI",675,STOLNICENI-PRĂJESCU,99165,1,PART,PRCNCT,PRSD,PRSD_SV,"2025-05-18 21:35:12",926,359,311,48,0,349,10,1000,641,252,97
24,IAŞI,"SCOALA GIMNAZIALA COZMESTI",676,STOLNICENI-PRĂJESCU,99165,1,PART,PRCNCT,PRSD,PRSD_SV,"2025-05-18 21:37:34",751,284,264,20,0,279,5,800,516,188,91
24,IAŞI,"SCOALA GIMNAZIALA STRUNGA",677,STRUNGA,99209,1,PART,PRCNCT,PRSD,PRSD_SV,"2025-05-18 21:37:10",446,225,179,46,0,224,1,500,275,121,103
24,IAŞI,"SCOALA PRIMARA BRATULESTI",678,STRUNGA,99209,1,PART,PRCNCT,PRSD,PRSD_SV,"2025-05-18 22:06:32",544,235,183,52,0,232,3,600,365,139,93
24,IAŞI,"GRĂDINIȚA CU PROGRAM NORMAL CRIVEȘTI",679,STRUNGA,99209,1,PART,PRCNCT,PRSD,PRSD_SV,"2025-05-18 21:37:04",236,104,84,20,0,102,2,300,196,65,37
24,IAŞI,"SCOALA CUCOVA",680,STRUNGA,99209,1,PART,PRCNCT,PRSD,PRSD_SV,"2025-05-18 21:49:23",127,65,47,18,0,65,0,200,135,33,32
24,IAŞI,"SCOALA GIMNAZIALA FARCASENI",681,STRUNGA,99209,1,PART,PRCNCT,PRSD,PRSD_SV,"2025-05-18 21:57:59",795,246,227,19,0,240,6,900,654,146,94
24,IAŞI,"SCOALA GIMNAZIALA FARCASENI",682,STRUNGA,99209,1,PART,PRCNCT,PRSD,PRSD_SV,"2025-05-18 21:43:04",842,263,248,15,0,262,1,900,637,172,90
24,IAŞI,"ŞCOALA HĂBĂŞEŞTI",683,STRUNGA,99209,1,PART,PRCNCT,PRSD,PRSD_SV,"2025-05-18 21:41:45",315,156,126,30,0,155,1,300,144,58,97
24,IAŞI,"GRUP SCOLAR SCHEIA",684,ŞCHEIA,99290,1,PART,PRCNCT,PRSD,PRSD_SV,"2025-05-18 21:50:04",907,365,315,50,0,360,5,1000,635,188,172
24,IAŞI,"SCOALA GENERALĂ CĂUESTI",685,ŞCHEIA,99290,1,PART,PRCNCT,PRSD,PRSD_SV,"2025-05-18 21:15:34",418,167,135,32,0,165,2,500,333,112,53
24,IAŞI,"SCOALA GENERALĂ CIOCA-BOCA",686,ŞCHEIA,99290,1,PART,PRCNCT,PRSD,PRSD_SV,"2025-05-18 21:16:29",426,171,154,17,0,169,2,500,329,101,68
24,IAŞI,"CASA DE PRĂZNUIRE A PAROHIEI ”SFINȚII ÎMPĂRAȚI CONSTANTIN ȘI ELENA” POIANA-ȘCHEII",687,ŞCHEIA,99290,1,PART,PRCNCT,PRSD,PRSD_SV,"2025-05-18 21:27:02",410,183,152,31,0,183,0,500,317,102,81
24,IAŞI,"SCOALA GENERALĂ SATU-NOU",688,ŞCHEIA,99290,1,PART,PRCNCT,PRSD,PRSD_SV,"2025-05-18 21:48:45",274,106,88,18,0,105,1,299,193,65,40
24,IAŞI,"BIBLIOTECĂ-CĂMIN CULTURAL ȘIPOTE",689,ŞIPOTE,99370,1,PART,PRCNCT,PRSD,PRSD_SV,"2025-05-18 21:23:26",622,308,254,54,0,307,1,700,392,163,144
24,IAŞI,"SCOALA GIMNAZIALĂ CHIȘCĂRENI",690,ŞIPOTE,99370,1,PART,PRCNCT,PRSD,PRSD_SV,"2025-05-18 21:34:24",1187,484,429,54,1,481,3,1300,816,244,237
24,IAŞI,"GRĂDINIȚA CU PROGRAM NORMAL HĂLCENI",691,ŞIPOTE,99370,1,PART,PRCNCT,PRSD,PRSD_SV,"2025-05-18 21:29:56",913,418,365,52,1,416,2,1000,582,258,158
24,IAŞI,"SCOALA GIMNAZIALA IAZU NOU",692,ŞIPOTE,99370,1,PART,PRCNCT,PRSD,PRSD_SV,"2025-05-18 21:26:05",780,253,214,29,10,250,3,900,647,136,114
24,IAŞI,"ȘCOALA PRIMARĂ IAZU VECHI",693,ŞIPOTE,99370,1,PART,PRCNCT,PRSD,PRSD_SV,"2025-05-18 21:18:50",260,141,123,18,0,139,2,300,159,90,49
24,IAŞI,"GRĂDINIȚA CU PROGRAM NORMAL TANSA",694,TANSA,99441,1,PART,PRCNCT,PRSD,PRSD_SV,"2025-05-18 21:41:07",1530,475,394,81,0,466,9,1700,1225,243,223
24,IAŞI,"GRĂDINIȚA CU PROGRAM NORMAL SUHULEȚ",695,TANSA,99441,1,PART,PRCNCT,PRSD,PRSD_SV,"2025-05-18 21:27:46",854,394,332,61,1,391,3,900,506,206,185
24,IAŞI,"CENTRUL CULTURAL ”ALEXANDRU VASILIU-TATARUSI”",696,TĂTĂRUŞI,99478,1,PART,PRCNCT,PRSD,PRSD_SV,"2025-05-18 21:54:44",1292,677,606,69,2,669,8,1400,723,405,264
24,IAŞI,"SCOALA PRIMARA IORCANI",697,TĂTĂRUŞI,99478,1,PART,PRCNCT,PRSD,PRSD_SV,"2025-05-18 21:31:31",636,306,271,35,0,301,5,700,394,210,91
24,IAŞI,"SCOALA GIMNAZIALA PIETROSU",698,TĂTĂRUŞI,99478,1,PART,PRCNCT,PRSD,PRSD_SV,"2025-05-18 21:46:22",1109,524,485,39,0,519,5,1200,676,292,227
24,IAŞI,"ȘCOALA GIMNAZIALĂ UDA - CORP A",699,TĂTĂRUŞI,99478,1,PART,PRCNCT,PRSD,PRSD_SV,"2025-05-18 21:43:36",1252,558,497,60,1,546,12,1400,842,374,172
24,IAŞI,"ȘCOALA CU CLASELE I-VIII NR.1 TODIREȘTI CORP A",700,TODIREŞTI,99539,1,PART,PRCNCT,PRSD,PRSD_SV,"2025-05-18 21:47:08",1002,375,348,26,1,363,12,1100,725,259,104
24,IAŞI,"ȘCOALA CU CLASELE I-VIII NR.1 TODIREȘTI CORP A",701,TODIREŞTI,99539,1,PART,PRCNCT,PRSD,PRSD_SV,"2025-05-18 22:31:53",1215,427,411,16,0,420,7,1300,873,314,106
24,IAŞI,"SCOALA PRIMARA NR.2 TODIRESTI",702,TODIREŞTI,99539,1,PART,PRCNCT,PRSD,PRSD_SV,"2025-05-18 21:23:31",1066,497,461,36,0,493,4,1200,703,356,137
24,IAŞI,"SCOALA PRIMARA BAICENI",703,TODIREŞTI,99539,1,PART,PRCNCT,PRSD,PRSD_SV,"2025-05-18 21:26:45",256,130,103,27,0,129,1,300,170,71,58
24,IAŞI,"ȘCOALA PRIMARĂ STROIEȘTI",704,TODIREŞTI,99539,1,PART,PRCNCT,PRSD,PRSD_SV,"2025-05-18 21:27:47",300,131,113,18,0,129,2,400,269,52,77
24,IAŞI,"PRIMARIA COMUNEI TOMESTI",705,TOMEŞTI,95293,1,PART,PRCNCT,PRSD,PRSD_SV,"2025-05-18 21:41:48",1420,896,749,141,6,890,6,1600,704,308,582
24,IAŞI,"SEDIUL SC.D.D.PATRASCANU",706,TOMEŞTI,95293,1,PART,PRCNCT,PRSD,PRSD_SV,"2025-05-18 21:48:16",1639,975,867,108,0,968,7,1800,825,480,488
24,IAŞI,"SEDIUL SC.D.D.PATRASCANU",707,TOMEŞTI,95293,1,PART,PRCNCT,PRSD,PRSD_SV,"2025-05-18 21:35:01",1410,739,627,112,0,734,5,1500,761,349,385
24,IAŞI,"SEDIUL SC.D.D.PATRASCANU",708,TOMEŞTI,95293,1,PART,PRCNCT,PRSD,PRSD_SV,"2025-05-18 21:36:31",1564,857,783,74,0,846,11,1700,843,426,420
24,IAŞI,"SEDIUL SC.D.D.PATRASCANU",709,TOMEŞTI,95293,1,PART,PRCNCT,PRSD,PRSD_SV,"2025-05-18 21:35:21",1554,806,737,69,0,793,13,1700,894,389,404
24,IAŞI,"SEDIUL SC.D.D.PATRASCANU",710,TOMEŞTI,95293,1,PART,PRCNCT,PRSD,PRSD_SV,"2025-05-18 21:42:35",1217,614,569,45,0,602,12,1300,686,272,330
24,IAŞI,"SEDIUL SCOALA GIMNAZIALA CHICEREA, SAT.CHICEREA, COM.TOMEŞTI",711,TOMEŞTI,95293,1,PART,PRCNCT,PRSD,PRSD_SV,"2025-05-18 21:48:24",1295,838,687,151,0,832,6,1400,562,386,446
24,IAŞI,"SEDIUL SCOALA GIMNAZIALA GORUNI, SATUL GORUNI, COM.TOMEŞTI",712,TOMEŞTI,95293,1,PART,PRCNCT,PRSD,PRSD_SV,"2025-05-18 21:33:35",1064,561,491,70,0,554,7,1200,639,326,228
24,IAŞI,"SEDIUL SCOALA PRIMARA VLĂDICENI, SAT. VLĂDICENI, COM.TOMEŞTI",713,TOMEŞTI,95293,1,PART,PRCNCT,PRSD,PRSD_SV,"2025-05-18 21:41:24",673,404,332,72,0,402,2,700,296,222,180
24,IAŞI,"GRĂDINIȚA CU PROGRAM NORMAL TRIFEȘTI",714,TRIFEŞTI,99600,1,PART,PRCNCT,PRSD,PRSD_SV,"2025-05-18 21:35:54",1396,663,584,72,7,659,4,1500,837,352,307
24,IAŞI,"ŞCOALA GIMNAZIALĂ HERMEZIU",715,TRIFEŞTI,99600,1,PART,PRCNCT,PRSD,PRSD_SV,"2025-05-18 21:58:16",754,421,383,37,1,416,5,800,379,288,128
24,IAŞI,"ŞCOALA PRIMARĂ VLADOMIRA",716,TRIFEŞTI,99600,1,PART,PRCNCT,PRSD,PRSD_SV,"2025-05-18 21:15:53",195,108,90,18,0,108,0,200,92,74,34
24,IAŞI,"ȘCOALA PRIMARĂ ZABOLOTENI",717,TRIFEŞTI,99600,1,PART,PRCNCT,PRSD,PRSD_SV,"2025-05-18 22:03:05",614,335,305,29,1,333,2,700,365,203,130
24,IAŞI,"LICEUL TEHNOLOGIC DE INDUSTRIE ALIMENTARĂ ŢIBANA",718,ŢIBANA,99673,1,PART,PRCNCT,PRSD,PRSD_SV,"2025-05-18 21:49:52",738,303,265,38,0,298,5,800,497,178,120
24,IAŞI,"ŞCOALA GIMNAZIALĂ ALEXENI",719,ŢIBANA,99673,1,PART,PRCNCT,PRSD,PRSD_SV,"2025-05-18 21:30:45",627,183,169,14,0,182,1,700,517,138,44
24,IAŞI,"ŞCOALA GIMNAZIALĂ DOMNIŢA",720,ŢIBANA,99673,1,PART,PRCNCT,PRSD,PRSD_SV,"2025-05-18 21:37:03",1169,378,352,26,0,376,2,1300,922,278,98
24,IAŞI,"ŞCOALA GIMNAZIALĂ GÎRBEŞTI",721,ŢIBANA,99673,1,PART,PRCNCT,PRSD,PRSD_SV,"2025-05-18 21:37:12",914,336,319,17,0,333,3,1000,664,220,113
24,IAŞI,"ŞCOALA PRIMARĂ GÎRBEŞTI",722,ŢIBANA,99673,1,PART,PRCNCT,PRSD,PRSD_SV,"2025-05-18 21:39:11",979,356,320,36,0,355,1,1100,744,248,107
24,IAŞI,"ŞCOALA PRIMARĂ POIANA DE SUS",723,ŢIBANA,99673,1,PART,PRCNCT,PRSD,PRSD_SV,"2025-05-18 21:38:43",417,166,149,17,0,165,1,500,334,96,69
24,IAŞI,"SCOALA GIMNAZIALĂ POIANA MĂNĂSTIRII",724,ŢIBANA,99673,1,PART,PRCNCT,PRSD,PRSD_SV,"2025-05-18 21:35:28",372,119,108,11,0,117,2,400,281,65,52
24,IAŞI,"ŞCOALA GIMNAZIALĂ RUNCU",725,ŢIBANA,99673,1,PART,PRCNCT,PRSD,PRSD_SV,"2025-05-18 21:42:52",421,193,176,17,0,191,2,500,307,109,82
24,IAŞI,"ŞCOALA PRIMARĂ VADU VEJEI",726,ŢIBANA,99673,1,PART,PRCNCT,PRSD,PRSD_SV,"2025-05-18 21:35:25",292,128,117,11,0,128,0,300,172,103,25
24,IAŞI,"GRĂDINIȚA CU PROGRAM NORMAL ȚIBĂNEȘTI",727,ŢIBĂNEŞTI,99780,1,PART,PRCNCT,PRSD,PRSD_SV,"2025-05-18 21:37:39",872,290,270,20,0,286,4,1000,710,179,107
24,IAŞI,"GRĂDINIȚA CU PROGRAM NORMAL ȚIBĂNEȘTI",728,ŢIBĂNEŞTI,99780,1,PART,PRCNCT,PRSD,PRSD_SV,"2025-05-18 21:26:28",976,382,359,23,0,378,4,1100,718,219,159
24,IAŞI,"ȘCOALA GIMNAZIALĂ GLODENII GÎNDULUI",729,ŢIBĂNEŞTI,99780,1,PART,PRCNCT,PRSD,PRSD_SV,"2025-05-18 21:34:03",1107,337,312,25,0,333,4,1200,863,257,76
24,IAŞI,"ȘCOALA GIMNAZIALĂ GLODENII GÎNDULUI",730,ŢIBĂNEŞTI,99780,1,PART,PRCNCT,PRSD,PRSD_SV,"2025-05-18 21:35:19",1089,365,340,25,0,361,4,1200,835,275,86
24,IAŞI,"GRĂDINIȚA CU PROGRAM NORMAL GRIEȘTI",731,ŢIBĂNEŞTI,99780,1,PART,PRCNCT,PRSD,PRSD_SV,"2025-05-18 21:25:25",216,84,73,11,0,83,1,300,216,54,29
24,IAŞI,"ȘCOALA GIMNAZIALĂ ”DR. PETRU BRÂNZEI” JIGORENI",732,ŢIBĂNEŞTI,99780,1,PART,PRCNCT,PRSD,PRSD_SV,"2025-05-18 21:21:45",551,221,198,23,0,219,2,600,379,139,80
24,IAŞI,"ȘCOALA GIMNAZIALĂ RĂSBOIENI",733,ŢIBĂNEŞTI,99780,1,PART,PRCNCT,PRSD,PRSD_SV,"2025-05-18 21:26:32",757,287,263,24,0,284,3,800,513,160,124
24,IAŞI,"GRĂDINIȚA CU PROGRAM NORMAL RECEA",734,ŢIBĂNEŞTI,99780,1,PART,PRCNCT,PRSD,PRSD_SV,"2025-05-18 21:20:01",102,57,42,15,0,53,4,200,143,27,26
24,IAŞI,"CĂMINUL CULTURAL TUNGUJEI",735,ŢIBĂNEŞTI,99780,1,PART,PRCNCT,PRSD,PRSD_SV,"2025-05-18 21:28:26",450,164,146,18,0,163,1,500,336,96,67
24,IAŞI,"GRĂDINIȚA CU PROGRAM NORMAL VĂLENII",736,ŢIBĂNEŞTI,99780,1,PART,PRCNCT,PRSD,PRSD_SV,"2025-05-18 21:26:01",219,96,73,23,0,96,0,300,204,62,34
24,IAŞI,"SCOALA GIMNAZIALA ”COSTACHE ANTONIU”TIGANASI",737,ŢIGĂNAŞI,99879,1,PART,PRCNCT,PRSD,PRSD_SV,"2025-05-18 21:43:55",1175,613,554,59,0,605,8,1300,687,361,244
24,IAŞI,"SCOALA GENERALA CIRNICENI",738,ŢIGĂNAŞI,99879,1,PART,PRCNCT,PRSD,PRSD_SV,"2025-05-18 21:24:41",1322,637,566,71,0,634,3,1400,763,381,253
24,IAŞI,"SCOALA GENERALA MIHAIL KOGALNICEANU",739,ŢIGĂNAŞI,99879,1,PART,PRCNCT,PRSD,PRSD_SV,"2025-05-18 21:27:03",1197,494,451,43,0,486,8,1300,806,328,158
24,IAŞI,"SCOALA PRIMARA STEJARII",740,ŢIGĂNAŞI,99879,1,PART,PRCNCT,PRSD,PRSD_SV,"2025-05-18 21:22:08",256,140,108,32,0,138,2,300,160,83,55
24,IAŞI,"SCOALA GIMNAZIALĂ ȚUȚORA",741,ŢUŢORA,99922,1,PART,PRCNCT,PRSD,PRSD_SV,"2025-05-18 21:41:45",1003,552,468,83,1,546,6,1100,548,280,266
24,IAŞI,"CASA PAROHIALĂ ”SF. NICOLAE” CHIPEREȘTI",742,ŢUŢORA,99922,1,PART,PRCNCT,PRSD,PRSD_SV,"2025-05-18 21:32:44",365,251,187,62,2,248,3,400,149,123,125
24,IAŞI,"CENTRU EDUCAȚIONAL OPRIȘENI",743,ŢUŢORA,99922,1,PART,PRCNCT,PRSD,PRSD_SV,"2025-05-18 21:35:50",609,340,286,54,0,337,3,700,360,202,135
24,IAŞI,"SCOALA GIMNAZIALA BOSIA- CORP B",744,UNGHENI,96003,1,PART,PRCNCT,PRSD,PRSD_SV,"2025-05-18 21:29:22",827,355,315,40,0,350,5,900,545,225,125
24,IAŞI,"SCOALA GIMNAZIALA BOSIA-CORP B",745,UNGHENI,96003,1,PART,PRCNCT,PRSD,PRSD_SV,"2025-05-18 21:23:20",713,365,340,25,0,361,4,800,435,251,110
24,IAŞI,"CASA SOCIALĂ-PAROHIA ”SF.DUMITRU” COADA STÂNCII",746,UNGHENI,96003,1,PART,PRCNCT,PRSD,PRSD_SV,"2025-05-18 21:27:46",558,266,237,29,0,263,3,600,334,165,98
24,IAŞI,"SCOALA PRIMARA MÎNZĂTEŞTI",747,UNGHENI,96003,1,PART,PRCNCT,PRSD,PRSD_SV,"2025-05-18 21:34:33",857,483,415,68,0,481,2,900,417,295,186
24,IAŞI,"SCOALA PRIMARA UNGHENI",748,UNGHENI,96003,1,PART,PRCNCT,PRSD,PRSD_SV,"2025-05-18 21:34:22",528,271,229,42,0,267,4,600,329,163,104
24,IAŞI,"LICEUL ”PROF. MIHAI DUMITRIU”-CORP E",749,"VALEA LUPULUI",100353,1,PART,PRCNCT,PRSD,PRSD_SV,"2025-05-18 22:10:52",1837,1270,833,437,0,1257,13,2000,730,321,936
24,IAŞI,"LICEUL ”PROF.MIHAI DUMITRIU”- CORP E",750,"VALEA LUPULUI",100353,1,PART,PRCNCT,PRSD,PRSD_SV,"2025-05-18 22:03:35",1951,1354,1207,145,2,1341,13,2100,746,334,1007
24,IAŞI,"LICEUL ”PROF.MIHAI DUMITRIU”-CORP E",751,"VALEA LUPULUI",100353,1,PART,PRCNCT,PRSD,PRSD_SV,"2025-05-18 22:04:04",1919,1264,1129,133,2,1246,18,2100,836,286,960
24,IAŞI,"CORP D-GRĂDINIȚA CU PROGRAM PRELUNGIT",752,"VALEA LUPULUI",100353,1,PART,PRCNCT,PRSD,PRSD_SV,"2025-05-18 22:28:13",2000,1603,1272,331,0,1580,23,2200,597,404,1176
24,IAŞI,"CORP D-GRĂDINIȚA CU PROGRAM PRELUNGIT",753,"VALEA LUPULUI",100353,1,PART,PRCNCT,PRSD,PRSD_SV,"2025-05-18 22:14:46",1916,1436,1128,306,2,1427,9,2100,664,312,1115
24,IAŞI,"CORP D-GRĂDINIȚA CU PROGRAM PRELUNGIT",754,"VALEA LUPULUI",100353,1,PART,PRCNCT,PRSD,PRSD_SV,"2025-05-18 21:52:14",1904,1429,1120,309,0,1418,11,2100,671,282,1136
24,IAŞI,"CORP D-GRĂDINIȚA CU PROGRAM PRELUNGIT",755,"VALEA LUPULUI",100353,1,PART,PRCNCT,PRSD,PRSD_SV,"2025-05-18 21:51:59",2001,1397,1173,223,1,1369,28,2200,803,366,1003
24,IAŞI,"SCOALA GIMNAZIALA VALEA SEACA",756,"VALEA SEACĂ",99968,1,PART,PRCNCT,PRSD,PRSD_SV,"2025-05-18 22:01:41",1643,712,670,42,0,700,12,1800,1088,429,271
24,IAŞI,"SCOALA GIMNAZIALA CONTESTI",757,"VALEA SEACĂ",99968,1,PART,PRCNCT,PRSD,PRSD_SV,"2025-05-18 22:04:44",1442,624,587,37,0,621,3,1600,976,358,263
24,IAŞI,"SCOALA GIMNAZIALA TOPILE",758,"VALEA SEACĂ",99968,1,PART,PRCNCT,PRSD,PRSD_SV,"2025-05-18 21:41:43",1835,690,635,54,1,685,5,2000,1310,430,255
24,IAŞI,"CAMINUL CULTURAL VINATORI",759,VÂNĂTORI,100086,1,PART,PRCNCT,PRSD,PRSD_SV,"2025-05-18 21:31:28",875,392,337,52,3,390,2,1000,608,164,226
24,IAŞI,"ȘCOALA CU CLASELE I-VIII CRIVEȘTI",760,VÂNĂTORI,100086,1,PART,PRCNCT,PRSD,PRSD_SV,"2025-05-18 22:01:02",1172,513,467,46,0,507,6,1300,787,368,139
24,IAŞI,"SCOALA CU CLASELE I-IV GURA-BIDILITEI",761,VÂNĂTORI,100086,1,PART,PRCNCT,PRSD,PRSD_SV,"2025-05-18 21:24:20",488,250,219,31,0,248,2,500,250,177,71
24,IAŞI,"ȘCOALA GIMNAZIALĂ HÎRTOAPE",762,VÂNĂTORI,100086,1,PART,PRCNCT,PRSD,PRSD_SV,"2025-05-18 21:52:36",909,433,393,40,0,428,5,1000,567,262,166
24,IAŞI,"ȘCOALA PRIMARĂ VLĂDNICUȚ",763,VÂNĂTORI,100086,1,PART,PRCNCT,PRSD,PRSD_SV,"2025-05-18 21:18:14",116,59,45,14,0,59,0,200,141,43,16
24,IAŞI,"CĂMIN CULTURAL VICTORIA",764,VICTORIA,100004,1,PART,PRCNCT,PRSD,PRSD_SV,"2025-05-18 21:40:41",1334,575,529,44,2,572,3,1500,925,365,207
24,IAŞI,"CĂMIN CULTURAL VICTORIA",765,VICTORIA,100004,1,PART,PRCNCT,PRSD,PRSD_SV,"2025-05-18 21:28:21",378,224,141,83,0,224,0,400,176,142,82
24,IAŞI,"ŞCOALA FRĂSULENI",766,VICTORIA,100004,1,PART,PRCNCT,PRSD,PRSD_SV,"2025-05-18 21:11:36",310,163,139,24,0,163,0,400,237,104,59
24,IAŞI,"ŞCOALA FRĂSULENI",767,VICTORIA,100004,1,PART,PRCNCT,PRSD,PRSD_SV,"2025-05-18 21:11:19",246,96,74,22,0,94,2,300,204,74,20
24,IAŞI,"ŞCOALA ICUŞENI",768,VICTORIA,100004,1,PART,PRCNCT,PRSD,PRSD_SV,"2025-05-18 21:13:50",399,183,154,29,0,182,1,400,217,120,62
24,IAŞI,"ŞCOALA ICUȘENI",769,VICTORIA,100004,1,PART,PRCNCT,PRSD,PRSD_SV,"2025-05-18 21:18:27",396,188,160,28,0,187,1,400,212,107,80
24,IAŞI,"ŞCOALA STÂNCA",770,VICTORIA,100004,1,PART,PRCNCT,PRSD,PRSD_SV,"2025-05-18 21:26:56",456,194,169,25,0,190,4,500,306,151,39
24,IAŞI,"LICEUL TEHNOLOGIC VLADENI",771,VLĂDENI,100148,1,PART,PRCNCT,PRSD,PRSD_SV,"2025-05-18 21:55:56",1359,619,541,77,1,616,3,1500,881,292,324
24,IAŞI,"SCOALA CU CLASELE I-IV ALEXANDRU CEL BUN",772,VLĂDENI,100148,1,PART,PRCNCT,PRSD,PRSD_SV,"2025-05-18 21:43:40",379,181,145,36,0,181,0,400,219,101,80
24,IAŞI,"SCOALA CU CLASELE I-VIII BORSA",773,VLĂDENI,100148,1,PART,PRCNCT,PRSD,PRSD_SV,"2025-05-18 21:49:52",659,261,227,34,0,259,2,692,431,140,119
24,IAŞI,"SCOALA CU CLASELE I-IV BROSTENI",774,VLĂDENI,100148,1,PART,PRCNCT,PRSD,PRSD_SV,"2025-05-18 21:46:34",337,134,114,20,0,132,2,400,266,91,41
24,IAŞI,"SCOALA CU CLASELE I-IV IACOBENI",775,VLĂDENI,100148,1,PART,PRCNCT,PRSD,PRSD_SV,"2025-05-18 21:41:40",170,105,81,23,1,103,2,200,95,56,47
24,IAŞI,"SCOALA PRIMARA VILCELELE",776,VLĂDENI,100148,1,PART,PRCNCT,PRSD,PRSD_SV,"2025-05-18 21:49:03",337,167,143,24,0,165,2,400,233,86,79
24,IAŞI,"ŞCOALA GIMNAZIALĂ ”IOANID ROMANESCU” VOINEŞTI",777,VOINEŞTI,100219,1,PART,PRCNCT,PRSD,PRSD_SV,"2025-05-18 21:27:33",1197,499,440,59,0,492,7,1300,801,295,197
24,IAŞI,"ŞCOALA GIMNAZIALĂ ”IOANID ROMANESCU” VOINEŞTI",778,VOINEŞTI,100219,1,PART,PRCNCT,PRSD,PRSD_SV,"2025-05-18 21:51:45",794,374,319,55,0,373,1,900,526,232,141
24,IAŞI,"ŞCOALA GIMNAZIALĂ ”IOANID ROMANESCU” VOINEŞTI",779,VOINEŞTI,100219,1,PART,PRCNCT,PRSD,PRSD_SV,"2025-05-18 21:34:15",1028,410,370,40,0,405,5,1100,690,249,156
24,IAŞI,"ŞCOALA PRIMARĂ LUNGANI",780,VOINEŞTI,100219,1,PART,PRCNCT,PRSD,PRSD_SV,"2025-05-18 21:32:39",499,236,203,33,0,234,2,570,334,166,68
24,IAŞI,"ŞCOALA PRIMARĂ SCHITU-STAVNIC",781,VOINEŞTI,100219,1,PART,PRCNCT,PRSD,PRSD_SV,"2025-05-18 21:27:15",476,178,154,24,0,178,0,500,322,118,60
24,IAŞI,"ŞCOALA GIMNAZIALĂ SLOBOZIA DEAL",782,VOINEŞTI,100219,1,PART,PRCNCT,PRSD,PRSD_SV,"2025-05-18 21:34:34",937,215,187,28,0,210,5,1000,785,168,42
24,IAŞI,"ŞCOALA GIMNAZIALĂ SLOBOZIA DEAL",783,VOINEŞTI,100219,1,PART,PRCNCT,PRSD,PRSD_SV,"2025-05-18 21:28:49",880,213,182,31,0,207,6,1000,787,178,29
24,IAŞI,"IMOBIL PROPRIETATE PRIVATA VRABIE CALIPSA",784,VOINEŞTI,100219,1,PART,PRCNCT,PRSD,PRSD_SV,"2025-05-18 21:25:24",107,92,51,41,0,88,4,200,108,38,50
25,ILFOV,"ȘCOALA GIMNAZIALĂ NR. 1 BRAGADIRU",1,"ORAŞ BRAGADIRU",179221,1,PART,PRCNCT,PRSD,PRSD_SV,"2025-05-18 22:30:03",1456,1171,786,385,0,1156,15,1600,429,635,521
25,ILFOV,"ȘCOALA GIMNAZIALĂ NR. 1 BRAGADIRU",2,"ORAŞ BRAGADIRU",179221,2,PART,PRCNCT,PRSD,PRSD_SV,"2025-05-19 06:57:10",1375,1030,757,272,1,1023,7,1500,470,556,467
25,ILFOV,"ȘCOALA GIMNAZIALĂ NR. 1 BRAGADIRU",3,"ORAŞ BRAGADIRU",179221,1,PART,PRCNCT,PRSD,PRSD_SV,"2025-05-18 22:06:32",1479,1169,855,313,1,1151,18,1600,431,575,576
25,ILFOV,"ȘCOALA GIMNAZIALĂ NR. 1 BRAGADIRU",4,"ORAŞ BRAGADIRU",179221,1,PART,PRCNCT,PRSD,PRSD_SV,"2025-05-18 22:21:30",1058,741,591,150,0,729,12,1200,459,434,295
25,ILFOV,"ȘCOALA GIMNAZIALĂ NR. 1 BRAGADIRU",5,"ORAŞ BRAGADIRU",179221,1,PART,PRCNCT,PRSD,PRSD_SV,"2025-05-18 22:13:17",1525,1123,919,203,1,1116,7,1700,577,491,625
25,ILFOV,"SC PIEȚE ȘI TÎRGURI BRAGADIRU SRL",6,"ORAŞ BRAGADIRU",179221,1,PART,PRCNCT,PRSD,PRSD_SV,"2025-05-18 22:40:38",1551,1357,936,421,0,1343,14,1700,343,737,606
25,ILFOV,"SC ANYADE GYM CLASS SRL",7,"ORAŞ BRAGADIRU",179221,1,PART,PRCNCT,PRSD,PRSD_SV,"2025-05-18 23:16:53",1262,1216,710,506,0,1212,4,1400,184,384,828
25,ILFOV,"SC ANYADE GYM CLASS SRL",8,"ORAŞ BRAGADIRU",179221,1,PART,PRCNCT,PRSD,PRSD_SV,"2025-05-18 23:31:44",1754,1569,987,582,0,1552,17,1900,331,583,969
25,ILFOV,"SC ANYADE GYM CLASS SRL",9,"ORAŞ BRAGADIRU",179221,1,PART,PRCNCT,PRSD,PRSD_SV,"2025-05-18 23:11:34",1575,1425,896,529,0,1402,23,1700,275,453,949
25,ILFOV,"SC ANYADE GYM CLASS SRL",10,"ORAŞ BRAGADIRU",179221,1,PART,PRCNCT,PRSD,PRSD_SV,"2025-05-18 23:33:41",1631,1561,972,588,1,1539,22,1800,239,500,1039
25,ILFOV,"GRĂDINIȚA CU PROGRAM PRELUNGIT NR 3",11,"ORAŞ BRAGADIRU",179221,1,PART,PRCNCT,PRSD,PRSD_SV,"2025-05-18 22:50:44",1742,1819,1017,802,0,1798,21,1900,81,633,1165
25,ILFOV,"GRĂDINIȚA CU PROGRAM PRELUNGIT NR 3",12,"ORAŞ BRAGADIRU",179221,1,PART,PRCNCT,PRSD,PRSD_SV,"2025-05-18 23:02:39",1813,1944,1188,756,0,1914,30,2000,56,581,1333
25,ILFOV,"GRĂDINIȚA CU PROGRAM PRELUNGIT NR 3",13,"ORAŞ BRAGADIRU",179221,1,PART,PRCNCT,PRSD,PRSD_SV,"2025-05-18 23:01:46",1768,1832,1072,760,0,1812,20,1900,68,563,1249
25,ILFOV,"GRĂDINIȚA CU PROGRAM PRELUNGIT NR. 4",14,"ORAŞ BRAGADIRU",179221,1,PART,PRCNCT,PRSD,PRSD_SV,"2025-05-18 23:28:26",1443,1331,783,548,0,1315,16,1600,269,549,766
25,ILFOV,"GRĂDINIȚA CU PROGRAM PRELUNGIT NR. 4",15,"ORAŞ BRAGADIRU",179221,1,PART,PRCNCT,PRSD,PRSD_SV,"2025-05-18 22:23:19",1690,1369,1024,345,0,1356,13,1800,431,547,809
25,ILFOV,"GRĂDINIȚA CU PROGRAM PRELUNGIT NR. 4",16,"ORAŞ BRAGADIRU",179221,1,PART,PRCNCT,PRSD,PRSD_SV,"2025-05-18 22:53:45",1626,1548,880,668,0,1525,23,1800,252,636,889
25,ILFOV,"GRĂDINIȚA CU PROGRAM PRELUNGIT NR. 4",17,"ORAŞ BRAGADIRU",179221,2,PART,PRCNCT,PRSD,PRSD_SV,"2025-05-19 06:48:44",1611,1291,966,323,2,1269,22,1800,509,482,787
25,ILFOV,"GRĂDINIȚA CU PROGRAM PRELUNGIT NR. 4",18,"ORAŞ BRAGADIRU",179221,1,PART,PRCNCT,PRSD,PRSD_SV,"2025-05-18 22:48:54",1448,1222,826,396,0,1211,11,1600,378,480,731
25,ILFOV,"SPAȚIU COMERCIAL",19,"ORAŞ BRAGADIRU",179221,1,PART,PRCNCT,PRSD,PRSD_SV,"2025-05-18 22:39:33",1684,1304,890,414,0,1294,10,1900,596,660,634
25,ILFOV,"ȘCOALA GIMNAZIALĂ NR. 1 BUFTEA",20,"ORAŞ BUFTEA",100576,1,PART,PRCNCT,PRSD,PRSD_SV,"2025-05-18 22:02:24",1651,1087,908,170,9,1072,15,1400,313,513,559
25,ILFOV,"ȘCOALA GIMNAZIALĂ NR. 1 BUFTEA",21,"ORAŞ BUFTEA",100576,2,PART,PRCNCT,PRSD,PRSD_SV,"2025-05-19 01:41:54",1721,1146,963,156,27,1120,26,1500,354,494,626
25,ILFOV,"ȘCOALA GIMNAZIALĂ NR. 1 BUFTEA",22,"ORAŞ BUFTEA",100576,1,PART,PRCNCT,PRSD,PRSD_SV,"2025-05-18 22:46:59",1809,972,876,87,9,944,28,1600,628,450,494
25,ILFOV,"LICEUL TEHNOLOGIC ”DUMITRU DUMITRESCU” BUFTEA",23,"ORAŞ BUFTEA",100576,1,PART,PRCNCT,PRSD,PRSD_SV,"2025-05-18 22:07:24",975,682,563,110,9,662,20,1100,418,332,330
25,ILFOV,"LICEUL TEHNOLOGIC ”DUMITRU DUMITRESCU” BUFTEA",24,"ORAŞ BUFTEA",100576,1,PART,PRCNCT,PRSD,PRSD_SV,"2025-05-18 22:27:30",1636,1084,940,114,30,1069,15,1800,716,664,405
25,ILFOV,"ȘCOALA GIMNAZIALĂ NR. 2 BUFTEA",25,"ORAŞ BUFTEA",100576,1,PART,PRCNCT,PRSD,PRSD_SV,"2025-05-18 22:22:41",1233,947,670,272,5,926,21,1300,353,384,542
25,ILFOV,"ȘCOALA GIMNAZIALĂ NR. 2 BUFTEA",26,"ORAŞ BUFTEA",100576,1,PART,PRCNCT,PRSD,PRSD_SV,"2025-05-18 22:12:59",1429,1056,865,177,14,1035,21,1600,544,431,604
25,ILFOV,"ȘCOALA GIMNAZIALĂ NR. 2 BUFTEA",27,"ORAŞ BUFTEA",100576,1,PART,PRCNCT,PRSD,PRSD_SV,"2025-05-18 22:07:01",1655,1225,1096,108,21,1210,15,1800,575,614,596
25,ILFOV,"ȘCOALA GIMNAZIALĂ NR. 2 BUFTEA",28,"ORAŞ BUFTEA",100576,1,PART,PRCNCT,PRSD,PRSD_SV,"2025-05-18 22:18:23",1568,1014,891,118,5,987,27,1300,286,480,507
25,ILFOV,"ȘCOALA GIMNAZIALĂ NR. 4 BUFTEA",29,"ORAŞ BUFTEA",100576,1,PART,PRCNCT,PRSD,PRSD_SV,"2025-05-18 22:31:19",1102,725,645,72,8,712,13,999,274,423,289
25,ILFOV,"DIRECȚIA POLIȚIEI LOCALE BUFTEA",30,"ORAŞ BUFTEA",100576,1,PART,PRCNCT,PRSD,PRSD_SV,"2025-05-18 22:33:14",1464,1017,911,98,8,1006,11,1100,83,669,337
25,ILFOV,"ȘCOALA GIMNAZIALĂ NR. 3 BUFTEA",31,"ORAŞ BUFTEA",100576,1,PART,PRCNCT,PRSD,PRSD_SV,"2025-05-18 22:35:49",1782,1298,1111,174,13,1276,22,1900,602,562,714
25,ILFOV,"ȘCOALA GIMNAZIALĂ NR. 3 BUFTEA",32,"ORAŞ BUFTEA",100576,1,PART,PRCNCT,PRSD,PRSD_SV,"2025-05-18 22:43:28",646,596,382,205,9,589,7,700,104,235,354
25,ILFOV,"PROPRIETATE PRIVATĂ: TUTUNARU GHEORGHE",33,"ORAŞ BUFTEA",100576,1,PART,PRCNCT,PRSD,PRSD_SV,"2025-05-18 22:36:41",480,255,198,57,0,248,7,600,345,169,79
25,ILFOV,"ȘCOALA GIMNAZIALĂ NR.2 CHITILA",34,"ORAŞ CHITILA",179285,2,PART,PRCNCT,PRSD,PRSD_SV,"2025-05-19 02:02:28",1331,1361,804,557,0,1343,18,1600,239,484,859
25,ILFOV,"CLĂDIRE ADMINISTRATIVĂ",35,"ORAŞ CHITILA",179285,1,PART,PRCNCT,PRSD,PRSD_SV,"2025-05-18 22:10:01",1118,743,603,140,0,732,11,1200,457,358,374
25,ILFOV,"ŞCOALA GIMNAZIALĂ CU CLASELE I-VIII NR.1 ”PROF.ION VIŞOIU”",36,"ORAŞ CHITILA",179285,1,PART,PRCNCT,PRSD,PRSD_SV,"2025-05-18 22:39:26",1570,1196,830,365,1,1168,28,1700,504,506,662
25,ILFOV,"ŞCOALA GIMNAZIALĂ CU CLASELE I-VIII NR.1 ”PROF. ION VIŞOIU”",37,"ORAŞ CHITILA",179285,1,PART,PRCNCT,PRSD,PRSD_SV,"2025-05-18 22:52:50",1702,1440,1029,410,1,1417,23,1900,460,470,947
25,ILFOV,"ŞCOALA PRIMARĂ ”ION OLTEANU” - CHITILA",38,"ORAŞ CHITILA",179285,1,PART,PRCNCT,PRSD,PRSD_SV,"2025-05-18 22:41:39",1316,863,640,223,0,849,14,1400,537,404,445
25,ILFOV,"SCOALA PRIMARĂ ”ION OLTEANU” - CHITILA",39,"ORAŞ CHITILA",179285,1,PART,PRCNCT,PRSD,PRSD_SV,"2025-05-18 22:00:22",1279,915,710,205,0,903,12,1400,485,450,453
25,ILFOV,"SERVICIUL IMPOZITE ȘI TAXE",40,"ORAŞ CHITILA",179285,1,PART,PRCNCT,PRSD,PRSD_SV,"2025-05-18 22:07:30",1248,909,720,189,0,893,16,1400,491,353,540
25,ILFOV,"ŞCOALA PRIMARĂ ELEONORA ILIESCU - CHITILA",41,"ORAŞ CHITILA",179285,1,PART,PRCNCT,PRSD,PRSD_SV,"2025-05-18 22:22:53",1079,699,573,126,0,686,13,1200,501,345,341
25,ILFOV,"GRĂDINIŢA ”VOINICEL” CHITILA",42,"ORAŞ CHITILA",179285,1,PART,PRCNCT,PRSD,PRSD_SV,"2025-05-18 22:38:43",1270,843,718,124,1,831,12,1200,357,435,396
25,ILFOV,"ŞCOALA PRIMARĂ NR.1 RUDENI - CHITILA",43,"ORAŞ CHITILA",179285,1,PART,PRCNCT,PRSD,PRSD_SV,"2025-05-18 23:02:30",1096,723,581,142,0,714,9,1200,477,440,274
25,ILFOV,"GRADINITA NR 2 MAGURELE",44,"ORAŞ MĂGURELE",179409,1,PART,PRCNCT,PRSD,PRSD_SV,"2025-05-18 22:32:33",1371,1085,796,242,47,1071,14,1600,515,473,598
25,ILFOV,"LICEUL TEORETIC ”HORIA HULUBEI”",45,"ORAŞ MĂGURELE",179409,1,PART,PRCNCT,PRSD,PRSD_SV,"2025-05-18 22:32:24",1080,958,671,191,96,952,6,1300,342,382,570
25,ILFOV,"PRIMĂRIA ORAŞULUI MĂGURELE",46,"ORAŞ MĂGURELE",179409,1,PART,PRCNCT,PRSD,PRSD_SV,"2025-05-18 23:31:31",2016,1826,1280,546,0,1807,19,2200,374,692,1115
25,ILFOV,"PRIMĂRIA ORAŞULUI MĂGURELE",47,"ORAŞ MĂGURELE",179409,1,PART,PRCNCT,PRSD,PRSD_SV,"2025-05-18 22:47:18",1834,1764,1056,708,0,1740,24,2000,236,689,1051
25,ILFOV,"FOSTA SCOALA SI GRADINITA ALUNISU",48,"ORAŞ MĂGURELE",179409,1,PART,PRCNCT,PRSD,PRSD_SV,"2025-05-18 22:24:07",1292,964,670,199,95,946,18,1500,536,521,425
25,ILFOV,"SCOALA PRIMARA NR 2 DUMITRANA",49,"ORAŞ MĂGURELE",179409,1,PART,PRCNCT,PRSD,PRSD_SV,"2025-05-18 22:26:13",1015,945,621,224,100,930,15,1200,255,566,364
25,ILFOV,"SCOALA PRIMARA NR 1 VARTEJU",50,"ORAŞ MĂGURELE",179409,1,PART,PRCNCT,PRSD,PRSD_SV,"2025-05-18 22:49:11",1401,1142,839,207,96,1122,20,1600,458,549,573
25,ILFOV,"GRADINITA NR 3 VARTEJU",51,"ORAŞ MĂGURELE",179409,1,PART,PRCNCT,PRSD,PRSD_SV,"2025-05-18 23:16:48",1490,1472,913,483,76,1458,14,1700,228,646,812
25,ILFOV,"LICEUL TEORETIC ”IOAN PETRUŞ”",52,"ORAŞ OTOPENI",179481,1,PART,PRCNCT,PRSD,PRSD_SV,"2025-05-18 23:40:50",1470,1735,854,796,85,1710,25,1999,264,484,1226
25,ILFOV,"LICEUL TEORETIC ”IOAN PETRUŞ”",53,"ORAŞ OTOPENI",179481,1,PART,PRCNCT,PRSD,PRSD_SV,"2025-05-18 22:52:26",893,907,517,322,68,893,14,1400,493,278,615
25,ILFOV,"LICEUL TEORETIC ”IOAN PETRUŞ”",54,"ORAŞ OTOPENI",179481,1,PART,PRCNCT,PRSD,PRSD_SV,"2025-05-18 23:32:26",1273,1193,790,340,63,1178,15,1400,207,375,803
25,ILFOV,"LICEUL TEORETIC ”IOAN PETRUŞ”",55,"ORAŞ OTOPENI",179481,1,PART,PRCNCT,PRSD,PRSD_SV,"2025-05-18 22:39:02",1345,1331,812,519,0,1314,17,1500,169,436,878
25,ILFOV,"PRIMĂRIA ORAŞULUI OTOPENI",56,"ORAŞ OTOPENI",179481,1,PART,PRCNCT,PRSD,PRSD_SV,"2025-05-18 23:50:47",1347,1362,782,579,1,1344,18,1500,138,446,898
25,ILFOV,"SALA DE SPORT OTOPENI",57,"ORAŞ OTOPENI",179481,1,PART,PRCNCT,PRSD,PRSD_SV,"2025-05-18 22:19:43",1794,1481,1082,397,2,1460,21,2000,519,463,997
25,ILFOV,"SALA DE SPORT OTOPENI",58,"ORAŞ OTOPENI",179481,1,PART,PRCNCT,PRSD,PRSD_SV,"2025-05-18 23:00:40",1644,1512,1012,498,2,1496,16,1800,288,443,1053
25,ILFOV,"GRĂDINIŢA CU PROGRAM NORMAL NR. 4",59,"ORAŞ OTOPENI",179481,1,PART,PRCNCT,PRSD,PRSD_SV,"2025-05-18 22:55:10",2011,1891,1277,614,0,1869,22,2198,307,450,1419
25,ILFOV,"GRĂDINIŢA CU PROGRAM NORMAL NR. 4",60,"ORAŞ OTOPENI",179481,2,PART,PRCNCT,PRSD,PRSD_SV,"2025-05-19 02:40:34",1850,1684,1185,498,1,1671,13,2000,316,435,1236
25,ILFOV,"LICEUL TEORETIC IOAN PETRUȘ",61,"ORAŞ OTOPENI",179481,2,PART,PRCNCT,PRSD,PRSD_SV,"2025-05-19 02:49:26",1167,1103,667,370,66,1086,17,1700,597,312,774
25,ILFOV,"GRĂDINIȚA CU PROGRAM PRELUNGIT NR.2",62,"ORAŞ OTOPENI",179481,1,PART,PRCNCT,PRSD,PRSD_SV,"2025-05-18 22:13:35",1631,1821,1142,678,1,1803,18,2200,379,415,1388
25,ILFOV,"GRĂDINIŢIA CU PROGRAM PRELUNGIT NR. 2",63,"ORAŞ OTOPENI",179481,1,PART,PRCNCT,PRSD,PRSD_SV,"2025-05-18 22:11:07",1487,1485,945,540,0,1469,16,2000,515,386,1083
25,ILFOV,"ŞCOALA GIMNAZIALĂ NR. 1 PANTELIMON",64,"ORAŞ PANTELIMON",179515,1,PART,PRCNCT,PRSD,PRSD_SV,"2025-05-18 22:12:53",1618,1020,879,141,0,1009,11,1750,730,516,493
25,ILFOV,"ŞCOALA GIMNAZIALĂ NR. 1 PANTELIMON",65,"ORAŞ PANTELIMON",179515,1,PART,PRCNCT,PRSD,PRSD_SV,"2025-05-18 21:43:19",1699,1078,840,238,0,1069,9,1900,822,614,455
25,ILFOV,"ŞCOALA GIMNAZIALĂ NR. 1 PANTELIMON",66,"ORAŞ PANTELIMON",179515,1,PART,PRCNCT,PRSD,PRSD_SV,"2025-05-18 22:04:45",1830,1294,1040,254,0,1278,16,2000,706,563,715
25,ILFOV,"ŞCOALA GIMNAZIALĂ NR. 1 PANTELIMON",67,"ORAŞ PANTELIMON",179515,1,PART,PRCNCT,PRSD,PRSD_SV,"2025-05-18 22:26:56",1908,1270,1002,268,0,1252,18,2100,830,689,563
25,ILFOV,"ŞCOALA GIMNAZIALĂ NR. 1 PANTELIMON",68,"ORAŞ PANTELIMON",179515,1,PART,PRCNCT,PRSD,PRSD_SV,"2025-05-18 21:56:41",1512,935,759,176,0,918,17,1650,715,548,370
25,ILFOV,"ŞCOALA GIMNAZIALĂ NR. 1 PANTELIMON",69,"ORAŞ PANTELIMON",179515,2,PART,PRCNCT,PRSD,PRSD_SV,"2025-05-19 04:37:53",1554,1072,893,176,3,1059,13,1700,628,483,576
25,ILFOV,"ŞCOALA GIMNAZIALĂ NR. 1 PANTELIMON",70,"ORAŞ PANTELIMON",179515,1,PART,PRCNCT,PRSD,PRSD_SV,"2025-05-18 22:41:26",1131,1024,588,436,0,1012,12,1600,576,505,507
25,ILFOV,"ŞCOALA GIMNAZIALĂ NR. 1 PANTELIMON",71,"ORAŞ PANTELIMON",179515,1,PART,PRCNCT,PRSD,PRSD_SV,"2025-05-18 22:48:45",1666,1358,923,435,0,1345,13,1800,442,524,821
25,ILFOV,"ŞCOALA GIMNAZIALĂ NR. 1 PANTELIMON",72,"ORAŞ PANTELIMON",179515,1,PART,PRCNCT,PRSD,PRSD_SV,"2025-05-18 22:05:37",1925,1400,1061,339,0,1381,19,2100,700,534,847
25,ILFOV,"SALA DE SPORT NR. 2 PANTELIMON",73,"ORAŞ PANTELIMON",179515,1,PART,PRCNCT,PRSD,PRSD_SV,"2025-05-18 22:38:10",1947,1136,1007,129,0,1118,18,2100,964,658,460
25,ILFOV,"SALA DE SPORT NR. 2 PANTELIMON",74,"ORAŞ PANTELIMON",179515,1,PART,PRCNCT,PRSD,PRSD_SV,"2025-05-18 23:19:38",1202,697,605,92,0,686,11,1300,603,413,273
25,ILFOV,"SALA DE SPORT NR. 2 PANTELIMON",75,"ORAŞ PANTELIMON",179515,1,PART,PRCNCT,PRSD,PRSD_SV,"2025-05-18 22:59:00",1529,874,767,107,0,865,9,1650,776,472,393
25,ILFOV,"GRĂDINIŢA NR.1 PANTELIMON",76,"ORAŞ PANTELIMON",179515,1,PART,PRCNCT,PRSD,PRSD_SV,"2025-05-18 21:57:45",1354,789,674,115,0,776,13,1500,711,459,317
25,ILFOV,"GRĂDINIŢA NR.1 PANTELIMON",77,"ORAŞ PANTELIMON",179515,1,PART,PRCNCT,PRSD,PRSD_SV,"2025-05-18 21:43:35",1241,727,587,140,0,713,14,1300,573,379,334
25,ILFOV,"GRĂDINIŢA NR.1 PANTELIMON",78,"ORAŞ PANTELIMON",179515,1,PART,PRCNCT,PRSD,PRSD_SV,"2025-05-18 21:56:47",1227,725,598,125,2,715,10,1350,625,376,339
25,ILFOV,"GRĂDINIŢA NR.1 PANTELIMON",79,"ORAŞ PANTELIMON",179515,1,PART,PRCNCT,PRSD,PRSD_SV,"2025-05-18 22:12:13",1853,880,778,102,0,865,15,2000,1120,558,307
25,ILFOV,"GRĂDINIŢA NR.1 PANTELIMON",80,"ORAŞ PANTELIMON",179515,1,PART,PRCNCT,PRSD,PRSD_SV,"2025-05-18 22:20:44",1916,972,880,90,2,951,21,2100,1128,605,346
25,ILFOV,"GRĂDINIȚA NR.5",81,"ORAŞ POPEŞTI-LEORDENI",179533,1,PART,PRCNCT,PRSD,PRSD_SV,"2025-05-18 22:53:25",1814,1500,991,508,1,1490,10,2000,500,335,1155
25,ILFOV,"GRĂDINIȚA NR.5",82,"ORAŞ POPEŞTI-LEORDENI",179533,1,PART,PRCNCT,PRSD,PRSD_SV,"2025-05-18 23:21:15",1865,1543,1019,524,0,1531,12,2000,457,392,1139
25,ILFOV,"S.C. APOLLO RESIDENCE S.R.L. - PROPRIETATE PRIVATĂ",83,"ORAŞ POPEŞTI-LEORDENI",179533,1,PART,PRCNCT,PRSD,PRSD_SV,"2025-05-18 23:44:51",1844,2159,1014,1145,0,2139,20,2400,241,432,1707
25,ILFOV,"S.C. APOLLO RESIDENCE S.R.L. - PROPRIETATE PRIVATĂ",84,"ORAŞ POPEŞTI-LEORDENI",179533,1,PART,PRCNCT,PRSD,PRSD_SV,"2025-05-19 00:53:25",1669,2186,922,1263,1,2172,13,2400,214,412,1760
25,ILFOV,"SC RAFFAELLO SHOES FACTORY SRL",85,"ORAŞ POPEŞTI-LEORDENI",179533,2,PART,PRCNCT,PRSD,PRSD_SV,"2025-05-19 06:17:20",1425,1398,803,595,0,1387,11,1600,202,291,1096
25,ILFOV,"SC RAFFAELLO SHOES FACTORY SRL",86,"ORAŞ POPEŞTI-LEORDENI",179533,1,PART,PRCNCT,PRSD,PRSD_SV,"2025-05-18 22:50:48",1182,1367,637,730,0,1352,15,1700,333,325,1027
25,ILFOV,"SC RAFFAELLO SHOES FACTORY SRL",87,"ORAŞ POPEŞTI-LEORDENI",179533,1,PART,PRCNCT,PRSD,PRSD_SV,"2025-05-18 23:32:05",1447,1690,823,867,0,1682,7,2000,310,359,1323
25,ILFOV,"FUNDAŢIA LEONARDO MURIALDO",88,"ORAŞ POPEŞTI-LEORDENI",179533,1,PART,PRCNCT,PRSD,PRSD_SV,"2025-05-18 23:07:20",1264,1438,712,725,1,1421,17,1700,262,323,1098
25,ILFOV,"FUNDAŢIA LEONARDO MURIALDO",89,"ORAŞ POPEŞTI-LEORDENI",179533,1,PART,PRCNCT,PRSD,PRSD_SV,"2025-05-18 22:39:28",1771,1411,926,485,0,1400,11,1900,489,334,1066
25,ILFOV,"FUNDAȚIA LEONARDO MURIALDO",90,"ORAŞ POPEŞTI-LEORDENI",179533,1,PART,PRCNCT,PRSD,PRSD_SV,"2025-05-18 23:04:28",1544,1551,866,684,1,1532,19,1700,149,392,1140
25,ILFOV,"FUNDATIA LEONARDO MURIALDO",91,"ORAŞ POPEŞTI-LEORDENI",179533,1,PART,PRCNCT,PRSD,PRSD_SV,"2025-05-18 22:16:53",1672,1239,934,305,0,1229,10,1800,561,296,933
25,ILFOV,"FUNDATIA LEORNARDO MURIALDO",92,"ORAŞ POPEŞTI-LEORDENI",179533,1,PART,PRCNCT,PRSD,PRSD_SV,"2025-05-18 22:17:55",1573,1204,874,329,1,1195,9,1700,496,303,892
25,ILFOV,"ŞCOALA GIMNAZIALĂ IOAN BĂDESCU",93,"ORAŞ POPEŞTI-LEORDENI",179533,1,PART,PRCNCT,PRSD,PRSD_SV,"2025-05-18 22:02:41",1574,1148,908,239,1,1135,13,1700,552,433,702
25,ILFOV,"ŞCOALA GIMNAZIALĂ IOAN BĂDESCU",94,"ORAŞ POPEŞTI-LEORDENI",179533,1,PART,PRCNCT,PRSD,PRSD_SV,"2025-05-18 22:32:00",1629,1265,1013,251,1,1243,22,1800,535,482,761
25,ILFOV,"ŞCOALA GIMNAZIALĂ IOAN BĂDESCU",95,"ORAŞ POPEŞTI-LEORDENI",179533,1,PART,PRCNCT,PRSD,PRSD_SV,"2025-05-18 22:51:04",1626,1274,902,372,0,1252,22,1800,526,479,773
25,ILFOV,"ŞCOALA GIMNAZIALĂ IOAN BĂDESCU",96,"ORAŞ POPEŞTI-LEORDENI",179533,1,PART,PRCNCT,PRSD,PRSD_SV,"2025-05-18 22:48:49",1438,1092,812,280,0,1082,10,1600,508,376,706
25,ILFOV,"LICEUL TEORETIC RADU POPESCU",97,"ORAŞ POPEŞTI-LEORDENI",179533,1,PART,PRCNCT,PRSD,PRSD_SV,"2025-05-18 23:31:45",1884,1419,1152,266,1,1411,8,2100,681,607,804
25,ILFOV,"LICEUL TEORETIC RADU POPESCU",98,"ORAŞ POPEŞTI-LEORDENI",179533,1,PART,PRCNCT,PRSD,PRSD_SV,"2025-05-18 22:32:33",1922,1507,1153,354,0,1492,15,2100,593,725,767
25,ILFOV,"LICEUL TEORETIC RADU POPESCU CORP E",99,"ORAŞ POPEŞTI-LEORDENI",179533,1,PART,PRCNCT,PRSD,PRSD_SV,"2025-05-18 22:40:03",1839,1404,1101,303,0,1390,14,2000,596,609,781
25,ILFOV,"ŞCOALA GIMNAZIALĂ NR. 3",100,"ORAŞ POPEŞTI-LEORDENI",179533,1,PART,PRCNCT,PRSD,PRSD_SV,"2025-05-18 23:01:38",1785,1208,1043,164,1,1194,14,2000,792,552,642
25,ILFOV,"ŞCOALA GIMNAZIALĂ NR. 3",101,"ORAŞ POPEŞTI-LEORDENI",179533,1,PART,PRCNCT,PRSD,PRSD_SV,"2025-05-19 00:14:36",1798,1294,938,352,4,1279,15,2000,706,636,643
25,ILFOV,"SC ONCUȚA MARKET SRL - PROPRIETATE PRIVATĂ",102,"ORAŞ POPEŞTI-LEORDENI",179533,1,PART,PRCNCT,PRSD,PRSD_SV,"2025-05-18 22:50:36",1646,819,790,29,0,804,15,1200,381,535,269
25,ILFOV,"SC ONCUȚA MARKET SRL - PROPRIETATE PRIVATĂ",103,"ORAŞ POPEŞTI-LEORDENI",179533,1,PART,PRCNCT,PRSD,PRSD_SV,"2025-05-18 22:18:13",494,387,213,174,0,385,2,549,162,266,119
25,ILFOV,"GRĂDINITA NR.3",104,"ORAŞ POPEŞTI-LEORDENI",179533,1,PART,PRCNCT,PRSD,PRSD_SV,"2025-05-18 22:17:11",1677,1324,855,469,0,1304,20,1800,476,419,885
25,ILFOV,"GRĂDINIȚA NR.4",105,"ORAŞ POPEŞTI-LEORDENI",179533,1,PART,PRCNCT,PRSD,PRSD_SV,"2025-05-18 22:11:39",1239,851,645,206,0,844,7,1400,549,191,653
25,ILFOV,"GRĂDINIȚA NR.4",106,"ORAŞ POPEŞTI-LEORDENI",179533,1,PART,PRCNCT,PRSD,PRSD_SV,"2025-05-18 22:34:25",1059,853,671,181,1,838,15,1200,347,266,572
25,ILFOV,"CREȘA PRICHINDEL NR. 3",107,"ORAŞ VOLUNTARI",179551,1,PART,PRCNCT,PRSD,PRSD_SV,"2025-05-18 22:27:12",1969,1486,996,489,1,1472,14,2100,614,339,1133
25,ILFOV,"ŞCOALA GIMNAZIALĂ NR. 3",108,"ORAŞ VOLUNTARI",179551,1,PART,PRCNCT,PRSD,PRSD_SV,"2025-05-18 22:28:46",1921,1441,1074,367,0,1421,20,2100,659,320,1101
25,ILFOV,"ŞCOALA GIMNAZIALĂ NR. 3",109,"ORAŞ VOLUNTARI",179551,1,PART,PRCNCT,PRSD,PRSD_SV,"2025-05-18 22:48:48",2072,1522,1075,447,0,1499,23,2200,678,352,1147
25,ILFOV,"ŞCOALA GIMNAZIALĂ NR. 3",110,"ORAŞ VOLUNTARI",179551,1,PART,PRCNCT,PRSD,PRSD_SV,"2025-05-18 22:54:09",1889,2024,1096,928,0,1992,32,2100,76,628,1364
25,ILFOV,"ŞCOALA GIMNAZIALĂ NR. 3",111,"ORAŞ VOLUNTARI",179551,1,PART,PRCNCT,PRSD,PRSD_SV,"2025-05-18 23:07:26",1975,1901,1220,681,0,1878,23,2200,299,445,1433
25,ILFOV,"ȘCOALA GIMNAZIALĂ NR. 3",112,"ORAŞ VOLUNTARI",179551,1,PART,PRCNCT,PRSD,PRSD_SV,"2025-05-18 22:44:20",1880,1679,1120,542,17,1664,15,2100,421,421,1243
25,ILFOV,"ȘCOALA GIMNAZIALĂ NR. 3",113,"ORAŞ VOLUNTARI",179551,1,PART,PRCNCT,PRSD,PRSD_SV,"2025-05-18 23:02:22",1967,1997,1127,868,2,1973,24,2099,102,428,1545
25,ILFOV,"SALA DE SPORT ”ANDREEA ISĂRESCU”",114,"ORAŞ VOLUNTARI",179551,1,PART,PRCNCT,PRSD,PRSD_SV,"2025-05-18 22:48:25",1876,1359,1054,304,1,1336,23,2000,641,654,682
25,ILFOV,"ŞCOALA GIMNAZIALĂ ANTON PANN",115,"ORAŞ VOLUNTARI",179551,1,PART,PRCNCT,PRSD,PRSD_SV,"2025-05-18 22:20:21",1397,1065,824,240,1,1051,14,1500,435,453,598
25,ILFOV,"ŞCOALA GIMNAZIALĂ ANTON PANN",116,"ORAŞ VOLUNTARI",179551,1,PART,PRCNCT,PRSD,PRSD_SV,"2025-05-18 21:53:55",1563,1081,912,169,0,1066,15,1700,619,602,464
25,ILFOV,"ŞCOALA GIMNAZIALĂ ANTON PANN",117,"ORAŞ VOLUNTARI",179551,1,PART,PRCNCT,PRSD,PRSD_SV,"2025-05-18 22:04:27",1900,1391,1086,305,0,1375,16,2100,709,595,780
25,ILFOV,"ŞCOALA GIMNAZIALĂ ANTON PANN",118,"ORAŞ VOLUNTARI",179551,1,PART,PRCNCT,PRSD,PRSD_SV,"2025-05-18 22:07:54",1757,1185,1050,135,0,1164,21,1900,715,626,538
25,ILFOV,"ŞCOALA GIMNAZIALĂ ANTON PANN",119,"ORAŞ VOLUNTARI",179551,1,PART,PRCNCT,PRSD,PRSD_SV,"2025-05-18 22:49:37",1664,1059,939,119,1,1038,21,1400,341,510,528
25,ILFOV,"ŞCOALA GIMNAZIALĂ ANTON PANN",120,"ORAŞ VOLUNTARI",179551,1,PART,PRCNCT,PRSD,PRSD_SV,"2025-05-18 22:01:21",1766,1240,1000,240,0,1222,18,1900,660,745,477
25,ILFOV,"ŞCOALA GIMNAZIALĂ ANTON PANN",121,"ORAŞ VOLUNTARI",179551,1,PART,PRCNCT,PRSD,PRSD_SV,"2025-05-18 21:55:14",1886,1210,1081,129,0,1180,30,1700,490,682,498
25,ILFOV,"ȘCOALA GIMNAZIALĂ ANTON PANN",122,"ORAŞ VOLUNTARI",179551,1,PART,PRCNCT,PRSD,PRSD_SV,"2025-05-18 22:42:17",1787,1084,980,103,1,1070,14,1600,516,452,618
25,ILFOV,"CASA DE CULTURĂ",123,"ORAŞ VOLUNTARI",179551,1,PART,PRCNCT,PRSD,PRSD_SV,"2025-05-18 22:29:25",1783,1333,1015,316,2,1312,21,1900,567,586,726
25,ILFOV,"ŞCOALA GIMNAZIALĂ NR. 2",124,"ORAŞ VOLUNTARI",179551,1,PART,PRCNCT,PRSD,PRSD_SV,"2025-05-18 23:06:50",1879,1278,1068,210,0,1257,21,2100,822,629,628
25,ILFOV,"ŞCOALA GIMNAZIALĂ NR. 2",125,"ORAŞ VOLUNTARI",179551,1,PART,PRCNCT,PRSD,PRSD_SV,"2025-05-18 22:10:08",1905,1298,1119,179,0,1268,30,2100,802,662,606
25,ILFOV,"ŞCOALA GIMNAZIALĂ NR. 2",126,"ORAŞ VOLUNTARI",179551,1,PART,PRCNCT,PRSD,PRSD_SV,"2025-05-18 22:11:48",1758,1190,1042,148,0,1173,17,1900,710,588,585
25,ILFOV,"FOSTUL SEDIU AL PRIMĂRIEI",127,"ORAŞ VOLUNTARI",179551,1,PART,PRCNCT,PRSD,PRSD_SV,"2025-05-18 22:08:30",1811,1251,988,263,0,1233,18,2000,749,670,563
25,ILFOV,"PRIMĂRIA ORAŞULUI VOLUNTARI",128,"ORAŞ VOLUNTARI",179551,1,PART,PRCNCT,PRSD,PRSD_SV,"2025-05-18 22:17:37",1498,1230,894,336,0,1212,18,1600,370,687,525
25,ILFOV,"ŞCOALA GIMNAZIALA NR. 1, CORP A",129,"1 DECEMBRIE",102543,1,PART,PRCNCT,PRSD,PRSD_SV,"2025-05-18 22:40:11",1996,1378,1116,262,0,1360,18,2200,822,607,753
25,ILFOV,"ŞCOALA GIMNAZIALA NR. 1, CORP A",130,"1 DECEMBRIE",102543,1,PART,PRCNCT,PRSD,PRSD_SV,"2025-05-18 22:33:36",1902,1352,996,356,0,1333,19,2100,748,694,639
25,ILFOV,"ŞCOALA GIMNAZIALA NR. 1, CORP B",131,"1 DECEMBRIE",102543,1,PART,PRCNCT,PRSD,PRSD_SV,"2025-05-18 22:28:44",1650,1187,854,233,100,1166,21,1900,713,647,519
25,ILFOV,"ŞCOALA GIMNAZIALA NR. 1, CORP B",132,"1 DECEMBRIE",102543,1,PART,PRCNCT,PRSD,PRSD_SV,"2025-05-18 22:05:30",1639,1110,746,268,96,1098,12,1900,790,599,499
25,ILFOV,"ȘCOALA GENERALĂ NR.1",133,AFUMAŢI,100834,1,PART,PRCNCT,PRSD,PRSD_SV,"2025-05-18 22:10:33",725,677,433,229,15,669,8,800,123,321,348
25,ILFOV,"ȘCOALA GENERALĂ NR.1",134,AFUMAŢI,100834,1,PART,PRCNCT,PRSD,PRSD_SV,"2025-05-18 22:04:07",1442,1054,840,207,7,1042,12,1600,546,471,571
25,ILFOV,"ŞCOALA GENERALĂ NR. 1 CU CLASELE V - VIII",135,AFUMAŢI,100834,1,PART,PRCNCT,PRSD,PRSD_SV,"2025-05-18 22:12:47",1135,923,681,204,38,912,11,1200,277,441,471
25,ILFOV,"ŞCOALA GENERALĂ NR. 3 CU CLASELE I - IV",136,AFUMAŢI,100834,1,PART,PRCNCT,PRSD,PRSD_SV,"2025-05-18 22:11:32",1707,1307,1032,243,32,1293,14,1900,593,696,597
25,ILFOV,"ŞCOALA GENERALĂ NR. 2 CU CLASELE I - IV",137,AFUMAŢI,100834,1,PART,PRCNCT,PRSD,PRSD_SV,"2025-05-18 22:12:14",1813,1296,1030,251,15,1278,18,2000,704,690,588
25,ILFOV,"CLĂDIRE POLICLINICĂ",138,BALOTEŞTI,100969,1,PART,PRCNCT,PRSD,PRSD_SV,"2025-05-18 22:21:37",1070,1003,659,283,61,988,15,1200,197,381,607
25,ILFOV,"ŞCOALA GIMNAZIALĂ NR. 1 BALOTEŞTI",139,BALOTEŞTI,100969,1,PART,PRCNCT,PRSD,PRSD_SV,"2025-05-18 22:29:42",1261,1158,696,462,0,1141,17,1400,242,508,633
25,ILFOV,"ŞCOALA GIMNAZIALĂ NR. 1 BALOTEŞTI",140,BALOTEŞTI,100969,1,PART,PRCNCT,PRSD,PRSD_SV,"2025-05-18 22:30:41",1049,805,629,175,1,795,10,1100,295,373,422
25,ILFOV,"ŞCOALA PRIMARĂ NR. 2 BALOTEŞTI",141,BALOTEŞTI,100969,1,PART,PRCNCT,PRSD,PRSD_SV,"2025-05-18 22:39:05",1650,1542,1080,460,2,1528,14,1800,258,452,1076
25,ILFOV,"ŞCOALA PRIMARĂ NR.2 BALOTEŞTI",142,BALOTEŞTI,100969,1,PART,PRCNCT,PRSD,PRSD_SV,"2025-05-18 22:12:13",1036,1016,556,458,2,1009,7,1100,84,399,610
25,ILFOV,"GRĂDINIŢA NR.3 DUMBRĂVENI",143,BALOTEŞTI,100969,1,PART,PRCNCT,PRSD,PRSD_SV,"2025-05-18 23:29:56",1160,1350,799,547,4,1338,12,1700,350,379,959
25,ILFOV,"ŞCOALA PRIMARĂ NR. 1 SĂFTICA",144,BALOTEŞTI,100969,1,PART,PRCNCT,PRSD,PRSD_SV,"2025-05-18 22:13:59",1365,1081,764,317,0,1066,15,1500,419,451,615
25,ILFOV,"CLĂDIRE MULTIFUNCȚIONALĂ",145,BERCENI,101145,1,PART,PRCNCT,PRSD,PRSD_SV,"2025-05-18 23:16:33",1695,1563,1158,405,0,1545,18,1800,237,580,965
25,ILFOV,"GRADINITA CU PROGRAM PRELUNGIT NR.3",146,BERCENI,101145,1,PART,PRCNCT,PRSD,PRSD_SV,"2025-05-18 22:48:42",1630,1652,1084,568,0,1636,16,1800,148,628,1008
25,ILFOV,"SCOALA PRIMARA NR. 2",147,BERCENI,101145,1,PART,PRCNCT,PRSD,PRSD_SV,"2025-05-18 23:00:44",1679,1873,1081,792,0,1837,36,2200,327,641,1196
25,ILFOV,"SCOALA PRIMARA NR. 2",148,BERCENI,101145,2,PART,PRCNCT,PRSD,PRSD_SV,"2025-05-19 01:10:12",1666,1812,1031,781,0,1784,28,2000,188,746,1038
25,ILFOV,"ŞCOALA GIMNAZIALA NR. 1",149,BERCENI,101145,1,PART,PRCNCT,PRSD,PRSD_SV,"2025-05-18 22:34:40",1576,1693,982,711,0,1677,16,1900,207,666,1011
25,ILFOV,"SCOALA GIMNAZIALA NR. 1",150,BERCENI,101145,1,PART,PRCNCT,PRSD,PRSD_SV,"2025-05-18 22:58:59",1690,1780,1071,709,0,1768,12,1998,218,733,1035
25,ILFOV,"ŞCOALA GIMNAZIALĂ NR.1 BRĂNEȘTI",151,BRĂNEŞTI,101298,1,PART,PRCNCT,PRSD,PRSD_SV,"2025-05-18 22:12:52",1040,1009,646,363,0,996,13,1300,291,450,546
25,ILFOV,"ȘCOALA GIMNAZIALĂ NR.1 BRĂNEȘTI",152,BRĂNEŞTI,101298,1,PART,PRCNCT,PRSD,PRSD_SV,"2025-05-18 21:56:23",1341,1155,862,293,0,1143,12,1500,345,489,654
25,ILFOV,"ŞCOALA GENERALĂ DIN CARTIERUL BĂJENARI",153,BRĂNEŞTI,101298,1,PART,PRCNCT,PRSD,PRSD_SV,"2025-05-18 22:18:17",1851,1353,1136,217,0,1333,20,1600,247,636,697
25,ILFOV,"LICEUL TEORETIC ”TRAIAN LALESCU”",154,BRĂNEŞTI,101298,1,PART,PRCNCT,PRSD,PRSD_SV,"2025-05-18 22:51:09",1882,1698,1194,504,0,1675,23,2000,302,659,1016
25,ILFOV,"GRĂDINIŢA NR.1",155,BRĂNEŞTI,101298,1,PART,PRCNCT,PRSD,PRSD_SV,"2025-05-18 22:15:41",1279,985,756,229,0,978,7,1400,415,596,382
25,ILFOV,"GRADINITA NR.2",156,BRĂNEŞTI,101298,1,PART,PRCNCT,PRSD,PRSD_SV,"2025-05-18 22:21:18",1037,1048,655,393,0,1030,18,1308,260,453,577
25,ILFOV,"ŞCOALA GIMNAZIALĂ NR.1",157,CERNICA,101742,1,PART,PRCNCT,PRSD,PRSD_SV,"2025-05-18 22:05:14",835,765,534,229,2,752,13,900,135,319,433
25,ILFOV,"ŞCOALA GIMNAZIALĂ NR.1",158,CERNICA,101742,1,PART,PRCNCT,PRSD,PRSD_SV,"2025-05-18 22:21:32",804,718,454,261,3,712,6,900,182,390,322
25,ILFOV,"ŞCOALA GIMNAZIALĂ NR.1",159,CERNICA,101742,1,PART,PRCNCT,PRSD,PRSD_SV,"2025-05-18 22:29:03",920,777,499,277,1,769,8,1000,223,499,270
25,ILFOV,"ŞCOALA GIMNAZIALĂ NR.3",160,CERNICA,101742,1,PART,PRCNCT,PRSD,PRSD_SV,"2025-05-18 22:07:58",1272,1010,723,257,30,999,11,1400,390,590,409
25,ILFOV,"ŞCOALA GIMNAZIALĂ NR.3",161,CERNICA,101742,1,PART,PRCNCT,PRSD,PRSD_SV,"2025-05-18 22:04:54",1599,1135,874,261,0,1126,9,1700,565,738,388
25,ILFOV,"GRĂDINIŢA NR.5",162,CERNICA,101742,1,PART,PRCNCT,PRSD,PRSD_SV,"2025-05-18 21:53:29",1012,889,602,287,0,882,7,1100,211,493,389
25,ILFOV,"ŞCOALA GIMNAZIALĂ NR.2",163,CERNICA,101742,1,PART,PRCNCT,PRSD,PRSD_SV,"2025-05-18 22:23:44",1308,834,684,143,7,820,14,1400,566,481,339
25,ILFOV,"ŞCOALA GIMNAZIALĂ NR.2",164,CERNICA,101742,1,PART,PRCNCT,PRSD,PRSD_SV,"2025-05-18 22:24:22",1349,654,599,55,0,641,13,1100,446,464,177
25,ILFOV,"ŞCOALA GIMNAZIALĂ ”ALEXANDRU ODOBESCU”",165,CHIAJNA,179249,1,PART,PRCNCT,PRSD,PRSD_SV,"2025-05-18 23:00:57",1666,1498,1003,495,0,1483,15,1800,302,529,954
25,ILFOV,"ŞCOALA GIMNAZIALĂ ”ALEXANDRU ODOBESCU”",166,CHIAJNA,179249,1,PART,PRCNCT,PRSD,PRSD_SV,"2025-05-18 22:58:34",1805,1325,1029,295,1,1308,17,2000,675,440,868
25,ILFOV,"ŞCOALA GIMNAZIALĂ ”ALEXANDRU ODOBESCU”",167,CHIAJNA,179249,1,PART,PRCNCT,PRSD,PRSD_SV,"2025-05-18 22:37:46",1797,1254,1008,246,0,1237,17,2000,746,521,716
25,ILFOV,"ŞCOALA GIMNAZIALĂ ”ALEXANDRU ODOBESCU”",168,CHIAJNA,179249,1,PART,PRCNCT,PRSD,PRSD_SV,"2025-05-18 22:26:51",1302,878,669,209,0,868,10,1400,522,345,523
25,ILFOV,"ŞCOALA GIMNAZIALĂ ”ALEXANDRU ODOBESCU”",169,CHIAJNA,179249,1,PART,PRCNCT,PRSD,PRSD_SV,"2025-05-18 23:08:53",1969,1236,809,427,0,1227,9,2000,764,487,740
25,ILFOV,"ŞCOALA GIMNAZIALĂ ”ALEXANDRU ODOBESCU”",170,CHIAJNA,179249,2,PART,PRCNCT,PRSD,PRSD_SV,"2025-05-19 04:43:29",1608,1326,996,330,0,1312,14,1800,474,465,847
25,ILFOV,"ŞCOALA GIMNAZIALĂ ”PETRU RAREȘ”",171,CHIAJNA,179249,1,PART,PRCNCT,PRSD,PRSD_SV,"2025-05-18 23:07:30",1904,1573,838,735,0,1561,12,2100,527,520,1041
25,ILFOV,"ŞCOALA GIMNAZIALĂ ”PETRU RAREȘ”",172,CHIAJNA,179249,1,PART,PRCNCT,PRSD,PRSD_SV,"2025-05-18 23:23:22",1732,1803,788,1015,0,1792,11,1900,97,665,1127
25,ILFOV,"ŞCOALA GIMNAZIALĂ ”PETRU RAREȘ”",173,CHIAJNA,179249,1,PART,PRCNCT,PRSD,PRSD_SV,"2025-05-18 22:57:40",1726,1643,810,833,0,1625,18,1900,257,535,1090
25,ILFOV,"ŞCOALA GIMNAZIALĂ ”PETRU RAREȘ”",174,CHIAJNA,179249,1,PART,PRCNCT,PRSD,PRSD_SV,"2025-05-18 23:26:02",1879,1761,899,862,0,1747,14,2100,339,515,1232
25,ILFOV,"ŞCOALA GIMNAZIALĂ ”PETRU RAREȘ”",175,CHIAJNA,179249,1,PART,PRCNCT,PRSD,PRSD_SV,"2025-05-18 22:50:03",1340,1536,660,876,0,1519,17,1700,164,474,1045
25,ILFOV,"ŞCOALA GIMNAZIALĂ ”PETRU RAREȘ”",176,CHIAJNA,179249,1,PART,PRCNCT,PRSD,PRSD_SV,"2025-05-18 23:57:58",1956,1843,999,844,0,1829,14,2100,257,712,1117
25,ILFOV,"ŞCOALA GIMNAZIALĂ ”PETRU RAREȘ”",177,CHIAJNA,179249,1,PART,PRCNCT,PRSD,PRSD_SV,"2025-05-18 23:28:43",1937,1525,864,661,0,1511,14,2100,575,603,908
25,ILFOV,"ŞCOALA GIMNAZIALĂ ”PETRU RAREȘ”",178,CHIAJNA,179249,1,PART,PRCNCT,PRSD,PRSD_SV,"2025-05-18 23:20:42",1392,1612,792,819,1,1598,13,1900,288,516,1082
25,ILFOV,"LICEUL TEHNOLOGIC ”DOAMNA CHIAJNA”",179,CHIAJNA,179249,1,PART,PRCNCT,PRSD,PRSD_SV,"2025-05-18 22:51:32",1917,1569,1126,440,3,1540,29,2092,523,659,881
25,ILFOV,"LICEUL TEHNOLOGIC ”DOAMNA CHIAJNA”",180,CHIAJNA,179249,1,PART,PRCNCT,PRSD,PRSD_SV,"2025-05-18 22:31:42",1784,1695,1052,643,0,1675,20,2000,305,550,1125
25,ILFOV,"LICEUL TEHNOLOGIC ”DOAMNA CHIAJNA”",181,CHIAJNA,179249,1,PART,PRCNCT,PRSD,PRSD_SV,"2025-05-18 23:31:53",1974,1398,963,435,0,1380,18,1800,402,539,841
25,ILFOV,"LICEUL TEHNOLOGIC ”DOAMNA CHIAJNA”",182,CHIAJNA,179249,1,PART,PRCNCT,PRSD,PRSD_SV,"2025-05-18 23:04:36",1890,1433,1028,405,0,1422,11,2100,667,485,937
25,ILFOV,"LICEUL TEHNOLOGIC ”DOAMNA CHIAJNA”",183,CHIAJNA,179249,1,PART,PRCNCT,PRSD,PRSD_SV,"2025-05-18 22:59:34",1525,1407,908,499,0,1398,9,1700,293,394,1004
25,ILFOV,"SALA DE SPORT CIOLPANI",184,CIOLPANI,101902,1,PART,PRCNCT,PRSD,PRSD_SV,"2025-05-18 23:23:06",1910,1345,966,378,1,1326,18,2100,755,723,603
25,ILFOV,"GRADINITA NR.4",185,CIOLPANI,101902,1,PART,PRCNCT,PRSD,PRSD_SV,"2025-05-18 22:17:37",1149,876,548,299,29,860,16,1250,374,416,444
25,ILFOV,"GRADINITA NR.3",186,CIOLPANI,101902,1,PART,PRCNCT,PRSD,PRSD_SV,"2025-05-18 22:41:30",670,609,308,301,0,601,8,700,91,239,362
25,ILFOV,"CAMIN CULTURAL",187,CIOLPANI,101902,1,PART,PRCNCT,PRSD,PRSD_SV,"2025-05-18 22:35:11",729,519,366,153,0,513,6,800,281,241,272
25,ILFOV,"ŞCOALA GIMNAZIALĂ NR. 1 CIOROGÂRLA",188,CIOROGÂRLA,101957,1,PART,PRCNCT,PRSD,PRSD_SV,"2025-05-18 22:16:59",1509,1420,932,488,0,1402,18,1700,280,598,804
25,ILFOV,"ŞCOALA GIMNAZIALĂ NR. 1 CIOROGÂRLA",189,CIOROGÂRLA,101957,1,PART,PRCNCT,PRSD,PRSD_SV,"2025-05-18 22:17:49",1993,1798,1165,632,1,1772,26,2200,402,864,908
25,ILFOV,"ŞCOALA GIMNAZIALĂ NR. 2 DÂRVARI",190,CIOROGÂRLA,101957,1,PART,PRCNCT,PRSD,PRSD_SV,"2025-05-18 22:09:05",1873,1250,983,267,0,1235,15,2000,750,830,405
25,ILFOV,"ŞCOALĂ PRIMARĂ NR.1 CLINCENI",191,CLINCENI,102035,1,PART,PRCNCT,PRSD,PRSD_SV,"2025-05-18 22:06:46",1647,1274,998,269,7,1255,19,1800,526,639,616
25,ILFOV,"LICEUL CU PROGRAM SPORTIV HELMUT DUCKADAM CLINCENI",192,CLINCENI,102035,1,PART,PRCNCT,PRSD,PRSD_SV,"2025-05-18 22:55:57",1345,1272,818,452,2,1255,16,1700,428,535,720
25,ILFOV,"LICEUL CU PROGRAM SPORTIV HELMUT DUCKADAM CLINCENI",193,CLINCENI,102035,1,PART,PRCNCT,PRSD,PRSD_SV,"2025-05-18 23:15:28",1569,1257,895,362,0,1241,16,1900,643,602,639
25,ILFOV,"SCOALA PRIMARA NR 2 OLTENI",194,CLINCENI,102035,1,PART,PRCNCT,PRSD,PRSD_SV,"2025-05-18 22:03:31",1198,1205,727,475,3,1190,15,1300,95,510,680
25,ILFOV,"ŞCOALA PRIMARĂ NR.2 OLTENI CLINCENI",195,CLINCENI,102035,1,PART,PRCNCT,PRSD,PRSD_SV,"2025-05-18 22:23:31",1156,1090,675,415,0,1081,9,1250,160,416,665
25,ILFOV,"AȘEZĂMÂNTUL SOCIAL AL BISERICII SF. DUMITRU",196,COPĂCENI,179588,1,PART,PRCNCT,PRSD,PRSD_SV,"2025-05-18 22:02:41",1509,1112,853,259,0,1105,7,1700,588,636,469
25,ILFOV,"SCOALA GIMNAZIALA NR. 1",197,COPĂCENI,179588,1,PART,PRCNCT,PRSD,PRSD_SV,"2025-05-18 21:56:36",1005,739,607,132,0,732,7,1100,361,398,334
25,ILFOV,"ŞCOALA GIMNAZIALĂ NR. 1",198,CORBEANCA,102160,1,PART,PRCNCT,PRSD,PRSD_SV,"2025-05-18 22:55:05",1521,1532,885,647,0,1517,15,1700,168,552,965
25,ILFOV,"ŞCOALA GIMNAZIALĂ NR. 1",199,CORBEANCA,102160,1,PART,PRCNCT,PRSD,PRSD_SV,"2025-05-18 23:04:31",1550,1477,1035,441,1,1469,8,1700,223,375,1094
25,ILFOV,"CLĂDIREA AFTER SCHOOL",200,CORBEANCA,102160,1,PART,PRCNCT,PRSD,PRSD_SV,"2025-05-18 22:51:49",1017,1360,661,696,3,1349,11,1700,340,286,1063
25,ILFOV,"CASA TINERETULUI",201,CORBEANCA,102160,1,PART,PRCNCT,PRSD,PRSD_SV,"2025-05-18 23:14:00",985,1016,655,361,0,1006,10,1500,484,252,754
25,ILFOV,"GRĂDINIŢA NR. 1",202,CORBEANCA,102160,2,PART,PRCNCT,PRSD,PRSD_SV,"2025-05-19 02:01:27",1208,1641,786,855,0,1624,17,1900,259,446,1178
25,ILFOV,"SCOALA GIMNAZIALA NR.2",203,CORBEANCA,102160,1,PART,PRCNCT,PRSD,PRSD_SV,"2025-05-18 23:13:56",1276,1213,797,416,0,1197,16,1400,187,481,716
25,ILFOV,"ȘCOALA GIMNAZIALA NR.2",204,CORBEANCA,102160,1,PART,PRCNCT,PRSD,PRSD_SV,"2025-05-18 23:13:38",1477,1386,950,435,1,1374,12,1800,414,455,919
25,ILFOV,"ŞCOALA GIMNAZIALĂ NR.1",205,CORNETU,102213,1,PART,PRCNCT,PRSD,PRSD_SV,"2025-05-18 22:20:50",1240,964,668,295,1,954,10,1200,236,464,490
25,ILFOV,"ŞCOALA GIMNAZIALĂ NR.1",206,CORNETU,102213,1,PART,PRCNCT,PRSD,PRSD_SV,"2025-05-18 22:11:33",951,653,503,150,0,645,8,1000,347,340,305
25,ILFOV,"ŞCOALA GIMNAZIALĂ NR.1",207,CORNETU,102213,1,PART,PRCNCT,PRSD,PRSD_SV,"2025-05-18 22:07:15",1055,810,598,212,0,805,5,1200,390,399,406
25,ILFOV,"ŞCOALA GIMNAZIALĂ NR.1",208,CORNETU,102213,3,PART,PRCNCT,PRSD,PRSD_SV,"2025-05-19 00:23:15",1054,773,587,185,1,768,5,1200,427,393,375
25,ILFOV,"ŞCOALA GIMNAZIALĂ NR.1",209,CORNETU,102213,1,PART,PRCNCT,PRSD,PRSD_SV,"2025-05-18 21:46:09",1254,897,686,211,0,886,11,1200,303,451,435
25,ILFOV,"ŞCOALA GIMNAZIALĂ DASCĂLU",210,DASCĂLU,102473,1,PART,PRCNCT,PRSD,PRSD_SV,"2025-05-18 23:22:36",1964,1582,1091,491,0,1568,14,2100,518,877,691
25,ILFOV,"GRĂDINIŢA NR. 2 GAGU",211,DASCĂLU,102473,1,PART,PRCNCT,PRSD,PRSD_SV,"2025-05-18 22:07:45",704,436,318,118,0,433,3,800,364,266,167
25,ILFOV,"ŞCOALA GENERALĂ NR. 1",212,DĂRĂŞTI-ILFOV,102525,1,PART,PRCNCT,PRSD,PRSD_SV,"2025-05-18 21:54:41",1022,678,525,147,6,665,13,1100,422,382,283
25,ILFOV,"ŞCOALA GENERALĂ NR. 1",213,DĂRĂŞTI-ILFOV,102525,1,PART,PRCNCT,PRSD,PRSD_SV,"2025-05-18 22:06:00",1201,746,607,128,11,731,15,1300,554,447,284
25,ILFOV,"ŞCOALA GIMNAZIALĂ NR. 1",214,DOBROEŞTI,179310,1,PART,PRCNCT,PRSD,PRSD_SV,"2025-05-18 22:22:20",1768,1503,1042,461,0,1479,24,1900,397,592,887
25,ILFOV,"ŞCOALA GIMNAZIALĂ NR. 1",215,DOBROEŞTI,179310,1,PART,PRCNCT,PRSD,PRSD_SV,"2025-05-18 22:42:53",1871,1319,1045,272,2,1296,23,2000,681,555,741
25,ILFOV,"ŞCOALA GIMNAZIALĂ NR. 1",216,DOBROEŞTI,179310,1,PART,PRCNCT,PRSD,PRSD_SV,"2025-05-18 22:47:38",1665,1415,946,469,0,1392,23,1800,385,632,760
25,ILFOV,"SCOALA GIMNAZIALA NR. 2 CAMPUS SCOLAR DOBROESTI",217,DOBROEŞTI,179310,1,PART,PRCNCT,PRSD,PRSD_SV,"2025-05-18 23:07:57",1825,1337,1013,324,0,1322,15,2000,663,501,821
25,ILFOV,"SCOALA GIMNAZIALA NR. 2 CAMPUS SCOLAR DOBROESTI",218,DOBROEŞTI,179310,2,PART,PRCNCT,PRSD,PRSD_SV,"2025-05-19 00:46:32",1848,1398,1011,386,1,1384,14,2000,602,602,782
25,ILFOV,"SCOALA GIMNAZIALA NR. 2 CAMPUS SCOLAR DOBROESTI",219,DOBROEŞTI,179310,1,PART,PRCNCT,PRSD,PRSD_SV,"2025-05-18 22:23:41",2032,1335,910,424,1,1326,9,2200,865,551,775
25,ILFOV,"GRĂDINIȚA NR. 2 FUNDENI",220,DOBROEŞTI,179310,1,PART,PRCNCT,PRSD,PRSD_SV,"2025-05-18 22:24:18",1168,820,667,153,0,808,12,1300,480,337,471
25,ILFOV,"AFTER SCHOOL DOMNESTI",221,DOMNEŞTI,102570,1,PART,PRCNCT,PRSD,PRSD_SV,"2025-05-18 22:50:01",1768,1276,1014,262,0,1264,12,1550,274,682,582
25,ILFOV,"GRADINIȚA CU PROGRAM PRELUNGIT TARÂMUL PRIETENIEI",222,DOMNEŞTI,102570,1,PART,PRCNCT,PRSD,PRSD_SV,"2025-05-19 00:10:56",1859,1803,1048,753,2,1770,33,2000,197,796,974
25,ILFOV,"GRADINIȚA CU PROGRAM PRELUNGIT TARÂMUL PRIETENIEI",223,DOMNEŞTI,102570,1,PART,PRCNCT,PRSD,PRSD_SV,"2025-05-18 22:16:54",1917,1607,1126,479,2,1592,15,2100,493,703,889
25,ILFOV,"ȘCOALA GIMNAZIALĂ ”GHEORGHE CORNELIU”",224,DOMNEŞTI,102570,1,PART,PRCNCT,PRSD,PRSD_SV,"2025-05-18 23:08:16",1619,1579,1019,560,0,1552,27,1800,221,506,1046
25,ILFOV,"ȘCOALA GIMNAZIALĂ GHEORGHE CORNELIU",225,DOMNEŞTI,102570,1,PART,PRCNCT,PRSD,PRSD_SV,"2025-05-18 22:43:30",1444,1485,869,614,2,1463,22,1800,315,643,820
25,ILFOV,"GRADINITA NR. 1- ȚEGHEȘ",226,DOMNEŞTI,102570,1,PART,PRCNCT,PRSD,PRSD_SV,"2025-05-18 23:16:24",1116,1087,711,376,0,1072,15,1350,263,528,544
25,ILFOV,"LICEUL TEHNOLOGIC ”VINTILĂ BRĂTIANU”",227,DRAGOMIREŞTI-VALE,102605,1,PART,PRCNCT,PRSD,PRSD_SV,"2025-05-18 22:23:14",1540,1479,970,509,0,1458,21,1700,221,690,768
25,ILFOV,"ȘCOALA GENERALĂ NR. 2",228,DRAGOMIREŞTI-VALE,102605,1,PART,PRCNCT,PRSD,PRSD_SV,"2025-05-18 22:34:57",1392,1219,777,442,0,1206,13,1500,281,588,618
25,ILFOV,"GRĂDINIȚA NR. 1 DRAGOMIREȘTI-DEAL(ȘCOALA VECHE)",229,DRAGOMIREŞTI-VALE,102605,1,PART,PRCNCT,PRSD,PRSD_SV,"2025-05-18 22:17:37",1372,1133,858,273,2,1116,17,1500,367,407,709
25,ILFOV,"ȘCOALA PRIMARĂ NR. 1",230,DRAGOMIREŞTI-VALE,102605,1,PART,PRCNCT,PRSD,PRSD_SV,"2025-05-18 22:05:30",918,729,566,163,0,718,11,1000,271,372,346
25,ILFOV,"ŞCOALA GĂNEASA",231,GĂNEASA,103130,1,PART,PRCNCT,PRSD,PRSD_SV,"2025-05-18 21:39:51",852,711,441,270,0,708,3,900,189,337,371
25,ILFOV,"ŞCOALA COZIENI",232,GĂNEASA,103130,1,PART,PRCNCT,PRSD,PRSD_SV,"2025-05-18 22:02:47",682,451,323,128,0,446,5,800,349,320,126
25,ILFOV,"ŞCOALA MOARA DOMNEASCĂ",233,GĂNEASA,103130,1,PART,PRCNCT,PRSD,PRSD_SV,"2025-05-18 21:38:07",555,409,307,102,0,407,2,600,191,210,197
25,ILFOV,"ŞCOALA PITEASCA",234,GĂNEASA,103130,1,PART,PRCNCT,PRSD,PRSD_SV,"2025-05-18 22:13:31",1162,627,559,68,0,624,3,887,260,523,101
25,ILFOV,"SCOALA GIMNAZIALA NR.3, ŞINDRILIŢA",235,GĂNEASA,103130,1,PART,PRCNCT,PRSD,PRSD_SV,"2025-05-18 22:10:12",1172,656,539,117,0,654,2,1300,644,550,104
25,ILFOV,"ŞCOALA GIMNAZIALĂ NR. 1",236,GLINA,179347,1,PART,PRCNCT,PRSD,PRSD_SV,"2025-05-18 22:56:41",1723,1221,953,268,0,1213,8,1600,379,764,449
25,ILFOV,"ŞCOALA GIMNAZIALĂ NR. 1",237,GLINA,179347,1,PART,PRCNCT,PRSD,PRSD_SV,"2025-05-18 22:53:21",1723,1096,936,160,0,1080,16,1500,404,590,490
25,ILFOV,"ŞCOALA GIMNAZIALĂ NR. 3",238,GLINA,179347,1,PART,PRCNCT,PRSD,PRSD_SV,"2025-05-18 23:51:09",1575,740,662,78,0,730,10,1300,560,614,116
25,ILFOV,"ŞCOALA GIMNAZIALĂ NR. 2",239,GLINA,179347,1,PART,PRCNCT,PRSD,PRSD_SV,"2025-05-18 22:49:35",1158,1106,647,459,0,1092,14,1300,194,470,622
25,ILFOV,"ŞCOALA GIMNAZIALĂ NR. 2",240,GLINA,179347,1,PART,PRCNCT,PRSD,PRSD_SV,"2025-05-18 22:41:17",965,1036,563,473,0,1024,12,1200,164,425,599
25,ILFOV,"CĂMINUL CULTURAL MULTIFUNCŢIONAL",241,GRĂDIŞTEA,103443,1,PART,PRCNCT,PRSD,PRSD_SV,"2025-05-18 22:07:46",1648,1193,887,306,0,1177,16,1800,607,662,515
25,ILFOV,"ŞCOALA PRIMARĂ NR. 1 SITARU",242,GRĂDIŞTEA,103443,1,PART,PRCNCT,PRSD,PRSD_SV,"2025-05-18 21:35:12",885,596,453,143,0,585,11,1000,404,357,228
25,ILFOV,"ŞCOALA DE 4 ANI",243,GRUIU,103513,1,PART,PRCNCT,PRSD,PRSD_SV,"2025-05-18 21:52:48",1545,1168,816,351,1,1159,9,1699,531,647,512
25,ILFOV,"ŞCOALA GIMNAZIALĂ NR.1 GRUIU",244,GRUIU,103513,1,PART,PRCNCT,PRSD,PRSD_SV,"2025-05-18 21:51:11",702,615,406,209,0,608,7,800,185,332,276
25,ILFOV,"GRĂDINIŢA DE COPII",245,GRUIU,103513,1,PART,PRCNCT,PRSD,PRSD_SV,"2025-05-18 22:03:10",1813,1223,951,271,1,1209,14,1600,377,774,435
25,ILFOV,"ŞCOALA DE 8 ANI",246,GRUIU,103513,1,PART,PRCNCT,PRSD,PRSD_SV,"2025-05-18 22:10:57",1849,1444,1000,440,4,1422,22,2000,556,836,586
25,ILFOV,"PROPRIETATE PRIVATĂ BACHAR DAVID-SAMUIL",247,JILAVA,179383,2,PART,PRCNCT,PRSD,PRSD_SV,"2025-05-19 01:33:26",1615,1075,742,236,97,1067,8,1899,824,653,414
25,ILFOV,"GRĂDINIȚA NR. 1",248,JILAVA,179383,1,PART,PRCNCT,PRSD,PRSD_SV,"2025-05-18 23:09:22",1376,1109,833,178,98,1096,13,1600,491,612,484
25,ILFOV,"ȘCOALA GIMNAZIALĂ NR.1",249,JILAVA,179383,1,PART,PRCNCT,PRSD,PRSD_SV,"2025-05-18 23:14:31",1873,1429,1016,315,98,1408,21,2100,671,817,591
25,ILFOV,"ȘCOALA GIMNAZIALĂ NR.2",250,JILAVA,179383,1,PART,PRCNCT,PRSD,PRSD_SV,"2025-05-18 22:58:31",1292,852,683,73,96,846,6,1500,648,503,343
25,ILFOV,"ȘCOALA GIMNAZIALĂ NR.2",251,JILAVA,179383,1,PART,PRCNCT,PRSD,PRSD_SV,"2025-05-18 22:18:22",896,613,408,108,97,603,10,1000,387,502,101
25,ILFOV,"POLICLINICA JILAVA",252,JILAVA,179383,1,PART,PRCNCT,PRSD,PRSD_SV,"2025-05-18 23:18:18",1866,1273,927,250,96,1257,16,2100,827,819,438
25,ILFOV,"ŞCOALA GIMNAZIALA NR. 2 MOARA VLASIEI",253,"MOARA VLĂSIEI",104243,1,PART,PRCNCT,PRSD,PRSD_SV,"2025-05-19 00:25:02",1928,1463,1183,280,0,1448,15,2100,637,775,673
25,ILFOV,"ŞCOALA GIMNAZIALA NR. 1 MOARA VLASIEI",254,"MOARA VLĂSIEI",104243,1,PART,PRCNCT,PRSD,PRSD_SV,"2025-05-18 22:39:57",1891,1337,1090,246,1,1318,19,2100,763,669,649
25,ILFOV,"ŞCOALA GIMNAZIALA NR. 3 ”AL. DIMITRIE GHICA ”",255,"MOARA VLĂSIEI",104243,1,PART,PRCNCT,PRSD,PRSD_SV,"2025-05-18 22:25:14",1632,1317,965,352,0,1304,13,1800,483,651,653
25,ILFOV,"SCOALA GIMNAZIALA NR.1 MOGOSOAIA",256,MOGOŞOAIA,179463,1,PART,PRCNCT,PRSD,PRSD_SV,"2025-05-18 23:26:40",1377,1317,871,445,1,1303,14,1500,183,482,821
25,ILFOV,"SCOALA GIMNAZIALA NR.1 MOGOSOAIA",257,MOGOŞOAIA,179463,1,PART,PRCNCT,PRSD,PRSD_SV,"2025-05-18 23:12:38",1535,1153,803,346,4,1142,11,1700,547,470,672
25,ILFOV,"SCOALA GIMNAZIALA NR.1 MOGOSOAIA -",258,MOGOŞOAIA,179463,1,PART,PRCNCT,PRSD,PRSD_SV,"2025-05-18 22:22:36",1378,1126,814,312,0,1116,10,1500,374,525,591
25,ILFOV,"SCOALA GIMNAZIALA NR.1 MOGOSOAIA -CORP B",259,MOGOŞOAIA,179463,2,PART,PRCNCT,PRSD,PRSD_SV,"2025-05-19 00:44:43",1691,1299,857,442,0,1286,13,1800,501,696,590
25,ILFOV,"SCOALA GIMNAZIALA NR.1 MOGOSOAIA -CORP B",260,MOGOŞOAIA,179463,1,PART,PRCNCT,PRSD,PRSD_SV,"2025-05-18 23:16:52",1885,1583,1123,460,0,1573,10,2100,517,409,1164
25,ILFOV,"ŞCOALA DIN SATUL MERII PETCHII",261,NUCI,104421,1,PART,PRCNCT,PRSD,PRSD_SV,"2025-05-18 22:23:39",820,657,449,176,32,651,6,900,243,316,335
25,ILFOV,"ŞCOALA DIN SATUL MICŞUNEŞTII-MOARĂ",262,NUCI,104421,2,PART,PRCNCT,PRSD,PRSD_SV,"2025-05-19 00:13:52",1309,1043,727,266,50,1028,15,1400,357,594,434
25,ILFOV,"LICEUL TEORETIC NR.1 PERIŞ",263,PERIŞ,104546,1,PART,PRCNCT,PRSD,PRSD_SV,"2025-05-18 22:43:25",1871,1191,950,241,0,1175,16,2000,809,698,477
25,ILFOV,"ȘCOALA GIMNAZIALĂ NR.2 PERIȘ",264,PERIŞ,104546,1,PART,PRCNCT,PRSD,PRSD_SV,"2025-05-18 22:11:28",1003,743,543,200,0,729,14,1100,357,397,332
25,ILFOV,"ȘCOALA GIMNAZIALĂ NR.2 PERIȘ",265,PERIŞ,104546,1,PART,PRCNCT,PRSD,PRSD_SV,"2025-05-18 21:49:38",1079,732,630,102,0,724,8,1200,468,397,327
25,ILFOV,"FOSTA ŞCOALA NR. 3 PERIS",266,PERIŞ,104546,1,PART,PRCNCT,PRSD,PRSD_SV,"2025-05-18 21:53:13",669,574,391,182,1,565,9,700,126,290,275
25,ILFOV,"GRĂDINIȚA NR.2, BĂLTENI",267,PERIŞ,104546,1,PART,PRCNCT,PRSD,PRSD_SV,"2025-05-18 21:37:18",438,416,240,176,0,409,7,500,84,174,235
25,ILFOV,"ȘCOALA GIMNAZIALĂ ”PROF.ION IONIȚĂ ” BURIAȘ",268,PERIŞ,104546,1,PART,PRCNCT,PRSD,PRSD_SV,"2025-05-18 22:15:34",1066,771,606,165,0,766,5,1200,429,436,330
25,ILFOV,"STRUCTURA CU GRUPE DE PREŞCOLARI",269,PETRĂCHIOAIA,104582,1,PART,PRCNCT,PRSD,PRSD_SV,"2025-05-18 22:06:25",1694,1109,820,289,0,1095,14,1900,791,694,401
25,ILFOV,"STRUCTURA CU CLASELE I-IV ŞI GRUPE DE PREŞCOLARI",270,PETRĂCHIOAIA,104582,1,PART,PRCNCT,PRSD,PRSD_SV,"2025-05-18 21:37:44",292,218,153,65,0,216,2,350,132,156,60
25,ILFOV,"STRUCTURA CU CLASELE I-IV ŞI GRUPE DE PREŞCOLARI",271,PETRĂCHIOAIA,104582,1,PART,PRCNCT,PRSD,PRSD_SV,"2025-05-18 22:13:13",484,352,251,101,0,347,5,501,149,237,110
25,ILFOV,"STRUCTURA CU CLASELE I-IV ŞI GRUPE DE PREŞCOLARI",272,PETRĂCHIOAIA,104582,1,PART,PRCNCT,PRSD,PRSD_SV,"2025-05-18 21:52:01",395,358,233,125,0,352,6,400,42,226,126
25,ILFOV,"ŞCOALA GENERALĂ SNAGOV",273,SNAGOV,105160,2,PART,PRCNCT,PRSD,PRSD_SV,"2025-05-19 02:14:38",1937,1691,1049,641,1,1671,20,2100,409,685,986
25,ILFOV,"GRĂDINIŢA NR. 1 CIOFLICENI",274,SNAGOV,105160,1,PART,PRCNCT,PRSD,PRSD_SV,"2025-05-18 23:19:37",1142,980,677,303,0,967,13,1200,220,404,563
25,ILFOV,"CASA DE CULTURĂ GHERMĂNEŞTI",275,SNAGOV,105160,1,PART,PRCNCT,PRSD,PRSD_SV,"2025-05-18 23:03:22",1367,1073,763,310,0,1055,18,1500,427,427,628
25,ILFOV,"CASA DE CULTURĂ GHERMĂNEŞTI",276,SNAGOV,105160,1,PART,PRCNCT,PRSD,PRSD_SV,"2025-05-18 22:27:20",1187,1114,666,448,0,1104,10,1300,186,512,592
25,ILFOV,"ŞCOALA GIMNAZIALĂ ”CONSTANTIN I.BĂICOIANU”",277,SNAGOV,105160,1,PART,PRCNCT,PRSD,PRSD_SV,"2025-05-18 23:03:31",1464,1060,733,294,33,1036,24,1600,540,530,506
25,ILFOV,"COMPLEX REZIDENȚIAL COSMOPOLIS, SPAȚIUL NR. 7 (SHOWROOM)",278,"ŞTEFĂNEŞTII DE JOS",105419,1,PART,PRCNCT,PRSD,PRSD_SV,"2025-05-19 00:28:42",1717,1734,898,836,0,1719,15,1899,165,356,1363
25,ILFOV,"ŞCOALA GIMNAZIALĂ NR. 1 ȘTEFĂNEȘTII DE JOS",279,"ŞTEFĂNEŞTII DE JOS",105419,1,PART,PRCNCT,PRSD,PRSD_SV,"2025-05-18 22:06:40",1152,759,523,236,0,756,3,1300,541,528,228
25,ILFOV,"ȘCOALA GIMNAZIALĂ NR. 1 ȘTEFĂNEȘTII DE JOS",280,"ŞTEFĂNEŞTII DE JOS",105419,1,PART,PRCNCT,PRSD,PRSD_SV,"2025-05-18 23:57:45",1260,656,594,62,0,650,6,900,244,572,78
25,ILFOV,"COMPLEX REZIDENȚIAL COSMOPOLIS - COSMOPOLIS PLAZA",281,"ŞTEFĂNEŞTII DE JOS",105419,1,PART,PRCNCT,PRSD,PRSD_SV,"2025-05-19 00:51:21",1307,2063,745,1318,0,2050,13,2100,37,490,1560
25,ILFOV,"ŞCOALA GIMNAZIALĂ NR. 1 ȘTEFĂNEȘTII DE JOS",282,"ŞTEFĂNEŞTII DE JOS",105419,1,PART,PRCNCT,PRSD,PRSD_SV,"2025-05-18 23:32:35",1304,679,548,131,0,676,3,1000,321,546,130
25,ILFOV,"BAZA SPORTIVĂ - CAMERA 12 (VESTIAR GAZDE)",283,"ŞTEFĂNEŞTII DE JOS",105419,1,PART,PRCNCT,PRSD,PRSD_SV,"2025-05-18 22:35:24",1665,989,838,151,0,980,9,1400,411,684,296
25,ILFOV,"GRĂDINIȚA NR. 1 ȘTEFĂNEȘTII DE JOS",284,"ŞTEFĂNEŞTII DE JOS",105419,1,PART,PRCNCT,PRSD,PRSD_SV,"2025-05-18 22:42:07",829,558,440,117,1,552,6,900,342,326,226
25,ILFOV,"ȘCOALA GIMNAZIALĂ NR. 1 TUNARI - SALA DE SPORT",285,TUNARI,105570,2,PART,PRCNCT,PRSD,PRSD_SV,"2025-05-19 02:22:49",1798,2054,1076,977,1,2029,25,2500,446,769,1260
25,ILFOV,"ȘCOALA GIMNAZIALĂ NR. 1 TUNARI - CORP A",286,TUNARI,105570,1,PART,PRCNCT,PRSD,PRSD_SV,"2025-05-18 23:45:03",1947,2225,1195,1029,1,2197,28,2300,75,850,1347
25,ILFOV,"ŞCOALA GIMNAZIALĂ NR. 1 TUNARI - CORP C",287,TUNARI,105570,1,PART,PRCNCT,PRSD,PRSD_SV,"2025-05-18 22:43:54",1883,1816,1091,725,0,1791,25,2100,284,760,1031
25,ILFOV,"ȘCOALA GIMNAZIALĂ NR. 1 TUNARI - CORP B",288,TUNARI,105570,1,PART,PRCNCT,PRSD,PRSD_SV,"2025-05-19 00:43:50",1964,1804,1241,563,0,1788,16,2200,396,465,1323
25,ILFOV,"CENTRUL DE ASISTENȚĂ DUPĂ PROGROMUL ȘCOLAR",289,TUNARI,105570,1,PART,PRCNCT,PRSD,PRSD_SV,"2025-05-18 23:09:47",408,705,266,439,0,698,7,1000,295,352,346
25,ILFOV,"ŞCOALA PRIMARA NR. 1 VIDRA",290,VIDRA,105936,2,PART,PRCNCT,PRSD,PRSD_SV,"2025-05-19 01:19:16",630,510,313,197,0,504,6,700,190,227,277
25,ILFOV,"ŞCOALA PRIMARA NR. 1 VIDRA",291,VIDRA,105936,1,PART,PRCNCT,PRSD,PRSD_SV,"2025-05-18 22:24:17",1521,958,847,111,0,953,5,1092,134,494,459
25,ILFOV,"LICEUL TEORETIC ALEXANDRU ROSETTI VIDRA",292,VIDRA,105936,1,PART,PRCNCT,PRSD,PRSD_SV,"2025-05-18 22:15:44",1216,863,639,224,0,856,7,1300,437,395,461
25,ILFOV,"ŞCOALA GIMNAZIALA NR. 2 CREŢEŞTI",293,VIDRA,105936,1,PART,PRCNCT,PRSD,PRSD_SV,"2025-05-18 22:24:19",1138,717,578,139,0,706,11,1300,583,409,297
25,ILFOV,"ŞCOALA GIMNAZIALA NR. 2 CREŢEŞTI",294,VIDRA,105936,1,PART,PRCNCT,PRSD,PRSD_SV,"2025-05-18 21:54:18",1054,574,483,91,0,567,7,1100,526,308,259
25,ILFOV,"ŞCOALA GIMNAZIALA NR. 3 SINTEŞTI",295,VIDRA,105936,1,PART,PRCNCT,PRSD,PRSD_SV,"2025-05-18 21:38:59",859,520,426,94,0,518,2,900,380,303,215
25,ILFOV,"ŞCOALA GIMNAZIALA NR. 3 SINTEŞTI",296,VIDRA,105936,1,PART,PRCNCT,PRSD,PRSD_SV,"2025-05-18 22:11:03",1156,549,455,94,0,533,16,873,324,388,145
26,MARAMUREŞ,"AGENȚIA DE PLĂȚI ȘI INTERVENȚIE PENTRU AGRICULTURĂ MARAMUREȘ",1,"MUNICIPIUL BAIA MARE",106318,1,PART,PRCNCT,PRSD,PRSD_SV,"2025-05-18 22:45:08",1843,1148,1059,88,1,1140,8,1908,760,335,805
26,MARAMUREŞ,"ECHIPAMENT CONTAINER MODULAR",2,"MUNICIPIUL BAIA MARE",106318,1,PART,PRCNCT,PRSD,PRSD_SV,"2025-05-18 22:45:42",921,538,492,46,0,533,5,1000,462,268,265
26,MARAMUREŞ,"ŞCOALA GIMNAZIALĂ „DR. VICTOR BABEȘ”",3,"MUNICIPIUL BAIA MARE",106318,1,PART,PRCNCT,PRSD,PRSD_SV,"2025-05-18 22:15:03",1682,1024,879,142,3,1015,9,1800,776,346,669
26,MARAMUREŞ,"ŞCOALA GIMNAZIALĂ „DR. VICTOR BABEȘ”",4,"MUNICIPIUL BAIA MARE",106318,1,PART,PRCNCT,PRSD,PRSD_SV,"2025-05-18 22:44:44",1785,1024,930,93,1,1005,19,2000,976,310,695
26,MARAMUREŞ,"COLEGIUL TEHNIC „AUREL VLAICU”",5,"MUNICIPIUL BAIA MARE",106318,2,PART,PRCNCT,PRSD,PRSD_SV,"2025-05-19 00:53:38",1941,676,593,83,0,660,16,2000,1324,290,370
26,MARAMUREŞ,"COLEGIUL TEHNIC „AUREL VLAICU”",6,"MUNICIPIUL BAIA MARE",106318,1,PART,PRCNCT,PRSD,PRSD_SV,"2025-05-18 21:39:40",1772,875,816,57,2,867,8,1900,1025,330,537
26,MARAMUREŞ,"CENTRUL UNIVERSITAR NORD - „FACULTATEA TEHNICĂ”",7,"MUNICIPIUL BAIA MARE",106318,1,PART,PRCNCT,PRSD,PRSD_SV,"2025-05-18 22:03:35",1225,712,566,146,0,703,9,1300,588,245,458
26,MARAMUREŞ,"ŞCOALA GIMNAZIALĂ „NICHITA STĂNESCU”",8,"MUNICIPIUL BAIA MARE",106318,1,PART,PRCNCT,PRSD,PRSD_SV,"2025-05-18 22:53:46",1518,958,808,117,33,945,13,1600,642,264,681
26,MARAMUREŞ,"ŞCOALA GIMNAZIALĂ „NICHITA STĂNESCU”",9,"MUNICIPIUL BAIA MARE",106318,1,PART,PRCNCT,PRSD,PRSD_SV,"2025-05-18 21:36:54",1395,810,648,128,34,802,8,1600,790,244,558
26,MARAMUREŞ,"ŞCOALA GIMNAZIALĂ „AVRAM IANCU”",10,"MUNICIPIUL BAIA MARE",106318,1,PART,PRCNCT,PRSD,PRSD_SV,"2025-05-18 21:51:48",920,488,454,33,1,486,2,1000,512,117,369
26,MARAMUREŞ,"ŞCOALA GIMNAZIALĂ „AVRAM IANCU”",11,"MUNICIPIUL BAIA MARE",106318,1,PART,PRCNCT,PRSD,PRSD_SV,"2025-05-18 21:38:07",1012,587,537,50,0,582,5,1100,513,127,455
26,MARAMUREŞ,"ŞCOALA GIMNAZIALĂ „AVRAM IANCU”",12,"MUNICIPIUL BAIA MARE",106318,1,PART,PRCNCT,PRSD,PRSD_SV,"2025-05-18 21:30:42",877,489,445,44,0,484,5,1000,511,105,379
26,MARAMUREŞ,"ŞCOALA GIMNAZIALĂ „AVRAM IANCU”",13,"MUNICIPIUL BAIA MARE",106318,1,PART,PRCNCT,PRSD,PRSD_SV,"2025-05-18 21:46:41",1359,766,705,59,2,761,5,1500,734,190,571
26,MARAMUREŞ,"CENTRUL UNIVERSITAR NORD - „FACULTATEA DE LITERE”",14,"MUNICIPIUL BAIA MARE",106318,1,PART,PRCNCT,PRSD,PRSD_SV,"2025-05-18 22:14:38",1326,797,697,98,2,787,10,1400,603,149,638
26,MARAMUREŞ,"CENTRUL UNIVERSITAR NORD - „FACULTATEA DE LITERE”",15,"MUNICIPIUL BAIA MARE",106318,1,PART,PRCNCT,PRSD,PRSD_SV,"2025-05-18 21:32:17",830,559,451,106,2,554,5,892,333,105,449
26,MARAMUREŞ,"ŞCOALA GIMNAZIALĂ „GEORGE COȘBUC”",16,"MUNICIPIUL BAIA MARE",106318,1,PART,PRCNCT,PRSD,PRSD_SV,"2025-05-18 21:39:50",1105,593,514,79,0,587,6,1200,607,154,433
26,MARAMUREŞ,"ŞCOALA GIMNAZIALĂ „GEORGE COȘBUC”",17,"MUNICIPIUL BAIA MARE",106318,1,PART,PRCNCT,PRSD,PRSD_SV,"2025-05-18 21:45:33",1015,537,468,69,0,529,8,1100,563,147,382
26,MARAMUREŞ,"ŞCOALA GIMNAZIALĂ „NICOLAE IORGA”",18,"MUNICIPIUL BAIA MARE",106318,1,PART,PRCNCT,PRSD,PRSD_SV,"2025-05-18 21:50:47",772,467,395,72,0,459,8,900,433,112,347
26,MARAMUREŞ,"ŞCOALA GIMNAZIALĂ „NICOLAE IORGA”",19,"MUNICIPIUL BAIA MARE",106318,1,PART,PRCNCT,PRSD,PRSD_SV,"2025-05-18 21:57:41",1048,609,525,83,1,601,8,1100,491,140,461
26,MARAMUREŞ,"GRĂDINIȚA CU PROGRAM PRELUNGIT NR. 9",20,"MUNICIPIUL BAIA MARE",106318,1,PART,PRCNCT,PRSD,PRSD_SV,"2025-05-18 21:53:59",1442,838,769,67,2,830,8,1600,762,200,630
26,MARAMUREŞ,"LICEUL TEORETIC „EMIL RACOVIȚĂ”",21,"MUNICIPIUL BAIA MARE",106318,1,PART,PRCNCT,PRSD,PRSD_SV,"2025-05-18 21:55:57",1315,701,558,79,64,691,10,1500,799,230,461
26,MARAMUREŞ,"LICEUL TEORETIC „EMIL RACOVIȚĂ”",22,"MUNICIPIUL BAIA MARE",106318,1,PART,PRCNCT,PRSD,PRSD_SV,"2025-05-18 22:21:20",1314,733,602,85,46,721,12,1500,767,203,518
26,MARAMUREŞ,"ŞCOALA GIMNAZIALĂ „ALEXANDRU IOAN CUZA”",23,"MUNICIPIUL BAIA MARE",106318,1,PART,PRCNCT,PRSD,PRSD_SV,"2025-05-18 22:04:54",1295,751,604,96,51,746,5,1400,649,241,505
26,MARAMUREŞ,"ŞCOALA GIMNAZIALĂ „ALEXANDRU IOAN CUZA”",24,"MUNICIPIUL BAIA MARE",106318,1,PART,PRCNCT,PRSD,PRSD_SV,"2025-05-18 22:33:12",1403,756,635,75,46,745,11,1500,744,252,493
26,MARAMUREŞ,"GRĂDINIȚA CU PROGRAM PRELUNGIT „MICUL PRINŢ”",25,"MUNICIPIUL BAIA MARE",106318,1,PART,PRCNCT,PRSD,PRSD_SV,"2025-05-18 22:14:04",1377,703,592,59,52,693,10,1500,797,270,423
26,MARAMUREŞ,"ŞCOALA GIMNAZIALĂ NR. 18",26,"MUNICIPIUL BAIA MARE",106318,1,PART,PRCNCT,PRSD,PRSD_SV,"2025-05-18 21:51:51",1381,768,648,120,0,762,6,1500,732,291,471
26,MARAMUREŞ,"ŞCOALA GIMNAZIALĂ NR. 18",27,"MUNICIPIUL BAIA MARE",106318,1,PART,PRCNCT,PRSD,PRSD_SV,"2025-05-18 21:53:19",1352,652,581,71,0,641,11,1500,848,283,358
26,MARAMUREŞ,"REGISTRU AUTO ROMÂN, REPREZENTANȚA MARAMUREȘ",28,"MUNICIPIUL BAIA MARE",106318,1,PART,PRCNCT,PRSD,PRSD_SV,"2025-05-18 21:47:18",1255,543,487,56,0,531,12,1400,857,271,260
26,MARAMUREŞ,"GRĂDINIȚA CU PROGRAM PRELUNGIT NR. 28",29,"MUNICIPIUL BAIA MARE",106318,1,PART,PRCNCT,PRSD,PRSD_SV,"2025-05-18 21:52:40",1264,595,545,47,3,592,3,1400,805,245,347
26,MARAMUREŞ,"GRĂDINIȚA CU PROGRAM PRELUNGIT NR. 25",30,"MUNICIPIUL BAIA MARE",106318,1,PART,PRCNCT,PRSD,PRSD_SV,"2025-05-18 22:06:15",1297,613,539,74,0,609,4,1400,787,255,354
26,MARAMUREŞ,"GRĂDINIȚA CU PROGRAM PRELUNGIT NR. 25",31,"MUNICIPIUL BAIA MARE",106318,1,PART,PRCNCT,PRSD,PRSD_SV,"2025-05-18 21:58:19",1172,554,515,39,0,547,7,1300,746,220,327
26,MARAMUREŞ,"ŞCOALA GIMNAZIALĂ „ION LUCA CARAGIALE”",32,"MUNICIPIUL BAIA MARE",106318,1,PART,PRCNCT,PRSD,PRSD_SV,"2025-05-18 21:45:06",816,417,379,38,0,410,7,900,483,141,269
26,MARAMUREŞ,"ŞCOALA GIMNAZIALĂ „ION LUCA CARAGIALE”",33,"MUNICIPIUL BAIA MARE",106318,1,PART,PRCNCT,PRSD,PRSD_SV,"2025-05-18 21:51:12",1242,618,573,45,0,611,7,1400,782,229,382
26,MARAMUREŞ,"ŞCOALA GIMNAZIALĂ „ION LUCA CARAGIALE”",34,"MUNICIPIUL BAIA MARE",106318,1,PART,PRCNCT,PRSD,PRSD_SV,"2025-05-18 21:30:19",1117,518,448,69,1,514,4,1200,682,283,231
26,MARAMUREŞ,"GRĂDINIȚA CU PROGRAM PRELUNGIT NR. 34",35,"MUNICIPIUL BAIA MARE",106318,1,PART,PRCNCT,PRSD,PRSD_SV,"2025-05-18 21:40:55",1328,690,610,80,0,678,12,1500,810,269,409
26,MARAMUREŞ,"ŞCOALA GIMNAZIALĂ „ALEXANDRU IVASIUC”",36,"MUNICIPIUL BAIA MARE",106318,1,PART,PRCNCT,PRSD,PRSD_SV,"2025-05-18 21:41:54",1345,678,588,90,0,671,7,1500,822,232,439
26,MARAMUREŞ,"ŞCOALA GIMNAZIALĂ „ALEXANDRU IVASIUC”",37,"MUNICIPIUL BAIA MARE",106318,2,PART,PRCNCT,PRSD,PRSD_SV,"2025-05-18 23:21:51",1307,557,522,35,0,548,9,1400,843,234,314
26,MARAMUREŞ,"ŞCOALA GIMNAZIALĂ „ALEXANDRU IVASIUC”",38,"MUNICIPIUL BAIA MARE",106318,1,PART,PRCNCT,PRSD,PRSD_SV,"2025-05-18 21:54:31",1327,661,630,31,0,654,7,1408,747,238,416
26,MARAMUREŞ,"ŞCOALA GIMNAZIALĂ „DIMITRIE CANTEMIR”",39,"MUNICIPIUL BAIA MARE",106318,1,PART,PRCNCT,PRSD,PRSD_SV,"2025-05-18 21:57:04",1338,779,622,157,0,769,10,1400,621,245,524
26,MARAMUREŞ,"ŞCOALA GIMNAZIALĂ „DIMITRIE CANTEMIR”",40,"MUNICIPIUL BAIA MARE",106318,1,PART,PRCNCT,PRSD,PRSD_SV,"2025-05-18 21:36:30",1289,629,560,68,1,621,8,1400,771,234,387
26,MARAMUREŞ,"ŞCOALA GIMNAZIALĂ „DIMITRIE CANTEMIR”",41,"MUNICIPIUL BAIA MARE",106318,1,PART,PRCNCT,PRSD,PRSD_SV,"2025-05-18 22:13:46",1409,657,615,42,0,648,9,1500,843,236,412
26,MARAMUREŞ,"ANSAMBLUL FOLCLORIC NAȚIONAL „TRANSILVANIA”",42,"MUNICIPIUL BAIA MARE",106318,1,PART,PRCNCT,PRSD,PRSD_SV,"2025-05-18 21:45:51",1257,740,624,116,0,728,12,1400,660,191,537
26,MARAMUREŞ,"LICEUL CU PROGRAM SPORTIV",43,"MUNICIPIUL BAIA MARE",106318,1,PART,PRCNCT,PRSD,PRSD_SV,"2025-05-18 21:41:39",1321,743,657,86,0,740,3,1500,757,199,541
26,MARAMUREŞ,"LICEUL CU PROGRAM SPORTIV",44,"MUNICIPIUL BAIA MARE",106318,1,PART,PRCNCT,PRSD,PRSD_SV,"2025-05-18 21:55:40",1080,536,478,55,3,531,5,1200,664,165,366
26,MARAMUREŞ,"LICEUL CU PROGRAM SPORTIV",45,"MUNICIPIUL BAIA MARE",106318,1,PART,PRCNCT,PRSD,PRSD_SV,"2025-05-18 22:15:51",743,392,359,32,1,388,4,800,408,117,271
26,MARAMUREŞ,"LICEUL CU PROGRAM SPORTIV",46,"MUNICIPIUL BAIA MARE",106318,1,PART,PRCNCT,PRSD,PRSD_SV,"2025-05-18 21:52:15",1421,705,664,39,2,695,10,1600,895,184,511
26,MARAMUREŞ,"CENTRUL SOCIAL „ASSOC”",47,"MUNICIPIUL BAIA MARE",106318,1,PART,PRCNCT,PRSD,PRSD_SV,"2025-05-18 22:21:06",1434,696,647,49,0,691,5,1600,904,214,477
26,MARAMUREŞ,"ADMINISTRAȚIA BAZELOR SPORTIVE",48,"MUNICIPIUL BAIA MARE",106318,1,PART,PRCNCT,PRSD,PRSD_SV,"2025-05-18 21:52:44",1354,714,632,82,0,710,4,1500,786,203,507
26,MARAMUREŞ,"COLEGIUL TEHNIC „ANGHEL SALIGNY”",49,"MUNICIPIUL BAIA MARE",106318,1,PART,PRCNCT,PRSD,PRSD_SV,"2025-05-18 22:03:11",1233,695,535,160,0,691,4,1400,705,172,519
26,MARAMUREŞ,"COLEGIUL TEHNIC „ANGHEL SALIGNY”",50,"MUNICIPIUL BAIA MARE",106318,1,PART,PRCNCT,PRSD,PRSD_SV,"2025-05-18 22:33:43",1509,875,796,78,1,868,7,1600,725,185,683
26,MARAMUREŞ,"BIBLIOTECA JUDEȚEANĂ „PETRE DULFU”",51,"MUNICIPIUL BAIA MARE",106318,1,PART,PRCNCT,PRSD,PRSD_SV,"2025-05-18 22:00:39",1181,714,654,59,1,707,7,1300,586,154,553
26,MARAMUREŞ,"LICEUL DE ARTE",52,"MUNICIPIUL BAIA MARE",106318,1,PART,PRCNCT,PRSD,PRSD_SV,"2025-05-18 21:31:52",1076,612,566,44,2,607,5,1200,588,109,498
26,MARAMUREŞ,"LICEUL DE ARTE",53,"MUNICIPIUL BAIA MARE",106318,1,PART,PRCNCT,PRSD,PRSD_SV,"2025-05-18 21:22:33",1120,725,639,86,0,718,7,1200,475,184,534
26,MARAMUREŞ,"LICEUL TEORETIC SANITAR",54,"MUNICIPIUL BAIA MARE",106318,1,PART,PRCNCT,PRSD,PRSD_SV,"2025-05-18 22:01:20",1298,767,686,80,1,762,5,1400,633,211,551
26,MARAMUREŞ,"GRĂDINIȚA CU PROGRAM NORMAL NR. 12",55,"MUNICIPIUL BAIA MARE",106318,1,PART,PRCNCT,PRSD,PRSD_SV,"2025-05-18 22:06:01",1599,854,804,50,0,846,8,1700,846,244,602
26,MARAMUREŞ,"ŞCOALA GIMNAZIALĂ „NICOLAE BĂLCESCU”",56,"MUNICIPIUL BAIA MARE",106318,1,PART,PRCNCT,PRSD,PRSD_SV,"2025-05-18 21:50:08",1524,706,673,33,0,695,11,1700,994,348,347
26,MARAMUREŞ,"ŞCOALA GIMNAZIALĂ „NICOLAE BĂLCESCU”",57,"MUNICIPIUL BAIA MARE",106318,1,PART,PRCNCT,PRSD,PRSD_SV,"2025-05-18 21:35:38",1296,655,620,33,2,648,7,1400,745,392,256
26,MARAMUREŞ,"ŞCOALA GIMNAZIALĂ „MIHAIL SADOVEANU”",58,"MUNICIPIUL BAIA MARE",106318,1,PART,PRCNCT,PRSD,PRSD_SV,"2025-05-18 21:50:03",1257,661,611,50,0,656,5,1400,739,376,280
26,MARAMUREŞ,"ŞCOALA GIMNAZIALĂ „MIHAIL SADOVEANU”",59,"MUNICIPIUL BAIA MARE",106318,1,PART,PRCNCT,PRSD,PRSD_SV,"2025-05-18 22:02:26",1170,595,563,32,0,595,0,1300,705,297,298
26,MARAMUREŞ,"ŞCOALA GIMNAZIALĂ NR. 13",60,"MUNICIPIUL BAIA MARE",106318,2,PART,PRCNCT,PRSD,PRSD_SV,"2025-05-19 00:48:07",1385,726,669,57,0,719,7,1500,774,425,294
26,MARAMUREŞ,"ŞCOALA GIMNAZIALĂ „OCTAVIAN GOGA”",61,"MUNICIPIUL BAIA MARE",106318,1,PART,PRCNCT,PRSD,PRSD_SV,"2025-05-18 21:33:09",1099,695,567,106,22,692,3,1200,505,191,501
26,MARAMUREŞ,"ŞCOALA GIMNAZIALĂ „OCTAVIAN GOGA”",62,"MUNICIPIUL BAIA MARE",106318,1,PART,PRCNCT,PRSD,PRSD_SV,"2025-05-18 22:04:02",1174,689,613,50,26,684,5,1300,611,185,499
26,MARAMUREŞ,"COLEGIUL NAȚIONAL „GHEORGHE ȘINCAI”",63,"MUNICIPIUL BAIA MARE",106318,1,PART,PRCNCT,PRSD,PRSD_SV,"2025-05-18 21:53:45",1547,978,799,160,19,972,6,1700,722,227,745
26,MARAMUREŞ,"COLEGIUL NAȚIONAL „VASILE LUCACIU”",64,"MUNICIPIUL BAIA MARE",106318,1,PART,PRCNCT,PRSD,PRSD_SV,"2025-05-18 22:19:56",1229,677,552,124,1,672,5,1300,623,155,517
26,MARAMUREŞ,"COLEGIUL TEHNIC „GEORGE BARIȚIU”",65,"MUNICIPIUL BAIA MARE",106318,1,PART,PRCNCT,PRSD,PRSD_SV,"2025-05-18 21:32:34",1275,845,690,152,3,836,9,1400,555,206,630
26,MARAMUREŞ,"ȘCOALA GIMNAZIALĂ „LUCIAN BLAGA”",66,"MUNICIPIUL BAIA MARE",106318,1,PART,PRCNCT,PRSD,PRSD_SV,"2025-05-18 21:39:11",1074,629,562,56,11,626,3,1200,571,173,453
26,MARAMUREŞ,"ȘCOALA GIMNAZIALĂ „LUCIAN BLAGA”",67,"MUNICIPIUL BAIA MARE",106318,1,PART,PRCNCT,PRSD,PRSD_SV,"2025-05-18 21:51:16",976,534,483,50,1,528,6,1100,566,130,398
26,MARAMUREŞ,"ȘCOALA GIMNAZIALĂ „LUCIAN BLAGA”",68,"MUNICIPIUL BAIA MARE",106318,1,PART,PRCNCT,PRSD,PRSD_SV,"2025-05-18 22:25:26",1687,1027,958,69,0,1018,9,1800,773,291,727
26,MARAMUREŞ,"ȘCOALA GIMNAZIALĂ „LUCIAN BLAGA”",69,"MUNICIPIUL BAIA MARE",106318,1,PART,PRCNCT,PRSD,PRSD_SV,"2025-05-18 21:48:38",1484,727,677,50,0,718,9,1600,873,242,476
26,MARAMUREŞ,"GAL BAIA MARE",70,"MUNICIPIUL BAIA MARE",106318,1,PART,PRCNCT,PRSD,PRSD_SV,"2025-05-18 21:50:33",1306,602,500,101,1,593,9,1400,798,346,247
26,MARAMUREŞ,"CENTRUL „PHOENIX”",71,"MUNICIPIUL BAIA MARE",106318,1,PART,PRCNCT,PRSD,PRSD_SV,"2025-05-18 21:50:06",1332,530,473,57,0,524,6,1500,970,286,238
26,MARAMUREŞ,"ŞCOALA GIMNAZIALĂ „VASILE ALECSANDRI”",72,"MUNICIPIUL BAIA MARE",106318,1,PART,PRCNCT,PRSD,PRSD_SV,"2025-05-18 21:55:53",1373,690,591,99,0,687,3,1500,810,279,408
26,MARAMUREŞ,"ŞCOALA GIMNAZIALĂ „VASILE ALECSANDRI”",73,"MUNICIPIUL BAIA MARE",106318,1,PART,PRCNCT,PRSD,PRSD_SV,"2025-05-18 21:58:20",1408,697,609,88,0,691,6,1500,803,291,400
26,MARAMUREŞ,"ŞCOALA GIMNAZIALĂ „VASILE ALECSANDRI”",74,"MUNICIPIUL BAIA MARE",106318,1,PART,PRCNCT,PRSD,PRSD_SV,"2025-05-18 21:45:15",1339,585,543,41,1,580,5,1400,815,271,309
26,MARAMUREŞ,"ŞCOALA GIMNAZIALĂ „VASILE ALECSANDRI”",75,"MUNICIPIUL BAIA MARE",106318,1,PART,PRCNCT,PRSD,PRSD_SV,"2025-05-18 21:33:28",1443,627,599,28,0,623,4,1500,873,260,363
26,MARAMUREŞ,"ŞCOALA GIMNAZIALĂ „VASILE ALECSANDRI”",76,"MUNICIPIUL BAIA MARE",106318,1,PART,PRCNCT,PRSD,PRSD_SV,"2025-05-18 21:37:40",1202,533,497,36,0,527,6,1300,767,280,247
26,MARAMUREŞ,"GRĂDINIȚA CU PROGRAM PRELUNGIT „OTILIA CAZIMIR”",77,"MUNICIPIUL BAIA MARE",106318,1,PART,PRCNCT,PRSD,PRSD_SV,"2025-05-18 21:59:44",1447,723,661,62,0,712,11,1600,877,241,471
26,MARAMUREŞ,"GRĂDINIȚA CU PROGRAM PRELUNGIT „OTILIA CAZIMIR”",78,"MUNICIPIUL BAIA MARE",106318,1,PART,PRCNCT,PRSD,PRSD_SV,"2025-05-18 21:46:34",1230,526,477,48,1,520,6,1300,774,272,248
26,MARAMUREŞ,"CENTRUL „SFÂNTUL FRANCISC DE ASSISI”",79,"MUNICIPIUL BAIA MARE",106318,1,PART,PRCNCT,PRSD,PRSD_SV,"2025-05-18 22:07:30",1352,569,513,56,0,558,11,1500,931,251,307
26,MARAMUREŞ,"GRĂDINIȚA CU PROGRAM PRELUNGIT NR. 27",80,"MUNICIPIUL BAIA MARE",106318,1,PART,PRCNCT,PRSD,PRSD_SV,"2025-05-18 21:48:12",1673,864,737,127,0,859,5,1800,936,323,536
26,MARAMUREŞ,"ŞCOALA GIMNAZIALĂ „SIMION BĂRNUȚIU”",81,"MUNICIPIUL BAIA MARE",106318,1,PART,PRCNCT,PRSD,PRSD_SV,"2025-05-18 22:06:19",1981,1048,905,143,0,1040,8,2100,1052,409,631
26,MARAMUREŞ,"ŞCOALA GIMNAZIALĂ „SIMION BĂRNUȚIU”",82,"MUNICIPIUL BAIA MARE",106318,2,PART,PRCNCT,PRSD,PRSD_SV,"2025-05-18 23:09:08",1991,1086,1022,64,0,1070,16,2100,1014,383,687
26,MARAMUREŞ,"CENTRUL „SALVAȚI FAMILIA”",83,"MUNICIPIUL BAIA MARE",106318,1,PART,PRCNCT,PRSD,PRSD_SV,"2025-05-18 22:02:26",1904,1008,909,99,0,988,20,2042,1034,392,596
26,MARAMUREŞ,"CENTRUL COMUNITAR ROMANII",84,"MUNICIPIUL BAIA MARE",106318,1,PART,PRCNCT,PRSD,PRSD_SV,"2025-05-18 21:35:29",1106,380,359,21,0,379,1,1200,820,265,114
26,MARAMUREŞ,"COLEGIUL TEHNIC „COSTIN D. NENIȚESCU”",85,"MUNICIPIUL BAIA MARE",106318,1,PART,PRCNCT,PRSD,PRSD_SV,"2025-05-18 21:44:55",1225,515,458,57,0,506,9,1300,785,305,201
26,MARAMUREŞ,"COLEGIUL TEHNIC „COSTIN D. NENIȚESCU”",86,"MUNICIPIUL BAIA MARE",106318,1,PART,PRCNCT,PRSD,PRSD_SV,"2025-05-18 21:31:38",1321,710,675,35,0,706,4,1400,690,214,492
26,MARAMUREŞ,"ȘCOALA GENERALĂ NR. 8",87,"MUNICIPIUL SIGHETU MARMAŢIEI",106559,1,PART,PRCNCT,PRSD,PRSD_SV,"2025-05-18 21:46:49",1046,451,408,43,0,446,5,1200,749,343,103
26,MARAMUREŞ,"ȘCOALA GENERALĂ NR. 1",88,"MUNICIPIUL SIGHETU MARMAŢIEI",106559,1,PART,PRCNCT,PRSD,PRSD_SV,"2025-05-18 22:06:01",1414,568,537,31,0,563,5,1499,931,368,195
26,MARAMUREŞ,"ȘCOALA GENERALĂ NR. 11",89,"MUNICIPIUL SIGHETU MARMAŢIEI",106559,1,PART,PRCNCT,PRSD,PRSD_SV,"2025-05-18 22:10:12",1121,500,476,23,1,493,7,1200,700,230,263
26,MARAMUREŞ,"GRĂDINIȚA NR. 12",90,"MUNICIPIUL SIGHETU MARMAŢIEI",106559,1,PART,PRCNCT,PRSD,PRSD_SV,"2025-05-18 22:18:40",1414,595,542,50,3,585,10,1600,1005,256,329
26,MARAMUREŞ,"UNIVERSITATEA „BABEȘ-BOLYAI”",91,"MUNICIPIUL SIGHETU MARMAŢIEI",106559,1,PART,PRCNCT,PRSD,PRSD_SV,"2025-05-18 21:29:21",805,353,295,58,0,351,2,900,547,169,182
26,MARAMUREŞ,"UNIVERSITATEA „BABEȘ-BOLYAI”",92,"MUNICIPIUL SIGHETU MARMAŢIEI",106559,1,PART,PRCNCT,PRSD,PRSD_SV,"2025-05-18 21:38:20",848,391,317,74,0,387,4,900,509,168,219
26,MARAMUREŞ,"LICEUL „REGELE FERDINAND”",93,"MUNICIPIUL SIGHETU MARMAŢIEI",106559,1,PART,PRCNCT,PRSD,PRSD_SV,"2025-05-18 21:25:35",868,340,282,25,33,339,1,1000,660,195,144
26,MARAMUREŞ,"LICEUL „REGELE FERDINAND”",94,"MUNICIPIUL SIGHETU MARMAŢIEI",106559,1,PART,PRCNCT,PRSD,PRSD_SV,"2025-05-18 21:53:29",1049,580,481,67,32,574,6,1200,620,229,345
26,MARAMUREŞ,"COLEGIUL NAȚIONAL „DRAGOȘ VODĂ”",95,"MUNICIPIUL SIGHETU MARMAŢIEI",106559,1,PART,PRCNCT,PRSD,PRSD_SV,"2025-05-18 21:56:43",958,423,394,27,2,419,4,1100,677,163,256
26,MARAMUREŞ,"COLEGIUL NAȚIONAL „DRAGOȘ VODĂ”",96,"MUNICIPIUL SIGHETU MARMAŢIEI",106559,1,PART,PRCNCT,PRSD,PRSD_SV,"2025-05-18 21:54:24",1095,507,460,47,0,503,4,1200,693,168,335
26,MARAMUREŞ,"COLEGIUL NAȚIONAL „DRAGOȘ VODĂ”",97,"MUNICIPIUL SIGHETU MARMAŢIEI",106559,1,PART,PRCNCT,PRSD,PRSD_SV,"2025-05-18 22:04:42",1052,459,400,59,0,451,8,1200,741,203,248
26,MARAMUREŞ,"LICEUL „TARAS SEVCENCO”",98,"MUNICIPIUL SIGHETU MARMAŢIEI",106559,1,PART,PRCNCT,PRSD,PRSD_SV,"2025-05-18 21:58:50",1196,494,428,66,0,489,5,1300,806,210,279
26,MARAMUREŞ,"LICEUL „TARAS SEVCENCO”",99,"MUNICIPIUL SIGHETU MARMAŢIEI",106559,1,PART,PRCNCT,PRSD,PRSD_SV,"2025-05-18 22:04:29",1197,531,487,40,4,525,6,1300,769,194,331
26,MARAMUREŞ,"ȘCOALA GENERALĂ NR. 2",100,"MUNICIPIUL SIGHETU MARMAŢIEI",106559,1,PART,PRCNCT,PRSD,PRSD_SV,"2025-05-18 22:09:39",1380,665,619,44,2,654,11,1501,836,183,471
26,MARAMUREŞ,"GRĂDINIȚA NR. 9",101,"MUNICIPIUL SIGHETU MARMAŢIEI",106559,1,PART,PRCNCT,PRSD,PRSD_SV,"2025-05-18 21:56:12",1501,785,726,58,1,777,8,1600,815,298,479
26,MARAMUREŞ,"ȘCOALA GENERALĂ NR. 9",102,"MUNICIPIUL SIGHETU MARMAŢIEI",106559,1,PART,PRCNCT,PRSD,PRSD_SV,"2025-05-18 21:37:03",1148,546,479,67,0,543,3,1300,754,204,339
26,MARAMUREŞ,"ȘCOALA GENERALĂ NR. 9",103,"MUNICIPIUL SIGHETU MARMAŢIEI",106559,1,PART,PRCNCT,PRSD,PRSD_SV,"2025-05-18 22:14:35",1072,443,394,49,0,439,4,1200,757,173,266
26,MARAMUREŞ,"LICEUL TEHNOLOGIC FORESTIER",104,"MUNICIPIUL SIGHETU MARMAŢIEI",106559,1,PART,PRCNCT,PRSD,PRSD_SV,"2025-05-18 22:10:05",807,383,336,46,1,375,8,900,517,131,244
26,MARAMUREŞ,"LICEUL TEHNOLOGIC FORESTIER",105,"MUNICIPIUL SIGHETU MARMAŢIEI",106559,2,PART,PRCNCT,PRSD,PRSD_SV,"2025-05-19 01:27:02",1095,505,470,35,0,495,10,1200,695,227,268
26,MARAMUREŞ,"ȘCOALA GENERALĂ NR. 6",106,"MUNICIPIUL SIGHETU MARMAŢIEI",106559,1,PART,PRCNCT,PRSD,PRSD_SV,"2025-05-18 22:29:22",1840,839,795,42,2,832,7,2000,1161,474,358
26,MARAMUREŞ,"LICEUL TEHNOLOGIC MARMAȚIA",107,"MUNICIPIUL SIGHETU MARMAŢIEI",106559,1,PART,PRCNCT,PRSD,PRSD_SV,"2025-05-18 21:42:05",1022,412,382,29,1,408,4,1100,688,204,204
26,MARAMUREŞ,"LICEUL TEHNOLOGIC MARMAȚIA",108,"MUNICIPIUL SIGHETU MARMAŢIEI",106559,1,PART,PRCNCT,PRSD,PRSD_SV,"2025-05-18 21:39:07",1045,392,357,35,0,384,8,1100,708,164,220
26,MARAMUREŞ,"LICEUL TEHNOLOGIC MARMAȚIA",109,"MUNICIPIUL SIGHETU MARMAŢIEI",106559,1,PART,PRCNCT,PRSD,PRSD_SV,"2025-05-18 22:04:26",886,327,262,65,0,323,4,1008,681,175,148
26,MARAMUREŞ,"GRĂDINIȚA NR. 1",110,"MUNICIPIUL SIGHETU MARMAŢIEI",106559,1,PART,PRCNCT,PRSD,PRSD_SV,"2025-05-18 21:57:59",967,402,360,42,0,397,5,1100,698,145,252
26,MARAMUREŞ,"GRĂDINIȚA NR. 1",111,"MUNICIPIUL SIGHETU MARMAŢIEI",106559,1,PART,PRCNCT,PRSD,PRSD_SV,"2025-05-18 21:49:00",814,329,311,18,0,326,3,900,571,134,192
26,MARAMUREŞ,"SALA POLIVALENTĂ",112,"MUNICIPIUL SIGHETU MARMAŢIEI",106559,1,PART,PRCNCT,PRSD,PRSD_SV,"2025-05-18 22:02:48",1164,507,483,24,0,505,2,1300,793,237,268
26,MARAMUREŞ,"SALA POLIVALENTĂ",113,"MUNICIPIUL SIGHETU MARMAŢIEI",106559,1,PART,PRCNCT,PRSD,PRSD_SV,"2025-05-18 21:55:17",1193,452,419,33,0,445,7,1300,848,217,228
26,MARAMUREŞ,"SALA POLIVALENTĂ",114,"MUNICIPIUL SIGHETU MARMAŢIEI",106559,1,PART,PRCNCT,PRSD,PRSD_SV,"2025-05-18 21:59:49",1217,587,527,60,0,579,8,1300,713,293,286
26,MARAMUREŞ,"ȘCOALA GENERALĂ NR. 5",115,"MUNICIPIUL SIGHETU MARMAŢIEI",106559,1,PART,PRCNCT,PRSD,PRSD_SV,"2025-05-18 22:32:04",1301,646,585,61,0,643,3,1400,754,365,278
26,MARAMUREŞ,"ȘCOALA GENERALĂ NR. 5",116,"MUNICIPIUL SIGHETU MARMAŢIEI",106559,1,PART,PRCNCT,PRSD,PRSD_SV,"2025-05-18 21:59:50",1450,670,629,41,0,665,5,1600,930,364,301
26,MARAMUREŞ,"ȘCOALA GENERALĂ NR. 7",117,"MUNICIPIUL SIGHETU MARMAŢIEI",106559,1,PART,PRCNCT,PRSD,PRSD_SV,"2025-05-18 21:44:20",802,328,301,27,0,327,1,900,572,209,118
26,MARAMUREŞ,"COLEGIUL TEHNIC DE TRANSPORTURI AUTO",118,"ORAŞ BAIA SPRIE",106684,1,PART,PRCNCT,PRSD,PRSD_SV,"2025-05-18 21:48:48",1167,633,566,66,1,623,10,1300,667,220,403
26,MARAMUREŞ,"COLEGIUL TEHNIC DE TRANSPORTURI AUTO",119,"ORAŞ BAIA SPRIE",106684,1,PART,PRCNCT,PRSD,PRSD_SV,"2025-05-18 21:33:20",1221,630,577,49,4,623,7,1300,670,213,410
26,MARAMUREŞ,"COLEGIUL TEHNIC DE TRANSPORTURI AUTO",120,"ORAŞ BAIA SPRIE",106684,1,PART,PRCNCT,PRSD,PRSD_SV,"2025-05-18 21:28:36",1044,454,407,47,0,450,4,1100,646,196,254
26,MARAMUREŞ,"COLEGIUL TEHNIC DE TRANSPORTURI AUTO",121,"ORAŞ BAIA SPRIE",106684,1,PART,PRCNCT,PRSD,PRSD_SV,"2025-05-18 21:31:38",1210,632,566,49,17,625,7,1300,668,243,382
26,MARAMUREŞ,"ȘCOALA GIMNAZIALĂ",122,"ORAŞ BAIA SPRIE",106684,1,PART,PRCNCT,PRSD,PRSD_SV,"2025-05-18 21:36:08",1552,601,551,50,0,597,4,1700,1099,371,226
26,MARAMUREŞ,"ȘCOALA GIMNAZIALĂ",123,"ORAŞ BAIA SPRIE",106684,1,PART,PRCNCT,PRSD,PRSD_SV,"2025-05-18 21:50:10",1445,641,612,27,2,638,3,1600,959,275,363
26,MARAMUREŞ,"SALA DE SPORT",124,"ORAŞ BAIA SPRIE",106684,1,PART,PRCNCT,PRSD,PRSD_SV,"2025-05-18 21:28:20",1080,654,601,53,0,648,6,1100,446,285,363
26,MARAMUREŞ,"SALA DE SPORT",125,"ORAŞ BAIA SPRIE",106684,1,PART,PRCNCT,PRSD,PRSD_SV,"2025-05-18 21:27:07",1221,591,547,44,0,585,6,1300,709,278,307
26,MARAMUREŞ,"ȘCOALA GIMNAZIALĂ",126,"ORAŞ BAIA SPRIE",106684,1,PART,PRCNCT,PRSD,PRSD_SV,"2025-05-18 21:20:45",515,310,277,33,0,304,6,600,290,159,145
26,MARAMUREŞ,"ȘCOALA GIMNAZIALĂ „IOAN SLAVICI”",127,"ORAŞ BAIA SPRIE",106684,1,PART,PRCNCT,PRSD,PRSD_SV,"2025-05-18 21:39:56",1288,728,566,62,100,723,5,1400,672,407,316
26,MARAMUREŞ,"ȘCOALA GIMNAZIALĂ „IOAN SLAVICI”",128,"ORAŞ BAIA SPRIE",106684,2,PART,PRCNCT,PRSD,PRSD_SV,"2025-05-18 22:33:53",1284,781,626,56,99,765,16,1400,619,338,427
26,MARAMUREŞ,"ȘCOALA GIMNAZIALĂ „IOAN SLAVICI”",129,"ORAŞ BAIA SPRIE",106684,1,PART,PRCNCT,PRSD,PRSD_SV,"2025-05-18 21:45:43",1018,754,564,91,99,747,7,1192,438,339,408
26,MARAMUREŞ,"ŞCOALA NR. 1",130,"ORAŞ BORŞA",106746,1,PART,PRCNCT,PRSD,PRSD_SV,"2025-05-18 21:43:56",1202,335,310,25,0,332,3,1300,965,228,104
26,MARAMUREŞ,"ŞCOALA NR. 1",131,"ORAŞ BORŞA",106746,1,PART,PRCNCT,PRSD,PRSD_SV,"2025-05-18 21:40:44",1387,487,473,13,1,480,7,1500,1013,343,137
26,MARAMUREŞ,"ŞCOALA NR. 8",132,"ORAŞ BORŞA",106746,1,PART,PRCNCT,PRSD,PRSD_SV,"2025-05-18 21:39:10",1330,465,434,31,0,462,3,1400,935,350,112
26,MARAMUREŞ,"ŞCOALA NR. 8",133,"ORAŞ BORŞA",106746,1,PART,PRCNCT,PRSD,PRSD_SV,"2025-05-18 21:31:39",1364,499,477,22,0,497,2,1400,901,340,157
26,MARAMUREŞ,"ŞCOALA NR. 9",134,"ORAŞ BORŞA",106746,1,PART,PRCNCT,PRSD,PRSD_SV,"2025-05-18 22:01:05",1607,485,454,31,0,480,5,1700,1215,287,193
26,MARAMUREŞ,"ŞCOALA NR. 9",135,"ORAŞ BORŞA",106746,1,PART,PRCNCT,PRSD,PRSD_SV,"2025-05-18 21:43:39",1081,352,339,13,0,350,2,1200,848,193,157
26,MARAMUREŞ,"ŞCOALA NR. 9 CORP B",136,"ORAŞ BORŞA",106746,1,PART,PRCNCT,PRSD,PRSD_SV,"2025-05-18 21:32:29",1190,463,403,9,51,460,3,1300,837,291,169
26,MARAMUREŞ,"ŞCOALA NR. 9 CORP B",137,"ORAŞ BORŞA",106746,1,PART,PRCNCT,PRSD,PRSD_SV,"2025-05-18 21:36:20",806,341,251,39,51,337,4,900,559,183,154
26,MARAMUREŞ,"ŞCOALA NR. 9 CORP B",138,"ORAŞ BORŞA",106746,1,PART,PRCNCT,PRSD,PRSD_SV,"2025-05-18 21:56:22",1027,361,294,18,49,356,5,1100,739,210,146
26,MARAMUREŞ,"ŞCOALA GÎRLEA",139,"ORAŞ BORŞA",106746,1,PART,PRCNCT,PRSD,PRSD_SV,"2025-05-18 21:36:15",1083,409,392,17,0,404,5,1200,791,305,99
26,MARAMUREŞ,"ŞCOALA REPEDEA",140,"ORAŞ BORŞA",106746,1,PART,PRCNCT,PRSD,PRSD_SV,"2025-05-18 21:31:34",797,287,270,17,0,281,6,900,613,221,60
26,MARAMUREŞ,"ŞCOALA REPEDEA",141,"ORAŞ BORŞA",106746,2,PART,PRCNCT,PRSD,PRSD_SV,"2025-05-19 01:52:46",1053,337,318,19,0,332,5,1100,763,229,103
26,MARAMUREŞ,"ŞCOALA POIANA",142,"ORAŞ BORŞA",106746,1,PART,PRCNCT,PRSD,PRSD_SV,"2025-05-18 21:23:47",984,322,304,18,0,319,3,1100,778,174,145
26,MARAMUREŞ,"ŞCOALA POIANA",143,"ORAŞ BORŞA",106746,1,PART,PRCNCT,PRSD,PRSD_SV,"2025-05-18 21:33:37",1021,350,325,25,0,342,8,1100,750,238,104
26,MARAMUREŞ,"ŞCOALA BIRŢ",144,"ORAŞ BORŞA",106746,1,PART,PRCNCT,PRSD,PRSD_SV,"2025-05-18 21:31:08",1330,454,421,32,1,447,7,1400,946,328,119
26,MARAMUREŞ,"ŞCOALA FÎNTÎNA",145,"ORAŞ BORŞA",106746,1,PART,PRCNCT,PRSD,PRSD_SV,"2025-05-18 21:40:11",1171,350,320,30,0,345,5,1300,950,243,102
26,MARAMUREŞ,"ŞCOALA ROTUNDU",146,"ORAŞ BORŞA",106746,1,PART,PRCNCT,PRSD,PRSD_SV,"2025-05-18 21:27:13",1161,371,349,22,0,367,4,1300,929,283,84
26,MARAMUREŞ,"ŞCOALA ROTUNDU",147,"ORAŞ BORŞA",106746,1,PART,PRCNCT,PRSD,PRSD_SV,"2025-05-18 21:29:18",1232,438,423,15,0,437,1,1300,862,293,144
26,MARAMUREŞ,"ŞCOALA NR. 7",148,"ORAŞ BORŞA",106746,1,PART,PRCNCT,PRSD,PRSD_SV,"2025-05-18 21:38:51",1166,399,378,21,0,395,4,1300,901,223,172
26,MARAMUREŞ,"ŞCOALA NR. 7",149,"ORAŞ BORŞA",106746,1,PART,PRCNCT,PRSD,PRSD_SV,"2025-05-18 21:56:44",1351,421,406,14,1,416,5,1500,1079,284,132
26,MARAMUREŞ,"COLEGIUL ECONOMIC „PINTEA VITEAZUL”",150,"ORAŞ CAVNIC",106782,2,PART,PRCNCT,PRSD,PRSD_SV,"2025-05-19 00:50:50",1640,715,663,43,9,700,15,1800,1085,448,252
26,MARAMUREŞ,"ŞCOALA GENERALĂ NR. 2",151,"ORAŞ CAVNIC",106782,1,PART,PRCNCT,PRSD,PRSD_SV,"2025-05-18 21:59:19",1619,769,691,35,43,755,14,1800,1031,457,298
26,MARAMUREŞ,"ŞCOALA GENERALĂ NR. 1",152,"ORAŞ CAVNIC",106782,1,PART,PRCNCT,PRSD,PRSD_SV,"2025-05-18 21:40:30",745,276,254,22,0,273,3,800,524,166,107
26,MARAMUREŞ,"SALA DE SPORT",153,"ORAŞ DRAGOMIREŞTI",108017,1,PART,PRCNCT,PRSD,PRSD_SV,"2025-05-18 21:55:27",1207,461,424,34,3,459,2,1300,839,257,202
26,MARAMUREŞ,"CĂMINUL CULTURAL",154,"ORAŞ DRAGOMIREŞTI",108017,1,PART,PRCNCT,PRSD,PRSD_SV,"2025-05-18 21:45:07",1288,460,401,55,4,459,1,1400,940,266,193
26,MARAMUREŞ,"CASA DE CULTURĂ",155,"ORAŞ SĂLIŞTEA DE SUS",108892,1,PART,PRCNCT,PRSD,PRSD_SV,"2025-05-18 21:38:10",1532,591,541,48,2,588,3,1700,1109,284,304
26,MARAMUREŞ,"ŞCOALA GIMNAZIALĂ „MIHAI EMINESCU”",156,"ORAŞ SĂLIŞTEA DE SUS",108892,1,PART,PRCNCT,PRSD,PRSD_SV,"2025-05-18 22:10:00",1505,596,558,37,1,588,8,1600,1004,256,332
26,MARAMUREŞ,"ŞCOALA GIMNAZIALĂ „MIHAI EMINESCU” LOCAL CENTRU 2",157,"ORAŞ SĂLIŞTEA DE SUS",108892,1,PART,PRCNCT,PRSD,PRSD_SV,"2025-05-18 21:53:53",1031,407,368,37,2,404,3,1100,693,209,195
26,MARAMUREŞ,"CASA DE CULTURĂ",158,"ORAŞ SEINI",108963,1,PART,PRCNCT,PRSD,PRSD_SV,"2025-05-18 21:56:33",1745,824,757,67,0,822,2,1892,1068,417,405
26,MARAMUREŞ,"ŞCOALA GENERALĂ NR. 1",159,"ORAŞ SEINI",108963,1,PART,PRCNCT,PRSD,PRSD_SV,"2025-05-18 21:28:40",1740,912,810,98,4,902,10,1900,988,488,414
26,MARAMUREŞ,"CASA BAY",160,"ORAŞ SEINI",108963,1,PART,PRCNCT,PRSD,PRSD_SV,"2025-05-18 22:06:43",1924,894,830,62,2,884,10,2100,1206,348,536
26,MARAMUREŞ,"ŞCOALA MAGHIARĂ",161,"ORAŞ SEINI",108963,1,PART,PRCNCT,PRSD,PRSD_SV,"2025-05-18 21:21:51",1277,613,547,64,2,603,10,1400,787,295,308
26,MARAMUREŞ,"CĂMINUL CULTURAL",162,"ORAŞ SEINI",108963,1,PART,PRCNCT,PRSD,PRSD_SV,"2025-05-18 21:27:18",696,359,320,39,0,356,3,800,441,214,142
26,MARAMUREŞ,"SALA MULTIFUNCŢIONALĂ VIILE APEI",163,"ORAŞ SEINI",108963,1,PART,PRCNCT,PRSD,PRSD_SV,"2025-05-18 21:25:55",562,282,257,24,1,280,2,600,318,150,130
26,MARAMUREŞ,"CASA DE CULTURĂ",164,"ORAŞ ŞOMCUTA MARE",109176,1,PART,PRCNCT,PRSD,PRSD_SV,"2025-05-18 21:43:09",886,497,420,76,1,490,7,1000,503,257,233
26,MARAMUREŞ,"CENTRUL CULTURAL ”CHIOARUL”",165,"ORAŞ ŞOMCUTA MARE",109176,1,PART,PRCNCT,PRSD,PRSD_SV,"2025-05-18 21:31:27",689,354,298,56,0,352,2,800,446,186,166
26,MARAMUREŞ,"GRĂDINIȚA CU PROGRAM PRELUNGIT",166,"ORAŞ ŞOMCUTA MARE",109176,1,PART,PRCNCT,PRSD,PRSD_SV,"2025-05-18 21:31:42",941,522,442,76,4,512,10,1000,478,237,275
26,MARAMUREŞ,"ȘCOALA GENERALĂ NR. 2",167,"ORAŞ ŞOMCUTA MARE",109176,2,PART,PRCNCT,PRSD,PRSD_SV,"2025-05-18 23:24:26",857,346,325,21,0,346,0,900,554,321,25
26,MARAMUREŞ,"CĂMINUL CULTURAL",168,"ORAŞ ŞOMCUTA MARE",109176,1,PART,PRCNCT,PRSD,PRSD_SV,"2025-05-18 21:30:05",609,361,296,62,3,356,5,700,339,166,190
26,MARAMUREŞ,"CĂMINUL CULTURAL",169,"ORAŞ ŞOMCUTA MARE",109176,1,PART,PRCNCT,PRSD,PRSD_SV,"2025-05-18 21:29:50",486,240,221,19,0,238,2,500,260,137,101
26,MARAMUREŞ,"CĂMINUL CULTURAL",170,"ORAŞ ŞOMCUTA MARE",109176,1,PART,PRCNCT,PRSD,PRSD_SV,"2025-05-18 21:22:49",203,132,114,18,0,129,3,300,168,63,66
26,MARAMUREŞ,"CĂMINUL CULTURAL",171,"ORAŞ ŞOMCUTA MARE",109176,1,PART,PRCNCT,PRSD,PRSD_SV,"2025-05-18 21:22:55",587,363,316,47,0,362,1,700,337,177,185
26,MARAMUREŞ,"ȘCOALA GENERALĂ",172,"ORAŞ ŞOMCUTA MARE",109176,1,PART,PRCNCT,PRSD,PRSD_SV,"2025-05-18 21:18:36",317,163,146,17,0,162,1,400,237,79,83
26,MARAMUREŞ,"ȘCOALA GENERALĂ",173,"ORAŞ ŞOMCUTA MARE",109176,1,PART,PRCNCT,PRSD,PRSD_SV,"2025-05-18 21:21:10",191,134,117,17,0,130,4,201,67,73,57
26,MARAMUREŞ,"ȘCOALA GENERALĂ",174,"ORAŞ ŞOMCUTA MARE",109176,1,PART,PRCNCT,PRSD,PRSD_SV,"2025-05-18 21:23:27",511,332,252,80,0,332,0,600,268,182,150
26,MARAMUREŞ,"SALA MULTIFUNCȚIONALĂ MĂGHERĂUȘ",175,"ORAŞ TĂUŢII-MĂGHERĂUŞ",106461,1,PART,PRCNCT,PRSD,PRSD_SV,"2025-05-18 22:19:48",1702,1110,988,120,2,1103,7,1800,690,343,760
26,MARAMUREŞ,"LICEUL TEHNOLOGIC „TRAIAN VUIA”",176,"ORAŞ TĂUŢII-MĂGHERĂUŞ",106461,1,PART,PRCNCT,PRSD,PRSD_SV,"2025-05-18 21:32:54",1341,989,800,189,0,978,11,1400,411,267,711
26,MARAMUREŞ,"CENTRU DE ZI PENTRU COPII HOȘTEZE",177,"ORAŞ TĂUŢII-MĂGHERĂUŞ",106461,1,PART,PRCNCT,PRSD,PRSD_SV,"2025-05-18 21:39:23",959,569,504,65,0,568,1,1100,531,220,348
26,MARAMUREŞ,"CENTRUL CULTURAL ION ȘIUGARIU",178,"ORAŞ TĂUŢII-MĂGHERĂUŞ",106461,1,PART,PRCNCT,PRSD,PRSD_SV,"2025-05-18 21:19:24",850,508,466,42,0,500,8,900,392,159,341
26,MARAMUREŞ,"CANTONUL SILVIC",179,"ORAŞ TĂUŢII-MĂGHERĂUŞ",106461,1,PART,PRCNCT,PRSD,PRSD_SV,"2025-05-18 21:15:43",223,138,112,26,0,136,2,300,162,69,67
26,MARAMUREŞ,"GRĂDINIȚA ROȘTI",180,"ORAŞ TĂUŢII-MĂGHERĂUŞ",106461,1,PART,PRCNCT,PRSD,PRSD_SV,"2025-05-18 21:17:06",512,298,275,23,0,293,5,600,302,108,185
26,MARAMUREŞ,"CĂMINUL CULTURAL",181,"ORAŞ TĂUŢII-MĂGHERĂUŞ",106461,1,PART,PRCNCT,PRSD,PRSD_SV,"2025-05-18 21:19:53",597,334,279,53,2,331,3,700,366,136,195
26,MARAMUREŞ,"ȘCOALA GENERALĂ",182,"ORAŞ TĂUŢII-MĂGHERĂUŞ",106461,1,PART,PRCNCT,PRSD,PRSD_SV,"2025-05-18 21:30:51",592,341,315,26,0,336,5,700,359,178,158
26,MARAMUREŞ,"GRĂDINIȚA 9 MAI",183,"ORAŞ TĂUŢII-MĂGHERĂUŞ",106461,1,PART,PRCNCT,PRSD,PRSD_SV,"2025-05-18 21:19:17",354,208,185,23,0,206,2,400,192,148,58
26,MARAMUREŞ,GRĂDINIȚA,184,"ORAŞ TĂUŢII-MĂGHERĂUŞ",106461,1,PART,PRCNCT,PRSD,PRSD_SV,"2025-05-18 21:31:06",593,366,305,61,0,364,2,700,334,195,169
26,MARAMUREŞ,"CĂMINUL CULTURAL",185,"ORAŞ TĂUŢII-MĂGHERĂUŞ",106461,1,PART,PRCNCT,PRSD,PRSD_SV,"2025-05-18 21:28:49",323,252,195,57,0,250,2,400,148,97,153
26,MARAMUREŞ,"CĂMINUL CULTURAL",186,"ORAŞ TĂUŢII-MĂGHERĂUŞ",106461,1,PART,PRCNCT,PRSD,PRSD_SV,"2025-05-18 21:14:28",152,107,85,22,0,107,0,200,93,66,41
26,MARAMUREŞ,"CASA ORĂŞENEASCĂ DE CULTURĂ",187,"ORAŞ TÂRGU LĂPUŞ",106817,1,PART,PRCNCT,PRSD,PRSD_SV,"2025-05-18 22:12:25",1446,795,633,161,1,790,5,1600,805,352,438
26,MARAMUREŞ,"CENTRUL ȘCOLAR PENTRU EDUCAȚIE INCLUZIVĂ",188,"ORAŞ TÂRGU LĂPUŞ",106817,1,PART,PRCNCT,PRSD,PRSD_SV,"2025-05-18 21:53:26",1400,780,668,71,41,771,9,1500,720,331,440
26,MARAMUREŞ,"LICEUL TEORETIC „PETRU RAREȘ”",189,"ORAŞ TÂRGU LĂPUŞ",106817,1,PART,PRCNCT,PRSD,PRSD_SV,"2025-05-18 21:54:54",1832,967,894,59,14,957,10,2000,1033,463,494
26,MARAMUREŞ,"ŞCOALA GENERALĂ",190,"ORAŞ TÂRGU LĂPUŞ",106817,1,PART,PRCNCT,PRSD,PRSD_SV,"2025-05-18 21:45:57",261,152,103,49,0,149,3,300,148,82,67
26,MARAMUREŞ,"ŞCOALA GENERALĂ",191,"ORAŞ TÂRGU LĂPUŞ",106817,1,PART,PRCNCT,PRSD,PRSD_SV,"2025-05-18 21:37:24",390,185,168,17,0,183,2,500,315,121,62
26,MARAMUREŞ,"ŞCOALA GENERALĂ",192,"ORAŞ TÂRGU LĂPUŞ",106817,1,PART,PRCNCT,PRSD,PRSD_SV,"2025-05-18 21:26:12",158,106,85,21,0,105,1,200,94,67,38
26,MARAMUREŞ,"ŞCOALA GENERALĂ",193,"ORAŞ TÂRGU LĂPUŞ",106817,1,PART,PRCNCT,PRSD,PRSD_SV,"2025-05-18 21:39:18",763,292,274,18,0,286,6,800,508,121,165
26,MARAMUREŞ,"ŞCOALA GENERALĂ",194,"ORAŞ TÂRGU LĂPUŞ",106817,1,PART,PRCNCT,PRSD,PRSD_SV,"2025-05-18 21:18:59",319,138,120,17,1,137,1,400,262,96,41
26,MARAMUREŞ,"ŞCOALA GENERALĂ",195,"ORAŞ TÂRGU LĂPUŞ",106817,1,PART,PRCNCT,PRSD,PRSD_SV,"2025-05-18 21:34:40",171,91,73,18,0,90,1,200,109,49,41
26,MARAMUREŞ,"ŞCOALA GENERALĂ",196,"ORAŞ TÂRGU LĂPUŞ",106817,1,PART,PRCNCT,PRSD,PRSD_SV,"2025-05-18 21:37:05",191,94,77,17,0,94,0,300,206,67,27
26,MARAMUREŞ,"ŞCOALA GENERALĂ",197,"ORAŞ TÂRGU LĂPUŞ",106817,1,PART,PRCNCT,PRSD,PRSD_SV,"2025-05-18 21:10:19",57,38,26,12,0,38,0,100,62,17,21
26,MARAMUREŞ,"ŞCOALA GENERALĂ",198,"ORAŞ TÂRGU LĂPUŞ",106817,1,PART,PRCNCT,PRSD,PRSD_SV,"2025-05-18 21:30:39",194,88,76,12,0,87,1,300,212,51,36
26,MARAMUREŞ,GRĂDINIȚA,199,"ORAŞ TÂRGU LĂPUŞ",106817,1,PART,PRCNCT,PRSD,PRSD_SV,"2025-05-18 21:37:02",638,252,233,19,0,252,0,700,448,163,89
26,MARAMUREŞ,"ŞCOALA GENERALĂ",200,"ORAŞ TÂRGU LĂPUŞ",106817,1,PART,PRCNCT,PRSD,PRSD_SV,"2025-05-18 21:39:28",482,242,227,15,0,240,2,500,258,159,81
26,MARAMUREŞ,GRĂDINIȚA,201,"ORAŞ TÂRGU LĂPUŞ",106817,1,PART,PRCNCT,PRSD,PRSD_SV,"2025-05-18 21:47:31",1229,460,436,20,4,458,2,1300,840,284,174
26,MARAMUREŞ,GRĂDINIŢĂ,202,"ORAŞ TÂRGU LĂPUŞ",106817,1,PART,PRCNCT,PRSD,PRSD_SV,"2025-05-18 21:24:17",579,304,272,32,0,304,0,600,296,185,119
26,MARAMUREŞ,"FOSTUL DISPENSAR",203,"ORAŞ TÂRGU LĂPUŞ",106817,1,PART,PRCNCT,PRSD,PRSD_SV,"2025-05-18 21:25:43",217,104,90,14,0,104,0,300,196,51,53
26,MARAMUREŞ,"CENTRUL DE CULTURĂ ȘI ARTĂ",204,"ORAŞ ULMENI",109265,1,PART,PRCNCT,PRSD,PRSD_SV,"2025-05-18 22:08:57",1127,689,566,112,11,683,6,1200,511,347,336
26,MARAMUREŞ,"ȘCOALA PRIMARĂ",205,"ORAŞ ULMENI",109265,1,PART,PRCNCT,PRSD,PRSD_SV,"2025-05-18 21:35:32",203,118,99,19,0,116,2,300,182,66,50
26,MARAMUREŞ,"ȘCOALA GIMNAZIALĂ „KOS KAROLY”",206,"ORAŞ ULMENI",109265,1,PART,PRCNCT,PRSD,PRSD_SV,"2025-05-18 21:25:22",678,428,369,28,31,423,5,700,272,52,371
26,MARAMUREŞ,"ȘCOALA GIMNAZIALĂ",207,"ORAŞ ULMENI",109265,1,PART,PRCNCT,PRSD,PRSD_SV,"2025-05-18 21:37:09",1306,634,574,50,10,633,1,1400,766,486,147
26,MARAMUREŞ,"CĂMINUL CULTURAL",208,"ORAŞ ULMENI",109265,1,PART,PRCNCT,PRSD,PRSD_SV,"2025-05-18 21:34:35",884,501,441,43,17,495,6,1000,499,199,296
26,MARAMUREŞ,"CĂMINUL CULTURAL",209,"ORAŞ ULMENI",109265,2,PART,PRCNCT,PRSD,PRSD_SV,"2025-05-18 23:49:47",600,290,242,48,0,289,1,700,410,184,105
26,MARAMUREŞ,"CENTRUL MULTIFUNCȚIONAL",210,"ORAŞ ULMENI",109265,1,PART,PRCNCT,PRSD,PRSD_SV,"2025-05-18 21:23:00",762,333,295,38,0,330,3,800,467,256,74
26,MARAMUREŞ,"ȘCOALA PRIMARĂ",211,"ORAŞ ULMENI",109265,2,PART,PRCNCT,PRSD,PRSD_SV,"2025-05-18 23:28:25",247,139,105,34,0,139,0,300,161,76,63
26,MARAMUREŞ,"GRĂDINIŢA NR. 5",212,"ORAŞ VIŞEU DE SUS",106979,1,PART,PRCNCT,PRSD,PRSD_SV,"2025-05-18 22:01:28",1043,399,360,38,1,396,3,1100,701,182,214
26,MARAMUREŞ,"GRĂDINIŢA NR. 5",213,"ORAŞ VIŞEU DE SUS",106979,1,PART,PRCNCT,PRSD,PRSD_SV,"2025-05-18 22:08:48",1038,389,355,33,1,386,3,1100,711,216,170
26,MARAMUREŞ,"LICEUL TEORETIC BOGDAN VODĂ",214,"ORAŞ VIŞEU DE SUS",106979,1,PART,PRCNCT,PRSD,PRSD_SV,"2025-05-18 21:46:44",837,335,283,19,33,331,4,900,565,149,182
26,MARAMUREŞ,"LICEUL TEORETIC BOGDAN VODĂ",215,"ORAŞ VIŞEU DE SUS",106979,1,PART,PRCNCT,PRSD,PRSD_SV,"2025-05-18 21:58:51",908,399,349,49,1,395,4,1000,601,150,245
26,MARAMUREŞ,"LICEUL TEHNOLOGIC",216,"ORAŞ VIŞEU DE SUS",106979,1,PART,PRCNCT,PRSD,PRSD_SV,"2025-05-18 22:00:23",1613,574,531,43,0,572,2,1700,1126,284,288
26,MARAMUREŞ,"LICEUL TEHNOLOGIC",217,"ORAŞ VIŞEU DE SUS",106979,1,PART,PRCNCT,PRSD,PRSD_SV,"2025-05-18 21:58:23",1621,463,425,38,0,459,4,1800,1337,250,209
26,MARAMUREŞ,"LICEUL TEHNOLOGIC NR. 4",218,"ORAŞ VIŞEU DE SUS",106979,1,PART,PRCNCT,PRSD,PRSD_SV,"2025-05-18 21:34:54",1028,346,326,20,0,344,2,1100,754,227,117
26,MARAMUREŞ,"LICEUL TEHNOLOGIC NR. 4",219,"ORAŞ VIŞEU DE SUS",106979,2,PART,PRCNCT,PRSD,PRSD_SV,"2025-05-19 01:37:12",952,353,336,17,0,349,4,1000,647,270,79
26,MARAMUREŞ,"CANTINA DE AJUTOR SOCIAL",220,"ORAŞ VIŞEU DE SUS",106979,1,PART,PRCNCT,PRSD,PRSD_SV,"2025-05-18 22:05:16",1457,674,579,91,4,667,7,1600,926,333,334
26,MARAMUREŞ,"ŞCOALA GIMNAZIALĂ NR. 7",221,"ORAŞ VIŞEU DE SUS",106979,1,PART,PRCNCT,PRSD,PRSD_SV,"2025-05-18 22:00:13",1652,612,565,47,0,608,4,1800,1188,350,258
26,MARAMUREŞ,"ŞCOALA GIMNAZIALĂ NR. 7",222,"ORAŞ VIŞEU DE SUS",106979,1,PART,PRCNCT,PRSD,PRSD_SV,"2025-05-18 22:07:46",1451,586,511,75,0,580,6,1600,1014,232,348
26,MARAMUREŞ,GRĂDINIŢA,223,"ORAŞ VIŞEU DE SUS",106979,1,PART,PRCNCT,PRSD,PRSD_SV,"2025-05-18 21:41:36",750,294,269,25,0,292,2,800,506,193,99
26,MARAMUREŞ,"ŞCOALA CU CLASELE I-VIII",224,ARDUSAT,107001,1,PART,PRCNCT,PRSD,PRSD_SV,"2025-05-18 22:07:10",1689,809,698,99,12,807,2,1800,991,550,257
26,MARAMUREŞ,"ŞCOALA CU CLASELE I-IV",225,ARDUSAT,107001,1,PART,PRCNCT,PRSD,PRSD_SV,"2025-05-18 21:28:59",226,163,128,34,1,162,1,299,136,74,88
26,MARAMUREŞ,"ŞCOALA CU CLASELE I-IV",226,ARDUSAT,107001,1,PART,PRCNCT,PRSD,PRSD_SV,"2025-05-18 21:40:21",384,226,181,45,0,226,0,500,274,140,86
26,MARAMUREŞ,"CĂMINUL CULTURAL",227,ARINIŞ,107047,1,PART,PRCNCT,PRSD,PRSD_SV,"2025-05-18 21:23:43",561,321,280,41,0,318,3,600,279,140,178
26,MARAMUREŞ,"CĂMINUL CULTURAL",228,ARINIŞ,107047,1,PART,PRCNCT,PRSD,PRSD_SV,"2025-05-18 21:21:26",151,117,84,31,2,115,2,200,83,76,39
26,MARAMUREŞ,"CĂMINUL CULTURAL",229,ARINIŞ,107047,1,PART,PRCNCT,PRSD,PRSD_SV,"2025-05-18 21:21:46",165,128,73,55,0,128,0,200,72,53,75
26,MARAMUREŞ,"CĂMINUL CULTURAL",230,"ASUAJU DE SUS",107083,1,PART,PRCNCT,PRSD,PRSD_SV,"2025-05-18 21:54:02",735,450,371,72,7,441,9,800,350,230,211
26,MARAMUREŞ,"CĂMINUL CULTURAL",231,"ASUAJU DE SUS",107083,1,PART,PRCNCT,PRSD,PRSD_SV,"2025-05-18 21:25:48",241,139,99,40,0,139,0,300,161,77,62
26,MARAMUREŞ,"CĂMINUL CULTURAL",232,"BĂIŢA DE SUB CODRU",107118,1,PART,PRCNCT,PRSD,PRSD_SV,"2025-05-18 21:52:19",1251,615,535,77,3,611,4,1400,785,421,190
26,MARAMUREŞ,"CĂMINUL CULTURAL",233,"BĂIŢA DE SUB CODRU",107118,1,PART,PRCNCT,PRSD,PRSD_SV,"2025-05-18 21:26:38",256,144,111,33,0,140,4,301,157,89,51
26,MARAMUREŞ,"ȘCOALA GIMNAZIALĂ REGINA ELISABETA",234,BĂIUŢ,107154,1,PART,PRCNCT,PRSD,PRSD_SV,"2025-05-18 21:40:07",1176,441,387,53,1,438,3,1300,859,166,272
26,MARAMUREŞ,"CĂMINUL CULTURAL",235,BĂIUŢ,107154,1,PART,PRCNCT,PRSD,PRSD_SV,"2025-05-18 21:35:49",153,97,66,31,0,96,1,200,103,42,54
26,MARAMUREŞ,"CĂMINUL CULTURAL",236,BĂIUŢ,107154,1,PART,PRCNCT,PRSD,PRSD_SV,"2025-05-18 21:35:03",461,229,190,39,0,228,1,500,271,109,119
26,MARAMUREŞ,"CĂMINUL CULTURAL",237,BĂSEŞTI,107190,1,PART,PRCNCT,PRSD,PRSD_SV,"2025-05-18 21:39:54",462,240,201,37,2,237,3,500,260,150,87
26,MARAMUREŞ,"CĂMINUL CULTURAL",238,BĂSEŞTI,107190,1,PART,PRCNCT,PRSD,PRSD_SV,"2025-05-18 21:31:07",301,168,123,45,0,167,1,400,232,104,63
26,MARAMUREŞ,"CĂMINUL CULTURAL",239,BĂSEŞTI,107190,1,PART,PRCNCT,PRSD,PRSD_SV,"2025-05-18 21:23:07",70,57,26,31,0,57,0,100,43,27,30
26,MARAMUREŞ,"CĂMINUL CULTURAL",240,BĂSEŞTI,107190,1,PART,PRCNCT,PRSD,PRSD_SV,"2025-05-18 21:25:27",221,112,75,37,0,112,0,300,188,68,44
26,MARAMUREŞ,"ŞCOALA GIMNAZIALĂ „MIRCEA VULCANESCU”",241,BÂRSANA,107314,1,PART,PRCNCT,PRSD,PRSD_SV,"2025-05-18 22:01:57",1445,581,549,32,0,577,4,1600,1019,329,248
26,MARAMUREŞ,"ŞCOALA GIMNAZIALĂ „MIRCEA VULCĂNESCU”",242,BÂRSANA,107314,1,PART,PRCNCT,PRSD,PRSD_SV,"2025-05-18 21:39:07",1162,452,415,37,0,450,2,1300,848,299,151
26,MARAMUREŞ,"ȘCOALA „VALEA MUNTELUI”",243,BÂRSANA,107314,1,PART,PRCNCT,PRSD,PRSD_SV,"2025-05-18 21:25:28",636,236,213,23,0,234,2,700,464,172,62
26,MARAMUREŞ,"ȘCOALA „NĂNEȘTI”",244,BÂRSANA,107314,1,PART,PRCNCT,PRSD,PRSD_SV,"2025-05-18 21:23:47",531,231,205,26,0,229,2,600,369,151,78
26,MARAMUREŞ,"CĂMINUL CULTURAL",245,BICAZ,107234,1,PART,PRCNCT,PRSD,PRSD_SV,"2025-05-18 21:51:17",421,226,186,35,5,226,0,500,274,144,82
26,MARAMUREŞ,"ŞCOALA CU CLASELE I-IV",246,BICAZ,107234,1,PART,PRCNCT,PRSD,PRSD_SV,"2025-05-18 21:21:35",130,99,65,33,1,99,0,201,102,51,48
26,MARAMUREŞ,"CĂMINUL CULTURAL",247,BICAZ,107234,1,PART,PRCNCT,PRSD,PRSD_SV,"2025-05-18 21:23:00",219,133,96,29,8,132,1,300,167,83,49
26,MARAMUREŞ,"PRIMĂRIA BISTRA",248,BISTRA,107270,1,PART,PRCNCT,PRSD,PRSD_SV,"2025-05-18 22:00:23",788,315,298,17,0,312,3,900,585,216,96
26,MARAMUREŞ,"CĂMINUL CULTURAL",249,BISTRA,107270,1,PART,PRCNCT,PRSD,PRSD_SV,"2025-05-18 21:48:28",1285,531,488,43,0,525,6,1400,869,387,138
26,MARAMUREŞ,"ŞCOALA GIMNAZIALĂ",250,BISTRA,107270,1,PART,PRCNCT,PRSD,PRSD_SV,"2025-05-18 21:31:50",1173,404,376,28,0,399,5,1300,896,276,123
26,MARAMUREŞ,"CLĂDIRE POST POLIȚIE, CLĂDIRE ARHIVĂ, CLĂDIRE BIROURI",251,"BOCICOIU MARE",107350,1,PART,PRCNCT,PRSD,PRSD_SV,"2025-05-18 22:11:13",497,244,227,17,0,241,3,600,356,165,76
26,MARAMUREŞ,"GRĂDINIŢA DE COPII",252,"BOCICOIU MARE",107350,1,PART,PRCNCT,PRSD,PRSD_SV,"2025-05-18 21:52:58",1328,562,512,46,4,557,5,1400,838,367,190
26,MARAMUREŞ,"ŞCOALA CU CLASELE I-VIII",253,"BOCICOIU MARE",107350,1,PART,PRCNCT,PRSD,PRSD_SV,"2025-05-18 21:47:40",691,285,269,16,0,283,2,800,515,206,77
26,MARAMUREŞ,"ŞCOALA CU CLASELE I-VIII",254,"BOCICOIU MARE",107350,1,PART,PRCNCT,PRSD,PRSD_SV,"2025-05-18 22:17:04",1237,588,548,40,0,581,7,1300,712,409,172
26,MARAMUREŞ,GRĂDINIȚĂ,255,"BOGDAN VODĂ",107403,1,PART,PRCNCT,PRSD,PRSD_SV,"2025-05-18 21:51:34",1903,720,656,48,16,718,2,2100,1380,360,358
26,MARAMUREŞ,"CĂMIN CULTURAL",256,"BOGDAN VODĂ",107403,1,PART,PRCNCT,PRSD,PRSD_SV,"2025-05-18 21:27:58",492,175,139,34,2,173,2,500,325,110,63
26,MARAMUREŞ,PRIMĂRIA,257,"BOIU MARE",107430,1,PART,PRCNCT,PRSD,PRSD_SV,"2025-05-18 21:18:54",463,223,175,44,4,223,0,500,277,113,110
26,MARAMUREŞ,"ŞCOALA GENERALĂ",258,"BOIU MARE",107430,1,PART,PRCNCT,PRSD,PRSD_SV,"2025-05-18 21:28:21",45,58,37,21,0,58,0,100,42,30,28
26,MARAMUREŞ,"CĂMINUL CULTURAL",259,"BOIU MARE",107430,1,PART,PRCNCT,PRSD,PRSD_SV,"2025-05-18 21:24:04",375,206,167,38,1,206,0,400,194,97,109
26,MARAMUREŞ,"ŞCOALA GENERALĂ",260,"BOIU MARE",107430,1,PART,PRCNCT,PRSD,PRSD_SV,"2025-05-18 21:18:21",53,36,29,7,0,36,0,100,64,10,26
26,MARAMUREŞ,"FOSTUL SEDIUL AL PRIMĂRIEI",261,BOTIZA,107485,1,PART,PRCNCT,PRSD,PRSD_SV,"2025-05-18 21:55:40",1736,769,738,30,1,766,3,1900,1131,462,304
26,MARAMUREŞ,"ŞCOALA PRIMARĂ VALEA SASULUI",262,BOTIZA,107485,1,PART,PRCNCT,PRSD,PRSD_SV,"2025-05-18 21:49:59",276,163,134,27,2,161,2,300,137,94,67
26,MARAMUREŞ,"SEDIUL PRIMĂRIEI",263,BUDEŞTI,107519,1,PART,PRCNCT,PRSD,PRSD_SV,"2025-05-18 22:04:30",1098,513,475,35,3,511,2,1200,687,343,168
26,MARAMUREŞ,"SEDIUL GRĂDINIȚEI",264,BUDEŞTI,107519,1,PART,PRCNCT,PRSD,PRSD_SV,"2025-05-18 21:52:41",625,291,276,15,0,291,0,700,409,190,101
26,MARAMUREŞ,"CĂMINUL CULTURAL",265,BUDEŞTI,107519,1,PART,PRCNCT,PRSD,PRSD_SV,"2025-05-18 21:46:40",632,270,251,19,0,268,2,700,430,178,90
26,MARAMUREŞ,"CĂMINUL CULTURAL",266,CĂLINEŞTI,107546,1,PART,PRCNCT,PRSD,PRSD_SV,"2025-05-18 21:44:52",1146,517,487,28,2,515,2,1200,683,330,185
26,MARAMUREŞ,"CĂMINUL CULTURAL",267,CĂLINEŞTI,107546,1,PART,PRCNCT,PRSD,PRSD_SV,"2025-05-18 21:33:13",348,168,149,19,0,168,0,400,232,132,36
26,MARAMUREŞ,"CĂMINUL CULTURAL",268,CĂLINEŞTI,107546,1,PART,PRCNCT,PRSD,PRSD_SV,"2025-05-18 21:54:42",1075,508,469,39,0,507,1,1200,692,367,140
26,MARAMUREŞ,"CAMINUL CULTURAL",269,"CÂMPULUNG LA TISA",107715,2,PART,PRCNCT,PRSD,PRSD_SV,"2025-05-19 01:22:50",1204,488,444,31,13,486,2,1300,812,189,297
26,MARAMUREŞ,PRIMĂRIA,270,"CÂMPULUNG LA TISA",107715,1,PART,PRCNCT,PRSD,PRSD_SV,"2025-05-18 21:25:15",821,395,353,30,12,392,3,900,505,120,272
26,MARAMUREŞ,"CENTRUL CULTURAL CERNEȘTI",271,CERNEŞTI,107582,1,PART,PRCNCT,PRSD,PRSD_SV,"2025-05-18 21:45:20",673,387,341,46,0,381,6,700,313,228,153
26,MARAMUREŞ,"ȘCOALA PRIMARĂ BREBENI",272,CERNEŞTI,107582,1,PART,PRCNCT,PRSD,PRSD_SV,"2025-05-18 21:23:50",164,100,72,28,0,99,1,200,100,53,46
26,MARAMUREŞ,"GRĂDINIȚA CIOCOTIȘ",273,CERNEŞTI,107582,2,PART,PRCNCT,PRSD,PRSD_SV,"2025-05-18 23:53:06",792,409,369,40,0,406,3,900,491,246,160
26,MARAMUREŞ,"ȘCOALA PRIMARĂ FÎNAȚE",274,CERNEŞTI,107582,1,PART,PRCNCT,PRSD,PRSD_SV,"2025-05-18 21:46:26",517,269,241,28,0,269,0,600,331,159,110
26,MARAMUREŞ,"ȘCOALA PRIMARĂ MĂGURENI",275,CERNEŞTI,107582,1,PART,PRCNCT,PRSD,PRSD_SV,"2025-05-18 22:30:33",175,112,88,22,2,111,1,199,87,63,48
26,MARAMUREŞ,"CĂMINUL CULTURAL TRESTIA",276,CERNEŞTI,107582,1,PART,PRCNCT,PRSD,PRSD_SV,"2025-05-18 21:22:44",580,313,276,37,0,313,0,600,287,202,111
26,MARAMUREŞ,"CĂMIN CULTURAL",277,CICÂRLĂU,107662,1,PART,PRCNCT,PRSD,PRSD_SV,"2025-05-18 21:45:45",1947,1066,928,138,0,1054,12,2100,1034,562,492
26,MARAMUREŞ,"CLĂDIRE ADMINISTRATIVĂ",278,CICÂRLĂU,107662,1,PART,PRCNCT,PRSD,PRSD_SV,"2025-05-18 21:16:45",259,176,132,44,0,176,0,300,124,65,111
26,MARAMUREŞ,"CĂMIN CULTURAL",279,CICÂRLĂU,107662,1,PART,PRCNCT,PRSD,PRSD_SV,"2025-05-18 21:24:08",385,185,152,33,0,185,0,500,315,115,70
26,MARAMUREŞ,"CĂMIN CULTURAL",280,CICÂRLĂU,107662,1,PART,PRCNCT,PRSD,PRSD_SV,"2025-05-18 21:29:40",1135,523,470,53,0,521,2,1200,677,300,221
26,MARAMUREŞ,"ŞCOALA GIMNAZIALA ”ION POPESCU DE COAȘ”",281,COAŞ,179837,1,PART,PRCNCT,PRSD,PRSD_SV,"2025-05-18 22:03:38",1147,683,573,103,7,677,6,1300,617,413,264
26,MARAMUREŞ,"ŞCOALA PRIMARĂ ÎNTRERÂURI",282,COAŞ,179837,1,PART,PRCNCT,PRSD,PRSD_SV,"2025-05-18 21:14:21",65,54,39,15,0,54,0,100,46,25,29
26,MARAMUREŞ,"CASA DE CULTURĂ ”TELEKI SÁNDOR ”",283,COLTĂU,179846,1,PART,PRCNCT,PRSD,PRSD_SV,"2025-05-18 21:54:31",1882,832,744,49,39,826,6,2000,1168,293,533
26,MARAMUREŞ,"CĂMINUL CULTURAL",284,COLTĂU,179846,1,PART,PRCNCT,PRSD,PRSD_SV,"2025-05-18 22:00:17",495,333,273,51,9,330,3,608,275,75,255
26,MARAMUREŞ,"CĂMINUL CULTURAL",285,COPALNIC-MĂNĂŞTUR,107733,1,PART,PRCNCT,PRSD,PRSD_SV,"2025-05-18 21:59:09",788,437,381,56,0,432,5,900,463,198,234
26,MARAMUREŞ,"CĂMINUL CULTURAL",286,COPALNIC-MĂNĂŞTUR,107733,1,PART,PRCNCT,PRSD,PRSD_SV,"2025-05-18 21:18:16",583,335,293,42,0,335,0,600,265,186,149
26,MARAMUREŞ,"CĂMINUL CULTURAL",287,COPALNIC-MĂNĂŞTUR,107733,1,PART,PRCNCT,PRSD,PRSD_SV,"2025-05-18 21:19:37",279,177,149,28,0,174,3,300,123,91,83
26,MARAMUREŞ,"CĂMINUL CULTURAL",288,COPALNIC-MĂNĂŞTUR,107733,1,PART,PRCNCT,PRSD,PRSD_SV,"2025-05-18 21:36:36",568,294,247,47,0,292,2,600,306,181,111
26,MARAMUREŞ,"CĂMINUL CULTURAL",289,COPALNIC-MĂNĂŞTUR,107733,1,PART,PRCNCT,PRSD,PRSD_SV,"2025-05-18 21:16:08",61,39,30,9,0,39,0,100,61,16,23
26,MARAMUREŞ,ŞCOALA,290,COPALNIC-MĂNĂŞTUR,107733,1,PART,PRCNCT,PRSD,PRSD_SV,"2025-05-18 21:14:11",239,124,101,23,0,124,0,300,176,74,50
26,MARAMUREŞ,"CĂMINUL CULTURAL",291,COPALNIC-MĂNĂŞTUR,107733,1,PART,PRCNCT,PRSD,PRSD_SV,"2025-05-18 21:35:53",702,352,326,23,3,351,1,800,448,229,122
26,MARAMUREŞ,"CĂMINUL CULTURAL",292,COPALNIC-MĂNĂŞTUR,107733,1,PART,PRCNCT,PRSD,PRSD_SV,"2025-05-18 21:48:55",378,246,222,24,0,244,2,400,154,119,125
26,MARAMUREŞ,"CĂMINUL CULTURAL",293,COPALNIC-MĂNĂŞTUR,107733,1,PART,PRCNCT,PRSD,PRSD_SV,"2025-05-18 21:19:18",269,171,141,30,0,166,5,300,129,76,90
26,MARAMUREŞ,ŞCOALA,294,COPALNIC-MĂNĂŞTUR,107733,1,PART,PRCNCT,PRSD,PRSD_SV,"2025-05-18 21:25:58",295,151,129,22,0,151,0,408,257,57,94
26,MARAMUREŞ,"CĂMINUL CULTURAL",295,COPALNIC-MĂNĂŞTUR,107733,1,PART,PRCNCT,PRSD,PRSD_SV,"2025-05-18 21:22:03",215,174,136,38,0,172,2,300,126,80,92
26,MARAMUREŞ,"ȘCOALA VAD",296,COPALNIC-MĂNĂŞTUR,107733,1,PART,PRCNCT,PRSD,PRSD_SV,"2025-05-18 21:18:12",277,179,151,28,0,179,0,300,121,81,98
26,MARAMUREŞ,PRIMÃRIE,297,COROIENI,107868,2,PART,PRCNCT,PRSD,PRSD_SV,"2025-05-19 00:04:25",293,173,138,29,6,173,0,310,137,82,91
26,MARAMUREŞ,"CĂMINUL CULTURAL",298,COROIENI,107868,1,PART,PRCNCT,PRSD,PRSD_SV,"2025-05-18 21:23:44",343,198,169,29,0,197,1,400,202,105,92
26,MARAMUREŞ,"ŞCOALA CU CLASELE I-IV",299,COROIENI,107868,1,PART,PRCNCT,PRSD,PRSD_SV,"2025-05-18 21:17:32",147,107,73,34,0,105,2,200,93,46,59
26,MARAMUREŞ,"CĂMINUL CULTURAL",300,COROIENI,107868,1,PART,PRCNCT,PRSD,PRSD_SV,"2025-05-18 21:23:16",154,96,71,25,0,95,1,200,104,52,43
26,MARAMUREŞ,"ȘCOALA PRIMARĂ PONORÂTA",301,COROIENI,107868,1,PART,PRCNCT,PRSD,PRSD_SV,"2025-05-18 21:30:05",396,182,164,18,0,176,6,400,218,146,30
26,MARAMUREŞ,"ŞCOALA GENERALÃ",302,COROIENI,107868,1,PART,PRCNCT,PRSD,PRSD_SV,"2025-05-18 21:51:37",414,237,205,32,0,236,1,500,263,146,90
26,MARAMUREŞ,"ŞCOALA CU CLASELE I-VIII",303,CUPŞENI,107920,1,PART,PRCNCT,PRSD,PRSD_SV,"2025-05-18 21:33:57",607,270,251,18,1,267,3,700,430,147,120
26,MARAMUREŞ,"ŞCOALA CU CLASELE I-VIII",304,CUPŞENI,107920,1,PART,PRCNCT,PRSD,PRSD_SV,"2025-05-18 21:19:22",340,132,120,12,0,132,0,400,268,78,54
26,MARAMUREŞ,"ŞCOALA CU CLASELE V-VIII",305,CUPŞENI,107920,1,PART,PRCNCT,PRSD,PRSD_SV,"2025-05-18 22:08:39",820,440,421,19,0,438,2,900,460,230,208
26,MARAMUREŞ,"ŞCOALA PRIMARĂ",306,CUPŞENI,107920,1,PART,PRCNCT,PRSD,PRSD_SV,"2025-05-18 21:31:37",948,344,304,40,0,341,3,1000,656,211,130
26,MARAMUREŞ,"CĂMINUL CULTURAL",307,DESEŞTI,107975,1,PART,PRCNCT,PRSD,PRSD_SV,"2025-05-18 21:44:09",724,413,361,44,8,407,6,800,387,239,168
26,MARAMUREŞ,"CĂMINUL CULTURAL",308,DESEŞTI,107975,1,PART,PRCNCT,PRSD,PRSD_SV,"2025-05-18 21:25:49",432,200,173,21,6,200,0,500,300,130,70
26,MARAMUREŞ,ȘCOALA,309,DESEŞTI,107975,1,PART,PRCNCT,PRSD,PRSD_SV,"2025-05-18 21:58:14",733,403,375,26,2,401,2,800,397,263,138
26,MARAMUREŞ,"ŞCOALA NOUĂ",310,DUMBRĂVIŢA,108035,1,PART,PRCNCT,PRSD,PRSD_SV,"2025-05-18 21:36:47",916,595,502,91,2,589,6,1000,405,259,330
26,MARAMUREŞ,"ŞCOALA GENERALĂ",311,DUMBRĂVIŢA,108035,1,PART,PRCNCT,PRSD,PRSD_SV,"2025-05-18 21:48:31",561,363,298,62,3,358,5,600,237,153,205
26,MARAMUREŞ,"ŞCOALA GENERALĂ",312,DUMBRĂVIŢA,108035,1,PART,PRCNCT,PRSD,PRSD_SV,"2025-05-18 21:30:06",789,460,401,58,1,457,3,900,440,241,216
26,MARAMUREŞ,"ŞCOALA GENERALĂ",313,DUMBRĂVIŢA,108035,2,PART,PRCNCT,PRSD,PRSD_SV,"2025-05-18 22:11:53",534,339,294,45,0,336,3,600,261,130,206
26,MARAMUREŞ,"ŞCOALA GENERALĂ",314,DUMBRĂVIŢA,108035,1,PART,PRCNCT,PRSD,PRSD_SV,"2025-05-18 21:32:09",496,299,249,50,0,294,5,500,201,147,147
26,MARAMUREŞ,"ŞCOALA GENERALĂ",315,DUMBRĂVIŢA,108035,1,PART,PRCNCT,PRSD,PRSD_SV,"2025-05-18 21:24:14",440,294,256,38,0,288,6,500,206,122,166
26,MARAMUREŞ,"CASA DE CULTURĂ",316,FĂRCAŞA,108106,1,PART,PRCNCT,PRSD,PRSD_SV,"2025-05-18 21:28:54",1475,851,752,94,5,845,6,1600,749,424,421
26,MARAMUREŞ,"CĂMIN CULTURAL",317,FĂRCAŞA,108106,1,PART,PRCNCT,PRSD,PRSD_SV,"2025-05-18 21:20:08",598,264,224,36,4,263,1,700,436,164,99
26,MARAMUREŞ,"CĂMIN CULTURAL",318,FĂRCAŞA,108106,1,PART,PRCNCT,PRSD,PRSD_SV,"2025-05-18 21:17:04",441,300,244,54,2,288,12,500,200,197,91
26,MARAMUREŞ,"CĂMIN CULTURAL",319,FĂRCAŞA,108106,1,PART,PRCNCT,PRSD,PRSD_SV,"2025-05-18 21:31:14",908,425,355,69,1,423,2,1000,575,246,177
26,MARAMUREŞ,"CĂMINUL CULTURAL",320,GÂRDANI,179855,1,PART,PRCNCT,PRSD,PRSD_SV,"2025-05-18 21:53:47",1117,618,528,90,0,613,5,1200,582,292,321
26,MARAMUREŞ,"CĂMINUL CULTURAL",321,GIULEŞTI,108151,2,PART,PRCNCT,PRSD,PRSD_SV,"2025-05-19 00:40:09",1019,474,424,37,13,469,5,1100,626,282,187
26,MARAMUREŞ,"ȘCOALA CU CLASELE I-VIII",322,GIULEŞTI,108151,1,PART,PRCNCT,PRSD,PRSD_SV,"2025-05-18 21:38:23",1241,607,543,33,31,600,7,1400,793,362,238
26,MARAMUREŞ,"ŞCOALA GENERALĂ",323,GIULEŞTI,108151,1,PART,PRCNCT,PRSD,PRSD_SV,"2025-05-18 21:37:11",386,237,196,32,9,234,3,400,163,135,99
26,MARAMUREŞ,"ȘCOALA GIMNAZIALĂ „GHEORGHE LUPAN”",324,GROŞI,106363,1,PART,PRCNCT,PRSD,PRSD_SV,"2025-05-18 22:01:06",1565,1007,905,94,8,999,8,1708,701,340,659
26,MARAMUREŞ,"ȘCOALA GENERALĂ",325,GROŞI,106363,1,PART,PRCNCT,PRSD,PRSD_SV,"2025-05-18 21:23:34",433,219,176,43,0,214,5,500,281,101,113
26,MARAMUREŞ,"ȘCOALA GENERALĂ",326,GROŞI,106363,1,PART,PRCNCT,PRSD,PRSD_SV,"2025-05-18 22:11:48",1245,799,692,107,0,793,6,1300,501,286,507
26,MARAMUREŞ,"GRĂDINIŢA CU PROGRAM NORMAL GROŞII ŢIBLEŞULUI",327,"GROŞII ŢIBLEŞULUI",179622,1,PART,PRCNCT,PRSD,PRSD_SV,"2025-05-18 21:39:45",906,451,412,37,2,449,2,1000,549,253,196
26,MARAMUREŞ,"ŞCOALA CU CLASELE I-IV GREBLE",328,"GROŞII ŢIBLEŞULUI",179622,1,PART,PRCNCT,PRSD,PRSD_SV,"2025-05-18 21:37:28",793,411,382,29,0,407,4,900,489,247,160
26,MARAMUREŞ,"ȘCOALA GIMNAZIALĂ",329,IEUD,108204,1,PART,PRCNCT,PRSD,PRSD_SV,"2025-05-18 21:59:46",1551,442,411,26,5,440,2,1700,1258,239,201
26,MARAMUREŞ,"ȘCOALA GIMNAZIALĂ",330,IEUD,108204,2,PART,PRCNCT,PRSD,PRSD_SV,"2025-05-19 01:25:42",1598,495,456,36,3,493,2,1698,1203,276,217
26,MARAMUREŞ,"GRĂDINIȚA PLOPȘOR",331,IEUD,108204,1,PART,PRCNCT,PRSD,PRSD_SV,"2025-05-18 21:36:56",366,111,93,18,0,109,2,400,289,74,35
26,MARAMUREŞ,PRIMĂRIA,332,LĂPUŞ,108222,1,PART,PRCNCT,PRSD,PRSD_SV,"2025-05-18 21:57:24",1368,715,623,83,9,709,6,1500,785,402,307
26,MARAMUREŞ,"GRĂDINIȚA CU PROGRAM NORMAL ,3 GRUPE",333,LĂPUŞ,108222,1,PART,PRCNCT,PRSD,PRSD_SV,"2025-05-18 22:41:27",1513,690,653,26,11,683,7,1700,1010,403,280
26,MARAMUREŞ,"ȘCOALA GIMNAZIALĂ NR.1, CORP B",334,LEORDINA,108240,1,PART,PRCNCT,PRSD,PRSD_SV,"2025-05-18 22:15:16",1444,563,518,44,1,558,5,1600,1037,324,234
26,MARAMUREŞ,ŞCOALA,335,LEORDINA,108240,1,PART,PRCNCT,PRSD,PRSD_SV,"2025-05-18 21:38:51",552,195,180,15,0,193,2,600,405,109,84
26,MARAMUREŞ,"PRIMĂRIA COMUNEI MIREȘU MARE",336,"MIREŞU MARE",108268,1,PART,PRCNCT,PRSD,PRSD_SV,"2025-05-18 22:14:39",1157,641,544,96,1,634,7,1300,659,415,219
26,MARAMUREŞ,"CENTRUL SOCIAL DE ASIGURARE A SERVICIILOR SOCIALE",337,"MIREŞU MARE",108268,1,PART,PRCNCT,PRSD,PRSD_SV,"2025-05-18 21:38:51",399,207,177,30,0,203,4,500,293,110,93
26,MARAMUREŞ,"ŞCOALA GENERALĂ",338,"MIREŞU MARE",108268,1,PART,PRCNCT,PRSD,PRSD_SV,"2025-05-18 21:51:08",742,401,363,36,2,396,5,808,407,219,177
26,MARAMUREŞ,"CENTRUL MULTIFUNCŢIONAL",339,"MIREŞU MARE",108268,2,PART,PRCNCT,PRSD,PRSD_SV,"2025-05-18 23:35:13",487,257,220,37,0,251,6,500,243,143,108
26,MARAMUREŞ,"ŞCOALA CU CLASELE I-IV",340,"MIREŞU MARE",108268,1,PART,PRCNCT,PRSD,PRSD_SV,"2025-05-18 21:41:37",504,253,206,46,1,249,4,600,347,157,92
26,MARAMUREŞ,"ŞCOALA CU CLASELE I-IV",341,"MIREŞU MARE",108268,1,PART,PRCNCT,PRSD,PRSD_SV,"2025-05-18 21:44:45",545,346,293,53,0,346,0,600,254,212,134
26,MARAMUREŞ,PRIMĂRIA,342,MOISEI,108348,1,PART,PRCNCT,PRSD,PRSD_SV,"2025-05-18 22:19:06",1682,734,642,92,0,721,13,1800,1066,409,312
26,MARAMUREŞ,GRĂDINIȚA,343,MOISEI,108348,1,PART,PRCNCT,PRSD,PRSD_SV,"2025-05-18 21:46:04",1066,451,419,32,0,448,3,1200,749,279,169
26,MARAMUREŞ,"ȘCOALA GIMNAZIALĂ „IOAN HOREA”",344,MOISEI,108348,1,PART,PRCNCT,PRSD,PRSD_SV,"2025-05-18 22:32:28",1609,654,605,49,0,650,4,1800,1146,436,214
26,MARAMUREŞ,"GOSPODĂRIE INDIVIDUALĂ",345,MOISEI,108348,1,PART,PRCNCT,PRSD,PRSD_SV,"2025-05-18 21:48:22",1189,483,467,16,0,480,3,1300,817,275,205
26,MARAMUREŞ,"ȘCOALA GIMNAZIALĂ „DRAGOȘ VODĂ”",346,MOISEI,108348,1,PART,PRCNCT,PRSD,PRSD_SV,"2025-05-18 21:56:16",1356,562,521,41,0,559,3,1400,838,356,203
26,MARAMUREŞ,"ȘCOALA GIMNAZIALĂ „DRAGOȘ VODĂ”",347,MOISEI,108348,1,PART,PRCNCT,PRSD,PRSD_SV,"2025-05-18 22:01:42",984,385,361,24,0,379,6,1100,715,230,149
26,MARAMUREŞ,PRIMĂRIA,348,"OARŢA DE JOS",108366,1,PART,PRCNCT,PRSD,PRSD_SV,"2025-05-18 21:40:07",338,221,154,55,12,219,2,400,179,86,133
26,MARAMUREŞ,"ȘCOALA GENERALĂ",349,"OARŢA DE JOS",108366,2,PART,PRCNCT,PRSD,PRSD_SV,"2025-05-19 01:10:25",562,337,263,57,17,336,1,600,263,180,156
26,MARAMUREŞ,"SALA DE FESTIVITĂȚI",350,"OCNA ŞUGATAG",108400,1,PART,PRCNCT,PRSD,PRSD_SV,"2025-05-18 21:52:57",1475,863,606,253,4,854,9,1600,737,390,464
26,MARAMUREŞ,"CĂMINUL CULTURAL",351,"OCNA ŞUGATAG",108400,1,PART,PRCNCT,PRSD,PRSD_SV,"2025-05-18 21:38:43",843,393,348,41,4,392,1,900,507,225,167
26,MARAMUREŞ,"CĂMINUL CULTURAL",352,"OCNA ŞUGATAG",108400,1,PART,PRCNCT,PRSD,PRSD_SV,"2025-05-18 21:29:39",239,114,100,14,0,113,1,300,186,65,48
26,MARAMUREŞ,"ŞCOALA GENERALĂ",353,"OCNA ŞUGATAG",108400,1,PART,PRCNCT,PRSD,PRSD_SV,"2025-05-18 21:48:23",965,428,395,32,1,426,2,1100,672,269,157
26,MARAMUREŞ,"CĂMINUL CULTURAL",354,ONCEŞTI,179864,2,PART,PRCNCT,PRSD,PRSD_SV,"2025-05-19 00:42:32",1254,646,564,81,1,641,5,1400,754,406,235
26,MARAMUREŞ,"ŞCOALA GENERALĂ „MOCEARSCHI”",355,PETROVA,108455,1,PART,PRCNCT,PRSD,PRSD_SV,"2025-05-18 21:58:52",991,392,364,28,0,390,2,1100,708,278,112
26,MARAMUREŞ,"ŞCOALA GENERALĂ „SUSANI”",356,PETROVA,108455,1,PART,PRCNCT,PRSD,PRSD_SV,"2025-05-18 21:44:29",942,346,324,22,0,340,6,1000,654,195,145
26,MARAMUREŞ,"ȘCOALA PROFESIONALĂ",357,"POIENILE DE SUB MUNTE",108473,1,PART,PRCNCT,PRSD,PRSD_SV,"2025-05-18 21:33:33",1202,522,491,31,0,516,5,1300,778,430,86
26,MARAMUREŞ,"ȘCOALA PROFESIONALĂ",358,"POIENILE DE SUB MUNTE",108473,1,PART,PRCNCT,PRSD,PRSD_SV,"2025-05-18 21:24:31",1112,431,420,11,0,428,3,1200,769,371,57
26,MARAMUREŞ,"ȘCOALA PRIMARĂ SI GRĂDINIȚA",359,"POIENILE DE SUB MUNTE",108473,1,PART,PRCNCT,PRSD,PRSD_SV,"2025-05-18 21:47:45",1117,437,420,17,0,434,3,1200,763,359,75
26,MARAMUREŞ,"ȘCOALA NEJNI CRAI",360,"POIENILE DE SUB MUNTE",108473,1,PART,PRCNCT,PRSD,PRSD_SV,"2025-05-18 21:51:10",1133,429,415,14,0,424,5,1200,771,364,60
26,MARAMUREŞ,"ȘCOALA GIMNAZIALĂ NR. 4",361,"POIENILE DE SUB MUNTE",108473,1,PART,PRCNCT,PRSD,PRSD_SV,"2025-05-18 21:47:09",1144,482,468,14,0,472,10,1300,818,419,53
26,MARAMUREŞ,"ȘCOALA GIMNAZIALĂ NR. 4",362,"POIENILE DE SUB MUNTE",108473,1,PART,PRCNCT,PRSD,PRSD_SV,"2025-05-18 21:53:51",1085,416,406,10,0,404,12,1200,784,382,22
26,MARAMUREŞ,"ȘCOALA GIMNAZIALĂ NR. 4, STRUCTURA LUHEI",363,"POIENILE DE SUB MUNTE",108473,1,PART,PRCNCT,PRSD,PRSD_SV,"2025-05-18 21:52:21",911,402,386,16,0,399,3,1000,598,372,27
26,MARAMUREŞ,PRIMĂRIA,364,"POIENILE IZEI",179604,1,PART,PRCNCT,PRSD,PRSD_SV,"2025-05-18 22:04:22",673,438,371,55,12,434,4,800,362,143,291
26,MARAMUREŞ,"ȘCOALĂ GIMNAZIALĂ",365,RECEA,106407,1,PART,PRCNCT,PRSD,PRSD_SV,"2025-05-18 22:01:48",1096,662,564,96,2,657,5,1200,538,309,348
26,MARAMUREŞ,"ȘCOALA CU CLASELE I-IV",366,RECEA,106407,1,PART,PRCNCT,PRSD,PRSD_SV,"2025-05-18 21:09:54",371,221,169,52,0,221,0,400,179,110,111
26,MARAMUREŞ,"ȘCOALA GIMNAZIALĂ",367,RECEA,106407,1,PART,PRCNCT,PRSD,PRSD_SV,"2025-05-18 21:23:00",1327,803,716,84,3,798,5,1500,697,307,491
26,MARAMUREŞ,"ȘCOALA CU CLASELE I-IV",368,RECEA,106407,1,PART,PRCNCT,PRSD,PRSD_SV,"2025-05-18 21:44:28",1216,875,742,132,1,864,11,1300,425,341,523
26,MARAMUREŞ,"ȘCOALA GIMNAZIALĂ",369,RECEA,106407,1,PART,PRCNCT,PRSD,PRSD_SV,"2025-05-18 22:05:41",1436,917,829,88,0,904,13,1500,583,353,551
26,MARAMUREŞ,GRĂDINIȚA,370,RECEA,106407,1,PART,PRCNCT,PRSD,PRSD_SV,"2025-05-18 21:30:30",724,547,449,98,0,544,3,800,253,173,371
26,MARAMUREŞ,"CĂMINUL CULTURAL",371,"REMETEA CHIOARULUI",108491,1,PART,PRCNCT,PRSD,PRSD_SV,"2025-05-18 22:02:35",982,485,401,84,0,482,3,1100,615,275,207
26,MARAMUREŞ,"ȘCOALA PRIMARĂ",372,"REMETEA CHIOARULUI",108491,1,PART,PRCNCT,PRSD,PRSD_SV,"2025-05-18 21:29:59",529,286,251,35,0,285,1,600,314,124,161
26,MARAMUREŞ,"CĂMINUL CULTURAL",373,"REMETEA CHIOARULUI",108491,1,PART,PRCNCT,PRSD,PRSD_SV,"2025-05-18 21:25:41",354,159,133,26,0,159,0,400,241,73,86
26,MARAMUREŞ,"CĂMINUL CULTURAL",374,"REMETEA CHIOARULUI",108491,1,PART,PRCNCT,PRSD,PRSD_SV,"2025-05-18 21:42:51",275,159,131,27,1,158,1,300,141,104,54
26,MARAMUREŞ,"ȘCOALA CU CLASELE I-IV",375,"REMETEA CHIOARULUI",108491,1,PART,PRCNCT,PRSD,PRSD_SV,"2025-05-18 21:19:42",223,139,103,36,0,139,0,300,161,84,55
26,MARAMUREŞ,"ŞCOALA CU CLASELE I-VIII",376,REMEŢI,108552,1,PART,PRCNCT,PRSD,PRSD_SV,"2025-05-18 21:37:45",1348,502,471,29,2,499,3,1500,998,311,188
26,MARAMUREŞ,GRĂDINIŢA,377,REMEŢI,108552,1,PART,PRCNCT,PRSD,PRSD_SV,"2025-05-18 21:36:22",792,277,263,13,1,276,1,900,623,164,112
26,MARAMUREŞ,"CĂMIN CULTURAL",378,REMEŢI,108552,1,PART,PRCNCT,PRSD,PRSD_SV,"2025-05-18 21:14:47",319,140,122,18,0,139,1,400,260,95,44
26,MARAMUREŞ,"CANTON DE EXPLOATARE ABA SOMEŞ-TISA",379,REMEŢI,108552,1,PART,PRCNCT,PRSD,PRSD_SV,"2025-05-18 21:24:42",144,75,56,19,0,73,2,200,125,44,29
26,MARAMUREŞ,"CĂMINUL CULTURAL",380,REPEDEA,108598,1,PART,PRCNCT,PRSD,PRSD_SV,"2025-05-18 22:13:47",1763,655,643,12,0,648,7,1900,1245,528,120
26,MARAMUREŞ,"ŞCOALA GENERALĂ CU CLASELE I-IV LUJANA",381,REPEDEA,108598,1,PART,PRCNCT,PRSD,PRSD_SV,"2025-05-18 21:54:46",751,270,255,15,0,270,0,800,530,232,38
26,MARAMUREŞ,"ŞCOALA GIMNAZIALĂ NR. 2",382,REPEDEA,108598,1,PART,PRCNCT,PRSD,PRSD_SV,"2025-05-18 21:54:45",1221,496,476,20,0,491,5,1300,804,440,51
26,MARAMUREŞ,"ŞCOALA GIMNAZIALĂ „LAURENŢIU ULICI”",383,"RONA DE JOS",108614,1,PART,PRCNCT,PRSD,PRSD_SV,"2025-05-18 21:56:33",1645,659,620,38,1,656,3,1800,1141,439,217
26,MARAMUREŞ,"CĂMINUL CULTURAL",384,"RONA DE SUS",108632,1,PART,PRCNCT,PRSD,PRSD_SV,"2025-05-18 21:44:14",1589,549,505,40,4,545,4,1700,1151,371,174
26,MARAMUREŞ,"CĂMINUL CULTURAL",385,"RONA DE SUS",108632,1,PART,PRCNCT,PRSD,PRSD_SV,"2025-05-18 21:45:42",1450,448,425,21,2,444,4,1600,1152,314,130
26,MARAMUREŞ,"CLUBUL TINERETULUI",386,"RONA DE SUS",108632,1,PART,PRCNCT,PRSD,PRSD_SV,"2025-05-18 21:44:31",606,278,225,40,13,277,1,700,422,155,122
26,MARAMUREŞ,PRIMĂRIA,387,ROZAVLEA,108669,1,PART,PRCNCT,PRSD,PRSD_SV,"2025-05-18 23:05:17",1910,822,726,78,18,822,0,2100,1278,355,467
26,MARAMUREŞ,"GRĂDINIȚA ȘESU MÂNĂSTIRII",388,ROZAVLEA,108669,1,PART,PRCNCT,PRSD,PRSD_SV,"2025-05-18 22:00:32",802,326,293,26,7,322,4,900,574,181,141
26,MARAMUREŞ,"CLUBUL TINERETULUI",389,RUSCOVA,108696,1,PART,PRCNCT,PRSD,PRSD_SV,"2025-05-18 21:53:49",1603,493,470,20,3,488,5,1700,1207,330,158
26,MARAMUREŞ,"GRĂDINIŢA NR.1",390,RUSCOVA,108696,1,PART,PRCNCT,PRSD,PRSD_SV,"2025-05-18 21:57:57",1721,564,520,28,16,564,0,1900,1336,396,168
26,MARAMUREŞ,"ŞCOALA GENERALĂ NR.2",391,RUSCOVA,108696,1,PART,PRCNCT,PRSD,PRSD_SV,"2025-05-18 21:38:58",1111,322,306,16,0,321,1,1200,878,257,64
26,MARAMUREŞ,"CĂMINUL CULTURAL",392,SARASĂU,106620,1,PART,PRCNCT,PRSD,PRSD_SV,"2025-05-18 22:31:36",1249,587,556,30,1,581,6,1400,813,357,224
26,MARAMUREŞ,"CĂMINUL CULTURAL",393,SARASĂU,106620,2,PART,PRCNCT,PRSD,PRSD_SV,"2025-05-19 01:23:17",1104,454,430,24,0,453,1,1200,746,315,138
26,MARAMUREŞ,"CĂMINUL CULTURAL",394,SATULUNG,108712,1,PART,PRCNCT,PRSD,PRSD_SV,"2025-05-18 21:57:27",1407,757,645,110,2,750,7,1500,743,415,335
26,MARAMUREŞ,"CĂMINUL CULTURAL",395,SATULUNG,108712,1,PART,PRCNCT,PRSD,PRSD_SV,"2025-05-18 21:16:44",195,126,94,32,0,122,4,201,75,74,48
26,MARAMUREŞ,"CĂMINUL CULTURAL",396,SATULUNG,108712,1,PART,PRCNCT,PRSD,PRSD_SV,"2025-05-18 21:34:07",608,372,310,61,1,371,1,700,328,192,179
26,MARAMUREŞ,"CĂMINUL CULTURAL",397,SATULUNG,108712,1,PART,PRCNCT,PRSD,PRSD_SV,"2025-05-18 21:36:18",1032,421,377,44,0,415,6,1100,679,300,115
26,MARAMUREŞ,"CĂMINUL CULTURAL",398,SATULUNG,108712,1,PART,PRCNCT,PRSD,PRSD_SV,"2025-05-18 21:36:34",623,322,262,59,1,313,9,700,378,166,147
26,MARAMUREŞ,"CĂMINUL CULTURAL",399,SATULUNG,108712,1,PART,PRCNCT,PRSD,PRSD_SV,"2025-05-18 21:39:26",673,347,302,44,1,343,4,700,353,179,164
26,MARAMUREŞ,"CĂMINUL CULTURAL",400,SATULUNG,108712,1,PART,PRCNCT,PRSD,PRSD_SV,"2025-05-18 21:30:36",634,375,316,53,6,373,2,700,325,193,180
26,MARAMUREŞ,"SALA DE SPORT",401,SĂCĂLĂŞENI,108794,1,PART,PRCNCT,PRSD,PRSD_SV,"2025-05-18 21:44:02",863,512,407,105,0,505,7,900,388,270,235
26,MARAMUREŞ,"CĂMINUL CULTURAL",402,SĂCĂLĂŞENI,108794,1,PART,PRCNCT,PRSD,PRSD_SV,"2025-05-18 21:58:15",698,469,393,60,16,466,3,800,331,242,224
26,MARAMUREŞ,"CĂMINUL CULTURAL",403,SĂCĂLĂŞENI,108794,1,PART,PRCNCT,PRSD,PRSD_SV,"2025-05-18 21:33:02",547,306,267,38,1,302,4,600,294,150,152
26,MARAMUREŞ,PRIMĂRIA,404,SĂCEL,108874,1,PART,PRCNCT,PRSD,PRSD_SV,"2025-05-18 21:39:55",1387,517,486,25,6,514,3,1500,983,330,184
26,MARAMUREŞ,"ŞCOALA VALEA CARELOR",405,SĂCEL,108874,1,PART,PRCNCT,PRSD,PRSD_SV,"2025-05-18 21:36:48",1264,493,453,35,5,489,4,1400,907,305,184
26,MARAMUREŞ,"CĂMINUL CULTURAL",406,SĂLSIG,108918,1,PART,PRCNCT,PRSD,PRSD_SV,"2025-05-18 21:56:27",1332,672,585,84,3,669,3,1492,820,382,287
26,MARAMUREŞ,"ȘCOALA GIMNAZIALĂ",407,SĂPÂNŢA,108945,1,PART,PRCNCT,PRSD,PRSD_SV,"2025-05-18 22:03:01",1368,673,562,82,29,667,6,1500,827,347,320
26,MARAMUREŞ,"ȘCOALA GIMNAZIALĂ",408,SĂPÂNŢA,108945,1,PART,PRCNCT,PRSD,PRSD_SV,"2025-05-18 21:47:20",1307,608,540,43,25,597,11,1400,792,268,329
26,MARAMUREŞ,"CĂMINUL CULTURAL ”FRAȚII PETREUȘ”",409,STRÂMTURA,109005,1,PART,PRCNCT,PRSD,PRSD_SV,"2025-05-18 22:30:40",1579,636,580,51,5,633,3,1600,964,380,253
26,MARAMUREŞ,"SALA DE EVENIMENTE",410,STRÂMTURA,109005,2,PART,PRCNCT,PRSD,PRSD_SV,"2025-05-19 00:36:54",400,159,145,12,2,158,1,500,341,116,42
26,MARAMUREŞ,"ȘCOALA GENERALĂ",411,STRÂMTURA,109005,1,PART,PRCNCT,PRSD,PRSD_SV,"2025-05-18 21:34:48",496,176,163,13,0,170,6,600,424,98,72
26,MARAMUREŞ,"ȘCOALA GENERALĂ",412,STRÂMTURA,109005,1,PART,PRCNCT,PRSD,PRSD_SV,"2025-05-18 21:43:21",395,150,126,24,0,148,2,500,350,84,64
26,MARAMUREŞ,PRIMĂRIA,413,"SUCIU DE SUS",109041,1,PART,PRCNCT,PRSD,PRSD_SV,"2025-05-18 22:01:25",1352,616,552,64,0,616,0,1500,884,362,254
26,MARAMUREŞ,"ŞCOALA GENERALĂ CANDELA",414,"SUCIU DE SUS",109041,1,PART,PRCNCT,PRSD,PRSD_SV,"2025-05-18 21:38:52",717,267,230,37,0,267,0,800,533,164,103
26,MARAMUREŞ,"ŞCOALA PRIMARĂ",415,"SUCIU DE SUS",109041,1,PART,PRCNCT,PRSD,PRSD_SV,"2025-05-18 21:23:51",256,127,108,19,0,126,1,300,173,58,68
26,MARAMUREŞ,"DISPENSAR UMAN",416,"SUCIU DE SUS",109041,1,PART,PRCNCT,PRSD,PRSD_SV,"2025-05-18 21:30:29",778,417,344,73,0,415,2,800,383,195,220
26,MARAMUREŞ,"CĂMINUL CULTURAL",417,ŞIEU,179613,1,PART,PRCNCT,PRSD,PRSD_SV,"2025-05-18 21:58:58",1192,454,391,57,6,454,0,1300,846,267,187
26,MARAMUREŞ,"ȘCOALA DE LA PODUL RÂTULUI",418,ŞIEU,179613,1,PART,PRCNCT,PRSD,PRSD_SV,"2025-05-18 21:44:49",707,256,230,25,1,255,1,800,544,164,91
26,MARAMUREŞ,PRIMĂRIA,419,ŞIŞEŞTI,109096,1,PART,PRCNCT,PRSD,PRSD_SV,"2025-05-18 21:53:10",1288,766,692,70,4,751,15,1400,634,369,382
26,MARAMUREŞ,"CĂMINUL CULTURAL",420,ŞIŞEŞTI,109096,1,PART,PRCNCT,PRSD,PRSD_SV,"2025-05-18 21:26:16",194,93,71,22,0,93,0,299,206,51,42
26,MARAMUREŞ,"ŞCOALA GENERALĂ",421,ŞIŞEŞTI,109096,1,PART,PRCNCT,PRSD,PRSD_SV,"2025-05-18 21:30:59",513,300,259,41,0,296,4,600,300,160,136
26,MARAMUREŞ,"ŞCOALA GENERALĂ",422,ŞIŞEŞTI,109096,1,PART,PRCNCT,PRSD,PRSD_SV,"2025-05-18 21:35:10",503,317,270,46,1,314,3,600,283,172,142
26,MARAMUREŞ,"ŞCOALA CU CLASELE I-IV",423,ŞIŞEŞTI,109096,1,PART,PRCNCT,PRSD,PRSD_SV,"2025-05-18 21:34:03",349,181,154,27,0,181,0,400,219,105,76
26,MARAMUREŞ,"ŞCOALA CU CLS I-IV",424,ŞIŞEŞTI,109096,1,PART,PRCNCT,PRSD,PRSD_SV,"2025-05-18 21:34:31",428,230,211,19,0,230,0,500,270,139,91
26,MARAMUREŞ,"SCOALA GENERALĂ",425,ŞIŞEŞTI,109096,1,PART,PRCNCT,PRSD,PRSD_SV,"2025-05-18 21:42:55",1202,710,664,46,0,706,4,1300,590,431,275
26,MARAMUREŞ,"ȘCOALA GIMNAZIALĂ VADU IZEI",426,"VADU IZEI",106648,1,PART,PRCNCT,PRSD,PRSD_SV,"2025-05-18 21:53:09",1026,588,460,125,3,580,8,1100,512,303,277
26,MARAMUREŞ,"ȘCOALA GIMNAZIALĂ VADU IZEI",427,"VADU IZEI",106648,1,PART,PRCNCT,PRSD,PRSD_SV,"2025-05-18 21:48:38",1022,520,446,72,2,515,5,1100,580,287,228
26,MARAMUREŞ,"SALA DE FESTIVITĂȚI",428,"VADU IZEI",106648,1,PART,PRCNCT,PRSD,PRSD_SV,"2025-05-18 21:25:12",371,176,159,17,0,175,1,400,224,122,53
26,MARAMUREŞ,"CĂMINUL CULTURAL",429,"VALEA CHIOARULUI",109354,1,PART,PRCNCT,PRSD,PRSD_SV,"2025-05-18 21:58:59",520,302,260,42,0,301,1,600,298,139,162
26,MARAMUREŞ,"CĂMINUL CULTURAL",430,"VALEA CHIOARULUI",109354,1,PART,PRCNCT,PRSD,PRSD_SV,"2025-05-18 21:24:52",223,156,99,56,1,156,0,300,144,80,76
26,MARAMUREŞ,"CĂMINUL CULTURAL",431,"VALEA CHIOARULUI",109354,1,PART,PRCNCT,PRSD,PRSD_SV,"2025-05-18 21:28:59",57,60,27,32,1,60,0,100,40,15,45
26,MARAMUREŞ,"ȘCOALA GENERALĂ",432,"VALEA CHIOARULUI",109354,1,PART,PRCNCT,PRSD,PRSD_SV,"2025-05-18 21:17:11",360,125,100,25,0,122,3,408,283,81,41
26,MARAMUREŞ,"ȘCOALA GENERALĂ",433,"VALEA CHIOARULUI",109354,1,PART,PRCNCT,PRSD,PRSD_SV,"2025-05-18 21:24:21",295,152,119,33,0,152,0,301,149,70,82
26,MARAMUREŞ,"CĂMINUL CULTURAL",434,"VALEA CHIOARULUI",109354,1,PART,PRCNCT,PRSD,PRSD_SV,"2025-05-18 21:27:22",207,142,98,44,0,140,2,300,158,61,79
26,MARAMUREŞ,"CĂMINUL CULTURAL",435,"VIMA MICĂ",109425,1,PART,PRCNCT,PRSD,PRSD_SV,"2025-05-18 21:26:41",267,143,111,32,0,143,0,300,157,95,48
26,MARAMUREŞ,"ȘCOALA PRIMARĂ",436,"VIMA MICĂ",109425,1,PART,PRCNCT,PRSD,PRSD_SV,"2025-05-18 21:21:18",42,38,18,20,0,38,0,100,62,16,22
26,MARAMUREŞ,"CĂMINUL CULTURAL",437,"VIMA MICĂ",109425,1,PART,PRCNCT,PRSD,PRSD_SV,"2025-05-18 21:14:14",77,52,38,14,0,52,0,100,48,30,22
26,MARAMUREŞ,"CĂMINUL CULTURAL",438,"VIMA MICĂ",109425,1,PART,PRCNCT,PRSD,PRSD_SV,"2025-05-18 21:12:03",32,37,15,22,0,37,0,100,63,19,18
26,MARAMUREŞ,"CĂMINUL CULTURAL",439,"VIMA MICĂ",109425,1,PART,PRCNCT,PRSD,PRSD_SV,"2025-05-18 21:22:29",177,109,80,29,0,108,1,200,91,59,49
26,MARAMUREŞ,"CĂMINUL CULTURAL",440,"VIMA MICĂ",109425,1,PART,PRCNCT,PRSD,PRSD_SV,"2025-05-18 21:16:17",203,93,80,13,0,93,0,300,207,61,32
26,MARAMUREŞ,"CĂMINUL CULTURAL",441,"VIMA MICĂ",109425,1,PART,PRCNCT,PRSD,PRSD_SV,"2025-05-18 21:34:18",322,174,134,40,0,174,0,400,226,124,50
26,MARAMUREŞ,PRIMĂRIE,442,"VIŞEU DE JOS",109504,1,PART,PRCNCT,PRSD,PRSD_SV,"2025-05-18 22:12:52",1347,553,512,40,1,549,4,1500,947,232,317
26,MARAMUREŞ,"ȘCOALA PRIMARĂ",443,"VIŞEU DE JOS",109504,1,PART,PRCNCT,PRSD,PRSD_SV,"2025-05-18 21:51:45",1485,564,533,31,0,562,2,1600,1036,294,268
26,MARAMUREŞ,"CĂMIN CULTURAL",444,"VIŞEU DE JOS",109504,1,PART,PRCNCT,PRSD,PRSD_SV,"2025-05-18 21:55:37",1254,478,431,47,0,476,2,1400,922,257,219
27,MEHEDINŢI,"CONSILIUL LOCAL DROBETA-TURNU SEVERIN - PALATUL CULTURII ”TEODOR COSTESCU”",1,"MUNICIPIUL DROBETA-TURNU SEVERIN",109773,1,PART,PRCNCT,PRSD,PRSD_SV,"2025-05-18 22:09:20",1234,753,574,177,2,738,15,1300,547,310,428
27,MEHEDINŢI,"COLEGIUL NAȚIONAL ”TRAIAN”",2,"MUNICIPIUL DROBETA-TURNU SEVERIN",109773,1,PART,PRCNCT,PRSD,PRSD_SV,"2025-05-18 22:02:45",1256,709,567,102,40,702,7,1300,591,314,388
27,MEHEDINŢI,"ȘCOALA GIMNAZIALĂ ”DUMITRU I.TOTIR” (ȘCOALA GENERALĂ NR.10)",3,"MUNICIPIUL DROBETA-TURNU SEVERIN",109773,1,PART,PRCNCT,PRSD,PRSD_SV,"2025-05-18 22:07:16",1347,733,687,43,3,722,11,1400,667,297,425
27,MEHEDINŢI,"ȘCOALA GIMNAZIALĂ ”DUMITRU I.TOTIR”(ȘCOALA GENERALĂ NR.10)",4,"MUNICIPIUL DROBETA-TURNU SEVERIN",109773,1,PART,PRCNCT,PRSD,PRSD_SV,"2025-05-18 22:00:46",1180,541,495,46,0,528,13,1300,759,210,318
27,MEHEDINŢI,"ASOCIAȚIA DE PROPRIETARI NR.90",5,"MUNICIPIUL DROBETA-TURNU SEVERIN",109773,1,PART,PRCNCT,PRSD,PRSD_SV,"2025-05-18 21:42:30",873,484,442,42,0,478,6,1000,516,195,283
27,MEHEDINŢI,"LICEUL TEHNOLOGIC SPECIAL ”DROBETA” (ȘCOALA ENERGETICĂ)",6,"MUNICIPIUL DROBETA-TURNU SEVERIN",109773,1,PART,PRCNCT,PRSD,PRSD_SV,"2025-05-18 21:55:40",1222,585,541,44,0,570,15,1300,715,253,317
27,MEHEDINŢI,"LICEUL TEHNOLOGIC SPECIAL ”DROBETA” (ȘCOALA ENERGETICĂ)",7,"MUNICIPIUL DROBETA-TURNU SEVERIN",109773,1,PART,PRCNCT,PRSD,PRSD_SV,"2025-05-18 21:32:11",963,422,389,33,0,418,4,1000,578,187,231
27,MEHEDINŢI,"S.C. TRANSPORT PUBLIC URBAN ”DROBETA” S.A. (AUTOGARĂ)",8,"MUNICIPIUL DROBETA-TURNU SEVERIN",109773,1,PART,PRCNCT,PRSD,PRSD_SV,"2025-05-18 21:45:21",1276,560,483,77,0,553,7,1400,840,294,259
27,MEHEDINŢI,"ȘCOALA GIMNAZIALĂ ”CONSTANTIN NEGREANU” (ȘCOALA GENERALĂ NR.9)",9,"MUNICIPIUL DROBETA-TURNU SEVERIN",109773,1,PART,PRCNCT,PRSD,PRSD_SV,"2025-05-18 22:09:08",1346,685,593,92,0,674,11,1400,715,345,329
27,MEHEDINŢI,"ȘCOALA GIMNAZIALĂ ”CONSTANTIN NEGREANU” (ȘCOALA GENERALĂ NR.9)",10,"MUNICIPIUL DROBETA-TURNU SEVERIN",109773,1,PART,PRCNCT,PRSD,PRSD_SV,"2025-05-18 22:59:13",1237,560,498,60,2,553,7,1300,740,279,274
27,MEHEDINŢI,"ȘCOALA GIMNAZIALĂ ”CONSTANTIN NEGREANU” (ȘCOALA GENERALĂ NR.9)",11,"MUNICIPIUL DROBETA-TURNU SEVERIN",109773,1,PART,PRCNCT,PRSD,PRSD_SV,"2025-05-18 21:52:38",1547,557,525,32,0,549,8,1700,1143,353,196
27,MEHEDINŢI,"PRIMARIA MUNICIPIULUI DROBETA-TURNU SEVERIN CENTRUL EXPOZIȚIONAL (PĂDUREA CRIHALA) DPITC",12,"MUNICIPIUL DROBETA-TURNU SEVERIN",109773,1,PART,PRCNCT,PRSD,PRSD_SV,"2025-05-18 21:52:25",1526,630,585,45,0,617,13,1600,970,353,264
27,MEHEDINŢI,"PRIMARIA MUNICIPIULUI DROBETA-TURNU SEVERIN CENTRUL EXPOZIȚIONAL (PĂDUREA CRIHALA) DPITC",13,"MUNICIPIUL DROBETA-TURNU SEVERIN",109773,1,PART,PRCNCT,PRSD,PRSD_SV,"2025-05-18 21:47:57",1390,578,536,42,0,572,6,1500,922,293,279
27,MEHEDINŢI,"COLEGIUL NAȚIONAL ”GHEORGHE ȚIȚEICA”",14,"MUNICIPIUL DROBETA-TURNU SEVERIN",109773,1,PART,PRCNCT,PRSD,PRSD_SV,"2025-05-18 22:03:48",1066,500,436,64,0,489,11,1100,600,222,267
27,MEHEDINŢI,"COLEGIUL NAȚIONAL ”GHEORGHE ȚIȚEICA”",15,"MUNICIPIUL DROBETA-TURNU SEVERIN",109773,1,PART,PRCNCT,PRSD,PRSD_SV,"2025-05-18 22:09:54",1074,497,452,42,3,491,6,1100,603,222,269
27,MEHEDINŢI,"COLEGIUL NAȚIONAL ECONOMIC ”THEODOR COSTESCU”",16,"MUNICIPIUL DROBETA-TURNU SEVERIN",109773,1,PART,PRCNCT,PRSD,PRSD_SV,"2025-05-18 22:04:46",963,464,406,56,2,454,10,1000,536,184,270
27,MEHEDINŢI,"GRĂDINIȚA CU PROGRAM PRELUNGIT NR. 22",17,"MUNICIPIUL DROBETA-TURNU SEVERIN",109773,1,PART,PRCNCT,PRSD,PRSD_SV,"2025-05-18 21:51:54",1035,389,335,54,0,381,8,1100,711,261,120
27,MEHEDINŢI,"ȘCOALA GIMNAZIALĂ NR. 14",18,"MUNICIPIUL DROBETA-TURNU SEVERIN",109773,1,PART,PRCNCT,PRSD,PRSD_SV,"2025-05-18 21:28:49",937,432,358,74,0,422,10,1000,568,233,189
27,MEHEDINŢI,"ȘCOALA GIMNAZIALĂ NR. 14",19,"MUNICIPIUL DROBETA-TURNU SEVERIN",109773,1,PART,PRCNCT,PRSD,PRSD_SV,"2025-05-18 21:36:40",1263,526,497,29,0,514,12,1300,774,337,177
27,MEHEDINŢI,"ASOCIATIA LIGA ”SOLIDARITATEA” A PENSIONARILOR",20,"MUNICIPIUL DROBETA-TURNU SEVERIN",109773,1,PART,PRCNCT,PRSD,PRSD_SV,"2025-05-18 21:33:44",1083,517,478,39,0,505,12,1200,683,266,239
27,MEHEDINŢI,"ȘCOALA GIMNAZIALĂ NR. 11",21,"MUNICIPIUL DROBETA-TURNU SEVERIN",109773,1,PART,PRCNCT,PRSD,PRSD_SV,"2025-05-18 21:53:30",1443,649,590,59,0,634,15,1500,851,331,303
27,MEHEDINŢI,"ȘCOALA GIMNAZIALĂ NR. 11",22,"MUNICIPIUL DROBETA-TURNU SEVERIN",109773,1,PART,PRCNCT,PRSD,PRSD_SV,"2025-05-18 21:38:21",1173,532,483,49,0,528,4,2000,1468,254,274
27,MEHEDINŢI,"MINISTERUL SĂNĂTĂȚII - SERVICIUL JUDEȚEAN DE AMBULANȚĂ - SPAȚIU ADMINISTRATIV",23,"MUNICIPIUL DROBETA-TURNU SEVERIN",109773,1,PART,PRCNCT,PRSD,PRSD_SV,"2025-05-18 22:01:58",1375,640,592,48,0,628,12,1500,860,281,347
27,MEHEDINŢI,"DIRECȚIA GENERALĂ DE ASISTENȚĂ ȘI PROTECȚIA COPILULUI MEHEDINȚI",24,"MUNICIPIUL DROBETA-TURNU SEVERIN",109773,1,PART,PRCNCT,PRSD,PRSD_SV,"2025-05-18 22:16:14",1537,741,611,45,85,728,13,1600,859,407,321
27,MEHEDINŢI,"DIRECȚIA GENERALĂ DE ASISTENȚĂ ȘI PROTECȚIA COPILULUI MEHEDINȚI",25,"MUNICIPIUL DROBETA-TURNU SEVERIN",109773,1,PART,PRCNCT,PRSD,PRSD_SV,"2025-05-18 21:48:06",1360,605,486,57,62,595,10,1400,795,317,278
27,MEHEDINŢI,"GRĂDINIȚA CU PROGRAM PRELUNGIT NR.20",26,"MUNICIPIUL DROBETA-TURNU SEVERIN",109773,1,PART,PRCNCT,PRSD,PRSD_SV,"2025-05-18 22:23:01",1703,856,787,69,0,841,15,1800,944,471,370
27,MEHEDINŢI,"COLEGIUL TEHNIC ”DOMNUL TUDOR”",27,"MUNICIPIUL DROBETA-TURNU SEVERIN",109773,1,PART,PRCNCT,PRSD,PRSD_SV,"2025-05-18 21:46:50",816,374,309,65,0,366,8,900,526,179,187
27,MEHEDINŢI,"COLEGIUL TEHNIC ”DOMNUL TUDOR”",28,"MUNICIPIUL DROBETA-TURNU SEVERIN",109773,1,PART,PRCNCT,PRSD,PRSD_SV,"2025-05-18 22:00:42",1047,507,474,30,3,503,4,1100,593,239,264
27,MEHEDINŢI,"COLEGIUL TEHNIC ”DOMNUL TUDOR”",29,"MUNICIPIUL DROBETA-TURNU SEVERIN",109773,1,PART,PRCNCT,PRSD,PRSD_SV,"2025-05-18 21:49:09",1173,527,485,39,3,518,9,1200,673,253,265
27,MEHEDINŢI,"COLEGIUL TEHNIC ”DOMNUL TUDOR”",30,"MUNICIPIUL DROBETA-TURNU SEVERIN",109773,1,PART,PRCNCT,PRSD,PRSD_SV,"2025-05-18 22:08:39",1180,479,454,25,0,472,7,1300,821,223,249
27,MEHEDINŢI,"PRIMĂRIA MUNICIPIULUI DROBETA-TURNU SEVERIN (STADIONUL MUNICIPAL)",31,"MUNICIPIUL DROBETA-TURNU SEVERIN",109773,1,PART,PRCNCT,PRSD,PRSD_SV,"2025-05-18 21:58:19",1272,579,528,49,2,572,7,1400,821,281,291
27,MEHEDINŢI,"COLEGIUL TEHNIC ”LORIN SĂLĂGEAN” (LICEUL INDUSTRIAL NR.4)",32,"MUNICIPIUL DROBETA-TURNU SEVERIN",109773,1,PART,PRCNCT,PRSD,PRSD_SV,"2025-05-18 21:45:48",1066,546,470,76,0,533,13,1100,554,278,255
27,MEHEDINŢI,"GRĂDINIȚA CU PROGRAM PRELUNGIT NR. 3",33,"MUNICIPIUL DROBETA-TURNU SEVERIN",109773,1,PART,PRCNCT,PRSD,PRSD_SV,"2025-05-18 22:20:17",1201,573,531,42,0,564,9,1300,727,246,318
27,MEHEDINŢI,"ȘCOALA GIMNAZIALĂ NR. 6",34,"MUNICIPIUL DROBETA-TURNU SEVERIN",109773,1,PART,PRCNCT,PRSD,PRSD_SV,"2025-05-18 21:57:33",1134,544,484,60,0,529,15,1200,656,268,261
27,MEHEDINŢI,"ȘCOALA GIMNAZIALĂ NR. 6",35,"MUNICIPIUL DROBETA-TURNU SEVERIN",109773,1,PART,PRCNCT,PRSD,PRSD_SV,"2025-05-18 21:38:38",1412,669,587,81,1,655,14,1500,831,303,352
27,MEHEDINŢI,"ȘCOALA GIMNAZIALĂ NR. 6",36,"MUNICIPIUL DROBETA-TURNU SEVERIN",109773,1,PART,PRCNCT,PRSD,PRSD_SV,"2025-05-18 21:47:47",1144,509,458,51,0,500,9,1200,691,235,265
27,MEHEDINŢI,"ȘCOALA GIMNAZIALĂ NR. 6",37,"MUNICIPIUL DROBETA-TURNU SEVERIN",109773,1,PART,PRCNCT,PRSD,PRSD_SV,"2025-05-18 22:08:00",1098,496,462,34,0,483,13,1200,704,252,231
27,MEHEDINŢI,"ȘCOALA GIMNAZIALĂ ”PETRE SERGESCU” (ȘCOALA GENERALĂ NR.4)",38,"MUNICIPIUL DROBETA-TURNU SEVERIN",109773,1,PART,PRCNCT,PRSD,PRSD_SV,"2025-05-18 21:30:32",1214,454,414,40,0,450,4,1300,846,296,154
27,MEHEDINŢI,"ȘCOALA GIMNAZIALĂ ”PETRE SERGESCU” (ȘCOALA GENERALĂ NR.4)",39,"MUNICIPIUL DROBETA-TURNU SEVERIN",109773,1,PART,PRCNCT,PRSD,PRSD_SV,"2025-05-18 21:43:29",1050,483,402,80,1,477,6,1100,617,260,217
27,MEHEDINŢI,"ȘCOALA GIMNAZIALĂ ”PETRE SERGESCU” (ȘCOALA GENERALĂ NR.4)",40,"MUNICIPIUL DROBETA-TURNU SEVERIN",109773,1,PART,PRCNCT,PRSD,PRSD_SV,"2025-05-18 21:34:30",1106,441,414,27,0,435,6,1200,759,259,176
27,MEHEDINŢI,"ȘCOALA GIMNAZIALĂ ”PETRE SERGESCU” (ȘCOALA GENERALĂ NR.4)",41,"MUNICIPIUL DROBETA-TURNU SEVERIN",109773,1,PART,PRCNCT,PRSD,PRSD_SV,"2025-05-18 21:25:04",1143,484,459,25,0,481,3,1200,716,299,182
27,MEHEDINŢI,"ȘCOALA GIMNAZIALĂ ”PETRE SERGESCU” (ȘCOALA GENERALĂ NR.4)",42,"MUNICIPIUL DROBETA-TURNU SEVERIN",109773,1,PART,PRCNCT,PRSD,PRSD_SV,"2025-05-18 21:31:40",1305,592,561,31,0,584,8,1400,808,389,195
27,MEHEDINŢI,"GRĂDINIȚA CU PROGRAM PRELUNGIT NR. 21",43,"MUNICIPIUL DROBETA-TURNU SEVERIN",109773,1,PART,PRCNCT,PRSD,PRSD_SV,"2025-05-18 21:37:10",924,428,379,49,0,420,8,1000,572,225,195
27,MEHEDINŢI,"GRĂDINIȚA CU PROGRAM PRELUNGIT NR. 21",44,"MUNICIPIUL DROBETA-TURNU SEVERIN",109773,1,PART,PRCNCT,PRSD,PRSD_SV,"2025-05-18 21:28:57",1155,483,441,42,0,474,9,1200,717,258,216
27,MEHEDINŢI,"PRIMĂRIA MUNICIPIULUI DROBETA-TURNU SEVERIN (SALA POLIVALENTĂ)",45,"MUNICIPIUL DROBETA-TURNU SEVERIN",109773,2,PART,PRCNCT,PRSD,PRSD_SV,"2025-05-18 22:53:31",1874,919,803,116,0,903,16,2000,1081,386,517
27,MEHEDINŢI,"PRIMĂRIA MUNICIPIULUI DROBETA-TURNU SEVERIN (SALA POLIVALENTĂ)",46,"MUNICIPIUL DROBETA-TURNU SEVERIN",109773,1,PART,PRCNCT,PRSD,PRSD_SV,"2025-05-18 22:17:26",1983,974,915,58,1,966,8,2100,1126,456,510
27,MEHEDINŢI,"ȘCOALA GIMNAZIALĂ ”DIMITRIE GRECESCU” (ȘCOALA GENERALĂ NR.1)",47,"MUNICIPIUL DROBETA-TURNU SEVERIN",109773,1,PART,PRCNCT,PRSD,PRSD_SV,"2025-05-18 22:07:55",1409,1038,701,82,255,1023,15,1500,462,507,516
27,MEHEDINŢI,"COLEGIUL TEHNIC ”DECEBAL”",48,"MUNICIPIUL DROBETA-TURNU SEVERIN",109773,1,PART,PRCNCT,PRSD,PRSD_SV,"2025-05-18 22:07:19",1275,643,574,67,2,634,9,1400,757,248,386
27,MEHEDINŢI,"ȘCOALA GIMNAZIALĂ NR.3",49,"MUNICIPIUL DROBETA-TURNU SEVERIN",109773,1,PART,PRCNCT,PRSD,PRSD_SV,"2025-05-18 21:34:14",1308,686,630,55,1,677,9,1400,714,305,372
27,MEHEDINŢI,"ȘCOALA GIMNAZIALĂ ”ALICE VOINESCU” (ȘCOALA GENERALĂ NR.2)",50,"MUNICIPIUL DROBETA-TURNU SEVERIN",109773,1,PART,PRCNCT,PRSD,PRSD_SV,"2025-05-18 22:25:22",1302,760,650,108,2,745,15,1400,640,302,443
27,MEHEDINŢI,"ȘCOALA GIMNAZIALĂ NR.15 (FOSTA ȘCOALĂ GENERALĂ NR.8)",51,"MUNICIPIUL DROBETA-TURNU SEVERIN",109773,1,PART,PRCNCT,PRSD,PRSD_SV,"2025-05-18 22:21:12",955,513,444,68,1,506,7,1000,487,236,270
27,MEHEDINŢI,"ȘCOALA GIMNAZIALĂ NR.15 (FOSTA ȘCOALĂ GENERALĂ NR.8)",52,"MUNICIPIUL DROBETA-TURNU SEVERIN",109773,2,PART,PRCNCT,PRSD,PRSD_SV,"2025-05-18 22:31:54",1762,867,829,36,2,853,14,1700,833,380,473
27,MEHEDINŢI,"ȘCOALA GIMNAZIALĂ ”TEODOR COSTESCU” ( ȘCOALA GENERALĂ NR.7)",53,"MUNICIPIUL DROBETA-TURNU SEVERIN",109773,1,PART,PRCNCT,PRSD,PRSD_SV,"2025-05-18 21:55:42",1697,707,636,71,0,701,6,1800,1093,359,342
27,MEHEDINŢI,"ȘCOALA GIMNAZIALĂ ”TEODOR COSTESCU” ( ȘCOALA GENERALĂ NR.7)",54,"MUNICIPIUL DROBETA-TURNU SEVERIN",109773,1,PART,PRCNCT,PRSD,PRSD_SV,"2025-05-18 21:53:05",1626,756,684,72,0,742,14,1700,944,370,372
27,MEHEDINŢI,"ȘCOALA GIMNAZIALĂ ”TEODOR COSTESCU” ( ȘCOALA GENERALĂ NR.7)",55,"MUNICIPIUL DROBETA-TURNU SEVERIN",109773,1,PART,PRCNCT,PRSD,PRSD_SV,"2025-05-18 22:02:46",1695,681,642,39,0,668,13,1800,1119,359,309
27,MEHEDINŢI,"ȘCOALA GIMNAZIALĂ ”TEODOR COSTESCU” (ȘCOALA GENERALĂ NR.7)",56,"MUNICIPIUL DROBETA-TURNU SEVERIN",109773,1,PART,PRCNCT,PRSD,PRSD_SV,"2025-05-18 21:55:32",1488,631,608,23,0,617,14,1600,969,346,271
27,MEHEDINŢI,"ȘCOALA GIMNAZIALĂ NR.15",57,"MUNICIPIUL DROBETA-TURNU SEVERIN",109773,1,PART,PRCNCT,PRSD,PRSD_SV,"2025-05-18 21:20:54",1220,514,447,67,0,506,8,1300,786,302,204
27,MEHEDINŢI,"ȘCOALA GIMNAZIALĂ NR.15",58,"MUNICIPIUL DROBETA-TURNU SEVERIN",109773,1,PART,PRCNCT,PRSD,PRSD_SV,"2025-05-18 21:42:48",942,438,405,33,0,433,5,1000,562,231,202
27,MEHEDINŢI,"ȘCOALA GIMNAZIALĂ NR.15",59,"MUNICIPIUL DROBETA-TURNU SEVERIN",109773,2,PART,PRCNCT,PRSD,PRSD_SV,"2025-05-18 22:50:00",1268,525,487,36,2,517,8,1300,775,265,252
27,MEHEDINŢI,"ȘCOALA GIMNAZIALĂ NR.15",60,"MUNICIPIUL DROBETA-TURNU SEVERIN",109773,1,PART,PRCNCT,PRSD,PRSD_SV,"2025-05-18 21:27:15",1624,723,691,29,3,713,10,1700,977,367,346
27,MEHEDINŢI,"GRĂDINIȚA CU PROGRAM PRELUNGIT NR.15",61,"MUNICIPIUL DROBETA-TURNU SEVERIN",109773,1,PART,PRCNCT,PRSD,PRSD_SV,"2025-05-18 21:50:06",998,519,481,38,0,512,7,1100,581,285,227
27,MEHEDINŢI,"GRĂDINIȚA CU PROGRAM PRELUNGIT NR.15",62,"MUNICIPIUL DROBETA-TURNU SEVERIN",109773,1,PART,PRCNCT,PRSD,PRSD_SV,"2025-05-18 21:46:52",1263,580,532,48,0,569,11,1300,720,333,236
27,MEHEDINŢI,"GRĂDINIȚA CU PROGRAM PRELUNGIT NR.15",63,"MUNICIPIUL DROBETA-TURNU SEVERIN",109773,1,PART,PRCNCT,PRSD,PRSD_SV,"2025-05-18 21:22:21",1569,490,465,25,0,486,4,1700,1210,378,108
27,MEHEDINŢI,"ȘCOALA GIMNAZIALĂ NR.5",64,"MUNICIPIUL DROBETA-TURNU SEVERIN",109773,1,PART,PRCNCT,PRSD,PRSD_SV,"2025-05-18 22:04:37",1620,810,760,50,0,793,17,1700,890,519,274
27,MEHEDINŢI,"ȘCOALA GIMNAZIALĂ ”DIMITRIE GRECESCU” (ȘCOALA GENERALĂ NR.15 GURA VĂII)",65,"MUNICIPIUL DROBETA-TURNU SEVERIN",109773,1,PART,PRCNCT,PRSD,PRSD_SV,"2025-05-18 21:41:24",1392,570,506,45,19,556,14,1500,930,320,236
27,MEHEDINŢI,"ȘCOALA CU CLASELE I-VIII PETRU DUMITRIU SUD",66,"MUNICIPIUL ORŞOVA",110063,1,PART,PRCNCT,PRSD,PRSD_SV,"2025-05-18 22:05:21",1474,721,623,98,0,714,7,1600,879,354,360
27,MEHEDINŢI,"LICEUL TRAIAN LALESCU",67,"MUNICIPIUL ORŞOVA",110063,1,PART,PRCNCT,PRSD,PRSD_SV,"2025-05-18 21:50:39",957,370,301,69,0,366,4,1000,630,241,125
27,MEHEDINŢI,"LICEUL TRAIAN LALESCU",68,"MUNICIPIUL ORŞOVA",110063,1,PART,PRCNCT,PRSD,PRSD_SV,"2025-05-18 21:31:13",1125,510,380,97,33,500,10,1200,690,309,191
27,MEHEDINŢI,"CLUBUL COPIILOR",69,"MUNICIPIUL ORŞOVA",110063,1,PART,PRCNCT,PRSD,PRSD_SV,"2025-05-18 22:00:19",894,390,340,50,0,385,5,1000,610,213,172
27,MEHEDINŢI,"CLUBUL COPIILOR",70,"MUNICIPIUL ORŞOVA",110063,1,PART,PRCNCT,PRSD,PRSD_SV,"2025-05-18 22:08:22",1151,469,435,34,0,468,1,1200,731,332,136
27,MEHEDINŢI,"COLEGIUL TEHNIC DIERNA",71,"MUNICIPIUL ORŞOVA",110063,1,PART,PRCNCT,PRSD,PRSD_SV,"2025-05-18 21:42:20",1327,618,497,121,0,603,15,1400,782,327,276
27,MEHEDINŢI,"ȘCOALA GENERALĂ I-VIII NUMĂRUL 1 NORD",72,"MUNICIPIUL ORŞOVA",110063,2,PART,PRCNCT,PRSD,PRSD_SV,"2025-05-19 01:40:21",1152,564,436,126,2,553,9,1200,636,285,268
27,MEHEDINŢI,"GRĂDINIŢA NUMĂRUL 3",73,"MUNICIPIUL ORŞOVA",110063,1,PART,PRCNCT,PRSD,PRSD_SV,"2025-05-18 22:15:45",1396,673,612,61,0,663,10,1500,827,391,272
27,MEHEDINŢI,"GRĂDINIŢA CORAMNIC",74,"MUNICIPIUL ORŞOVA",110063,1,PART,PRCNCT,PRSD,PRSD_SV,"2025-05-18 21:36:55",311,218,143,75,0,215,3,400,182,148,67
27,MEHEDINŢI,"ȘCOALA GENERALĂ BAIA DE ARAMĂ",75,"ORAŞ BAIA DE ARAMĂ",109924,1,PART,PRCNCT,PRSD,PRSD_SV,"2025-05-18 22:00:13",1185,586,472,114,0,576,10,1300,714,375,201
27,MEHEDINŢI,"GRUPUL ŞCOLAR CONSTANTIN BRÂNCOVEANU",76,"ORAŞ BAIA DE ARAMĂ",109924,1,PART,PRCNCT,PRSD,PRSD_SV,"2025-05-18 21:50:59",1167,579,480,97,2,573,6,1200,621,394,179
27,MEHEDINŢI,"ŞCOALA GENERALĂ MĂRĂŞEŞTI",77,"ORAŞ BAIA DE ARAMĂ",109924,1,PART,PRCNCT,PRSD,PRSD_SV,"2025-05-18 22:30:11",1036,519,481,38,0,515,4,1100,581,350,165
27,MEHEDINŢI,"ŞCOALA GENERALĂ NEGOEŞTI",78,"ORAŞ BAIA DE ARAMĂ",109924,1,PART,PRCNCT,PRSD,PRSD_SV,"2025-05-18 22:00:51",647,338,278,60,0,334,4,700,362,238,96
27,MEHEDINŢI,"ŞCOALA GENERALĂ TITERLEŞTI",79,"ORAŞ BAIA DE ARAMĂ",109924,1,PART,PRCNCT,PRSD,PRSD_SV,"2025-05-18 21:48:37",377,217,185,32,0,214,3,405,188,129,85
27,MEHEDINŢI,"LICEUL TEHNOLOGIC MATEI BASARAB",80,"ORAŞ STREHAIA",110116,1,PART,PRCNCT,PRSD,PRSD_SV,"2025-05-18 22:13:25",1703,677,588,89,0,668,9,1800,1123,508,160
27,MEHEDINŢI,"GRĂDINIŢA 2",81,"ORAŞ STREHAIA",110116,1,PART,PRCNCT,PRSD,PRSD_SV,"2025-05-18 21:54:38",1436,607,572,32,3,602,5,1500,893,395,207
27,MEHEDINŢI,"ŞCOALA GENERALĂ STREHAIA",82,"ORAŞ STREHAIA",110116,1,PART,PRCNCT,PRSD,PRSD_SV,"2025-05-18 22:04:19",1315,654,519,126,9,648,6,1400,746,374,274
27,MEHEDINŢI,"GRĂDINIŢA VEST STREHAIA",83,"ORAŞ STREHAIA",110116,1,PART,PRCNCT,PRSD,PRSD_SV,"2025-05-18 21:53:56",1318,660,596,47,17,655,5,1400,740,404,251
27,MEHEDINŢI,"ŞCOALA GENERALĂ CIOCHIUŢA",84,"ORAŞ STREHAIA",110116,1,PART,PRCNCT,PRSD,PRSD_SV,"2025-05-18 21:46:44",715,373,323,50,0,371,2,800,427,259,112
27,MEHEDINŢI,"ŞCOALA GENERALĂ COMANDA",85,"ORAŞ STREHAIA",110116,1,PART,PRCNCT,PRSD,PRSD_SV,"2025-05-18 21:40:06",1236,490,455,35,0,486,4,1300,810,371,115
27,MEHEDINŢI,"ŞCOALA GENERALĂ HURDUCEŞTI",86,"ORAŞ STREHAIA",110116,1,PART,PRCNCT,PRSD,PRSD_SV,"2025-05-18 21:25:52",205,124,114,10,0,123,1,300,176,96,27
27,MEHEDINŢI,"ŞCOALA GENERALĂ LUNCA BANULUI",87,"ORAŞ STREHAIA",110116,1,PART,PRCNCT,PRSD,PRSD_SV,"2025-05-18 21:46:17",367,202,155,47,0,201,1,400,198,116,85
27,MEHEDINŢI,"ŞCOALA GENERALĂ SLĂTINICUL MARE",88,"ORAŞ STREHAIA",110116,1,PART,PRCNCT,PRSD,PRSD_SV,"2025-05-18 21:29:10",255,150,126,24,0,149,1,300,150,116,33
27,MEHEDINŢI,"ŞCOALA GENERALĂ STĂNCEŞTI",89,"ORAŞ STREHAIA",110116,1,PART,PRCNCT,PRSD,PRSD_SV,"2025-05-18 21:24:04",140,87,65,22,0,86,1,200,113,55,31
27,MEHEDINŢI,"LICEUL TEORETIC VÎNJU MARE",90,"ORAŞ VÂNJU MARE",110232,1,PART,PRCNCT,PRSD,PRSD_SV,"2025-05-18 22:25:01",1149,611,464,144,3,604,7,1200,589,337,267
27,MEHEDINŢI,"ŞCOALA GENERALĂ I-VIII VÎNJU MARE",91,"ORAŞ VÂNJU MARE",110232,1,PART,PRCNCT,PRSD,PRSD_SV,"2025-05-18 22:24:50",1597,663,590,72,1,656,7,1700,1037,339,317
27,MEHEDINŢI,"GRADINIŢA BUCURA",92,"ORAŞ VÂNJU MARE",110232,1,PART,PRCNCT,PRSD,PRSD_SV,"2025-05-18 21:15:40",279,160,139,21,0,160,0,400,240,93,67
27,MEHEDINŢI,"ŞCOALA GENERALĂ I-IV NICOLAE BĂLCESCU",93,"ORAŞ VÂNJU MARE",110232,1,PART,PRCNCT,PRSD,PRSD_SV,"2025-05-18 21:22:39",585,276,230,46,0,271,5,700,424,190,81
27,MEHEDINŢI,"CĂMINUL CULTURAL OREVIŢA MARE",94,"ORAŞ VÂNJU MARE",110232,2,PART,PRCNCT,PRSD,PRSD_SV,"2025-05-19 01:44:04",570,272,217,54,1,268,4,600,328,164,104
27,MEHEDINŢI,"ŞCOALA GIMNAZIALĂ VÎNJU MARE, GRĂDINIŢA CU PROGRAM NORMAL TRAIAN",95,"ORAŞ VÂNJU MARE",110232,1,PART,PRCNCT,PRSD,PRSD_SV,"2025-05-18 21:57:10",473,214,179,35,0,213,1,500,286,146,67
27,MEHEDINŢI,"CĂMINUL CULTURAL BALA",96,BALA,110296,1,PART,PRCNCT,PRSD,PRSD_SV,"2025-05-18 22:28:56",683,480,320,160,0,472,8,800,320,288,184
27,MEHEDINŢI,"ȘCOALA GENERALĂ I-IV BALA DE SUS",97,BALA,110296,1,PART,PRCNCT,PRSD,PRSD_SV,"2025-05-18 21:18:23",470,263,224,39,0,263,0,500,237,193,70
27,MEHEDINŢI,"ȘCOALA GENERALĂ I-IV BRATEŞUL",98,BALA,110296,1,PART,PRCNCT,PRSD,PRSD_SV,"2025-05-18 21:13:15",99,55,44,11,0,55,0,200,145,37,18
27,MEHEDINŢI,"ŞCOALA GENERALĂ I-IV COMĂNEŞTI",99,BALA,110296,1,PART,PRCNCT,PRSD,PRSD_SV,"2025-05-18 21:25:20",295,169,131,38,0,169,0,400,231,124,45
27,MEHEDINŢI,"ȘCOALA GENERALĂ I-VIII CRAINICI",100,BALA,110296,1,PART,PRCNCT,PRSD,PRSD_SV,"2025-05-18 21:18:51",295,185,152,33,0,184,1,400,215,111,73
27,MEHEDINŢI,"ȘCOALA GENERALĂ I-VIII DÎLMA",101,BALA,110296,1,PART,PRCNCT,PRSD,PRSD_SV,"2025-05-18 21:29:42",298,148,116,32,0,147,1,400,252,105,42
27,MEHEDINŢI,"ȘCOALA GENERALĂ I-IV IUPCA",102,BALA,110296,1,PART,PRCNCT,PRSD,PRSD_SV,"2025-05-18 21:18:10",134,75,60,15,0,75,0,200,125,41,34
27,MEHEDINŢI,"ȘCOALA GENERALĂ I-IV RUDINA",103,BALA,110296,1,PART,PRCNCT,PRSD,PRSD_SV,"2025-05-18 21:26:34",350,174,133,41,0,173,1,400,226,125,48
27,MEHEDINŢI,"ȘCOALA GENERALĂ I-IV SĂRDĂNEŞTI",104,BALA,110296,1,PART,PRCNCT,PRSD,PRSD_SV,"2025-05-18 21:21:07",177,95,77,18,0,95,0,200,105,59,36
27,MEHEDINŢI,"ȘCOALA GENERALĂ I-IV VIDIMIREŞTI",105,BALA,110296,1,PART,PRCNCT,PRSD,PRSD_SV,"2025-05-18 21:17:18",109,78,54,24,0,78,0,200,122,51,27
27,MEHEDINŢI,"CĂMINUL CULTURAL BALTA",106,BALTA,110456,1,PART,PRCNCT,PRSD,PRSD_SV,"2025-05-18 22:06:23",291,251,152,97,2,246,5,350,99,127,119
27,MEHEDINŢI,"CĂMINUL CULTURAL COSTEŞTI",107,BALTA,110456,1,PART,PRCNCT,PRSD,PRSD_SV,"2025-05-18 21:59:09",115,182,69,113,0,175,7,249,67,52,123
27,MEHEDINŢI,"CĂMINUL CULTURAL GORNOVIŢA",108,BALTA,110456,1,PART,PRCNCT,PRSD,PRSD_SV,"2025-05-18 21:34:37",140,121,79,40,2,121,0,200,79,64,57
27,MEHEDINŢI,"CĂMINUL CULTURAL PREJNA",109,BALTA,110456,1,PART,PRCNCT,PRSD,PRSD_SV,"2025-05-18 22:12:02",205,183,114,65,4,181,2,298,115,98,83
27,MEHEDINŢI,"ŞCOALA GIMNAZIALĂ BĂLĂCIŢA",110,BĂLĂCIŢA,110535,1,PART,PRCNCT,PRSD,PRSD_SV,"2025-05-18 21:42:18",962,395,327,68,0,395,0,1000,605,277,118
27,MEHEDINŢI,"ŞCOALA PRIMARĂ DOBRA",111,BĂLĂCIŢA,110535,1,PART,PRCNCT,PRSD,PRSD_SV,"2025-05-18 21:26:58",321,163,127,36,0,162,1,400,237,92,70
27,MEHEDINŢI,"ŞCOALA GIMNAZIALĂ GVARDINIŢA",112,BĂLĂCIŢA,110535,1,PART,PRCNCT,PRSD,PRSD_SV,"2025-05-18 21:35:18",685,339,260,79,0,338,1,800,461,213,125
27,MEHEDINŢI,"ȘCOALA GENERALĂ I-VIII BÎCLEȘ",113,BÂCLEŞ,110571,1,PART,PRCNCT,PRSD,PRSD_SV,"2025-05-18 21:32:47",435,386,212,112,62,384,2,499,113,151,233
27,MEHEDINŢI,"ȘCOALA GENERALĂ I-IV CORZU",114,BÂCLEŞ,110571,1,PART,PRCNCT,PRSD,PRSD_SV,"2025-05-18 22:02:44",311,259,168,54,37,257,2,400,141,114,143
27,MEHEDINŢI,"ȘCOALA GENERALĂ I-IV PETRA",115,BÂCLEŞ,110571,1,PART,PRCNCT,PRSD,PRSD_SV,"2025-05-18 21:25:21",117,118,45,38,35,117,1,200,82,38,79
27,MEHEDINŢI,"ȘCOALA GENERALĂ I-IV PODU GROSULUI",116,BÂCLEŞ,110571,1,PART,PRCNCT,PRSD,PRSD_SV,"2025-05-18 21:18:26",140,116,78,28,10,116,0,200,84,29,87
27,MEHEDINŢI,"ȘCOALA GENERALĂ I-IV SMADOVIŢA",117,BÂCLEŞ,110571,1,PART,PRCNCT,PRSD,PRSD_SV,"2025-05-18 21:31:43",308,283,144,77,62,280,3,400,117,102,178
27,MEHEDINŢI,"PRIMĂRIA BÎLVĂNEŞTI",118,BÂLVĂNEŞTI,110688,1,PART,PRCNCT,PRSD,PRSD_SV,"2025-05-18 22:27:02",714,478,350,128,0,473,5,800,322,291,182
27,MEHEDINŢI,"ȘCOALA GIMNAZIALĂ BRANIȘTEA",119,BRANIŞTEA,114060,1,PART,PRCNCT,PRSD,PRSD_SV,"2025-05-18 21:43:18",1026,580,491,89,0,575,5,1100,520,337,238
27,MEHEDINŢI,"ȘCOALA GENERALĂ I-IV GOANŢA",120,BRANIŞTEA,114060,1,PART,PRCNCT,PRSD,PRSD_SV,"2025-05-18 21:25:53",364,218,178,40,0,218,0,400,182,98,120
27,MEHEDINŢI,"CĂMIN CULTURAL BREZNITA-MOTRU",121,BREZNIŢA-MOTRU,110740,1,PART,PRCNCT,PRSD,PRSD_SV,"2025-05-18 21:36:18",765,440,352,73,15,433,7,700,260,274,159
27,MEHEDINŢI,"ŞCOALA GENERALĂ I-VIII FĂUROAIA",122,BREZNIŢA-MOTRU,110740,1,PART,PRCNCT,PRSD,PRSD_SV,"2025-05-18 21:25:00",243,166,109,52,5,163,3,299,133,91,72
27,MEHEDINŢI,"ŞCOALA GENERALĂ I-VIII BREZNIŢA OCOL",123,BREZNIŢA-OCOL,110820,1,PART,PRCNCT,PRSD,PRSD_SV,"2025-05-18 21:52:26",1455,647,606,41,0,635,12,1600,953,496,139
27,MEHEDINŢI,"ŞCOALA GENERALĂ I-IV JIDOŞTIŢA",124,BREZNIŢA-OCOL,110820,1,PART,PRCNCT,PRSD,PRSD_SV,"2025-05-18 21:41:11",882,428,351,77,0,422,6,1000,572,323,99
27,MEHEDINŢI,"ŞCOALA GENERALĂ I-IV MAGHERU",125,BREZNIŢA-OCOL,110820,1,PART,PRCNCT,PRSD,PRSD_SV,"2025-05-18 21:32:35",910,451,402,49,0,449,2,1000,549,334,115
27,MEHEDINŢI,"CĂMIN CULTURAL BROŞTENI",126,BROŞTENI,110875,1,PART,PRCNCT,PRSD,PRSD_SV,"2025-05-18 21:38:07",1207,1003,617,385,1,995,8,1300,297,675,320
27,MEHEDINŢI,"CENTRUL TURISTIC PENTRU ACTIVITĂȚI CULTURALE SI SPORTIVE",127,BROŞTENI,110875,1,PART,PRCNCT,PRSD,PRSD_SV,"2025-05-18 21:56:21",1051,661,560,99,2,648,13,1100,439,468,180
27,MEHEDINŢI,"ȘCOALA GENERALĂ BURILA MARE",128,"BURILA MARE",110946,1,PART,PRCNCT,PRSD,PRSD_SV,"2025-05-18 21:41:02",560,346,259,81,6,330,16,600,254,240,90
27,MEHEDINŢI,"ȘCOALA GENERALĂ CRIVINA",129,"BURILA MARE",110946,1,PART,PRCNCT,PRSD,PRSD_SV,"2025-05-18 21:32:01",508,324,218,102,4,320,4,600,276,188,132
27,MEHEDINŢI,"ȘCOALA GENERALĂ IZVORU FRUMOS",130,"BURILA MARE",110946,1,PART,PRCNCT,PRSD,PRSD_SV,"2025-05-18 21:19:43",161,101,51,46,4,100,1,200,99,59,41
27,MEHEDINŢI,"ȘCOALA GENERALĂ ŢIGĂNAŞI",131,"BURILA MARE",110946,1,PART,PRCNCT,PRSD,PRSD_SV,"2025-05-18 21:45:46",243,184,113,71,0,181,3,300,116,114,67
27,MEHEDINŢI,"ȘCOALA VECHE VRANCEA",132,"BURILA MARE",110946,1,PART,PRCNCT,PRSD,PRSD_SV,"2025-05-18 21:45:19",177,275,81,187,7,274,1,400,125,108,166
27,MEHEDINŢI,"PRIMĂRIA BUTOIEŞTI",133,BUTOIEŞTI,111006,1,PART,PRCNCT,PRSD,PRSD_SV,"2025-05-18 21:43:56",544,360,250,110,0,356,4,600,240,211,145
27,MEHEDINŢI,"ŞCOALA GENERALĂ I-IV ARGINEŞTI",134,BUTOIEŞTI,111006,1,PART,PRCNCT,PRSD,PRSD_SV,"2025-05-18 21:39:18",460,282,236,45,1,280,2,500,218,213,67
27,MEHEDINŢI,"ŞCOALA GENERALĂ I-IV BUICEŞTI",135,BUTOIEŞTI,111006,1,PART,PRCNCT,PRSD,PRSD_SV,"2025-05-18 21:29:28",394,244,190,54,0,241,3,500,256,152,89
27,MEHEDINŢI,"ŞCOALA GENERALĂ I-IV GURA MOTRULUI",136,BUTOIEŞTI,111006,1,PART,PRCNCT,PRSD,PRSD_SV,"2025-05-18 21:32:54",227,153,115,38,0,149,4,300,147,104,45
27,MEHEDINŢI,"ȘCOALA GENERALA I-IV JUGASTRU",137,BUTOIEŞTI,111006,1,PART,PRCNCT,PRSD,PRSD_SV,"2025-05-18 21:25:00",276,149,113,36,0,149,0,300,151,126,23
27,MEHEDINŢI,"ŞCOALA GENERALĂ I-IV PLUTA",138,BUTOIEŞTI,111006,1,PART,PRCNCT,PRSD,PRSD_SV,"2025-05-18 21:26:26",305,178,137,41,0,174,4,400,222,120,54
27,MEHEDINŢI,"ŞCOALA GENERALĂ I-IV ŢÎNŢARU",139,BUTOIEŞTI,111006,1,PART,PRCNCT,PRSD,PRSD_SV,"2025-05-18 21:38:47",315,197,153,44,0,197,0,400,203,147,50
27,MEHEDINŢI,"SCOALA GENERALĂ I-IV CĂZĂNEŞTI",140,CĂZĂNEŞTI,111097,1,PART,PRCNCT,PRSD,PRSD_SV,"2025-05-18 21:42:20",740,445,311,133,1,440,5,800,355,332,108
27,MEHEDINŢI,"SCOALA GENERALĂ I-IV SEVERINEŞTI",141,CĂZĂNEŞTI,111097,1,PART,PRCNCT,PRSD,PRSD_SV,"2025-05-18 21:32:46",953,576,429,147,0,563,13,1000,424,409,154
27,MEHEDINŢI,"CĂMINUL CULTURAL CIREŞU",142,CIREŞU,111220,1,PART,PRCNCT,PRSD,PRSD_SV,"2025-05-18 21:40:38",384,304,184,116,4,297,7,500,196,150,147
27,MEHEDINŢI,"CĂMINUL CULTURAL CORCOVA",143,CORCOVA,111275,1,PART,PRCNCT,PRSD,PRSD_SV,"2025-05-18 21:55:52",973,520,449,71,0,511,9,1000,480,319,192
27,MEHEDINŢI,"ŞCOALA GENERALĂ CERNAIA",144,CORCOVA,111275,1,PART,PRCNCT,PRSD,PRSD_SV,"2025-05-18 21:32:01",380,209,175,34,0,208,1,500,291,140,68
27,MEHEDINŢI,"ŞCOALA GENERALĂ CORDUN",145,CORCOVA,111275,1,PART,PRCNCT,PRSD,PRSD_SV,"2025-05-18 21:34:03",582,232,211,21,0,231,1,700,468,167,64
27,MEHEDINŢI,"ŞCOALA GENERALĂ GÂRBOVĂŢU DE JOS",146,CORCOVA,111275,1,PART,PRCNCT,PRSD,PRSD_SV,"2025-05-18 21:55:55",415,252,204,48,0,252,0,500,248,158,94
27,MEHEDINŢI,"ŞCOALA GENERALĂ IMOASA",147,CORCOVA,111275,1,PART,PRCNCT,PRSD,PRSD_SV,"2025-05-18 21:24:46",323,209,183,23,3,208,1,400,191,144,64
27,MEHEDINŢI,"CĂMINUL CULTURAL JIROV",148,CORCOVA,111275,1,PART,PRCNCT,PRSD,PRSD_SV,"2025-05-18 21:31:59",1219,555,513,42,0,551,4,1300,745,413,138
27,MEHEDINŢI,"ŞCOALA GENERALĂ MĂRU ROŞU",149,CORCOVA,111275,1,PART,PRCNCT,PRSD,PRSD_SV,"2025-05-18 21:22:40",472,264,242,22,0,262,2,500,236,213,49
27,MEHEDINŢI,"ŞCOALA GENERALĂ I-IV STEJARU",150,CORCOVA,111275,1,PART,PRCNCT,PRSD,PRSD_SV,"2025-05-18 21:19:23",464,194,169,25,0,192,2,500,306,139,53
27,MEHEDINŢI,"ȘCOALA PROFESIONALĂ CORLĂŢEL",151,CORLĂŢEL,111417,1,PART,PRCNCT,PRSD,PRSD_SV,"2025-05-18 21:59:46",625,416,329,75,12,408,8,700,284,221,187
27,MEHEDINŢI,"ȘCOALA PROFESIONALĂ VALEA ANILOR",152,CORLĂŢEL,111417,1,PART,PRCNCT,PRSD,PRSD_SV,"2025-05-18 21:26:52",434,206,153,41,12,204,2,500,294,98,106
27,MEHEDINŢI,"CĂMINUL CULTURAL",153,CUJMIR,111444,1,PART,PRCNCT,PRSD,PRSD_SV,"2025-05-18 21:41:30",1021,594,463,124,7,588,6,1100,506,298,290
27,MEHEDINŢI,"CĂMINUL CULTURAL",154,CUJMIR,111444,1,PART,PRCNCT,PRSD,PRSD_SV,"2025-05-18 21:46:48",661,404,319,51,34,401,3,700,296,204,197
27,MEHEDINŢI,"ŞCOALA GENERALĂ AURORA",155,CUJMIR,111444,1,PART,PRCNCT,PRSD,PRSD_SV,"2025-05-18 21:47:57",485,269,217,42,10,268,1,600,331,140,128
27,MEHEDINŢI,"GRĂDINIŢA CUJMIRU MIC",156,CUJMIR,111444,1,PART,PRCNCT,PRSD,PRSD_SV,"2025-05-18 21:36:03",371,229,198,31,0,225,4,400,171,141,84
27,MEHEDINŢI,"CĂMINUL CULTURAL NOU-DÎRVARI",157,DÂRVARI,111550,1,PART,PRCNCT,PRSD,PRSD_SV,"2025-05-18 21:42:27",1089,650,481,128,41,640,10,1200,550,264,376
27,MEHEDINŢI,"CĂMINUL CULTURAL VECHI-GEMENI",158,DÂRVARI,111550,2,PART,PRCNCT,PRSD,PRSD_SV,"2025-05-19 01:23:03",847,455,385,48,22,455,0,900,445,113,342
27,MEHEDINŢI,"ȘCOALA GIMNAZIALĂ DEVESEL",159,DEVESEL,111480,2,PART,PRCNCT,PRSD,PRSD_SV,"2025-05-19 01:27:11",990,737,468,247,22,732,5,1000,263,313,419
27,MEHEDINŢI,"ŞCOALA GENERALA BATOŢI",160,DEVESEL,111480,1,PART,PRCNCT,PRSD,PRSD_SV,"2025-05-18 21:41:38",354,386,181,195,10,383,3,500,114,157,226
27,MEHEDINŢI,"ŞCOALA GENERALĂ BISTREŢU",161,DEVESEL,111480,1,PART,PRCNCT,PRSD,PRSD_SV,"2025-05-18 21:40:19",378,263,153,105,5,255,8,500,237,130,125
27,MEHEDINŢI,"ŞCOALA GENERALĂ SCĂPĂU",162,DEVESEL,111480,1,PART,PRCNCT,PRSD,PRSD_SV,"2025-05-18 22:05:36",691,392,283,86,23,387,5,800,408,152,235
27,MEHEDINŢI,"PRIMĂRIA DUBOVA",163,DUBOVA,112904,1,PART,PRCNCT,PRSD,PRSD_SV,"2025-05-18 21:52:54",434,408,229,170,9,405,3,500,92,215,190
27,MEHEDINŢI,"FOSTA ŞCOALĂ BAIA NOUĂ",164,DUBOVA,112904,1,PART,PRCNCT,PRSD,PRSD_SV,"2025-05-18 21:17:15",149,65,48,16,1,65,0,199,134,20,45
27,MEHEDINŢI,"FOSTA PRIMĂRIE EIBENTHAL",165,DUBOVA,112904,1,PART,PRCNCT,PRSD,PRSD_SV,"2025-05-18 21:35:49",254,143,105,26,12,142,1,300,157,59,83
27,MEHEDINŢI,"CĂMINUL CULTURAL DUMBRAVA DE JOS",166,DUMBRAVA,111587,1,PART,PRCNCT,PRSD,PRSD_SV,"2025-05-18 21:42:33",344,265,170,66,29,260,5,399,134,154,106
27,MEHEDINŢI,"ŞCOALA GENERALĂ ALBULEŞTI",167,DUMBRAVA,111587,1,PART,PRCNCT,PRSD,PRSD_SV,"2025-05-18 21:40:12",424,285,209,45,31,285,0,500,215,99,186
27,MEHEDINŢI,"CĂMINUL CULTURAL ROCŞORENI",168,DUMBRAVA,111587,1,PART,PRCNCT,PRSD,PRSD_SV,"2025-05-18 21:17:24",76,71,27,41,3,69,2,100,29,34,35
27,MEHEDINŢI,"CLĂDIRE FOSTA ŞCOALĂ VALEA MARCULUI",169,DUMBRAVA,111587,1,PART,PRCNCT,PRSD,PRSD_SV,"2025-05-18 21:25:42",89,91,55,31,5,90,1,208,117,35,55
27,MEHEDINŢI,"CLĂDIRE FOSTĂ ŞCOALĂ VLĂDICA",170,DUMBRAVA,111587,1,PART,PRCNCT,PRSD,PRSD_SV,"2025-05-18 21:35:05",46,67,29,35,3,66,1,200,133,32,34
27,MEHEDINŢI,"GRADINITA ESELNITA",171,EŞELNIŢA,112245,1,PART,PRCNCT,PRSD,PRSD_SV,"2025-05-18 22:51:12",1164,638,521,112,5,628,10,1200,562,427,201
27,MEHEDINŢI,"GRADINITA ESELNITA",172,EŞELNIŢA,112245,1,PART,PRCNCT,PRSD,PRSD_SV,"2025-05-18 22:18:15",1236,710,590,117,3,701,9,1300,590,474,227
27,MEHEDINŢI,"ŞCOALA GENERALĂ I-VIII FLOREŞTI",173,FLOREŞTI,111685,1,PART,PRCNCT,PRSD,PRSD_SV,"2025-05-18 21:56:43",1299,739,619,106,14,731,8,1400,661,504,227
27,MEHEDINŢI,"ŞCOALA GENERALĂ I-VIII ZEGUJANI",174,FLOREŞTI,111685,1,PART,PRCNCT,PRSD,PRSD_SV,"2025-05-18 21:48:10",813,511,392,105,14,507,4,900,389,301,206
27,MEHEDINŢI,"CĂMINUL CULTURAL GÂRLA MARE",175,"GÂRLA MARE",111783,1,PART,PRCNCT,PRSD,PRSD_SV,"2025-05-18 21:44:43",1549,580,396,124,60,568,12,1700,1120,230,338
27,MEHEDINŢI,"CĂMINUL CULTURAL GÂRLA MARE",176,"GÂRLA MARE",111783,1,PART,PRCNCT,PRSD,PRSD_SV,"2025-05-18 21:48:45",1137,449,334,73,42,441,8,1200,751,160,281
27,MEHEDINŢI,"PRIMĂRIA GODEANU",177,GODEANU,111818,1,PART,PRCNCT,PRSD,PRSD_SV,"2025-05-18 21:57:37",440,414,227,187,0,409,5,500,86,183,226
27,MEHEDINŢI,"ŞCOALA GENERALĂ CLASELE I-VIII GOGOȘU",178,GOGOŞU,111863,2,PART,PRCNCT,PRSD,PRSD_SV,"2025-05-19 00:18:16",879,411,336,75,0,408,3,1000,589,246,162
27,MEHEDINŢI,"GRĂDINIȚA BALTA VERDE ISJ",179,GOGOŞU,111863,1,PART,PRCNCT,PRSD,PRSD_SV,"2025-05-18 21:43:16",1024,378,284,94,0,374,4,1100,722,311,63
27,MEHEDINŢI,"ŞCOALA GENERALĂ BURILA MICĂ",180,GOGOŞU,111863,1,PART,PRCNCT,PRSD,PRSD_SV,"2025-05-18 21:33:26",798,234,204,30,0,234,0,892,658,204,30
27,MEHEDINŢI,"ŞCOALA GENERALĂ OSTROVU MARE",181,GOGOŞU,111863,1,PART,PRCNCT,PRSD,PRSD_SV,"2025-05-18 21:35:13",577,276,201,75,0,268,8,700,424,168,100
27,MEHEDINŢI,"CĂMINUL CULTURAL GRECI",182,GRECI,111916,1,PART,PRCNCT,PRSD,PRSD_SV,"2025-05-18 22:41:36",438,370,204,142,24,366,4,500,130,208,158
27,MEHEDINŢI,"ŞCOALA GENERALĂ BÎLTANELE",183,GRECI,111916,1,PART,PRCNCT,PRSD,PRSD_SV,"2025-05-18 22:05:18",312,234,144,69,21,231,3,400,166,101,130
27,MEHEDINŢI,"ŞCOALA GENERALĂ SĂLĂTRUC",184,GRECI,111916,1,PART,PRCNCT,PRSD,PRSD_SV,"2025-05-18 21:26:35",156,105,65,33,7,104,1,200,95,66,38
27,MEHEDINŢI,"GRĂDINIŢA CU PROGRAM NORMAL CU DOUĂ SĂLI DE GRUPĂ, SAT GROZEŞTI, COMUNA GROZEŞTI, JUDEŢUL MEHEDINŢI",185,GROZEŞTI,111989,2,PART,PRCNCT,PRSD,PRSD_SV,"2025-05-18 23:49:45",351,210,193,17,0,208,2,400,190,179,29
27,MEHEDINŢI,"ŞCOALA GENERALĂ I-IV CÎRCENI",186,GROZEŞTI,111989,1,PART,PRCNCT,PRSD,PRSD_SV,"2025-05-18 21:26:25",789,326,295,31,0,322,4,900,574,253,69
27,MEHEDINŢI,"CONTAINER MODULAR FIX-CURTEA ŞCOLII GENERALE I-IV ŞUŞIŢA",187,GROZEŞTI,111989,1,PART,PRCNCT,PRSD,PRSD_SV,"2025-05-18 21:17:54",366,206,156,47,3,204,2,400,194,124,80
27,MEHEDINŢI,"CĂMINUL CULTURAL GRUIA",188,GRUIA,112030,1,PART,PRCNCT,PRSD,PRSD_SV,"2025-05-18 21:52:06",619,337,247,90,0,335,2,700,363,204,131
27,MEHEDINŢI,"STADIONUL COMUNAL GRUIA",189,GRUIA,112030,1,PART,PRCNCT,PRSD,PRSD_SV,"2025-05-18 21:20:58",745,238,221,17,0,234,4,800,562,183,51
27,MEHEDINŢI,"CĂMINUL CULTURAL",190,GRUIA,112030,2,PART,PRCNCT,PRSD,PRSD_SV,"2025-05-19 01:19:10",667,374,248,126,0,367,7,700,326,221,146
27,MEHEDINŢI,"ŞCOALA POIANA GRUII",191,GRUIA,112030,1,PART,PRCNCT,PRSD,PRSD_SV,"2025-05-18 21:12:01",107,87,46,41,0,86,1,200,113,50,36
27,MEHEDINŢI,"ŞCOALA GENERALĂ I-VIII HINOVA",192,HINOVA,112076,1,PART,PRCNCT,PRSD,PRSD_SV,"2025-05-18 21:55:05",956,405,322,83,0,402,3,1000,595,257,145
27,MEHEDINŢI,"CĂMINUL CULTURAL BISTRIȚA",193,HINOVA,112076,1,PART,PRCNCT,PRSD,PRSD_SV,"2025-05-18 21:42:20",1144,633,534,97,2,617,16,1200,567,409,208
27,MEHEDINŢI,"CĂMINUL CULTURAL OSTROVU CORBULUI",194,HINOVA,112076,1,PART,PRCNCT,PRSD,PRSD_SV,"2025-05-18 21:56:51",325,265,177,88,0,263,2,400,135,175,88
27,MEHEDINŢI,"ŞCOALA GIMNAZIALĂ HUSNICIOARA-C2",195,HUSNICIOARA,112129,1,PART,PRCNCT,PRSD,PRSD_SV,"2025-05-18 21:38:18",499,372,229,134,9,371,1,599,227,118,253
27,MEHEDINŢI,"ŞCOALA GENERALĂ BĂDIŢEŞTI",196,HUSNICIOARA,112129,1,PART,PRCNCT,PRSD,PRSD_SV,"2025-05-18 21:30:23",145,129,68,61,0,126,3,200,71,53,73
27,MEHEDINŢI,"CĂMINUL CULTURAL PERI",197,HUSNICIOARA,112129,1,PART,PRCNCT,PRSD,PRSD_SV,"2025-05-18 21:30:31",304,215,141,72,2,214,1,400,185,92,122
27,MEHEDINŢI,"CAMIN CULTURAL ILOVĂŢ",198,ILOVĂŢ,112263,1,PART,PRCNCT,PRSD,PRSD_SV,"2025-05-18 22:25:50",926,778,447,244,87,764,14,998,220,389,375
27,MEHEDINŢI,"ȘCOALA GENERALĂ ILOVIŢA",199,ILOVIŢA,112334,1,PART,PRCNCT,PRSD,PRSD_SV,"2025-05-18 21:42:33",643,390,315,54,21,389,1,700,310,217,172
27,MEHEDINŢI,"CĂMINUL CULTURAL BAHNA",200,ILOVIŢA,112334,1,PART,PRCNCT,PRSD,PRSD_SV,"2025-05-18 22:08:22",421,257,211,44,2,254,3,500,243,221,33
27,MEHEDINŢI,"CĂMIN CULTURAL ISVERNA",201,ISVERNA,112370,1,PART,PRCNCT,PRSD,PRSD_SV,"2025-05-18 22:40:47",1256,652,541,111,0,645,7,1300,648,424,221
27,MEHEDINŢI,"CĂMIN CULTURAL BUSEȘTI",202,ISVERNA,112370,1,PART,PRCNCT,PRSD,PRSD_SV,"2025-05-18 21:47:05",120,109,57,52,0,108,1,200,91,48,60
27,MEHEDINŢI,"ȘCOALA GENERALĂ NADANOVA",203,ISVERNA,112370,1,PART,PRCNCT,PRSD,PRSD_SV,"2025-05-18 22:08:52",321,182,134,48,0,182,0,400,218,117,65
27,MEHEDINŢI,"CĂMINUL CULTURAL IZVORU BÎRZII",204,"IZVORU BÂRZII",112469,1,PART,PRCNCT,PRSD,PRSD_SV,"2025-05-18 21:56:47",1092,623,512,111,0,610,13,1200,577,399,211
27,MEHEDINŢI,"ȘCOALA GENERALĂ I-IV BALOTEŞTI",205,"IZVORU BÂRZII",112469,1,PART,PRCNCT,PRSD,PRSD_SV,"2025-05-18 21:51:57",500,322,214,108,0,319,3,600,278,200,119
27,MEHEDINŢI,"ȘCOALA GENERALĂ I-VIII HALÎNGA",206,"IZVORU BÂRZII",112469,1,PART,PRCNCT,PRSD,PRSD_SV,"2025-05-18 21:44:20",733,457,340,116,1,454,3,800,343,290,164
27,MEHEDINŢI,"ȘCOALA GENERALĂ I-VIII JIANA",207,JIANA,112548,1,PART,PRCNCT,PRSD,PRSD_SV,"2025-05-18 21:24:18",595,360,261,65,34,355,5,700,340,136,219
27,MEHEDINŢI,"CĂMINUL CULTURAL CIOROBORENI",208,JIANA,112548,1,PART,PRCNCT,PRSD,PRSD_SV,"2025-05-18 21:42:12",513,406,254,118,34,403,3,600,194,172,231
27,MEHEDINŢI,"CĂMINUL CULTURAL DĂNCEU",209,JIANA,112548,1,PART,PRCNCT,PRSD,PRSD_SV,"2025-05-18 21:37:43",1050,497,372,81,44,497,0,1100,603,185,312
27,MEHEDINŢI,"ȘCOALA GENERALĂ I-IV JIANA MARE",210,JIANA,112548,1,PART,PRCNCT,PRSD,PRSD_SV,"2025-05-18 21:22:01",583,413,254,77,82,409,4,700,287,113,296
27,MEHEDINŢI,"ȘCOALA GENERALĂ I-VIII JIANA VECHE",211,JIANA,112548,1,PART,PRCNCT,PRSD,PRSD_SV,"2025-05-18 21:23:19",961,344,249,40,55,340,4,1000,656,178,162
27,MEHEDINŢI,"CĂMINUL CULTURAL LIVEZILE",212,LIVEZILE,112600,1,PART,PRCNCT,PRSD,PRSD_SV,"2025-05-18 22:07:27",686,498,356,111,31,489,9,800,302,199,290
27,MEHEDINŢI,"ŞCOALA PRIMARĂ IZVORĂLU DE JOS",213,LIVEZILE,112600,1,PART,PRCNCT,PRSD,PRSD_SV,"2025-05-18 21:29:39",133,118,61,53,4,116,2,200,82,59,57
27,MEHEDINŢI,"ŞCOALA PRIMARĂ IZVORU ANEŞTILOR",214,LIVEZILE,112600,1,PART,PRCNCT,PRSD,PRSD_SV,"2025-05-18 21:35:36",346,325,191,130,4,321,4,399,74,166,155
27,MEHEDINŢI,"CĂMINUL CULTURAL MALOVĂŢ",215,MALOVĂŢ,112664,1,PART,PRCNCT,PRSD,PRSD_SV,"2025-05-18 21:49:55",972,627,523,104,0,621,6,1000,373,438,183
27,MEHEDINŢI,"SCOALA GENERALĂ I-IV 23 AUGUST",216,MALOVĂŢ,112664,1,PART,PRCNCT,PRSD,PRSD_SV,"2025-05-18 21:36:13",348,207,143,64,0,202,5,400,193,116,86
27,MEHEDINŢI,"CĂMINUL CULTURAL BOBAIŢA",217,MALOVĂŢ,112664,1,PART,PRCNCT,PRSD,PRSD_SV,"2025-05-18 22:16:55",469,315,200,115,0,312,3,500,185,214,98
27,MEHEDINŢI,"ŞCOALA GENERALĂ I-IV COLIBAŞI",218,MALOVĂŢ,112664,1,PART,PRCNCT,PRSD,PRSD_SV,"2025-05-18 21:26:03",350,229,171,58,0,227,2,400,171,157,70
27,MEHEDINŢI,"ȘCOALA GENERALĂ I-VIII OBÎRȘIA CLOȘANI",219,OBÂRŞIA-CLOŞANI,110027,1,PART,PRCNCT,PRSD,PRSD_SV,"2025-05-18 21:51:17",788,620,449,156,15,615,5,900,280,287,328
27,MEHEDINŢI,"CĂMINUL CULTURAL OBÂRŞIA DE CÂMP",220,"OBÂRŞIA DE CÂMP",112744,1,PART,PRCNCT,PRSD,PRSD_SV,"2025-05-18 21:32:34",582,333,263,70,0,331,2,700,367,173,158
27,MEHEDINŢI,"CĂMINUL CULTURAL IZIMŞA",221,"OBÂRŞIA DE CÂMP",112744,1,PART,PRCNCT,PRSD,PRSD_SV,"2025-05-18 21:48:58",759,432,351,72,9,430,2,800,368,254,176
27,MEHEDINŢI,"CĂMINUL CULTURAL OPRIȘOR",222,OPRIŞOR,112771,1,PART,PRCNCT,PRSD,PRSD_SV,"2025-05-18 21:33:55",632,331,229,99,3,325,6,699,368,207,118
27,MEHEDINŢI,"ȘCOALA GENERALĂ I-VIII OPRIȘOR",223,OPRIŞOR,112771,1,PART,PRCNCT,PRSD,PRSD_SV,"2025-05-18 21:39:29",630,287,228,58,1,286,1,700,413,198,88
27,MEHEDINŢI,"ȘCOALA GENERALĂ PRISĂCEAUA",224,OPRIŞOR,112771,1,PART,PRCNCT,PRSD,PRSD_SV,"2025-05-18 21:29:01",244,160,107,53,0,159,1,300,140,92,67
27,MEHEDINŢI,"CĂMINUL CULTURAL PĂDINA MARE",225,PĂDINA,112806,1,PART,PRCNCT,PRSD,PRSD_SV,"2025-05-18 21:21:10",190,157,102,42,13,152,5,270,113,112,40
27,MEHEDINŢI,"ŞCOALA GENERALĂ IABLANIŢA",226,PĂDINA,112806,1,PART,PRCNCT,PRSD,PRSD_SV,"2025-05-18 21:25:15",166,115,68,39,8,114,1,200,85,69,45
27,MEHEDINŢI,"ŞCOALA GENERALĂ PĂDINA MICĂ",227,PĂDINA,112806,1,PART,PRCNCT,PRSD,PRSD_SV,"2025-05-18 21:15:17",161,151,84,55,12,150,1,200,49,115,35
27,MEHEDINŢI,"CĂMINUL CULTURAL SLAŞOMA",228,PĂDINA,112806,1,PART,PRCNCT,PRSD,PRSD_SV,"2025-05-18 21:25:58",356,211,131,58,22,206,5,400,189,141,65
27,MEHEDINŢI,"CĂMINUL CULTURAL PĂTULELE",229,PĂTULELE,112879,1,PART,PRCNCT,PRSD,PRSD_SV,"2025-05-18 21:33:01",1101,618,507,89,22,607,11,1200,582,417,190
27,MEHEDINŢI,"ŞCOALA GENERALĂ I-IV PĂTULELE",230,PĂTULELE,112879,2,PART,PRCNCT,PRSD,PRSD_SV,"2025-05-18 23:44:09",966,471,393,63,15,468,3,999,528,332,136
27,MEHEDINŢI,"GRĂDINIŢA NR. 3 RUDĂRIE",231,PĂTULELE,112879,1,PART,PRCNCT,PRSD,PRSD_SV,"2025-05-18 21:33:53",370,137,123,9,5,136,1,400,263,75,61
27,MEHEDINŢI,"CĂMINUL CULTURAL VIAŞU",232,PĂTULELE,112879,1,PART,PRCNCT,PRSD,PRSD_SV,"2025-05-18 21:43:46",399,247,201,37,9,245,2,500,253,150,95
27,MEHEDINŢI,"CĂMINUL CULTURAL PODENI",233,PODENI,112959,1,PART,PRCNCT,PRSD,PRSD_SV,"2025-05-18 21:28:25",495,286,229,57,0,284,2,600,314,167,117
27,MEHEDINŢI,"CĂMINUL CULTURAL GORNENŢI",234,PODENI,112959,1,PART,PRCNCT,PRSD,PRSD_SV,"2025-05-18 21:26:21",118,106,65,41,0,105,1,200,94,56,49
27,MEHEDINŢI,"CĂMINUL CULTURAL PONOARELE",235,PONOARELE,112995,1,PART,PRCNCT,PRSD,PRSD_SV,"2025-05-18 21:37:57",802,543,394,134,15,536,7,900,357,325,211
27,MEHEDINŢI,"CĂMINUL CULTURAL BÎRÎIACU",236,PONOARELE,112995,1,PART,PRCNCT,PRSD,PRSD_SV,"2025-05-18 21:31:15",219,142,113,26,3,142,0,300,158,99,43
27,MEHEDINŢI,"CĂMINUL CULTURAL GĂRDĂNEASA",237,PONOARELE,112995,1,PART,PRCNCT,PRSD,PRSD_SV,"2025-05-18 21:31:38",371,206,174,32,0,205,1,400,194,130,75
27,MEHEDINŢI,"CĂMINUL CULTURAL GHEORGHEȘTI",238,PONOARELE,112995,1,PART,PRCNCT,PRSD,PRSD_SV,"2025-05-18 21:28:13",498,265,224,38,3,262,3,600,335,176,86
27,MEHEDINŢI,"ŞCOALA GENERALĂ POROINA MARE",239,"POROINA MARE",113153,1,PART,PRCNCT,PRSD,PRSD_SV,"2025-05-18 21:40:05",276,217,122,69,26,217,0,300,83,58,159
27,MEHEDINŢI,"ŞCOALA GENERALĂ FÎNTÂNILE NEGRE",240,"POROINA MARE",113153,1,PART,PRCNCT,PRSD,PRSD_SV,"2025-05-18 21:42:02",133,126,71,46,9,125,1,200,74,46,79
27,MEHEDINŢI,"ŞCOALA GENERALĂ I-IV STIGNIŢA",241,"POROINA MARE",113153,1,PART,PRCNCT,PRSD,PRSD_SV,"2025-05-18 21:41:34",331,282,172,88,22,277,5,400,118,81,196
27,MEHEDINŢI,"CĂMINUL CULTURAL PRISTOL",242,PRISTOL,113206,1,PART,PRCNCT,PRSD,PRSD_SV,"2025-05-18 22:11:34",727,497,303,194,0,489,8,800,303,284,205
27,MEHEDINŢI,"ŞCOALA GENERALĂ COZIA",243,PRISTOL,113206,1,PART,PRCNCT,PRSD,PRSD_SV,"2025-05-18 21:29:12",407,255,189,66,0,250,5,500,245,139,111
27,MEHEDINŢI,"ŞCOALA GENERALĂ PRUNIŞOR",244,PRUNIŞOR,113233,1,PART,PRCNCT,PRSD,PRSD_SV,"2025-05-18 22:12:32",454,450,207,234,9,446,4,600,150,100,346
27,MEHEDINŢI,"CĂMINUL CULTURAL CERVENIŢA",245,PRUNIŞOR,113233,1,PART,PRCNCT,PRSD,PRSD_SV,"2025-05-18 21:28:39",291,257,138,113,6,256,1,400,143,91,165
27,MEHEDINŢI,"CĂMINUL CULTURAL FÎNTÎNA DOMNEASCĂ",246,PRUNIŞOR,113233,1,PART,PRCNCT,PRSD,PRSD_SV,"2025-05-18 21:29:46",302,223,141,76,6,222,1,400,177,92,130
27,MEHEDINŢI,"HM GÂRNIȚA",247,PRUNIŞOR,113233,1,PART,PRCNCT,PRSD,PRSD_SV,"2025-05-18 21:41:11",273,264,134,116,14,264,0,399,135,95,169
27,MEHEDINŢI,"ŞCOALA GENERALĂ ZEGAIA",248,PRUNIŞOR,113233,1,PART,PRCNCT,PRSD,PRSD_SV,"2025-05-18 21:27:45",205,208,106,100,2,207,1,300,92,56,151
27,MEHEDINŢI,"CĂMINUL CULTURAL PUNGHINA",249,PUNGHINA,113395,1,PART,PRCNCT,PRSD,PRSD_SV,"2025-05-18 21:35:12",923,245,197,48,0,240,5,1000,755,150,90
27,MEHEDINŢI,"CĂMINUL CULTURAL CEARÎNG",250,PUNGHINA,113395,1,PART,PRCNCT,PRSD,PRSD_SV,"2025-05-18 21:15:51",113,94,63,31,0,94,0,200,106,58,36
27,MEHEDINŢI,"FOSTA CANCELARIE-ȘCOALA GENERALĂ DRINCEA",251,PUNGHINA,113395,1,PART,PRCNCT,PRSD,PRSD_SV,"2025-05-18 21:17:04",227,157,110,47,0,156,1,300,143,76,80
27,MEHEDINŢI,"ŞCOALA I-IV RECEA",252,PUNGHINA,113395,1,PART,PRCNCT,PRSD,PRSD_SV,"2025-05-18 21:17:59",821,235,209,26,0,230,5,900,665,188,42
27,MEHEDINŢI,"ŞCOALA GENERALĂ I-VIII ROGOVA",253,ROGOVA,113466,1,PART,PRCNCT,PRSD,PRSD_SV,"2025-05-18 21:53:56",1216,740,553,140,47,726,14,1300,560,449,277
27,MEHEDINŢI,"ŞCOALA GENERALĂ V-VIII SALCIA",254,SALCIA,113493,1,PART,PRCNCT,PRSD,PRSD_SV,"2025-05-18 21:48:19",1053,591,454,63,74,587,4,1100,509,234,353
27,MEHEDINŢI,"ŞCOALA GENERALĂ V-VIII SALCIA",255,SALCIA,113493,1,PART,PRCNCT,PRSD,PRSD_SV,"2025-05-18 21:52:41",1129,604,478,63,63,596,8,1200,596,269,327
27,MEHEDINŢI,"ŞCOALA GENERALĂ STÎNGĂCEAUA",256,STÂNGĂCEAUA,113518,1,PART,PRCNCT,PRSD,PRSD_SV,"2025-05-18 21:26:08",509,238,183,55,0,237,1,600,362,133,104
27,MEHEDINŢI,"ŞCOALA GENERALĂ I-IV BÎRLOGENI",257,STÂNGĂCEAUA,113518,1,PART,PRCNCT,PRSD,PRSD_SV,"2025-05-18 21:17:11",172,121,83,38,0,120,1,200,79,77,43
27,MEHEDINŢI,"ŞCOALA GENERALĂ SATU MARE",258,STÂNGĂCEAUA,113518,1,PART,PRCNCT,PRSD,PRSD_SV,"2025-05-18 21:22:54",319,167,136,31,0,164,3,400,233,125,39
27,MEHEDINŢI,"PRIMĂRIA SVINIŢA",259,SVINIŢA,113607,1,PART,PRCNCT,PRSD,PRSD_SV,"2025-05-18 21:47:54",729,405,309,81,15,394,11,800,395,278,116
27,MEHEDINŢI,"ŞCOALA GENERALĂ I-VIII ŞIMIAN",260,ŞIMIAN,109826,1,PART,PRCNCT,PRSD,PRSD_SV,"2025-05-18 21:58:49",1835,1217,901,315,1,1198,19,2000,783,486,712
27,MEHEDINŢI,"ŞCOALA GENERALĂ I-VIII ŞIMIAN",261,ŞIMIAN,109826,1,PART,PRCNCT,PRSD,PRSD_SV,"2025-05-18 22:37:49",1909,929,824,105,0,918,11,2100,1171,528,390
27,MEHEDINŢI,"ŞCOALA GENERALĂ I-VIII CERNEŢI",262,ŞIMIAN,109826,1,PART,PRCNCT,PRSD,PRSD_SV,"2025-05-18 21:59:50",1483,1052,738,314,0,1049,3,1600,548,498,551
27,MEHEDINŢI,"ŞCOALA GENERALĂ I-VIII CERNEŢI",263,ŞIMIAN,109826,1,PART,PRCNCT,PRSD,PRSD_SV,"2025-05-18 22:08:33",1475,873,726,147,0,864,9,1600,727,477,387
27,MEHEDINŢI,"ŞCOALA GENERALĂ I-IV DEDOVIŢA NOUĂ",264,ŞIMIAN,109826,2,PART,PRCNCT,PRSD,PRSD_SV,"2025-05-19 00:05:11",369,298,211,87,0,293,5,400,102,150,143
27,MEHEDINŢI,"ŞCOALA GENERALĂ I-IV DUDAŞU",265,ŞIMIAN,109826,1,PART,PRCNCT,PRSD,PRSD_SV,"2025-05-18 21:36:38",1247,560,469,91,0,548,12,1300,740,289,259
27,MEHEDINŢI,"ŞCOALA GENERALĂ I-IV POROINA",266,ŞIMIAN,109826,1,PART,PRCNCT,PRSD,PRSD_SV,"2025-05-18 21:35:47",242,178,135,43,0,176,2,300,122,96,80
27,MEHEDINŢI,"ȘCOALA GENERALĂ I-IV POROINA",267,ŞIMIAN,109826,1,PART,PRCNCT,PRSD,PRSD_SV,"2025-05-18 21:40:50",285,158,128,30,0,157,1,400,242,98,59
27,MEHEDINŢI,"ŞCOALA GENERALĂ VALEA COPCII",268,ŞIMIAN,109826,1,PART,PRCNCT,PRSD,PRSD_SV,"2025-05-18 21:40:46",96,165,68,97,0,164,1,200,35,63,101
27,MEHEDINŢI,"CĂMINUL CULTURAL ŞIŞEŞTI",269,ŞIŞEŞTI,113625,1,PART,PRCNCT,PRSD,PRSD_SV,"2025-05-18 21:39:05",898,604,431,148,25,602,2,1000,396,442,160
27,MEHEDINŢI,"ŞCOALA GENERALĂ I-IV COCOROVA",270,ŞIŞEŞTI,113625,1,PART,PRCNCT,PRSD,PRSD_SV,"2025-05-18 21:26:56",291,208,148,60,0,207,1,400,192,142,65
27,MEHEDINŢI,"ȘCOALA GENERALĂ I - IV CRĂGUEȘTI",271,ŞIŞEŞTI,113625,1,PART,PRCNCT,PRSD,PRSD_SV,"2025-05-18 21:23:00",281,208,131,77,0,207,1,400,192,148,59
27,MEHEDINŢI,"SCOALA GIMNAZIALA NOAPTEȘA",272,ŞIŞEŞTI,113625,1,PART,PRCNCT,PRSD,PRSD_SV,"2025-05-18 21:47:14",527,344,271,71,2,342,2,600,256,266,76
27,MEHEDINŢI,"PRIMĂRIA ŞOVARNA",273,ŞOVARNA,113698,1,PART,PRCNCT,PRSD,PRSD_SV,"2025-05-18 22:07:32",913,561,408,153,0,559,2,1000,439,351,208
27,MEHEDINŢI,"PRIMĂRIA TÎMNA",274,TÂMNA,113732,1,PART,PRCNCT,PRSD,PRSD_SV,"2025-05-18 21:44:31",1047,401,283,112,6,395,6,900,499,298,97
27,MEHEDINŢI,"CENTRUL DE ZI TÂMNA",275,TÂMNA,113732,1,PART,PRCNCT,PRSD,PRSD_SV,"2025-05-18 21:38:32",461,264,202,62,0,264,0,500,236,135,129
27,MEHEDINŢI,"ŞCOALA CREMENEA",276,TÂMNA,113732,1,PART,PRCNCT,PRSD,PRSD_SV,"2025-05-18 21:17:00",136,116,58,58,0,112,4,200,84,79,33
27,MEHEDINŢI,"SCOALA CU CLASELE I-VIII",277,TÂMNA,113732,1,PART,PRCNCT,PRSD,PRSD_SV,"2025-05-18 21:45:42",243,163,93,70,0,157,6,300,137,85,72
27,MEHEDINŢI,"ŞCOALA GENERALĂ PLOPI",278,TÂMNA,113732,1,PART,PRCNCT,PRSD,PRSD_SV,"2025-05-18 21:48:06",503,270,221,49,0,265,5,600,330,192,73
27,MEHEDINŢI,"CAMIN CULTURAL VANATORI",279,VÂNĂTORI,113849,1,PART,PRCNCT,PRSD,PRSD_SV,"2025-05-18 21:38:33",838,514,356,129,29,509,5,899,385,247,262
27,MEHEDINŢI,"MAGAZIN SĂTESC ROȘIORI",280,VÂNĂTORI,113849,1,PART,PRCNCT,PRSD,PRSD_SV,"2025-05-18 21:53:12",698,395,294,94,7,391,4,800,405,194,197
27,MEHEDINŢI,"CĂMIN CULTURAL VÎNJULEŢ",281,VÂNJULEŢ,113894,1,PART,PRCNCT,PRSD,PRSD_SV,"2025-05-18 22:03:46",1462,1024,523,232,269,1015,9,1600,576,476,539
27,MEHEDINŢI,"ŞCOALA I-VIII PREDA BUZESCU, VLĂDAIA",282,VLĂDAIA,113929,1,PART,PRCNCT,PRSD,PRSD_SV,"2025-05-18 21:45:44",365,191,129,62,0,188,3,392,201,94,94
27,MEHEDINŢI,"ŞCOALA GENERALĂ I-IV ALMĂJEL",283,VLĂDAIA,113929,1,PART,PRCNCT,PRSD,PRSD_SV,"2025-05-18 21:42:17",582,210,164,46,0,203,7,700,490,114,89
27,MEHEDINŢI,"ŞCOALA GENERALĂ I-IV SCORILA",284,VLĂDAIA,113929,1,PART,PRCNCT,PRSD,PRSD_SV,"2025-05-18 21:21:19",137,69,36,33,0,67,2,200,131,51,16
27,MEHEDINŢI,"ŞCOALA GENERALĂ I-IV ŞTIRCOVIŢA",285,VLĂDAIA,113929,1,PART,PRCNCT,PRSD,PRSD_SV,"2025-05-18 21:27:20",143,92,47,45,0,92,0,200,108,52,40
27,MEHEDINŢI,"ŞCOALA GENERALĂ I-VIII VOLOIAC",286,VOLOIAC,113974,1,PART,PRCNCT,PRSD,PRSD_SV,"2025-05-18 21:22:02",479,271,231,40,0,265,6,601,330,166,99
27,MEHEDINŢI,"ȘCOALA GENERALĂ I-VIII VOLOIAC",287,VOLOIAC,113974,1,PART,PRCNCT,PRSD,PRSD_SV,"2025-05-18 21:13:50",80,51,32,19,0,51,0,200,149,32,19
27,MEHEDINŢI,"ŞCOALA GENERALĂ I-IV COTOROAIA",288,VOLOIAC,113974,1,PART,PRCNCT,PRSD,PRSD_SV,"2025-05-18 21:32:58",434,214,185,29,0,208,6,500,286,154,54
27,MEHEDINŢI,"ŞCOALA GENERALĂ I-IV VALEA BUNĂ",289,VOLOIAC,113974,1,PART,PRCNCT,PRSD,PRSD_SV,"2025-05-18 21:17:26",271,172,139,33,0,166,6,300,128,101,65
27,MEHEDINŢI,"CĂMINUL CULTURAL VRATA",290,VRATA,114079,1,PART,PRCNCT,PRSD,PRSD_SV,"2025-05-18 21:46:03",1456,551,428,123,0,548,3,1600,1049,328,220
28,MUREŞ,"CASA ”APOLLO” (ŞCOALA DE ARTE)",1,"MUNICIPIUL TÂRGU MUREŞ",114319,1,PART,PRCNCT,PRSD,PRSD_SV,"2025-05-18 22:37:46",1309,854,520,332,2,850,4,1400,546,153,697
28,MUREŞ,"UNIVERSITATEA DE MEDICINĂ, FARMACIE, ȘTIINȚE ȘI TEHNOLOGIE TÂRGU MUREȘ",2,"MUNICIPIUL TÂRGU MUREŞ",114319,2,PART,PRCNCT,PRSD,PRSD_SV,"2025-05-19 01:04:40",1487,1044,799,181,64,1035,9,1600,556,176,859
28,MUREŞ,"LICEUL TEORETIC ”BOLYAI FARKAS”,",3,"MUNICIPIUL TÂRGU MUREŞ",114319,1,PART,PRCNCT,PRSD,PRSD_SV,"2025-05-18 22:43:26",1263,1254,697,328,229,1235,19,1400,146,299,936
28,MUREŞ,"INTERNAT LICEUL TEHNOLOGIC ”AVRAM IANCU”",4,"MUNICIPIUL TÂRGU MUREŞ",114319,1,PART,PRCNCT,PRSD,PRSD_SV,"2025-05-18 21:51:40",1220,704,581,93,30,700,4,1300,596,111,589
28,MUREŞ,"ȘCOALA GIMNAZIALĂ ”NICOLAE BĂLCESCU”",5,"MUNICIPIUL TÂRGU MUREŞ",114319,1,PART,PRCNCT,PRSD,PRSD_SV,"2025-05-18 21:49:46",1622,942,829,109,4,935,7,1780,838,217,718
28,MUREŞ,"ȘCOALA GIMNAZIALĂ ”NICOLAE BĂLCESCU”",6,"MUNICIPIUL TÂRGU MUREŞ",114319,1,PART,PRCNCT,PRSD,PRSD_SV,"2025-05-18 21:43:19",1726,1064,889,171,4,1054,10,1800,736,262,792
28,MUREŞ,"ȘCOALA GIMNAZIALĂ ”NICOLAE BĂLCESCU”",7,"MUNICIPIUL TÂRGU MUREŞ",114319,1,PART,PRCNCT,PRSD,PRSD_SV,"2025-05-18 21:40:36",1312,723,646,72,5,715,8,1400,677,157,558
28,MUREŞ,"ȘCOALA GIMNAZIALĂ ”NICOLAE BĂLCESCU”",8,"MUNICIPIUL TÂRGU MUREŞ",114319,1,PART,PRCNCT,PRSD,PRSD_SV,"2025-05-18 22:07:34",1227,743,685,55,3,728,15,1300,557,126,602
28,MUREŞ,"ȘCOALA GIMNAZIALĂ ”NICOLAE BĂLCESCU”",9,"MUNICIPIUL TÂRGU MUREŞ",114319,1,PART,PRCNCT,PRSD,PRSD_SV,"2025-05-18 22:45:46",1521,878,797,75,6,875,3,1650,772,115,760
28,MUREŞ,"LICEUL TEHNOLOGIC ”AUREL PERȘU”",10,"MUNICIPIUL TÂRGU MUREŞ",114319,1,PART,PRCNCT,PRSD,PRSD_SV,"2025-05-18 21:58:15",1167,546,485,61,0,535,11,1299,753,246,289
28,MUREŞ,"LICEUL TEHNOLOGIC ”AUREL PERȘU”",11,"MUNICIPIUL TÂRGU MUREŞ",114319,1,PART,PRCNCT,PRSD,PRSD_SV,"2025-05-18 22:20:54",1176,711,659,50,2,704,7,1300,589,182,522
28,MUREŞ,"PRIMĂRIA MUNICIPIULUI TG.MUREŞ",12,"MUNICIPIUL TÂRGU MUREŞ",114319,1,PART,PRCNCT,PRSD,PRSD_SV,"2025-05-18 21:46:14",1285,1023,680,323,20,1010,13,1400,377,188,822
28,MUREŞ,"COLEGIUL AGRICOL ”TRAIAN SAVULESCU”",13,"MUNICIPIUL TÂRGU MUREŞ",114319,1,PART,PRCNCT,PRSD,PRSD_SV,"2025-05-18 22:10:46",1470,925,788,135,2,918,7,1600,675,202,716
28,MUREŞ,"ŞCOALA GIMNAZIALĂ ”AL.I.CUZA”",14,"MUNICIPIUL TÂRGU MUREŞ",114319,1,PART,PRCNCT,PRSD,PRSD_SV,"2025-05-18 22:10:31",1823,1138,1052,81,5,1127,11,2000,862,295,832
28,MUREŞ,"ŞCOALA GIMNAZIALĂ ”AL.I.CUZA”",15,"MUNICIPIUL TÂRGU MUREŞ",114319,1,PART,PRCNCT,PRSD,PRSD_SV,"2025-05-18 22:38:55",1871,1204,1128,74,2,1191,13,2000,796,276,915
28,MUREŞ,"ŞCOALA GIMNAZIALĂ ”AL.I.CUZA”",16,"MUNICIPIUL TÂRGU MUREŞ",114319,2,PART,PRCNCT,PRSD,PRSD_SV,"2025-05-19 01:35:49",1776,1166,1051,114,1,1155,11,1900,734,287,868
28,MUREŞ,"ŞCOALA GIMNAZIALĂ”AL.I.CUZA”",17,"MUNICIPIUL TÂRGU MUREŞ",114319,1,PART,PRCNCT,PRSD,PRSD_SV,"2025-05-18 21:57:47",1868,1201,1057,143,1,1189,12,2000,799,350,839
28,MUREŞ,"ŞCOALA GIMNAZIALĂ”AL.I.CUZA”",18,"MUNICIPIUL TÂRGU MUREŞ",114319,1,PART,PRCNCT,PRSD,PRSD_SV,"2025-05-18 22:32:24",1872,1159,1052,105,2,1145,14,2000,841,282,863
28,MUREŞ,"ŞCOALA GIMNAZIALĂ”AL.I.CUZA”",19,"MUNICIPIUL TÂRGU MUREŞ",114319,1,PART,PRCNCT,PRSD,PRSD_SV,"2025-05-18 21:59:51",1771,1083,1009,73,1,1070,13,1950,867,264,806
28,MUREŞ,"ŞCOALA GEN. NR. 19 BEŞA",20,"MUNICIPIUL TÂRGU MUREŞ",114319,1,PART,PRCNCT,PRSD,PRSD_SV,"2025-05-18 21:42:54",852,439,421,18,0,433,6,948,509,212,221
28,MUREŞ,"GRĂDINIȚA P.P. ”RAZĂ DE SOARE”",21,"MUNICIPIUL TÂRGU MUREŞ",114319,1,PART,PRCNCT,PRSD,PRSD_SV,"2025-05-18 21:58:20",1149,701,586,115,0,699,2,1250,549,68,631
28,MUREŞ,"GRĂDINIȚA P.P. ”RAZĂ DE SOARE”",22,"MUNICIPIUL TÂRGU MUREŞ",114319,1,PART,PRCNCT,PRSD,PRSD_SV,"2025-05-18 21:46:25",1163,786,652,132,2,781,5,1300,514,125,656
28,MUREŞ,"LICEUL CU PROGRAM SPORTIV ”SZASZ ADALBERT”",23,"MUNICIPIUL TÂRGU MUREŞ",114319,1,PART,PRCNCT,PRSD,PRSD_SV,"2025-05-18 22:14:01",1503,906,711,126,69,897,9,1650,744,147,750
28,MUREŞ,"ŞCOALA GIMNAZIALĂ ”EUROPA”",24,"MUNICIPIUL TÂRGU MUREŞ",114319,1,PART,PRCNCT,PRSD,PRSD_SV,"2025-05-18 21:50:52",1286,1420,668,673,79,1409,11,1800,380,211,1198
28,MUREŞ,"GRĂDINIŢA PROGR.PREL.NR.6",25,"MUNICIPIUL TÂRGU MUREŞ",114319,1,PART,PRCNCT,PRSD,PRSD_SV,"2025-05-18 21:49:54",1180,744,635,108,1,735,9,1300,556,151,584
28,MUREŞ,"LICEUL TEHNOLOGIC ”C-TIN BRÂNCUŞI”",26,"MUNICIPIUL TÂRGU MUREŞ",114319,1,PART,PRCNCT,PRSD,PRSD_SV,"2025-05-18 23:26:04",1268,1019,714,161,144,1009,10,1200,181,167,842
28,MUREŞ,"ŞCOALA GIMNAZIALĂ NR. 7 CORP A",27,"MUNICIPIUL TÂRGU MUREŞ",114319,2,PART,PRCNCT,PRSD,PRSD_SV,"2025-05-18 23:17:12",1191,948,634,312,2,940,8,1300,352,144,796
28,MUREŞ,"LIEUL TEORETIC ”BOLYAI FARKAS”",28,"MUNICIPIUL TÂRGU MUREŞ",114319,1,PART,PRCNCT,PRSD,PRSD_SV,"2025-05-18 21:38:32",935,662,424,237,1,655,7,1003,341,103,552
28,MUREŞ,"LICEUL TEORETIC ”BOLYAI FARKAS”",29,"MUNICIPIUL TÂRGU MUREŞ",114319,2,PART,PRCNCT,PRSD,PRSD_SV,"2025-05-18 23:12:10",1144,689,575,113,1,684,5,1250,561,106,578
28,MUREŞ,"LICEUL TEHNOLOGIC ”ION VLASIU”",30,"MUNICIPIUL TÂRGU MUREŞ",114319,1,PART,PRCNCT,PRSD,PRSD_SV,"2025-05-18 22:46:48",1310,1148,659,275,214,1139,9,1450,302,274,865
28,MUREŞ,"CENTRUL CULTURAL ”MIHAI EMINESCU”",31,"MUNICIPIUL TÂRGU MUREŞ",114319,1,PART,PRCNCT,PRSD,PRSD_SV,"2025-05-18 21:55:26",739,1170,400,764,6,1165,5,1450,280,110,1055
28,MUREŞ,"COLEGIUL NAŢIONAL ”UNIREA”",32,"MUNICIPIUL TÂRGU MUREŞ",114319,1,PART,PRCNCT,PRSD,PRSD_SV,"2025-05-18 22:38:32",1583,1099,935,151,13,1090,9,1450,351,149,941
28,MUREŞ,"LICEUL VOCAŢIONAL ”M. EMINESCU”",33,"MUNICIPIUL TÂRGU MUREŞ",114319,1,PART,PRCNCT,PRSD,PRSD_SV,"2025-05-18 22:01:42",1489,876,789,82,5,868,8,1592,716,151,717
28,MUREŞ,"ŞCOALA GIMNAZIALĂ ”T.VLADIMIRESCU”",34,"MUNICIPIUL TÂRGU MUREŞ",114319,1,PART,PRCNCT,PRSD,PRSD_SV,"2025-05-18 22:07:27",1359,886,698,186,2,874,12,1500,614,217,657
28,MUREŞ,"ŞCOALA GIMNAZIALĂ ”T.VLADIMIRESCU”",35,"MUNICIPIUL TÂRGU MUREŞ",114319,1,PART,PRCNCT,PRSD,PRSD_SV,"2025-05-18 22:00:24",1353,840,748,92,0,832,8,1497,657,220,612
28,MUREŞ,"ŞCOALA GIMNAZIALĂ ”T.VLADIMIRESCU”",36,"MUNICIPIUL TÂRGU MUREŞ",114319,1,PART,PRCNCT,PRSD,PRSD_SV,"2025-05-18 21:38:04",1348,855,782,73,0,846,9,1500,645,191,655
28,MUREŞ,"ŞCOALA GIMNAZIALĂ ”T.VLADIMIRESCU”",37,"MUNICIPIUL TÂRGU MUREŞ",114319,1,PART,PRCNCT,PRSD,PRSD_SV,"2025-05-18 21:40:13",1426,853,789,64,0,842,11,1550,697,209,633
28,MUREŞ,"ŞCOALA GIMNAZIALĂ ”T.VLADIMIRESCU”",38,"MUNICIPIUL TÂRGU MUREŞ",114319,1,PART,PRCNCT,PRSD,PRSD_SV,"2025-05-18 22:04:17",1275,729,682,46,1,722,7,1400,671,176,546
28,MUREŞ,"LICEUL TEHNOLOGIC ELECTROMUREŞ",39,"MUNICIPIUL TÂRGU MUREŞ",114319,1,PART,PRCNCT,PRSD,PRSD_SV,"2025-05-18 22:18:26",1908,1256,1114,139,3,1249,7,2100,844,276,973
28,MUREŞ,"LICEUL TEHNOLOGIC ELECTROMUREŞ",40,"MUNICIPIUL TÂRGU MUREŞ",114319,1,PART,PRCNCT,PRSD,PRSD_SV,"2025-05-18 22:13:28",1499,905,796,109,0,897,8,1650,745,207,690
28,MUREŞ,"LICEUL TEHNOLOGIC ELECTROMUREŞ",41,"MUNICIPIUL TÂRGU MUREŞ",114319,1,PART,PRCNCT,PRSD,PRSD_SV,"2025-05-18 22:20:50",1359,899,719,141,39,893,6,1500,601,202,691
28,MUREŞ,"LICEUL TEHNOLOGIC ELECTROMUREŞ",42,"MUNICIPIUL TÂRGU MUREŞ",114319,1,PART,PRCNCT,PRSD,PRSD_SV,"2025-05-18 22:14:00",1404,937,748,188,1,928,9,1550,613,209,719
28,MUREŞ,"PUNCT COLECTARE TAXE ŞI IMPOZITE",43,"MUNICIPIUL TÂRGU MUREŞ",114319,1,PART,PRCNCT,PRSD,PRSD_SV,"2025-05-18 21:56:58",1072,734,610,124,0,728,6,1150,416,176,552
28,MUREŞ,"ŞCOALA GIMNAZIALĂ ”MIHAI VITEAZUL”",44,"MUNICIPIUL TÂRGU MUREŞ",114319,1,PART,PRCNCT,PRSD,PRSD_SV,"2025-05-18 22:11:15",1456,917,782,131,4,907,10,1600,683,169,738
28,MUREŞ,"ŞCOALA GIMNAZIALĂ ”MIHAI VITEAZUL”",45,"MUNICIPIUL TÂRGU MUREŞ",114319,1,PART,PRCNCT,PRSD,PRSD_SV,"2025-05-18 22:05:28",1444,934,790,143,1,920,14,1600,666,183,737
28,MUREŞ,"ŞCOALA GIMNAZIALĂ ”MIHAI VITEAZUL”",46,"MUNICIPIUL TÂRGU MUREŞ",114319,1,PART,PRCNCT,PRSD,PRSD_SV,"2025-05-18 21:44:05",1518,927,815,110,2,915,12,1650,723,201,714
28,MUREŞ,"ŞCOALA GIMNAZIALĂ ”MIHAI VITEAZUL”",47,"MUNICIPIUL TÂRGU MUREŞ",114319,1,PART,PRCNCT,PRSD,PRSD_SV,"2025-05-18 21:54:38",1388,816,746,68,2,811,5,1500,684,189,622
28,MUREŞ,"ŞCOALA GIMNAZIALĂ ”ROMULUS GUGA”",48,"MUNICIPIUL TÂRGU MUREŞ",114319,1,PART,PRCNCT,PRSD,PRSD_SV,"2025-05-18 21:58:23",1432,933,799,134,0,919,14,1600,667,213,706
28,MUREŞ,"ŞCOALA GIMNAZIALĂ ”ROMULUS GUGA”",49,"MUNICIPIUL TÂRGU MUREŞ",114319,1,PART,PRCNCT,PRSD,PRSD_SV,"2025-05-18 22:30:01",1808,1156,1074,82,0,1153,3,1950,794,263,890
28,MUREŞ,"ŞCOALA GIMNAZIALĂ ”ROMULUS GUGA”",50,"MUNICIPIUL TÂRGU MUREŞ",114319,1,PART,PRCNCT,PRSD,PRSD_SV,"2025-05-18 22:01:23",1356,855,750,101,4,847,8,1500,645,168,679
28,MUREŞ,"ŞCOALA GIMNAZIALĂ ”ROMULUS GUGA”",51,"MUNICIPIUL TÂRGU MUREŞ",114319,1,PART,PRCNCT,PRSD,PRSD_SV,"2025-05-18 21:58:23",1301,777,693,84,0,775,2,1400,623,172,603
28,MUREŞ,"GRĂDINIŢA CU PROGR.PREL.”CODRIŞOR”",52,"MUNICIPIUL TÂRGU MUREŞ",114319,1,PART,PRCNCT,PRSD,PRSD_SV,"2025-05-18 21:50:25",1449,883,809,72,2,869,14,1600,717,173,696
28,MUREŞ,"ŞCOALA GIMNAZIALĂ ”G.COŞBUC”",53,"MUNICIPIUL TÂRGU MUREŞ",114319,1,PART,PRCNCT,PRSD,PRSD_SV,"2025-05-18 22:00:08",1326,750,669,74,7,742,8,1450,700,98,644
28,MUREŞ,"ŞCOALA GIMNAZIALĂ ”G.COŞBUC”",54,"MUNICIPIUL TÂRGU MUREŞ",114319,1,PART,PRCNCT,PRSD,PRSD_SV,"2025-05-18 22:21:38",1424,902,756,138,8,895,7,1550,648,149,746
28,MUREŞ,"ŞCOALA GIMNAZIALĂ ”DACIA”/B",55,"MUNICIPIUL TÂRGU MUREŞ",114319,2,PART,PRCNCT,PRSD,PRSD_SV,"2025-05-19 02:12:06",1406,884,793,90,1,874,10,1500,616,148,726
28,MUREŞ,"ŞCOALA GIMNAZIALĂ ”DACIA”/B",56,"MUNICIPIUL TÂRGU MUREŞ",114319,1,PART,PRCNCT,PRSD,PRSD_SV,"2025-05-18 22:04:10",1359,742,673,64,5,737,5,1500,758,141,596
28,MUREŞ,"CENTRUL ŞCOLAR PENTRU EDUCAŢIE INCLUZIVĂ NR.1",57,"MUNICIPIUL TÂRGU MUREŞ",114319,1,PART,PRCNCT,PRSD,PRSD_SV,"2025-05-18 22:40:57",1404,936,752,76,108,926,10,1500,564,212,714
28,MUREŞ,"CENTRUL ŞCOLAR PENTRU EDUCAŢIE INCLUZIVĂ NR.1",58,"MUNICIPIUL TÂRGU MUREŞ",114319,1,PART,PRCNCT,PRSD,PRSD_SV,"2025-05-18 22:14:13",1454,598,537,60,1,582,16,1600,1002,322,260
28,MUREŞ,"ŞCOALA GIMNAZIALĂ ”DACIA”/A",59,"MUNICIPIUL TÂRGU MUREŞ",114319,1,PART,PRCNCT,PRSD,PRSD_SV,"2025-05-18 22:35:21",1363,819,751,63,5,811,8,1450,631,154,657
28,MUREŞ,"ŞCOALA GIMNAZIALĂ ”DACIA”/A",60,"MUNICIPIUL TÂRGU MUREŞ",114319,1,PART,PRCNCT,PRSD,PRSD_SV,"2025-05-18 21:46:11",1284,829,742,75,12,819,10,1400,571,115,704
28,MUREŞ,"ŞCOALA GIMNAZIALĂ ”DACIA”/A",61,"MUNICIPIUL TÂRGU MUREŞ",114319,1,PART,PRCNCT,PRSD,PRSD_SV,"2025-05-18 21:50:29",949,564,485,79,0,563,1,1050,486,96,467
28,MUREŞ,"LICEUL TEHNOLOGIC ”AVRAM IANCU”",62,"MUNICIPIUL TÂRGU MUREŞ",114319,1,PART,PRCNCT,PRSD,PRSD_SV,"2025-05-18 21:56:48",1234,793,647,141,5,785,8,1350,557,118,667
28,MUREŞ,"LICEUL TEHNOLOGIC ”AVRAM IANCU”",63,"MUNICIPIUL TÂRGU MUREŞ",114319,1,PART,PRCNCT,PRSD,PRSD_SV,"2025-05-18 21:57:34",1460,876,800,68,8,869,7,1600,724,126,743
28,MUREŞ,"LICEUL TEHNOLOGIC ”AVRAM IANCU”",64,"MUNICIPIUL TÂRGU MUREŞ",114319,1,PART,PRCNCT,PRSD,PRSD_SV,"2025-05-18 22:26:13",1292,721,618,88,15,709,12,1400,679,129,580
28,MUREŞ,"GRĂDINIŢA PROG.PREL.”ALBINUŢA”",65,"MUNICIPIUL TÂRGU MUREŞ",114319,1,PART,PRCNCT,PRSD,PRSD_SV,"2025-05-18 22:18:11",1238,781,656,123,2,774,7,1350,569,165,609
28,MUREŞ,"ŞCOALA GIMNAZIALĂ ”LIVIU REBREANU”",66,"MUNICIPIUL TÂRGU MUREŞ",114319,1,PART,PRCNCT,PRSD,PRSD_SV,"2025-05-18 21:50:25",1261,711,628,80,3,704,7,1400,689,184,520
28,MUREŞ,"ŞCOALA GIMNAZIALĂ ”LIVIU REBREANU”",67,"MUNICIPIUL TÂRGU MUREŞ",114319,1,PART,PRCNCT,PRSD,PRSD_SV,"2025-05-18 21:42:50",1361,853,798,52,3,847,6,1500,647,162,685
28,MUREŞ,"ŞCOALA GIMNAZIALĂ ”LIVIU REBREANU”",68,"MUNICIPIUL TÂRGU MUREŞ",114319,1,PART,PRCNCT,PRSD,PRSD_SV,"2025-05-18 21:55:38",1333,691,643,43,5,689,2,1450,759,114,575
28,MUREŞ,"ŞCOALA GIMNAZIALĂ ”LIVIU REBREANU”",69,"MUNICIPIUL TÂRGU MUREŞ",114319,1,PART,PRCNCT,PRSD,PRSD_SV,"2025-05-18 21:41:23",1371,797,729,66,2,782,15,1500,703,101,681
28,MUREŞ,"GRĂDINIŢA PROG.PREL.”LICURICI”",70,"MUNICIPIUL TÂRGU MUREŞ",114319,1,PART,PRCNCT,PRSD,PRSD_SV,"2025-05-18 21:31:56",1377,785,734,48,3,779,6,1516,731,123,656
28,MUREŞ,"GRĂDINIŢA PROG.PREL.”LICURICI”",71,"MUNICIPIUL TÂRGU MUREŞ",114319,1,PART,PRCNCT,PRSD,PRSD_SV,"2025-05-18 21:21:45",1154,723,649,71,3,715,8,1250,527,93,622
28,MUREŞ,"LICEUL TEHNOLOGIC ”GH. ŞINCAI”",72,"MUNICIPIUL TÂRGU MUREŞ",114319,1,PART,PRCNCT,PRSD,PRSD_SV,"2025-05-18 21:44:20",1426,882,781,96,5,875,7,1550,668,145,730
28,MUREŞ,"LICEUL TEHNOLOGIC ”GH. ŞINCAI”",73,"MUNICIPIUL TÂRGU MUREŞ",114319,1,PART,PRCNCT,PRSD,PRSD_SV,"2025-05-18 21:52:34",1309,777,698,76,3,772,5,1400,623,144,628
28,MUREŞ,"LICEUL TEHNOLOGIC ”GH. ŞINCAI”",74,"MUNICIPIUL TÂRGU MUREŞ",114319,1,PART,PRCNCT,PRSD,PRSD_SV,"2025-05-18 21:38:29",1416,813,742,66,5,803,10,1500,687,150,653
28,MUREŞ,"ŞCOALA GIMNAZIALĂ LIVIU REBREANU",75,"MUNICIPIUL TÂRGU MUREŞ",114319,1,PART,PRCNCT,PRSD,PRSD_SV,"2025-05-18 21:47:32",1273,769,725,40,4,763,6,1400,631,116,647
28,MUREŞ,"ŞCOALA GIMNAZIALĂ LIVIU REBREANU",76,"MUNICIPIUL TÂRGU MUREŞ",114319,1,PART,PRCNCT,PRSD,PRSD_SV,"2025-05-18 21:45:00",1290,708,678,28,2,700,8,1400,692,146,554
28,MUREŞ,"GRĂDINIŢA CU PROG.PREL.”RÂNDUNICA”",77,"MUNICIPIUL TÂRGU MUREŞ",114319,1,PART,PRCNCT,PRSD,PRSD_SV,"2025-05-18 21:59:18",1560,845,753,92,0,839,6,1690,845,171,668
28,MUREŞ,"ŞCOALA GIMNAZIALĂ ”SERAFIM DUICU”",78,"MUNICIPIUL TÂRGU MUREŞ",114319,1,PART,PRCNCT,PRSD,PRSD_SV,"2025-05-18 21:50:59",1682,1027,940,86,1,1017,10,1800,773,186,831
28,MUREŞ,"ŞCOALA GIMNAZIALĂ ”SERAFIM DUICU”",79,"MUNICIPIUL TÂRGU MUREŞ",114319,1,PART,PRCNCT,PRSD,PRSD_SV,"2025-05-18 22:00:17",1253,653,569,81,3,647,6,1400,747,212,435
28,MUREŞ,"ŞCOALA GIMNAZIALĂ ”SERAFIM DUICU”",80,"MUNICIPIUL TÂRGU MUREŞ",114319,1,PART,PRCNCT,PRSD,PRSD_SV,"2025-05-18 21:47:55",1460,768,708,60,0,761,7,1600,832,251,510
28,MUREŞ,"LICEUL TEHNOLOGIC ”TRAIAN VUIA”",81,"MUNICIPIUL TÂRGU MUREŞ",114319,1,PART,PRCNCT,PRSD,PRSD_SV,"2025-05-18 22:00:44",1494,751,721,30,0,744,7,1600,849,199,545
28,MUREŞ,"LICEUL TEHNOLOGIC ”TRAIAN VUIA”",82,"MUNICIPIUL TÂRGU MUREŞ",114319,1,PART,PRCNCT,PRSD,PRSD_SV,"2025-05-18 21:54:03",1387,608,575,29,4,598,10,1500,892,231,367
28,MUREŞ,"LICEUL TEHNOLOGIC ”TRAIAN VUIA”",83,"MUNICIPIUL TÂRGU MUREŞ",114319,2,PART,PRCNCT,PRSD,PRSD_SV,"2025-05-19 00:24:41",1354,795,697,81,17,786,9,1450,655,251,535
28,MUREŞ,"FOSTUL LICEU TEHNOLOGIC ”EMIL A.DANDEA”",84,"MUNICIPIUL TÂRGU MUREŞ",114319,1,PART,PRCNCT,PRSD,PRSD_SV,"2025-05-18 21:49:42",1246,542,501,40,1,524,18,1350,808,211,313
28,MUREŞ,"FOSTUL LICEU TEHNOLOGIC ”EMIL A. DANDEA”",85,"MUNICIPIUL TÂRGU MUREŞ",114319,1,PART,PRCNCT,PRSD,PRSD_SV,"2025-05-18 22:15:46",972,462,403,57,2,459,3,1050,588,165,294
28,MUREŞ,"ŞCOALA GIMNAZIALĂ ”ALEXANDRU CEUŞIANU”",86,"MUNICIPIUL REGHIN",114809,1,PART,PRCNCT,PRSD,PRSD_SV,"2025-05-18 21:49:50",1324,743,659,83,1,738,5,1450,707,204,534
28,MUREŞ,"CLUBUL COPIILOR",87,"MUNICIPIUL REGHIN",114809,1,PART,PRCNCT,PRSD,PRSD_SV,"2025-05-18 22:01:04",1344,793,752,38,3,776,17,1450,657,221,555
28,MUREŞ,"LICEUL TEORETIC ”LUCIAN BLAGA”",88,"MUNICIPIUL REGHIN",114809,1,PART,PRCNCT,PRSD,PRSD_SV,"2025-05-18 21:28:51",1600,983,903,80,0,977,6,1700,717,325,652
28,MUREŞ,"LICEUL TEORETIC ”LUCIAN BLAGA”",89,"MUNICIPIUL REGHIN",114809,1,PART,PRCNCT,PRSD,PRSD_SV,"2025-05-18 21:27:44",1379,750,705,44,1,742,8,1500,750,265,477
28,MUREŞ,"COLEGIUL ”PETRU MAIOR”",90,"MUNICIPIUL REGHIN",114809,1,PART,PRCNCT,PRSD,PRSD_SV,"2025-05-18 21:42:52",1977,1060,1006,43,11,1039,21,2100,1040,355,684
28,MUREŞ,"COLEGIUL ”PETRU MAIOR”",91,"MUNICIPIUL REGHIN",114809,1,PART,PRCNCT,PRSD,PRSD_SV,"2025-05-18 21:49:04",1457,774,731,43,0,761,13,1600,826,277,484
28,MUREŞ,"COLEGIUL”PETRU MAIOR”",92,"MUNICIPIUL REGHIN",114809,1,PART,PRCNCT,PRSD,PRSD_SV,"2025-05-18 21:35:38",877,494,421,73,0,485,9,950,456,160,325
28,MUREŞ,"LICEUL TEHNOLOGIC ”IOAN BOJOR”",93,"MUNICIPIUL REGHIN",114809,1,PART,PRCNCT,PRSD,PRSD_SV,"2025-05-18 21:50:39",1544,834,759,74,1,827,7,1700,866,260,567
28,MUREŞ,"LICEUL TEHNOLOGIC ”IOAN BOJOR”",94,"MUNICIPIUL REGHIN",114809,1,PART,PRCNCT,PRSD,PRSD_SV,"2025-05-18 21:37:54",1649,850,809,39,2,842,8,1750,900,256,586
28,MUREŞ,"GRĂDINIŢA CU PROGRAM PRELUNGIT NR.4",95,"MUNICIPIUL REGHIN",114809,1,PART,PRCNCT,PRSD,PRSD_SV,"2025-05-18 21:32:37",1018,525,492,33,0,523,2,1100,575,232,291
28,MUREŞ,"GRĂDINIŢA CU PROGRAM PRELUNGIT NR.4",96,"MUNICIPIUL REGHIN",114809,1,PART,PRCNCT,PRSD,PRSD_SV,"2025-05-18 21:40:24",910,409,380,29,0,406,3,1000,591,232,174
28,MUREŞ,"CĂMINUL CULTURAL ”IERNUŢENI”",97,"MUNICIPIUL REGHIN",114809,1,PART,PRCNCT,PRSD,PRSD_SV,"2025-05-18 22:17:55",1368,841,736,88,17,833,8,1500,659,314,519
28,MUREŞ,"ŞCOALA GIMNAZIALĂ ”NICOLAE GHEORGHE”",98,"MUNICIPIUL REGHIN",114809,1,PART,PRCNCT,PRSD,PRSD_SV,"2025-05-18 21:46:22",1119,467,450,17,0,460,7,1200,733,411,49
28,MUREŞ,"ŞCOALA GIMNAZIALĂ ”NICOLAE GHEORGHE”",99,"MUNICIPIUL REGHIN",114809,3,PART,PRCNCT,PRSD,PRSD_SV,"2025-05-19 00:40:11",1055,552,524,28,0,546,6,1150,598,192,354
28,MUREŞ,"GRĂDINIŢA CU PROGRAM PRELUNGIT NR.3",100,"MUNICIPIUL REGHIN",114809,1,PART,PRCNCT,PRSD,PRSD_SV,"2025-05-18 22:19:07",1886,1027,967,60,0,1019,8,2000,973,323,696
28,MUREŞ,"ŞCOALA GIMNAZIALĂ ”FLOREA BOGDAN”",101,"MUNICIPIUL REGHIN",114809,1,PART,PRCNCT,PRSD,PRSD_SV,"2025-05-18 21:48:35",838,494,397,95,2,486,8,900,406,159,327
28,MUREŞ,"ŞCOALA GIMNAZIALĂ ”FLOREA BOGDAN”",102,"MUNICIPIUL REGHIN",114809,1,PART,PRCNCT,PRSD,PRSD_SV,"2025-05-18 21:47:58",1331,638,630,7,1,631,7,1450,812,226,405
28,MUREŞ,"ŞCOALA GIMNAZIALĂ ”FLOREA BOGDAN”",103,"MUNICIPIUL REGHIN",114809,1,PART,PRCNCT,PRSD,PRSD_SV,"2025-05-18 21:44:05",1227,608,571,36,1,603,5,1300,692,252,351
28,MUREŞ,"GRĂDINIŢA CU PROGRAM NORMAL NR.3",104,"MUNICIPIUL REGHIN",114809,1,PART,PRCNCT,PRSD,PRSD_SV,"2025-05-18 21:27:15",1256,778,721,55,2,773,5,1400,622,235,538
28,MUREŞ,"GRĂDINIŢA CU PROGRAM NORMAL NR.3",105,"MUNICIPIUL REGHIN",114809,1,PART,PRCNCT,PRSD,PRSD_SV,"2025-05-18 21:35:30",1037,617,572,45,0,612,5,1100,483,182,430
28,MUREŞ,"GRĂDINITA CU PROGRAM NORMAL NR.1 REGHIN",106,"MUNICIPIUL REGHIN",114809,1,PART,PRCNCT,PRSD,PRSD_SV,"2025-05-18 21:51:50",1015,525,478,46,1,524,1,1100,575,142,382
28,MUREŞ,"ŞCOALA GIMNAZIALĂ ”AUGUSTIN MAIOR”",107,"MUNICIPIUL REGHIN",114809,1,PART,PRCNCT,PRSD,PRSD_SV,"2025-05-18 21:31:16",1133,579,529,50,0,573,6,1250,671,212,361
28,MUREŞ,"CASA DE CULTURĂ DR. ”EUGEN NICOARA”",108,"MUNICIPIUL REGHIN",114809,1,PART,PRCNCT,PRSD,PRSD_SV,"2025-05-18 22:08:27",1133,648,550,53,45,643,5,1200,552,227,416
28,MUREŞ,"ŞCOALA GIMNAZIALĂ ” OCTAVIAN GOGA ”",109,"MUNICIPIUL SIGHIŞOARA",114514,1,PART,PRCNCT,PRSD,PRSD_SV,"2025-05-18 22:17:12",1401,718,665,51,2,705,13,1500,782,266,439
28,MUREŞ,"LICEUL TEHNOLOGIC NR. 2",110,"MUNICIPIUL SIGHIŞOARA",114514,1,PART,PRCNCT,PRSD,PRSD_SV,"2025-05-18 21:35:24",1029,505,451,54,0,503,2,1130,625,162,341
28,MUREŞ,"LICEUL TEHNOLOGIC NR. 2",111,"MUNICIPIUL SIGHIŞOARA",114514,1,PART,PRCNCT,PRSD,PRSD_SV,"2025-05-18 21:39:03",868,404,330,63,11,403,1,950,546,170,233
28,MUREŞ,"ŞCOALA GIMNAZIALĂ ”MIRON NEAGU”",112,"MUNICIPIUL SIGHIŞOARA",114514,1,PART,PRCNCT,PRSD,PRSD_SV,"2025-05-18 21:37:36",1302,566,491,75,0,559,7,1400,834,254,305
28,MUREŞ,"ŞCOALA GIMNAZIALĂ ”MIRON NEAGU”",113,"MUNICIPIUL SIGHIŞOARA",114514,1,PART,PRCNCT,PRSD,PRSD_SV,"2025-05-18 21:51:37",1254,598,496,102,0,591,7,1370,772,233,358
28,MUREŞ,"LICEUL TEORETIC ”JOSEPH HALTRICH”",114,"MUNICIPIUL SIGHIŞOARA",114514,1,PART,PRCNCT,PRSD,PRSD_SV,"2025-05-18 22:21:44",998,616,366,250,0,609,7,1100,484,198,411
28,MUREŞ,"GRĂDINIŢA CU PROGRAM PRELUNGIT NR.2",115,"MUNICIPIUL SIGHIŞOARA",114514,1,PART,PRCNCT,PRSD,PRSD_SV,"2025-05-18 22:03:14",1160,576,515,60,1,570,6,1250,674,179,391
28,MUREŞ,"ŞCOALA GIMNAZIALĂ ” NICOLAE IORGA ”",116,"MUNICIPIUL SIGHIŞOARA",114514,1,PART,PRCNCT,PRSD,PRSD_SV,"2025-05-18 21:28:32",890,400,379,21,0,390,10,1000,600,165,225
28,MUREŞ,"ŞCOALA GIMNAZIALĂ ” NICOLAE IORGA ”",117,"MUNICIPIUL SIGHIŞOARA",114514,1,PART,PRCNCT,PRSD,PRSD_SV,"2025-05-18 22:01:00",917,448,398,50,0,441,7,1000,552,106,335
28,MUREŞ,"ŞCOALA GIMNAZIALĂ ” NICOLAE IORGA ”",118,"MUNICIPIUL SIGHIŞOARA",114514,1,PART,PRCNCT,PRSD,PRSD_SV,"2025-05-18 21:35:50",1267,579,547,32,0,569,10,1400,821,225,344
28,MUREŞ,"ŞCOALA GIMNAZIALĂ ” NICOLAE IORGA ”",119,"MUNICIPIUL SIGHIŞOARA",114514,1,PART,PRCNCT,PRSD,PRSD_SV,"2025-05-18 21:44:51",1071,461,441,20,0,454,7,1150,689,170,284
28,MUREŞ,"ŞCOALA GIMNAZIALĂ ” ZAHARIA BOIU ”",120,"MUNICIPIUL SIGHIŞOARA",114514,1,PART,PRCNCT,PRSD,PRSD_SV,"2025-05-18 21:55:08",1186,554,532,21,1,550,4,1300,746,226,324
28,MUREŞ,"ŞCOALA GIMNAZIALĂ ” ZAHARIA BOIU ”",121,"MUNICIPIUL SIGHIŞOARA",114514,1,PART,PRCNCT,PRSD,PRSD_SV,"2025-05-18 21:39:20",1196,611,567,44,0,607,4,1300,689,219,388
28,MUREŞ,"ŞCOALA GIMNAZIALĂ ” ZAHARIA BOIU ”",122,"MUNICIPIUL SIGHIŞOARA",114514,1,PART,PRCNCT,PRSD,PRSD_SV,"2025-05-18 22:13:16",1134,503,479,22,2,494,9,1250,747,177,317
28,MUREŞ,"ŞCOALA GIMNAZIALĂ ” ZAHARIA BOIU ”",123,"MUNICIPIUL SIGHIŞOARA",114514,1,PART,PRCNCT,PRSD,PRSD_SV,"2025-05-18 21:50:48",1580,798,755,43,0,789,9,1700,902,270,519
28,MUREŞ,"ŞCOALA GIMNAZIALĂ ” ZAHARIA BOIU ”",124,"MUNICIPIUL SIGHIŞOARA",114514,1,PART,PRCNCT,PRSD,PRSD_SV,"2025-05-18 21:40:18",1452,677,622,55,0,670,7,1600,923,282,388
28,MUREŞ,"ŞCOALA PRIMARĂ ”DEALUL VIILOR”",125,"MUNICIPIUL SIGHIŞOARA",114514,1,PART,PRCNCT,PRSD,PRSD_SV,"2025-05-18 21:49:58",1591,669,625,44,0,655,14,1700,1031,334,321
28,MUREŞ,"ŞCOALA GIMNAZIALĂ ”AUREL MOSORA”",126,"MUNICIPIUL SIGHIŞOARA",114514,2,PART,PRCNCT,PRSD,PRSD_SV,"2025-05-19 02:10:26",1326,767,624,140,3,758,9,1400,633,191,567
28,MUREŞ,"ŞCOALA GIMNAZIALĂ ”AUREL MOSORA”",127,"MUNICIPIUL SIGHIŞOARA",114514,1,PART,PRCNCT,PRSD,PRSD_SV,"2025-05-18 21:41:09",1267,686,591,92,3,681,5,1400,714,246,435
28,MUREŞ,"ŞCOALA GIMNAZIALĂ ”RADU POPA”",128,"MUNICIPIUL SIGHIŞOARA",114514,1,PART,PRCNCT,PRSD,PRSD_SV,"2025-05-18 22:03:49",1060,662,498,135,29,660,2,1150,488,234,426
28,MUREŞ,"ŞCOALA GIMNAZIALĂ ” VICTOR JINGA”",129,"MUNICIPIUL SIGHIŞOARA",114514,1,PART,PRCNCT,PRSD,PRSD_SV,"2025-05-18 22:04:41",1120,635,561,71,3,628,7,1200,565,201,427
28,MUREŞ,"ŞCOALA GIMNAZIALĂ ” VICTOR JINGA”",130,"MUNICIPIUL SIGHIŞOARA",114514,1,PART,PRCNCT,PRSD,PRSD_SV,"2025-05-18 21:38:09",968,438,407,30,1,433,5,1050,612,211,222
28,MUREŞ,"ȘCOALA PRIMARĂ HETIUR",131,"MUNICIPIUL SIGHIŞOARA",114514,1,PART,PRCNCT,PRSD,PRSD_SV,"2025-05-18 21:56:09",831,336,304,32,0,332,4,900,564,219,113
28,MUREŞ,"GRĂDINIȚA CU PROGRAM PRELUNGIT NR. 4",132,"MUNICIPIUL TÂRNĂVENI",114925,1,PART,PRCNCT,PRSD,PRSD_SV,"2025-05-18 21:44:08",921,408,376,32,0,402,6,1000,592,167,235
28,MUREŞ,"ȘCOALA GIMNAZIALĂ NR.3",133,"MUNICIPIUL TÂRNĂVENI",114925,1,PART,PRCNCT,PRSD,PRSD_SV,"2025-05-18 21:27:46",1102,366,336,30,0,359,7,1200,834,277,82
28,MUREŞ,"ȘCOALA GIMNAZIALĂ NR.3",134,"MUNICIPIUL TÂRNĂVENI",114925,1,PART,PRCNCT,PRSD,PRSD_SV,"2025-05-18 21:56:40",977,370,352,18,0,366,4,1050,680,222,144
28,MUREŞ,"GRĂDINIȚA CU PROGRAM PRELUNGIT NR.1",135,"MUNICIPIUL TÂRNĂVENI",114925,1,PART,PRCNCT,PRSD,PRSD_SV,"2025-05-18 22:00:13",893,471,434,33,4,467,4,1000,529,122,345
28,MUREŞ,"ȘCOALA GIMNAZIALĂ TRAIAN",136,"MUNICIPIUL TÂRNĂVENI",114925,1,PART,PRCNCT,PRSD,PRSD_SV,"2025-05-18 21:59:42",1090,492,457,34,1,486,6,1200,708,207,279
28,MUREŞ,"LICEUL CONSTANTIN BRÂNCUŞI",137,"MUNICIPIUL TÂRNĂVENI",114925,1,PART,PRCNCT,PRSD,PRSD_SV,"2025-05-18 21:59:00",984,411,377,33,1,406,5,1100,689,182,224
28,MUREŞ,"CASA DE CULTURĂ MIHAI EMINESCU",138,"MUNICIPIUL TÂRNĂVENI",114925,1,PART,PRCNCT,PRSD,PRSD_SV,"2025-05-18 21:52:43",1140,580,509,70,1,573,7,1250,670,246,327
28,MUREŞ,"COLEGIUL TEHNIC",139,"MUNICIPIUL TÂRNĂVENI",114925,1,PART,PRCNCT,PRSD,PRSD_SV,"2025-05-18 21:49:12",868,439,414,25,0,430,9,950,511,135,295
28,MUREŞ,"ŞCOALA GIMNAZIALĂ AVRAM IANCU",140,"MUNICIPIUL TÂRNĂVENI",114925,1,PART,PRCNCT,PRSD,PRSD_SV,"2025-05-18 22:17:36",855,340,302,38,0,337,3,950,610,160,177
28,MUREŞ,"ȘCOALA GIMNAZIALĂ AVRAM IANCU",141,"MUNICIPIUL TÂRNĂVENI",114925,1,PART,PRCNCT,PRSD,PRSD_SV,"2025-05-18 22:05:00",927,393,373,19,1,388,5,1000,607,162,226
28,MUREŞ,"LICEUL TEORETIC ANDREI BÂRSEANU",142,"MUNICIPIUL TÂRNĂVENI",114925,1,PART,PRCNCT,PRSD,PRSD_SV,"2025-05-18 21:48:56",1203,554,525,26,3,549,5,1300,746,201,348
28,MUREŞ,"LICEUL TEORETIC ANDREI BÂRSEANU",143,"MUNICIPIUL TÂRNĂVENI",114925,1,PART,PRCNCT,PRSD,PRSD_SV,"2025-05-18 22:13:12",1243,578,535,43,0,573,5,1300,722,220,353
28,MUREŞ,"GRĂDINIȚA CU PROGRAM NORMAL NR. 6",144,"MUNICIPIUL TÂRNĂVENI",114925,1,PART,PRCNCT,PRSD,PRSD_SV,"2025-05-18 22:02:45",1040,485,451,34,0,480,5,1100,615,224,256
28,MUREŞ,"CLUBUL PENSIONARILOR NR. 2",145,"MUNICIPIUL TÂRNĂVENI",114925,1,PART,PRCNCT,PRSD,PRSD_SV,"2025-05-18 22:05:04",1091,506,481,25,0,500,6,1150,644,219,281
28,MUREŞ,"CENTRUL SOCIAL VICTORIA",146,"MUNICIPIUL TÂRNĂVENI",114925,1,PART,PRCNCT,PRSD,PRSD_SV,"2025-05-18 22:02:49",1052,625,498,69,58,616,9,1100,475,262,354
28,MUREŞ,"ŞCOALA GIMNAZIALĂ VASILE MOLDOVAN",147,"MUNICIPIUL TÂRNĂVENI",114925,1,PART,PRCNCT,PRSD,PRSD_SV,"2025-05-18 21:39:12",982,423,414,9,0,413,10,1050,627,169,244
28,MUREŞ,"ŞCOALA GIMNAZIALĂ VASILE MOLDOVAN",148,"MUNICIPIUL TÂRNĂVENI",114925,1,PART,PRCNCT,PRSD,PRSD_SV,"2025-05-18 22:02:02",1102,475,436,39,0,464,11,1200,725,240,224
28,MUREŞ,"ŞCOALA GIMNAZIALĂ VASILE MOLDOVAN",149,"MUNICIPIUL TÂRNĂVENI",114925,1,PART,PRCNCT,PRSD,PRSD_SV,"2025-05-18 22:12:14",1084,514,493,21,0,507,7,1150,636,219,288
28,MUREŞ,"CĂMINUL CULTURAL BOBOHALMA",150,"MUNICIPIUL TÂRNĂVENI",114925,1,PART,PRCNCT,PRSD,PRSD_SV,"2025-05-18 21:48:08",755,349,313,36,0,347,2,850,501,212,135
28,MUREŞ,"ŞCOALA PRIMARĂ BOTORCA",151,"MUNICIPIUL TÂRNĂVENI",114925,1,PART,PRCNCT,PRSD,PRSD_SV,"2025-05-18 21:22:46",291,136,121,15,0,136,0,350,214,54,82
28,MUREŞ,"GRĂDINIŢA CU PROGRAM NORMAL NR. 6",152,"MUNICIPIUL TÂRNĂVENI",114925,1,PART,PRCNCT,PRSD,PRSD_SV,"2025-05-18 21:44:44",469,245,224,21,0,240,5,550,305,135,105
28,MUREŞ,"CASA DE CULTURĂ IERNUT",153,"ORAŞ IERNUT",117827,1,PART,PRCNCT,PRSD,PRSD_SV,"2025-05-18 22:04:10",1237,701,631,67,3,694,7,1300,599,291,403
28,MUREŞ,"GRĂDINIŢA CU PROGRAM NORMAL IERNUT",154,"ORAŞ IERNUT",117827,1,PART,PRCNCT,PRSD,PRSD_SV,"2025-05-18 21:58:26",1038,612,553,54,5,603,9,1100,488,220,383
28,MUREŞ,"LICEUL TEHNOLOGIC IERNUT",155,"ORAŞ IERNUT",117827,1,PART,PRCNCT,PRSD,PRSD_SV,"2025-05-18 22:19:14",1197,689,612,76,1,675,14,1300,611,296,379
28,MUREŞ,"LICEUL TEHNOLOGIC IERNUT",156,"ORAŞ IERNUT",117827,1,PART,PRCNCT,PRSD,PRSD_SV,"2025-05-18 22:46:34",1367,670,625,41,4,661,9,1500,830,336,325
28,MUREŞ,"ŞCOALA GIMNAZIALĂ CIPĂU",157,"ORAŞ IERNUT",117827,1,PART,PRCNCT,PRSD,PRSD_SV,"2025-05-18 22:11:27",916,521,468,50,3,516,5,1000,479,304,212
28,MUREŞ,"CĂMIN CULTURAL",158,"ORAŞ IERNUT",117827,1,PART,PRCNCT,PRSD,PRSD_SV,"2025-05-18 21:18:23",245,131,98,33,0,127,4,300,169,68,59
28,MUREŞ,"ŞCOALA GIMNAZIALĂ LECHINŢA",159,"ORAŞ IERNUT",117827,1,PART,PRCNCT,PRSD,PRSD_SV,"2025-05-18 21:40:32",706,378,336,42,0,376,2,800,422,270,106
28,MUREŞ,"CĂMIN CULTURAL OARBA DE MUREŞ",160,"ORAŞ IERNUT",117827,1,PART,PRCNCT,PRSD,PRSD_SV,"2025-05-18 21:14:34",90,41,26,15,0,41,0,100,59,14,27
28,MUREŞ,"ŞCOALA PRIMARĂ SĂLCUD",161,"ORAŞ IERNUT",117827,1,PART,PRCNCT,PRSD,PRSD_SV,"2025-05-18 21:38:00",493,234,199,35,0,232,2,550,316,152,80
28,MUREŞ,"ŞCOALA PRIMARĂ SFÎNTU GHEORGHE",162,"ORAŞ IERNUT",117827,1,PART,PRCNCT,PRSD,PRSD_SV,"2025-05-18 21:44:33",337,216,192,24,0,212,4,400,184,95,117
28,MUREŞ,"CĂMINUL CULTURAL GHEJA-LUDUȘ",163,"ORAŞ LUDUŞ",114710,1,PART,PRCNCT,PRSD,PRSD_SV,"2025-05-18 21:31:01",1266,667,618,48,1,656,11,1400,733,372,284
28,MUREŞ,"CĂMINUL CULTURAL ROȘIORI-LUDUȘ",164,"ORAŞ LUDUŞ",114710,1,PART,PRCNCT,PRSD,PRSD_SV,"2025-05-18 21:57:28",1041,543,511,30,2,536,7,1100,557,229,307
28,MUREŞ,"SALA DE SPORT LUDUŞ",165,"ORAŞ LUDUŞ",114710,1,PART,PRCNCT,PRSD,PRSD_SV,"2025-05-18 22:00:43",1542,898,803,70,25,891,7,1650,752,372,519
28,MUREŞ,"ŞCOALA GIMNAZIALĂ ”IOAN VLĂDUŢIU” - LUDUȘ",166,"ORAŞ LUDUŞ",114710,2,PART,PRCNCT,PRSD,PRSD_SV,"2025-05-19 02:08:18",1274,742,694,46,2,736,6,1400,658,270,466
28,MUREŞ,"ŞCOALA GIMNAZIALĂ ”IOAN VLĂDUŢIU” - LUDUȘ",167,"ORAŞ LUDUŞ",114710,1,PART,PRCNCT,PRSD,PRSD_SV,"2025-05-18 22:32:09",1646,963,899,64,0,953,10,1800,837,334,619
28,MUREŞ,"LICEUL TEHNOLOGIC NR. 1 - LUDUȘ",168,"ORAŞ LUDUŞ",114710,1,PART,PRCNCT,PRSD,PRSD_SV,"2025-05-18 22:04:27",1238,679,630,48,1,674,5,1300,621,294,380
28,MUREŞ,"GRĂDINIŢA ”CĂSUŢA FERMECATĂ” - LUDUȘ",169,"ORAŞ LUDUŞ",114710,1,PART,PRCNCT,PRSD,PRSD_SV,"2025-05-18 21:45:14",1247,696,636,60,0,691,5,1350,654,263,428
28,MUREŞ,"GRĂDINIȚA CU PROGRAM NORMAL NR. 02 - LUDUȘ",170,"ORAŞ LUDUŞ",114710,1,PART,PRCNCT,PRSD,PRSD_SV,"2025-05-18 21:59:45",1421,859,779,79,1,851,8,1500,641,362,489
28,MUREŞ,"GRĂDINIŢA CU PROGRAM PRELUNGIT NR. 01 - LUDUȘ",171,"ORAŞ LUDUŞ",114710,1,PART,PRCNCT,PRSD,PRSD_SV,"2025-05-18 21:55:48",1099,512,450,59,3,503,9,1200,688,285,218
28,MUREŞ,"ŞCOALA GIMNAZIALĂ NR.1 - LUDUȘ",172,"ORAŞ LUDUŞ",114710,1,PART,PRCNCT,PRSD,PRSD_SV,"2025-05-18 21:57:50",1090,562,504,58,0,555,7,1200,638,259,296
28,MUREŞ,"ŞCOALA GIMNAZIALĂ NR.1 - LUDUȘ",173,"ORAŞ LUDUŞ",114710,1,PART,PRCNCT,PRSD,PRSD_SV,"2025-05-18 21:49:05",1095,621,546,74,1,614,7,1200,579,253,361
28,MUREŞ,"ȘCOALA PRIMARĂ MIERCUREA NIRAJULUI",174,"ORAŞ MIERCUREA NIRAJULUI",118281,1,PART,PRCNCT,PRSD,PRSD_SV,"2025-05-18 21:45:13",744,327,290,25,12,325,2,800,473,21,304
28,MUREŞ,"ŞCOALA GIMNAZIALĂ DEÁK FARKAS",175,"ORAŞ MIERCUREA NIRAJULUI",118281,1,PART,PRCNCT,PRSD,PRSD_SV,"2025-05-18 21:30:39",1507,896,737,94,65,887,9,1600,704,64,823
28,MUREŞ,"ȘCOALĂ GIMNAZIALĂ ”DEÁK FARKAS” MIERCUREA NIRAJULUI",176,"ORAŞ MIERCUREA NIRAJULUI",118281,2,PART,PRCNCT,PRSD,PRSD_SV,"2025-05-19 00:15:27",842,472,422,43,7,468,4,900,428,36,432
28,MUREŞ,"CAMINUL CULTURAL",177,"ORAŞ MIERCUREA NIRAJULUI",118281,1,PART,PRCNCT,PRSD,PRSD_SV,"2025-05-18 21:30:09",269,174,147,19,8,174,0,300,126,10,164
28,MUREŞ,"ŞCOALA PRIMARĂ",178,"ORAŞ MIERCUREA NIRAJULUI",118281,1,PART,PRCNCT,PRSD,PRSD_SV,"2025-05-18 21:38:47",285,184,119,62,3,182,2,350,166,79,103
28,MUREŞ,"ŞCOALA GIMNAZIALĂ",179,"ORAŞ MIERCUREA NIRAJULUI",118281,1,PART,PRCNCT,PRSD,PRSD_SV,"2025-05-18 21:24:10",581,249,213,35,1,248,1,650,401,97,151
28,MUREŞ,"CAMINUL CULTURAL",180,"ORAŞ MIERCUREA NIRAJULUI",118281,1,PART,PRCNCT,PRSD,PRSD_SV,"2025-05-18 21:23:10",476,162,139,18,5,161,1,550,388,21,140
28,MUREŞ,"SALĂ SPORT SĂRMAŞU",181,"ORAŞ SĂRMAŞU",119242,1,PART,PRCNCT,PRSD,PRSD_SV,"2025-05-18 22:00:53",1073,570,493,73,4,564,6,1150,580,197,367
28,MUREŞ,"LICEUL TEORETIC ”SAMUIL MICU” SĂRMAŞU",182,"ORAŞ SĂRMAŞU",119242,1,PART,PRCNCT,PRSD,PRSD_SV,"2025-05-18 21:36:45",788,399,347,37,15,397,2,900,501,112,285
28,MUREŞ,"LICEUL TEORETIC ”SAMUIL MICU” - ŞCOALA GIMNAZIALĂ SĂRMAŞU",183,"ORAŞ SĂRMAŞU",119242,1,PART,PRCNCT,PRSD,PRSD_SV,"2025-05-18 22:15:45",967,516,468,42,6,511,5,1050,534,249,262
28,MUREŞ,"ȘCOALA GENERALĂ BALDA",184,"ORAŞ SĂRMAŞU",119242,1,PART,PRCNCT,PRSD,PRSD_SV,"2025-05-18 21:49:03",905,415,373,42,0,411,4,1000,585,223,188
28,MUREŞ,"ŞCOALA PRIMARĂ LARGA",185,"ORAŞ SĂRMAŞU",119242,1,PART,PRCNCT,PRSD,PRSD_SV,"2025-05-18 21:16:52",136,57,45,12,0,57,0,150,93,35,22
28,MUREŞ,"ȘCOALA GENERALĂ SĂRMĂȘEL GARĂ",186,"ORAŞ SĂRMAŞU",119242,1,PART,PRCNCT,PRSD,PRSD_SV,"2025-05-18 21:46:05",536,311,255,53,3,310,1,600,289,185,125
28,MUREŞ,"CĂMINUL CULTURAL SĂRMĂŞEL",187,"ORAŞ SĂRMAŞU",119242,1,PART,PRCNCT,PRSD,PRSD_SV,"2025-05-18 21:43:28",592,342,292,47,3,340,2,650,308,166,174
28,MUREŞ,"CĂMINUL CULTURAL VIŞINELU",188,"ORAŞ SĂRMAŞU",119242,1,PART,PRCNCT,PRSD,PRSD_SV,"2025-05-18 21:42:13",329,205,172,33,0,204,1,400,195,134,70
28,MUREŞ,"CAMINUL CULTURAL SÂNGEORGIU DE PĂDURE",189,"ORAŞ SÂNGEORGIU DE PĂDURE",119331,1,PART,PRCNCT,PRSD,PRSD_SV,"2025-05-18 21:48:15",1204,659,588,41,30,652,7,1300,641,76,576
28,MUREŞ,"CAMINUL CULTURAL SÂNGEORGIU DE PĂDURE",190,"ORAŞ SÂNGEORGIU DE PĂDURE",119331,1,PART,PRCNCT,PRSD,PRSD_SV,"2025-05-18 21:37:41",1272,546,510,22,14,542,4,1400,854,153,389
28,MUREŞ,"LICEUL TEHNOLOGIC” SFÂNTUL GHEORGHE” SÂNGEORGIU DE PĂDURE",191,"ORAŞ SÂNGEORGIU DE PĂDURE",119331,1,PART,PRCNCT,PRSD,PRSD_SV,"2025-05-18 21:44:06",1278,673,552,59,62,664,9,1400,727,99,565
28,MUREŞ,"SCOALA GIMNAZIALĂ BEZID",192,"ORAŞ SÂNGEORGIU DE PĂDURE",119331,1,PART,PRCNCT,PRSD,PRSD_SV,"2025-05-18 21:27:19",482,294,226,50,18,290,4,550,256,11,279
28,MUREŞ,"ŞCOALA GIMNAZIALĂ ”S.ILLYES LAJOS” SOVATA",193,"ORAŞ SOVATA",114854,1,PART,PRCNCT,PRSD,PRSD_SV,"2025-05-18 21:31:43",929,543,423,112,8,538,5,1050,507,63,475
28,MUREŞ,"ŞCOALA GIMNAZIALĂ ”S.ILLYES LAJOS” SOVATA",194,"ORAŞ SOVATA",114854,1,PART,PRCNCT,PRSD,PRSD_SV,"2025-05-18 21:35:29",1430,784,742,36,6,779,5,1500,716,64,715
28,MUREŞ,"PRIMĂRIA ORAŞ SOVATA",195,"ORAŞ SOVATA",114854,1,PART,PRCNCT,PRSD,PRSD_SV,"2025-05-18 21:39:28",1364,829,672,133,24,826,3,1500,671,69,757
28,MUREŞ,"CENTRUL NAȚIONAL DE INFORMARE ȘI PROMOVARE TURISTICĂ SOVATA",196,"ORAŞ SOVATA",114854,1,PART,PRCNCT,PRSD,PRSD_SV,"2025-05-18 21:53:13",453,795,185,610,0,791,4,900,105,159,632
28,MUREŞ,"CENTRUL CULTURAL ”DOMOKOS KÁZMÉR” SOVATA",197,"ORAŞ SOVATA",114854,1,PART,PRCNCT,PRSD,PRSD_SV,"2025-05-18 21:47:28",1526,764,697,66,1,750,14,1700,936,105,645
28,MUREŞ,"ŞCOALA PRRIMARĂ SOVATA NR.3",198,"ORAŞ SOVATA",114854,1,PART,PRCNCT,PRSD,PRSD_SV,"2025-05-18 21:26:25",1093,553,508,41,4,546,7,1200,647,45,501
28,MUREŞ,"CĂMINUL CULTURAL SATUL ILIEŞI",199,"ORAŞ SOVATA",114854,1,PART,PRCNCT,PRSD,PRSD_SV,"2025-05-18 21:44:27",343,203,183,20,0,201,2,400,197,15,186
28,MUREŞ,"ŞCOALA PRIMARĂ SĂCĂDATU DE JOS",200,"ORAŞ SOVATA",114854,1,PART,PRCNCT,PRSD,PRSD_SV,"2025-05-18 21:30:49",1219,631,588,42,1,626,5,1350,719,93,533
28,MUREŞ,"ŞCOALA GIMNAZIALĂ ”EMIL DRĂGAN” UNGHENI",201,"ORAŞ UNGHENI",119894,1,PART,PRCNCT,PRSD,PRSD_SV,"2025-05-18 21:46:59",937,587,490,96,1,579,8,1000,413,246,333
28,MUREŞ,"ŞCOALA GIMNAZIALĂ ”EMIL DRĂGAN”UNGHENI",202,"ORAŞ UNGHENI",119894,1,PART,PRCNCT,PRSD,PRSD_SV,"2025-05-18 21:35:32",785,454,411,43,0,445,9,850,396,199,246
28,MUREŞ,"CĂMIN CULTURAL UNGHENI",203,"ORAŞ UNGHENI",119894,1,PART,PRCNCT,PRSD,PRSD_SV,"2025-05-18 21:38:51",887,459,365,92,2,449,10,950,491,194,255
28,MUREŞ,"CĂMIN CULTURAL UNGHENI",204,"ORAŞ UNGHENI",119894,1,PART,PRCNCT,PRSD,PRSD_SV,"2025-05-18 21:41:03",863,392,345,39,8,389,3,933,541,187,202
28,MUREŞ,"CĂMIN CULTURAL CERGHID",205,"ORAŞ UNGHENI",119894,1,PART,PRCNCT,PRSD,PRSD_SV,"2025-05-18 21:39:58",416,296,226,70,0,293,3,500,204,157,136
28,MUREŞ,"ȘCOALA PRIMARĂ CERGHIZEL",206,"ORAŞ UNGHENI",119894,1,PART,PRCNCT,PRSD,PRSD_SV,"2025-05-18 21:34:15",406,271,240,31,0,267,4,450,179,139,128
28,MUREŞ,"CĂMIN CULTURAL MOREŞTI",207,"ORAŞ UNGHENI",119894,1,PART,PRCNCT,PRSD,PRSD_SV,"2025-05-18 21:31:21",707,386,341,43,2,381,5,800,414,241,140
28,MUREŞ,"ȘCOALA PRIMARĂ ŞĂUŞA",208,"ORAŞ UNGHENI",119894,1,PART,PRCNCT,PRSD,PRSD_SV,"2025-05-18 21:15:45",242,114,94,20,0,109,5,300,186,59,50
28,MUREŞ,"ȘCOALA PRIMARĂ VIDRASĂU",209,"ORAŞ UNGHENI",119894,2,PART,PRCNCT,PRSD,PRSD_SV,"2025-05-18 23:38:05",980,519,450,67,2,515,4,1026,507,344,171
28,MUREŞ,"CĂMINUL CULTURAL ACĂŢARI",210,ACĂŢARI,114970,2,PART,PRCNCT,PRSD,PRSD_SV,"2025-05-18 23:14:25",990,594,487,69,38,588,6,1050,456,68,520
28,MUREŞ,"CENTRU DE COMUNITATE MULTIFUNCȚIONAL",211,ACĂŢARI,114970,1,PART,PRCNCT,PRSD,PRSD_SV,"2025-05-18 21:29:56",296,212,173,29,10,210,2,350,138,24,186
28,MUREŞ,"CĂMINUL CULTURAL GRUIȘOR",212,ACĂŢARI,114970,1,PART,PRCNCT,PRSD,PRSD_SV,"2025-05-18 21:17:39",319,210,180,17,13,208,2,350,140,20,188
28,MUREŞ,"CĂMIN CULTURAL MURGEȘTI",213,ACĂŢARI,114970,1,PART,PRCNCT,PRSD,PRSD_SV,"2025-05-18 21:22:57",413,294,240,34,20,292,2,450,156,27,265
28,MUREŞ,"CĂMINUL CULTURAL ROTENI",214,ACĂŢARI,114970,1,PART,PRCNCT,PRSD,PRSD_SV,"2025-05-18 21:29:27",608,449,401,30,18,444,5,700,251,35,409
28,MUREŞ,"CĂMIN CULTURAL STEJERIȘ",215,ACĂŢARI,114970,1,PART,PRCNCT,PRSD,PRSD_SV,"2025-05-18 21:21:19",272,164,126,31,7,159,5,301,137,23,136
28,MUREŞ,"CĂMIN CULTURAL SUVEICA",216,ACĂŢARI,114970,1,PART,PRCNCT,PRSD,PRSD_SV,"2025-05-18 21:34:00",178,121,84,26,11,119,2,200,79,13,106
28,MUREŞ,"CASA DE TINERET VĂLENII",217,ACĂŢARI,114970,1,PART,PRCNCT,PRSD,PRSD_SV,"2025-05-18 21:20:43",669,388,317,50,21,386,2,750,362,37,349
28,MUREŞ,"ȘCOALA GIMNAZIALĂ ADĂMUȘ",218,ADĂMUŞ,115076,1,PART,PRCNCT,PRSD,PRSD_SV,"2025-05-18 21:19:15",662,232,206,24,2,228,4,750,518,112,116
28,MUREŞ,"CĂMINUL CULTURAL ADĂMUȘ",219,ADĂMUŞ,115076,1,PART,PRCNCT,PRSD,PRSD_SV,"2025-05-18 21:17:41",1055,444,410,34,0,442,2,1100,656,270,172
28,MUREŞ,"CĂMINUL CULTURAL CORNEȘTI",220,ADĂMUŞ,115076,1,PART,PRCNCT,PRSD,PRSD_SV,"2025-05-18 21:29:48",931,372,330,40,2,363,9,1000,628,178,185
28,MUREŞ,"CĂMINUL CULTURAL CRĂIEȘTI",221,ADĂMUŞ,115076,1,PART,PRCNCT,PRSD,PRSD_SV,"2025-05-18 21:37:39",836,366,306,37,23,363,3,900,534,107,256
28,MUREŞ,"SCOALA GIMNAZIALĂ DÂMBĂU",222,ADĂMUŞ,115076,1,PART,PRCNCT,PRSD,PRSD_SV,"2025-05-18 21:26:58",848,391,346,37,8,390,1,950,559,113,277
28,MUREŞ,"CĂMIN CULTURAL ALBEȘTI",223,ALBEŞTI,114603,1,PART,PRCNCT,PRSD,PRSD_SV,"2025-05-18 22:21:37",1741,829,778,44,7,815,14,1900,1071,361,454
28,MUREŞ,"SALA DE SPORT",224,ALBEŞTI,114603,2,PART,PRCNCT,PRSD,PRSD_SV,"2025-05-19 02:02:40",1796,917,842,72,3,904,13,1900,983,430,474
28,MUREŞ,"CĂMINUL CULTURAL BOIU",225,ALBEŞTI,114603,1,PART,PRCNCT,PRSD,PRSD_SV,"2025-05-18 21:55:18",1176,500,466,34,0,496,4,1300,800,303,193
28,MUREŞ,"CĂMIN CULTURAL ȚOPA",226,ALBEŞTI,114603,1,PART,PRCNCT,PRSD,PRSD_SV,"2025-05-18 21:32:06",288,171,144,23,4,165,6,350,179,59,106
28,MUREŞ,"CĂMINUL CULTURAL ALUNIŞ-SALA MARE",227,ALUNIŞ,115147,1,PART,PRCNCT,PRSD,PRSD_SV,"2025-05-18 22:08:07",764,422,368,43,11,416,6,850,428,185,231
28,MUREŞ,"CĂMINUL CULTURAL ALUNIŞ-SALA MICĂ",228,ALUNIŞ,115147,1,PART,PRCNCT,PRSD,PRSD_SV,"2025-05-18 21:47:23",766,441,380,36,25,438,3,850,409,72,366
28,MUREŞ,"ŞCOALA PRIMARĂ FIŢCĂU",229,ALUNIŞ,115147,1,PART,PRCNCT,PRSD,PRSD_SV,"2025-05-18 21:54:35",380,252,216,19,17,252,0,450,198,28,224
28,MUREŞ,"CĂMINUL CULTURAL LUNCA- MUREŞ - SALA MICĂ",230,ALUNIŞ,115147,1,PART,PRCNCT,PRSD,PRSD_SV,"2025-05-18 21:34:54",525,345,274,36,35,343,2,600,255,31,312
28,MUREŞ,"ȘCOALA GIMNAZIALĂ APOLD",231,APOLD,115183,1,PART,PRCNCT,PRSD,PRSD_SV,"2025-05-18 21:37:01",853,330,275,55,0,329,1,950,620,207,122
28,MUREŞ,"ŞCOALA PRIMARĂ DAIA",232,APOLD,115183,1,PART,PRCNCT,PRSD,PRSD_SV,"2025-05-18 21:35:28",546,195,185,8,2,194,1,600,405,129,65
28,MUREŞ,"ŞCOALA GIMNAZIALĂ ŞAEŞ",233,APOLD,115183,1,PART,PRCNCT,PRSD,PRSD_SV,"2025-05-18 21:42:56",1122,385,348,37,0,385,0,1208,823,291,94
28,MUREŞ,"CĂMINUL CULTURAL AȚINTIȘ",234,AŢINTIŞ,115236,1,PART,PRCNCT,PRSD,PRSD_SV,"2025-05-18 21:40:08",559,264,200,60,4,262,2,600,336,150,112
28,MUREŞ,"CAMIN CULTURAL BOTEZ",235,AŢINTIŞ,115236,1,PART,PRCNCT,PRSD,PRSD_SV,"2025-05-18 21:19:47",146,79,60,19,0,78,1,200,121,52,26
28,MUREŞ,"CĂMINUL CULTURAL CECĂLACA",236,AŢINTIŞ,115236,1,PART,PRCNCT,PRSD,PRSD_SV,"2025-05-18 21:26:52",301,169,135,34,0,168,1,350,181,88,80
28,MUREŞ,"SCOALA PRIMARA ISTIHAZA",237,AŢINTIŞ,115236,1,PART,PRCNCT,PRSD,PRSD_SV,"2025-05-18 21:40:21",176,88,71,17,0,88,0,200,112,21,67
28,MUREŞ,"ŞCOALA GIMNAZIALĂ BAHNEA",238,BAHNEA,115307,1,PART,PRCNCT,PRSD,PRSD_SV,"2025-05-18 21:42:46",974,405,386,17,2,394,11,1050,645,218,176
28,MUREŞ,"ŞCOALA GIMNAZIALĂ BAHNEA",239,BAHNEA,115307,1,PART,PRCNCT,PRSD,PRSD_SV,"2025-05-18 21:26:51",563,262,236,26,0,258,4,600,338,99,159
28,MUREŞ,"CĂMIN CULTURAL BERNADEA",240,BAHNEA,115307,1,PART,PRCNCT,PRSD,PRSD_SV,"2025-05-18 21:37:41",164,105,81,24,0,105,0,200,95,58,47
28,MUREŞ,"ŞCOALA PRIMARĂ CUND",241,BAHNEA,115307,1,PART,PRCNCT,PRSD,PRSD_SV,"2025-05-18 21:46:18",169,91,65,26,0,90,1,200,109,46,44
28,MUREŞ,"ŞCOALA PRIMARĂ DAIA",242,BAHNEA,115307,1,PART,PRCNCT,PRSD,PRSD_SV,"2025-05-18 21:15:31",130,81,61,20,0,81,0,150,69,39,42
28,MUREŞ,"ŞCOALA GIMNAZIALĂ GOGAN",243,BAHNEA,115307,1,PART,PRCNCT,PRSD,PRSD_SV,"2025-05-18 21:17:52",401,177,151,26,0,175,2,450,273,50,125
28,MUREŞ,"CĂMIN CULTURAL IDICIU",244,BAHNEA,115307,1,PART,PRCNCT,PRSD,PRSD_SV,"2025-05-18 21:16:15",268,151,134,17,0,149,2,300,149,90,59
28,MUREŞ,"ŞCOALA PRIMARĂ LEPINDEA",245,BAHNEA,115307,1,PART,PRCNCT,PRSD,PRSD_SV,"2025-05-18 21:24:42",114,69,43,26,0,67,2,150,81,34,33
28,MUREŞ,"SCOALA PROFESIONALA BAND",246,BAND,115389,1,PART,PRCNCT,PRSD,PRSD_SV,"2025-05-18 21:37:30",661,312,290,22,0,311,1,700,388,60,251
28,MUREŞ,"ȘCOALA PROFESIONALĂ BAND",247,BAND,115389,1,PART,PRCNCT,PRSD,PRSD_SV,"2025-05-18 21:17:55",777,278,255,21,2,277,1,850,572,83,194
28,MUREŞ,"CAMIN CULTURAL BAND",248,BAND,115389,1,PART,PRCNCT,PRSD,PRSD_SV,"2025-05-18 21:25:52",1008,231,205,26,0,214,17,1100,869,133,81
28,MUREŞ,"GRĂDINIȚA CU PROGRAM NORMAL BAND",249,BAND,115389,1,PART,PRCNCT,PRSD,PRSD_SV,"2025-05-18 21:25:28",785,319,302,17,0,314,5,850,531,121,193
28,MUREŞ,"CĂMINUL CULTURAL DRĂCULEA BANDULUI",250,BAND,115389,1,PART,PRCNCT,PRSD,PRSD_SV,"2025-05-18 21:13:33",88,60,38,22,0,60,0,100,40,31,29
28,MUREŞ,"ŞCOALA GIMNAZIALĂ FÂNAȚE",251,BAND,115389,2,PART,PRCNCT,PRSD,PRSD_SV,"2025-05-19 02:13:36",308,147,127,20,0,145,2,350,203,102,43
28,MUREŞ,"ŞCOALA PRIMARĂ FÂNAȚE",252,BAND,115389,1,PART,PRCNCT,PRSD,PRSD_SV,"2025-05-18 21:20:45",173,78,59,19,0,78,0,200,122,62,16
28,MUREŞ,"ȘCOALA PRIMARĂ MĂRĂȘEȘTI",253,BAND,115389,1,PART,PRCNCT,PRSD,PRSD_SV,"2025-05-18 21:24:40",255,144,129,15,0,143,1,300,156,86,57
28,MUREŞ,"SALĂ ȘEDINȚĂ-PAROHIA REFORMATĂ NEGRENII DE CÂMPIE",254,BAND,115389,1,PART,PRCNCT,PRSD,PRSD_SV,"2025-05-18 21:17:18",97,59,38,21,0,58,1,150,91,10,48
28,MUREŞ,"CĂMIN CULTURAL OROIU",255,BAND,115389,2,PART,PRCNCT,PRSD,PRSD_SV,"2025-05-18 22:41:14",235,129,92,37,0,125,4,300,171,80,45
28,MUREŞ,"ŞCOALA PRIMARĂ PETEA",256,BAND,115389,1,PART,PRCNCT,PRSD,PRSD_SV,"2025-05-18 21:15:21",155,81,55,26,0,80,1,200,119,42,38
28,MUREŞ,"SALĂ FESTIVĂ ȚIPTELNIC",257,BAND,115389,1,PART,PRCNCT,PRSD,PRSD_SV,"2025-05-18 21:15:42",101,62,49,13,0,59,3,150,88,37,22
28,MUREŞ,"ȘCOALA PRIMARĂ VALEA RECE",258,BAND,115389,1,PART,PRCNCT,PRSD,PRSD_SV,"2025-05-18 21:33:47",199,80,55,25,0,79,1,250,170,43,36
28,MUREŞ,"CĂMIN CULTURAL BATOŞ",259,BATOŞ,115520,1,PART,PRCNCT,PRSD,PRSD_SV,"2025-05-18 21:43:11",1090,500,470,28,2,496,4,1200,700,223,273
28,MUREŞ,"CĂMIN CULTURAL DEDRAD",260,BATOŞ,115520,1,PART,PRCNCT,PRSD,PRSD_SV,"2025-05-18 21:46:55",1328,636,586,49,1,632,4,1450,814,370,262
28,MUREŞ,"CĂMIN CULTURAL GORENI",261,BATOŞ,115520,1,PART,PRCNCT,PRSD,PRSD_SV,"2025-05-18 21:50:02",491,223,199,24,0,222,1,550,327,134,88
28,MUREŞ,"CĂMIN CULTURAL UILA",262,BATOŞ,115520,1,PART,PRCNCT,PRSD,PRSD_SV,"2025-05-18 21:37:47",466,173,154,19,0,171,2,500,327,97,74
28,MUREŞ,"CĂMINUL CULTURAL BĂGACIU",263,BĂGACIU,115575,1,PART,PRCNCT,PRSD,PRSD_SV,"2025-05-18 21:30:37",1195,390,354,36,0,389,1,1300,910,313,76
28,MUREŞ,"CĂMIN CULTURAL DELENII",264,BĂGACIU,115575,1,PART,PRCNCT,PRSD,PRSD_SV,"2025-05-18 21:31:03",855,453,418,34,1,453,0,950,497,133,320
28,MUREŞ,"CĂMIN CULTURAL",265,BĂLA,115600,1,PART,PRCNCT,PRSD,PRSD_SV,"2025-05-18 21:30:12",381,218,150,54,14,216,2,450,232,77,139
28,MUREŞ,"ȘCOALA PRIMARĂ",266,BĂLA,115600,1,PART,PRCNCT,PRSD,PRSD_SV,"2025-05-18 21:17:56",113,70,48,22,0,69,1,150,80,42,27
28,MUREŞ,"CĂMINUL CULTURAL „EPERJESI MIMI”",267,BĂLĂUŞERI,115637,1,PART,PRCNCT,PRSD,PRSD_SV,"2025-05-18 21:27:56",919,378,305,42,31,376,2,1000,622,56,320
28,MUREŞ,"CĂMIN CULTURAL AGRIŞTEU",268,BĂLĂUŞERI,115637,1,PART,PRCNCT,PRSD,PRSD_SV,"2025-05-18 21:48:21",611,265,221,36,8,262,3,700,435,82,180
28,MUREŞ,"SCOALĂ GIMNAZIALĂ SAMUEL JOZSEF CHENDU",269,BĂLĂUŞERI,115637,2,PART,PRCNCT,PRSD,PRSD_SV,"2025-05-19 00:28:50",1136,626,550,38,38,620,6,1200,574,40,580
28,MUREŞ,"CĂMIN CULTURAL DUMITRENI",270,BĂLĂUŞERI,115637,1,PART,PRCNCT,PRSD,PRSD_SV,"2025-05-18 21:17:47",351,189,136,37,16,184,5,400,211,17,167
28,MUREŞ,"CĂMIN CULTURAL FILITELNIC",271,BĂLĂUŞERI,115637,1,PART,PRCNCT,PRSD,PRSD_SV,"2025-05-18 21:14:05",175,105,75,30,0,103,2,200,95,60,43
28,MUREŞ,"CĂMINUL CULTURAL SENEREUȘ",272,BĂLĂUŞERI,115637,1,PART,PRCNCT,PRSD,PRSD_SV,"2025-05-18 21:27:01",535,269,231,26,12,266,3,600,331,152,114
28,MUREŞ,"ȘCOALA PRIMARĂ BEICA DE JOS",273,"BEICA DE JOS",115708,2,PART,PRCNCT,PRSD,PRSD_SV,"2025-05-19 00:19:55",697,265,236,29,0,261,4,750,485,170,91
28,MUREŞ,"GRĂDINIȚA CU PROGRAM NORMAL BEICA DE SUS",274,"BEICA DE JOS",115708,1,PART,PRCNCT,PRSD,PRSD_SV,"2025-05-18 21:17:38",226,81,58,23,0,81,0,250,169,55,26
28,MUREŞ,"DISPENSAR CĂCUCIU",275,"BEICA DE JOS",115708,1,PART,PRCNCT,PRSD,PRSD_SV,"2025-05-18 21:40:58",127,91,58,33,0,91,0,180,89,52,39
28,MUREŞ,"ȘCOALA PRIMARĂ NADĂȘA",276,"BEICA DE JOS",115708,1,PART,PRCNCT,PRSD,PRSD_SV,"2025-05-18 21:16:18",167,115,85,30,0,115,0,200,85,66,49
28,MUREŞ,"CĂMINUL CULTURAL SÂNMIHAI DE PĂDURE",277,"BEICA DE JOS",115708,1,PART,PRCNCT,PRSD,PRSD_SV,"2025-05-18 21:23:07",181,105,77,27,1,105,0,200,95,33,72
28,MUREŞ,"CĂMIN CULTURAL ȘERBENI",278,"BEICA DE JOS",115708,1,PART,PRCNCT,PRSD,PRSD_SV,"2025-05-18 21:24:46",242,145,111,34,0,145,0,300,155,92,53
28,MUREŞ,"CĂMINUL CULTURAL BERENI",279,BERENI,120511,1,PART,PRCNCT,PRSD,PRSD_SV,"2025-05-18 21:38:26",442,265,185,56,24,260,5,500,235,31,229
28,MUREŞ,"LOCUINȚĂ DE SERVICIU",280,BERENI,120511,1,PART,PRCNCT,PRSD,PRSD_SV,"2025-05-18 21:11:40",196,151,114,25,12,149,2,250,99,12,137
28,MUREŞ,"ȘCOALA GIMNAZIALĂ MĂRCULENI",281,BERENI,120511,1,PART,PRCNCT,PRSD,PRSD_SV,"2025-05-18 21:18:39",339,201,147,19,35,200,1,400,199,15,185
28,MUREŞ,"CĂMIN CULTURAL BICHIŞ",282,BICHIŞ,115771,1,PART,PRCNCT,PRSD,PRSD_SV,"2025-05-18 21:27:14",138,91,54,35,2,90,1,203,112,7,83
28,MUREŞ,"CÃMIN CULTURAL GÎMBUŢ",283,BICHIŞ,115771,1,PART,PRCNCT,PRSD,PRSD_SV,"2025-05-18 21:26:05",112,64,49,15,0,64,0,150,86,37,27
28,MUREŞ,"ŞCOALA PRIMARĂ NANDRA",284,BICHIŞ,115771,1,PART,PRCNCT,PRSD,PRSD_SV,"2025-05-18 21:12:05",109,47,33,14,0,46,1,150,103,23,23
28,MUREŞ,"CĂMINUL CULTURAL OZD",285,BICHIŞ,115771,1,PART,PRCNCT,PRSD,PRSD_SV,"2025-05-18 21:18:28",230,180,113,47,20,180,0,300,120,29,151
28,MUREŞ,"PRIMARIA BOGATA",286,BOGATA,115824,1,PART,PRCNCT,PRSD,PRSD_SV,"2025-05-18 21:40:32",1272,655,554,77,24,650,5,1400,745,325,325
28,MUREŞ,"ŞCOALA PRIMARĂ",287,BOGATA,115824,1,PART,PRCNCT,PRSD,PRSD_SV,"2025-05-18 21:21:28",245,129,98,31,0,126,3,300,171,71,55
28,MUREŞ,"ȘCOALA PRIMARĂ",288,BRÂNCOVENEŞTI,115897,1,PART,PRCNCT,PRSD,PRSD_SV,"2025-05-18 22:07:00",1304,603,526,58,19,601,2,1400,797,169,432
28,MUREŞ,"ȘCOALA PRIMARĂ",289,BRÂNCOVENEŞTI,115897,1,PART,PRCNCT,PRSD,PRSD_SV,"2025-05-18 21:36:29",299,150,130,19,1,148,2,350,200,82,66
28,MUREŞ,"CĂMIN CULTURAL",290,BRÂNCOVENEŞTI,115897,1,PART,PRCNCT,PRSD,PRSD_SV,"2025-05-18 21:37:19",364,205,175,30,0,204,1,400,195,166,38
28,MUREŞ,"ȘCOALA PRIMARĂ",291,BRÂNCOVENEŞTI,115897,1,PART,PRCNCT,PRSD,PRSD_SV,"2025-05-18 21:30:34",250,150,118,32,0,147,3,300,150,87,60
28,MUREŞ,"CLUB-CĂMIN CULTURAL",292,BRÂNCOVENEŞTI,115897,1,PART,PRCNCT,PRSD,PRSD_SV,"2025-05-18 21:43:35",999,578,482,59,37,577,1,1100,522,72,505
28,MUREŞ,"CAMIN CULTURAL BREAZA",293,BREAZA,115851,1,PART,PRCNCT,PRSD,PRSD_SV,"2025-05-18 22:00:15",1057,657,593,64,0,652,5,1150,493,224,428
28,MUREŞ,"CĂMIN CULTURAL FILPIŞU MARE",294,BREAZA,115851,1,PART,PRCNCT,PRSD,PRSD_SV,"2025-05-18 21:37:01",634,324,273,50,1,322,2,700,376,176,146
28,MUREŞ,"ȘCOALA PRIMARĂ FILPIȘU MIC",295,BREAZA,115851,1,PART,PRCNCT,PRSD,PRSD_SV,"2025-05-18 21:45:37",334,216,188,24,4,213,3,400,184,78,135
28,MUREŞ,"PRIMĂRIA CEUAŞU DE CÂMPIE",296,"CEUAŞU DE CÂMPIE",115959,1,PART,PRCNCT,PRSD,PRSD_SV,"2025-05-18 21:47:06",1380,730,649,81,0,721,9,1500,770,242,479
28,MUREŞ,"CĂMINUL CULTURAL BOZED",297,"CEUAŞU DE CÂMPIE",115959,1,PART,PRCNCT,PRSD,PRSD_SV,"2025-05-18 21:24:39",99,64,40,24,0,64,0,150,86,28,36
28,MUREŞ,"CĂMINUL CULTURAL CÂMPENIŢA",298,"CEUAŞU DE CÂMPIE",115959,1,PART,PRCNCT,PRSD,PRSD_SV,"2025-05-18 21:28:07",710,445,400,45,0,444,1,800,355,31,413
28,MUREŞ,"CĂMINUL CULTURAL CULPIU",299,"CEUAŞU DE CÂMPIE",115959,1,PART,PRCNCT,PRSD,PRSD_SV,"2025-05-18 21:26:45",310,155,133,22,0,152,3,350,195,40,112
28,MUREŞ,"CĂMINUL CULTURAL HERGHELIA",300,"CEUAŞU DE CÂMPIE",115959,1,PART,PRCNCT,PRSD,PRSD_SV,"2025-05-18 21:31:06",353,215,173,42,0,211,4,400,185,119,92
28,MUREŞ,"ȘCOALA PRIMARĂ PORUMBENI",301,"CEUAŞU DE CÂMPIE",115959,1,PART,PRCNCT,PRSD,PRSD_SV,"2025-05-18 21:34:58",508,233,207,25,1,229,4,550,317,78,151
28,MUREŞ,"CĂMINUL CULTURAL SĂBED",302,"CEUAŞU DE CÂMPIE",115959,1,PART,PRCNCT,PRSD,PRSD_SV,"2025-05-18 21:33:35",628,357,308,49,0,357,0,700,343,49,308
28,MUREŞ,"CĂMINUL CULTURAL VOINICENI",303,"CEUAŞU DE CÂMPIE",115959,1,PART,PRCNCT,PRSD,PRSD_SV,"2025-05-18 21:35:24",991,597,506,91,0,589,8,1050,453,307,282
28,MUREŞ,"SEDIUL PRIMARIEI CHETANI",304,CHEŢANI,116046,1,PART,PRCNCT,PRSD,PRSD_SV,"2025-05-18 21:52:34",910,571,484,86,1,565,6,1000,429,296,269
28,MUREŞ,"CAMIN CULTURAL",305,CHEŢANI,116046,1,PART,PRCNCT,PRSD,PRSD_SV,"2025-05-18 21:44:09",463,251,199,52,0,248,3,500,249,127,121
28,MUREŞ,"CAMIN CULTURAL HADARENI",306,CHEŢANI,116046,1,PART,PRCNCT,PRSD,PRSD_SV,"2025-05-18 22:05:35",658,354,290,64,0,351,3,750,396,184,167
28,MUREŞ,"PRIMĂRIA COMUNEI CHIBED",307,CHIBED,120478,1,PART,PRCNCT,PRSD,PRSD_SV,"2025-05-18 22:14:57",1313,714,638,74,2,710,4,1450,736,35,675
28,MUREŞ,"SEDIUL PRIMĂRIEI COMUNEI CHIHERU DE JOS",308,"CHIHERU DE JOS",116126,1,PART,PRCNCT,PRSD,PRSD_SV,"2025-05-18 21:34:26",353,225,169,51,5,222,3,400,175,116,106
28,MUREŞ,"ŞCOALA PRIMARĂ CHIHERU DE SUS",309,"CHIHERU DE JOS",116126,1,PART,PRCNCT,PRSD,PRSD_SV,"2025-05-18 21:21:41",306,159,122,37,0,157,2,350,191,92,65
28,MUREŞ,"ŞCOALA PRIMARĂ URISIU DE JOS",310,"CHIHERU DE JOS",116126,1,PART,PRCNCT,PRSD,PRSD_SV,"2025-05-18 21:35:22",253,157,117,37,3,155,2,300,143,81,74
28,MUREŞ,"CAMINUL CULTURAL URISIU DE SUS",311,"CHIHERU DE JOS",116126,1,PART,PRCNCT,PRSD,PRSD_SV,"2025-05-18 21:31:27",328,193,163,30,0,192,1,350,157,81,111
28,MUREŞ,"ȘCOALA PRIMARĂ COROISÂNMĂRTIN",312,COROISÂNMĂRTIN,116171,1,PART,PRCNCT,PRSD,PRSD_SV,"2025-05-18 21:20:43",321,142,111,31,0,141,1,350,208,102,39
28,MUREŞ,"ȘCOALA PRIMARĂ COROI",313,COROISÂNMĂRTIN,116171,1,PART,PRCNCT,PRSD,PRSD_SV,"2025-05-18 21:28:05",89,59,30,29,0,59,0,150,91,34,25
28,MUREŞ,"CĂMINUL CULTURAL ODRIHEI",314,COROISÂNMĂRTIN,116171,1,PART,PRCNCT,PRSD,PRSD_SV,"2025-05-18 21:32:28",431,202,176,26,0,200,2,500,298,110,90
28,MUREŞ,"ȘCOALA PRIMARĂ ȘOIMUȘ",315,COROISÂNMĂRTIN,116171,1,PART,PRCNCT,PRSD,PRSD_SV,"2025-05-18 21:32:08",298,165,124,41,0,164,1,350,185,109,55
28,MUREŞ,"ȘCOALA GIMNAZIALĂ THOLDALAGI MIHALY",316,CORUNCA,120487,1,PART,PRCNCT,PRSD,PRSD_SV,"2025-05-18 22:03:54",1535,926,741,179,6,909,17,1620,694,143,766
28,MUREŞ,"ȘCOALA GIMNAZIALĂ THOLDALAGI MIHALY",317,CORUNCA,120487,1,PART,PRCNCT,PRSD,PRSD_SV,"2025-05-18 21:54:19",1797,1392,1245,142,5,1380,12,1900,508,279,1101
28,MUREŞ,"CĂMINUL CULTURAL BOZENI",318,CORUNCA,120487,1,PART,PRCNCT,PRSD,PRSD_SV,"2025-05-18 21:33:41",136,126,87,39,0,125,1,200,74,7,118
28,MUREŞ,"CĂMINUL CULTURAL COZMA",319,COZMA,116224,1,PART,PRCNCT,PRSD,PRSD_SV,"2025-05-18 21:29:12",299,185,145,29,11,184,1,350,165,71,113
28,MUREŞ,"CAMIN CULTURAL",320,COZMA,116224,1,PART,PRCNCT,PRSD,PRSD_SV,"2025-05-18 21:17:56",90,82,46,15,21,82,0,150,68,21,61
28,MUREŞ,"CĂMIN CULTURAL CRĂCIUNEŞTI SALA MICĂ",321,CRĂCIUNEŞTI,116288,1,PART,PRCNCT,PRSD,PRSD_SV,"2025-05-18 21:49:29",752,219,170,26,23,217,2,800,581,52,165
28,MUREŞ,"CĂMINUL CULTURAL CRĂCIUNEŞTI SALA MARE",322,CRĂCIUNEŞTI,116288,1,PART,PRCNCT,PRSD,PRSD_SV,"2025-05-18 21:35:38",1100,578,530,39,9,574,4,1200,622,51,523
28,MUREŞ,"ŞCOALA PRIMARĂ BUDIU MIC",323,CRĂCIUNEŞTI,116288,1,PART,PRCNCT,PRSD,PRSD_SV,"2025-05-18 21:30:33",414,206,176,30,0,204,2,450,244,52,152
28,MUREŞ,"ŞCOALA PRIMARĂ CINTA",324,CRĂCIUNEŞTI,116288,1,PART,PRCNCT,PRSD,PRSD_SV,"2025-05-18 21:30:02",399,296,248,34,14,296,0,450,154,24,272
28,MUREŞ,"CĂMINUL CULTURAL CORNEŞTI",325,CRĂCIUNEŞTI,116288,1,PART,PRCNCT,PRSD,PRSD_SV,"2025-05-18 21:54:25",715,485,440,31,14,480,5,800,315,51,429
28,MUREŞ,"PRIMARIA COMUNEI CRAIESTI",326,CRĂIEŞTI,116340,1,PART,PRCNCT,PRSD,PRSD_SV,"2025-05-18 21:52:13",492,284,239,45,0,284,0,550,266,178,106
28,MUREŞ,"CĂMIN CULTURAL LEFAIA",327,CRĂIEŞTI,116340,1,PART,PRCNCT,PRSD,PRSD_SV,"2025-05-18 21:18:48",42,42,29,13,0,42,0,100,58,25,17
28,MUREŞ,"CĂMIN CULTURAL MILAȘEL",328,CRĂIEŞTI,116340,1,PART,PRCNCT,PRSD,PRSD_SV,"2025-05-18 21:33:47",132,70,52,18,0,70,0,150,80,45,25
28,MUREŞ,"CĂMINUL CULTURAL CRISTEȘTI",329,CRISTEŞTI,114355,1,PART,PRCNCT,PRSD,PRSD_SV,"2025-05-18 21:31:43",1440,800,731,67,2,795,5,1550,750,248,547
28,MUREŞ,"GRĂDINIȚA CU PROGRAM PRELUNGIT CRISTEȘTI",330,CRISTEŞTI,114355,1,PART,PRCNCT,PRSD,PRSD_SV,"2025-05-18 21:34:14",1257,770,690,80,0,759,11,1400,630,258,501
28,MUREŞ,"GRĂDINIȚA CU PROGRAM NORMAL CRISTEŞTI",331,CRISTEŞTI,114355,1,PART,PRCNCT,PRSD,PRSD_SV,"2025-05-18 21:56:44",1401,768,697,68,3,758,10,1500,732,305,453
28,MUREŞ,"CĂMINUL CULTURAL",332,CRISTEŞTI,114355,1,PART,PRCNCT,PRSD,PRSD_SV,"2025-05-18 21:24:26",805,355,311,43,1,354,1,900,545,71,283
28,MUREŞ,"PRIMĂRIA COMUNEI CUCERDEA",333,CUCERDEA,116395,1,PART,PRCNCT,PRSD,PRSD_SV,"2025-05-18 21:34:51",533,305,233,72,0,304,1,600,295,135,169
28,MUREŞ,"CĂMIN CULTURAL BORD",334,CUCERDEA,116395,1,PART,PRCNCT,PRSD,PRSD_SV,"2025-05-18 21:19:47",94,55,40,15,0,54,1,120,65,29,25
28,MUREŞ,"ȘCOALA GIMNAZIALĂ ȘEULIA DE MUREȘ",335,CUCERDEA,116395,1,PART,PRCNCT,PRSD,PRSD_SV,"2025-05-18 21:27:30",443,238,193,45,0,235,3,500,262,118,117
28,MUREŞ,"PRIMĂRIA CUCI",336,CUCI,116439,1,PART,PRCNCT,PRSD,PRSD_SV,"2025-05-18 21:26:48",665,380,332,28,20,375,5,750,370,162,213
28,MUREŞ,"SCOALA PRIMARĂ",337,CUCI,116439,1,PART,PRCNCT,PRSD,PRSD_SV,"2025-05-18 21:23:12",240,162,106,55,1,161,1,292,130,97,64
28,MUREŞ,"CAMIN CULTURAL",338,CUCI,116439,1,PART,PRCNCT,PRSD,PRSD_SV,"2025-05-18 21:31:08",133,79,56,23,0,78,1,150,71,36,42
28,MUREŞ,"CĂMIN CULTURAL",339,CUCI,116439,1,PART,PRCNCT,PRSD,PRSD_SV,"2025-05-18 21:33:33",419,175,144,31,0,172,3,500,325,115,57
28,MUREŞ,"SEDIUL PRIMĂRIEI DANEȘ-SALĂ OFICIERE CĂSĂTORII",340,DANEŞ,116493,1,PART,PRCNCT,PRSD,PRSD_SV,"2025-05-18 21:49:30",966,498,438,60,0,494,4,1050,552,262,232
28,MUREŞ,"CLUBUL TINERETULUI",341,DANEŞ,116493,1,PART,PRCNCT,PRSD,PRSD_SV,"2025-05-18 21:48:22",1030,459,421,38,0,455,4,1100,641,298,157
28,MUREŞ,"ŞCOALA GIMNAZIALA INV.”STROIESCU IOAN ”CRIŞ",342,DANEŞ,116493,1,PART,PRCNCT,PRSD,PRSD_SV,"2025-05-18 21:41:39",557,225,182,41,2,224,1,600,375,132,92
28,MUREŞ,"SCOALA GIMNAZIALA SELEUS-DANES",343,DANEŞ,116493,1,PART,PRCNCT,PRSD,PRSD_SV,"2025-05-18 21:32:21",901,362,338,24,0,358,4,1000,638,253,105
28,MUREŞ,"SCOALA GIMNAZIALA SELEUS-DANES",344,DANEŞ,116493,1,PART,PRCNCT,PRSD,PRSD_SV,"2025-05-18 21:30:20",946,359,346,13,0,347,12,1050,691,250,97
28,MUREŞ,"CĂMINUL CULTURAL STEJĂRENII",345,DANEŞ,116493,1,PART,PRCNCT,PRSD,PRSD_SV,"2025-05-18 21:21:02",271,94,69,25,0,94,0,300,206,56,38
28,MUREŞ,"CĂMIN CULTURAL DEDA",346,DEDA,116545,1,PART,PRCNCT,PRSD,PRSD_SV,"2025-05-18 22:33:15",1515,866,768,83,15,850,16,1600,734,531,319
28,MUREŞ,"ŞCOALA GIMNAZIALĂ BISTRA-MUREŞULUI",347,DEDA,116545,1,PART,PRCNCT,PRSD,PRSD_SV,"2025-05-18 21:44:12",824,546,450,93,3,539,7,900,354,339,200
28,MUREŞ,"ŞCOALA PRIMARĂ FILEA",348,DEDA,116545,1,PART,PRCNCT,PRSD,PRSD_SV,"2025-05-18 21:42:59",579,329,302,27,0,326,3,650,321,202,124
28,MUREŞ,"ŞCOALA PRIMARĂ PIETRŞ",349,DEDA,116545,1,PART,PRCNCT,PRSD,PRSD_SV,"2025-05-18 21:53:01",389,237,195,42,0,235,2,450,213,125,110
28,MUREŞ,"ȘCOALA GIMNAZIALĂ ”DR. NYULAS FERENC ” EREMITU",350,EREMITU,116590,1,PART,PRCNCT,PRSD,PRSD_SV,"2025-05-18 21:47:10",1470,763,686,55,22,755,8,1600,837,133,622
28,MUREŞ,"ȘCOALA PRIMARĂ CĂLUGĂRENI",351,EREMITU,116590,1,PART,PRCNCT,PRSD,PRSD_SV,"2025-05-18 21:48:11",461,200,156,38,6,193,7,500,300,31,162
28,MUREŞ,"ȘCOALA PRIMARĂ CÎMPU CETĂŢII",352,EREMITU,116590,1,PART,PRCNCT,PRSD,PRSD_SV,"2025-05-18 21:33:26",289,214,140,74,0,213,1,350,136,19,194
28,MUREŞ,"CĂMINUL CULTURAL DĂMIENI",353,EREMITU,116590,1,PART,PRCNCT,PRSD,PRSD_SV,"2025-05-18 21:34:17",179,119,87,29,3,119,0,200,81,13,106
28,MUREŞ,"ȘCOALA GIMNAZIALĂ MĂTRICI",354,EREMITU,116590,1,PART,PRCNCT,PRSD,PRSD_SV,"2025-05-18 21:48:13",744,422,353,65,4,418,4,800,378,39,379
28,MUREŞ,"PRIMĂRIA COMUNEI ERNEI-BIROUL PRIMARULUI",355,ERNEI,116652,1,PART,PRCNCT,PRSD,PRSD_SV,"2025-05-18 21:29:46",891,496,417,54,25,491,5,1000,504,86,405
28,MUREŞ,"SALA DE ŞEDINŢE - PRIMĂRIA COMUNEI ERNEI",356,ERNEI,116652,1,PART,PRCNCT,PRSD,PRSD_SV,"2025-05-18 21:48:45",1227,686,581,79,26,679,7,1300,614,124,555
28,MUREŞ,"CĂMINUL CULTURAL CĂLUŞERI",357,ERNEI,116652,1,PART,PRCNCT,PRSD,PRSD_SV,"2025-05-18 21:26:38",461,270,215,36,19,269,1,500,230,21,248
28,MUREŞ,"CĂMINUL CULTURAL DUMBRĂVIOARA",358,ERNEI,116652,1,PART,PRCNCT,PRSD,PRSD_SV,"2025-05-18 21:25:34",1482,774,692,57,25,766,8,1600,826,123,643
28,MUREŞ,"CĂMINUL CULTURAL ICLAND",359,ERNEI,116652,1,PART,PRCNCT,PRSD,PRSD_SV,"2025-05-18 21:31:03",324,183,153,26,4,181,2,350,167,26,155
28,MUREŞ,"SCOALA PRIMARĂ SĂCĂRENI",360,ERNEI,116652,1,PART,PRCNCT,PRSD,PRSD_SV,"2025-05-18 21:22:15",212,148,86,57,5,148,0,250,102,14,134
28,MUREŞ,"CĂMINUL CULTURAL SÎNGERU DE PĂDURE",361,ERNEI,116652,1,PART,PRCNCT,PRSD,PRSD_SV,"2025-05-18 21:20:45",314,100,77,23,0,96,4,350,250,62,34
28,MUREŞ,"SEDIU PRIMARIE",362,FĂRĂGĂU,116723,1,PART,PRCNCT,PRSD,PRSD_SV,"2025-05-18 21:38:04",347,241,189,50,2,235,6,450,209,130,105
28,MUREŞ,"CLĂDIREA FOSTULUI CAP POARTA",363,FĂRĂGĂU,116723,1,PART,PRCNCT,PRSD,PRSD_SV,"2025-05-18 21:23:27",184,120,85,35,0,119,1,200,80,69,50
28,MUREŞ,"ȘCOALA GENERALA TONCIU",364,FĂRĂGĂU,116723,1,PART,PRCNCT,PRSD,PRSD_SV,"2025-05-18 21:40:15",726,287,264,23,0,276,11,800,513,232,44
28,MUREŞ,"ŞCOALA GIMNAZIALĂ FÎNTÎNELE",365,FÂNTÂNELE,116796,1,PART,PRCNCT,PRSD,PRSD_SV,"2025-05-18 21:34:58",956,533,448,39,46,528,5,1000,467,30,498
28,MUREŞ,"ŞCOALA GIMNAZIALĂ FÎNTÎNELE",366,FÂNTÂNELE,116796,1,PART,PRCNCT,PRSD,PRSD_SV,"2025-05-18 21:58:23",955,505,410,39,56,499,6,1000,495,43,456
28,MUREŞ,"ŞCOALA PRIMARĂ BORDOŞIU",367,FÂNTÂNELE,116796,1,PART,PRCNCT,PRSD,PRSD_SV,"2025-05-18 21:22:01",244,108,85,22,1,106,2,300,192,11,95
28,MUREŞ,"ŞCOALA GIMNAZIALĂ CĂLIMĂNEŞTI",368,FÂNTÂNELE,116796,1,PART,PRCNCT,PRSD,PRSD_SV,"2025-05-18 21:21:01",713,386,291,55,40,382,4,800,414,28,354
28,MUREŞ,"GRĂDINIŢA CU PROGRAM NORMAL CIBU",369,FÂNTÂNELE,116796,1,PART,PRCNCT,PRSD,PRSD_SV,"2025-05-18 21:12:12",70,47,26,15,6,46,1,100,53,5,41
28,MUREŞ,"ŞCOALA PRIMARĂ ROUA",370,FÂNTÂNELE,116796,1,PART,PRCNCT,PRSD,PRSD_SV,"2025-05-18 21:14:28",290,84,62,20,2,80,4,350,266,24,56
28,MUREŞ,"CĂMIN CULTURAL VIFOROASA",371,FÂNTÂNELE,116796,1,PART,PRCNCT,PRSD,PRSD_SV,"2025-05-18 21:31:11",672,369,306,31,32,364,5,750,381,32,332
28,MUREŞ,"ȘCOALA GIMNAZIALĂ „SZENTIVÁNI MIHÁLY”",372,GĂLEŞTI,116867,1,PART,PRCNCT,PRSD,PRSD_SV,"2025-05-18 21:18:03",737,281,248,29,4,273,8,800,519,27,246
28,MUREŞ,"ŞCOALA PRIMARĂ ADRIANU MARE",373,GĂLEŞTI,116867,1,PART,PRCNCT,PRSD,PRSD_SV,"2025-05-18 21:12:23",104,99,53,44,2,99,0,150,51,7,92
28,MUREŞ,"CĂMINUL CULTURAL BEDENI",374,GĂLEŞTI,116867,1,PART,PRCNCT,PRSD,PRSD_SV,"2025-05-18 21:15:08",98,78,45,23,10,78,0,150,72,7,71
28,MUREŞ,"ŞCOALA PRIMARĂ MAIAD",375,GĂLEŞTI,116867,1,PART,PRCNCT,PRSD,PRSD_SV,"2025-05-18 21:16:03",216,136,85,51,0,134,2,200,64,24,110
28,MUREŞ,"CĂMINUL CULTURAL SÂNVĂSII",376,GĂLEŞTI,116867,1,PART,PRCNCT,PRSD,PRSD_SV,"2025-05-18 21:21:56",249,157,125,28,4,157,0,300,143,4,153
28,MUREŞ,"ŞCOALA GIMNAZIALĂ TROIŢA",377,GĂLEŞTI,116867,1,PART,PRCNCT,PRSD,PRSD_SV,"2025-05-18 21:15:44",547,289,236,39,14,286,3,600,311,16,270
28,MUREŞ,"SALA DE SPORT GĂNEŞTI",378,GĂNEŞTI,116938,1,PART,PRCNCT,PRSD,PRSD_SV,"2025-05-18 21:41:48",956,529,485,38,6,526,3,1000,471,174,352
28,MUREŞ,"ŞCOALA GIMNAZIALĂ FOGARASI SAMUEL GĂNEŞTI",379,GĂNEŞTI,116938,1,PART,PRCNCT,PRSD,PRSD_SV,"2025-05-18 21:25:34",747,445,400,30,15,441,4,850,405,92,349
28,MUREŞ,"ŞCOALA PRIMARĂ PĂUCIŞOARA",380,GĂNEŞTI,116938,1,PART,PRCNCT,PRSD,PRSD_SV,"2025-05-18 21:17:26",203,105,79,24,2,103,2,250,145,48,55
28,MUREŞ,"CĂMINUL CULTURAL SEUCA",381,GĂNEŞTI,116938,1,PART,PRCNCT,PRSD,PRSD_SV,"2025-05-18 21:32:51",922,515,448,44,23,509,6,1000,485,178,331
28,MUREŞ,"CĂMINUL CULTURAL GHEORGHE DOJA",382,"GHEORGHE DOJA",116983,1,PART,PRCNCT,PRSD,PRSD_SV,"2025-05-18 21:36:14",400,259,185,66,8,259,0,450,191,27,232
28,MUREŞ,"CĂMINUL CULTURAL ILIENI",383,"GHEORGHE DOJA",116983,1,PART,PRCNCT,PRSD,PRSD_SV,"2025-05-18 21:19:44",322,223,179,34,10,222,1,350,127,9,213
28,MUREŞ,"CĂMINUL CULTURAL LEORDENI",384,"GHEORGHE DOJA",116983,1,PART,PRCNCT,PRSD,PRSD_SV,"2025-05-18 21:42:49",323,220,150,54,16,219,1,350,130,18,201
28,MUREŞ,"CĂMIN CULTURAL SATU NOU",385,"GHEORGHE DOJA",116983,1,PART,PRCNCT,PRSD,PRSD_SV,"2025-05-18 21:25:22",643,349,305,22,22,349,0,698,349,56,293
28,MUREŞ,"CĂMIN CULTURAL TIRIMIA",386,"GHEORGHE DOJA",116983,1,PART,PRCNCT,PRSD,PRSD_SV,"2025-05-18 21:28:55",745,395,331,62,2,391,4,800,405,201,190
28,MUREŞ,"CĂMINUL CULTURAL GHINDARI",387,GHINDARI,117042,1,PART,PRCNCT,PRSD,PRSD_SV,"2025-05-18 21:48:40",1281,520,433,86,1,515,5,1400,880,57,458
28,MUREŞ,"ȘCOALĂ PRIMARĂ ABUD",388,GHINDARI,117042,1,PART,PRCNCT,PRSD,PRSD_SV,"2025-05-18 21:16:04",91,70,42,28,0,70,0,100,30,7,63
28,MUREŞ,"ȘCOALĂ PRIMARĂ SOLOCMA",389,GHINDARI,117042,1,PART,PRCNCT,PRSD,PRSD_SV,"2025-05-18 21:27:20",243,143,105,38,0,141,2,300,157,11,130
28,MUREŞ,"CĂMIN CULTURAL TREI SATE",390,GHINDARI,117042,1,PART,PRCNCT,PRSD,PRSD_SV,"2025-05-18 21:40:29",1012,406,346,50,10,398,8,1100,694,42,356
28,MUREŞ,"ȘCOALA GIMNAZIALĂ „ADORJANI KAROLY” GLODENI",391,GLODENI,117113,1,PART,PRCNCT,PRSD,PRSD_SV,"2025-05-18 21:26:21",1010,388,331,43,14,379,9,1100,712,148,231
28,MUREŞ,"ȘCOALA GIMNAZIALĂ „ADORJANI KAROLY” GLODENI",392,GLODENI,117113,1,PART,PRCNCT,PRSD,PRSD_SV,"2025-05-18 22:03:51",1061,666,536,43,87,661,5,1100,434,104,557
28,MUREŞ,"CĂMINUL CULTURAL MERIȘOR",393,GLODENI,117113,1,PART,PRCNCT,PRSD,PRSD_SV,"2025-05-18 21:20:43",116,78,46,32,0,76,2,150,72,49,27
28,MUREŞ,"ŞCOALA PRIMARĂ MOIȘA",394,GLODENI,117113,1,PART,PRCNCT,PRSD,PRSD_SV,"2025-05-18 21:26:15",178,83,64,19,0,83,0,200,117,50,33
28,MUREŞ,"ŞCOALA PRIMARĂ PĂCURENI",395,GLODENI,117113,1,PART,PRCNCT,PRSD,PRSD_SV,"2025-05-18 21:33:33",172,137,101,24,12,136,1,200,63,16,120
28,MUREŞ,"ȘCOALA PRIMARĂ PĂINGENI",396,GLODENI,117113,1,PART,PRCNCT,PRSD,PRSD_SV,"2025-05-18 21:34:35",293,218,154,35,29,217,1,350,132,22,195
28,MUREŞ,"SCOALA GIMNAZIALA TELEKI DOMOKOS",397,GORNEŞTI,117177,1,PART,PRCNCT,PRSD,PRSD_SV,"2025-05-18 21:33:08",811,456,399,42,15,447,9,900,444,116,331
28,MUREŞ,"GRADINITA CU PROGRAM NORMAL",398,GORNEŞTI,117177,1,PART,PRCNCT,PRSD,PRSD_SV,"2025-05-18 21:38:20",780,409,353,38,18,405,4,850,441,127,278
28,MUREŞ,"CĂMINUL CULTURAL IARA DE MUREŞ",399,GORNEŞTI,117177,1,PART,PRCNCT,PRSD,PRSD_SV,"2025-05-18 21:16:45",242,155,106,42,7,154,1,300,145,22,132
28,MUREŞ,"CAMIN CULTURAL",400,GORNEŞTI,117177,1,PART,PRCNCT,PRSD,PRSD_SV,"2025-05-18 21:19:31",84,50,26,21,3,48,2,100,50,7,41
28,MUREŞ,"CAMIN CULTURAL",401,GORNEŞTI,117177,1,PART,PRCNCT,PRSD,PRSD_SV,"2025-05-18 21:29:03",353,263,214,32,17,261,1,400,137,14,247
28,MUREŞ,"ȘCOALA GIMNAZIALĂ PERIȘ",402,GORNEŞTI,117177,1,PART,PRCNCT,PRSD,PRSD_SV,"2025-05-18 21:38:13",1504,893,797,79,17,884,9,1600,707,143,741
28,MUREŞ,"ȘCOALA PRIMARĂ PETRILACA DE MUREȘ",403,GORNEŞTI,117177,2,PART,PRCNCT,PRSD,PRSD_SV,"2025-05-19 00:17:47",343,179,148,31,0,178,1,400,221,23,155
28,MUREŞ,"CĂMIN CULTURAL TELEAC",404,GORNEŞTI,117177,1,PART,PRCNCT,PRSD,PRSD_SV,"2025-05-18 21:29:34",288,157,111,43,3,155,2,350,193,81,74
28,MUREŞ,"CĂMIN CULTURAL GREBENISU DE CIMPIE",405,"GREBENIŞU DE CÂMPIE",117275,1,PART,PRCNCT,PRSD,PRSD_SV,"2025-05-18 22:04:22",1331,657,584,63,10,653,4,1500,843,472,181
28,MUREŞ,"CĂMINUL CULTURAL GURGHIU",406,GURGHIU,117319,1,PART,PRCNCT,PRSD,PRSD_SV,"2025-05-18 21:27:34",879,468,423,45,0,466,2,900,432,308,158
28,MUREŞ,"CAMINUL CULTURAL GURGHIU",407,GURGHIU,117319,1,PART,PRCNCT,PRSD,PRSD_SV,"2025-05-18 21:34:48",722,325,292,33,0,321,4,800,475,204,117
28,MUREŞ,"CĂMINUL CULTURAL ADRIAN",408,GURGHIU,117319,1,PART,PRCNCT,PRSD,PRSD_SV,"2025-05-18 21:23:05",251,124,99,25,0,123,1,300,176,86,37
28,MUREŞ,"SCOALA PRIMARA CASVA",409,GURGHIU,117319,1,PART,PRCNCT,PRSD,PRSD_SV,"2025-05-18 21:37:29",641,371,325,46,0,367,4,700,329,246,121
28,MUREŞ,"FOSTA SCOALA PRIMARA COMORI",410,GURGHIU,117319,1,PART,PRCNCT,PRSD,PRSD_SV,"2025-05-18 21:19:46",146,96,72,24,0,95,1,200,104,53,42
28,MUREŞ,"CAMINUL CULTURAL GLAJARIE",411,GURGHIU,117319,1,PART,PRCNCT,PRSD,PRSD_SV,"2025-05-18 21:44:13",1369,708,633,52,23,704,4,1450,742,128,576
28,MUREŞ,"SCOALA PRIMARA LARGA",412,GURGHIU,117319,1,PART,PRCNCT,PRSD,PRSD_SV,"2025-05-18 21:30:28",197,125,96,29,0,124,1,250,125,81,43
28,MUREŞ,"CAMINUL CULTURAL ORSOVA",413,GURGHIU,117319,1,PART,PRCNCT,PRSD,PRSD_SV,"2025-05-18 21:30:40",624,312,285,27,0,306,6,700,388,192,114
28,MUREŞ,"ȘCOALA GIMNAZIALĂ HODAC",414,HODAC,117426,1,PART,PRCNCT,PRSD,PRSD_SV,"2025-05-18 21:32:28",994,396,343,53,0,394,2,1077,681,310,84
28,MUREŞ,"ȘCOALA GIMNAZIALĂ HODAC",415,HODAC,117426,1,PART,PRCNCT,PRSD,PRSD_SV,"2025-05-18 21:34:04",1058,517,483,34,0,515,2,1100,583,365,150
28,MUREŞ,"SCOALA GIMNAZIALA DUBISTEA DE PADURE",416,HODAC,117426,1,PART,PRCNCT,PRSD,PRSD_SV,"2025-05-18 21:30:59",378,220,195,24,1,219,1,450,230,167,52
28,MUREŞ,"GRADINITA CU PROGRAM NORMAL TOACA",417,HODAC,117426,1,PART,PRCNCT,PRSD,PRSD_SV,"2025-05-18 21:46:41",658,373,346,27,0,372,1,750,377,251,121
28,MUREŞ,"ȘCOALA GIMNAZIALĂ TOACA",418,HODAC,117426,1,PART,PRCNCT,PRSD,PRSD_SV,"2025-05-18 21:53:06",816,438,406,32,0,437,1,900,462,294,143
28,MUREŞ,"PRIMĂRIA COMUNEI HODOȘA",419,HODOŞA,117505,1,PART,PRCNCT,PRSD,PRSD_SV,"2025-05-18 21:56:20",177,136,115,21,0,136,0,200,64,20,116
28,MUREŞ,"ȘCOALA PRIMARĂ IHOD",420,HODOŞA,117505,1,PART,PRCNCT,PRSD,PRSD_SV,"2025-05-18 21:15:24",102,85,58,24,3,85,0,153,68,5,80
28,MUREŞ,"CLĂDIREA BAZEI SPORTIVE ISLA",421,HODOŞA,117505,1,PART,PRCNCT,PRSD,PRSD_SV,"2025-05-18 21:16:51",218,149,116,33,0,147,2,250,101,21,126
28,MUREŞ,"ȘCOALA GIMNAZIALĂ ”PETREȘ KÁLMÁN „ SÎMBRIAȘ",422,HODOŞA,117505,1,PART,PRCNCT,PRSD,PRSD_SV,"2025-05-18 21:30:18",471,291,241,30,20,291,0,542,251,12,279
28,MUREŞ,"CENTRUL DE DOCUMENTARE ȘI INFORMARE",423,IBĂNEŞTI,117550,2,PART,PRCNCT,PRSD,PRSD_SV,"2025-05-19 01:17:25",1300,725,651,74,0,717,8,1400,675,402,315
28,MUREŞ,"SALĂ MANIFESTĂRI ISTICEU",424,IBĂNEŞTI,117550,1,PART,PRCNCT,PRSD,PRSD_SV,"2025-05-18 21:32:50",478,299,260,37,2,293,6,550,251,171,122
28,MUREŞ,"CĂMIN CULTURAL DULCEA",425,IBĂNEŞTI,117550,1,PART,PRCNCT,PRSD,PRSD_SV,"2025-05-18 21:35:41",889,570,501,67,2,565,5,1000,430,393,172
28,MUREŞ,"GRĂDINIŢA CU PROGRAM PRELUNGIT IBĂNEŞTI-PĂDURE",426,IBĂNEŞTI,117550,1,PART,PRCNCT,PRSD,PRSD_SV,"2025-05-18 21:41:53",772,467,422,45,0,462,5,820,353,333,129
28,MUREŞ,"CAMINUL CULTURAL",427,ICLĂNZEL,117667,1,PART,PRCNCT,PRSD,PRSD_SV,"2025-05-18 21:58:25",983,531,455,76,0,529,2,1091,560,362,167
28,MUREŞ,"CĂMIN CULTURAL CĂPUȘU DE CÎMPIE",428,ICLĂNZEL,117667,1,PART,PRCNCT,PRSD,PRSD_SV,"2025-05-18 21:53:24",627,322,258,64,0,317,5,700,378,199,118
28,MUREŞ,"ȘCOALA GIMNAZIALĂ IDECIU DE JOS",429,"IDECIU DE JOS",117783,1,PART,PRCNCT,PRSD,PRSD_SV,"2025-05-18 21:44:24",890,509,419,60,30,497,12,950,441,250,247
28,MUREŞ,"CĂMIN CULTURAL DELENI",430,"IDECIU DE JOS",117783,1,PART,PRCNCT,PRSD,PRSD_SV,"2025-05-18 21:24:06",193,139,107,32,0,138,1,250,111,74,64
28,MUREŞ,"CĂMIN CULTURAL IDECIU DE SUS",431,"IDECIU DE JOS",117783,1,PART,PRCNCT,PRSD,PRSD_SV,"2025-05-18 21:37:08",725,364,325,38,1,361,3,800,436,236,125
28,MUREŞ,"CENTRUL COMUNITAR DE SERVICII INTEGRATE LIVEZENI",432,LIVEZENI,117925,1,PART,PRCNCT,PRSD,PRSD_SV,"2025-05-18 22:01:32",1053,804,592,207,5,799,5,1149,345,116,683
28,MUREŞ,"CENTRUL COMUNITAR DE SERVICII INTEGRATE LIVEZENI",433,LIVEZENI,117925,1,PART,PRCNCT,PRSD,PRSD_SV,"2025-05-18 22:17:43",1564,1095,972,113,10,1084,11,1650,555,218,866
28,MUREŞ,"ȘCOALA PRIMARĂ IVĂNEȘTI",434,LIVEZENI,117925,1,PART,PRCNCT,PRSD,PRSD_SV,"2025-05-18 21:36:44",441,252,210,42,0,251,1,500,248,80,171
28,MUREŞ,"ȘCOALA PRIMARĂ POIENIȚA",435,LIVEZENI,117925,1,PART,PRCNCT,PRSD,PRSD_SV,"2025-05-18 21:32:36",282,162,121,41,0,161,1,350,188,56,105
28,MUREŞ,"ȘCOALA PRIMARĂ SÂNIȘOR",436,LIVEZENI,117925,1,PART,PRCNCT,PRSD,PRSD_SV,"2025-05-18 21:19:42",221,149,117,32,0,148,1,251,102,17,131
28,MUREŞ,"SEDIUL ADMINISTRATIV AL PRIMĂRIEI",437,LUNCA,117998,1,PART,PRCNCT,PRSD,PRSD_SV,"2025-05-18 22:05:08",397,240,193,47,0,237,3,450,210,118,119
28,MUREŞ,"ŞCOALA GIMNAZIALĂ BĂIŢA",438,LUNCA,117998,1,PART,PRCNCT,PRSD,PRSD_SV,"2025-05-18 21:41:26",587,284,257,27,0,280,4,650,366,164,116
28,MUREŞ,"ŞCOALA PRIMARĂ FRUNZENI",439,LUNCA,117998,1,PART,PRCNCT,PRSD,PRSD_SV,"2025-05-18 21:40:02",304,167,137,30,0,166,1,350,183,84,82
28,MUREŞ,"ŞCOALA PRIMARĂ LOGIG",440,LUNCA,117998,1,PART,PRCNCT,PRSD,PRSD_SV,"2025-05-18 21:40:18",294,158,124,34,0,154,4,350,192,74,80
28,MUREŞ,"CĂMINUL CULTURAL SÂNTU",441,LUNCA,117998,1,PART,PRCNCT,PRSD,PRSD_SV,"2025-05-18 21:47:24",252,180,144,36,0,180,0,300,120,80,100
28,MUREŞ,"CASA DE CULTURA LUNCA BRADULUI",442,"LUNCA BRADULUI",118058,2,PART,PRCNCT,PRSD,PRSD_SV,"2025-05-19 01:44:41",1138,485,416,67,2,484,1,1250,765,273,211
28,MUREŞ,"SCOALA PRIMARA SAT NEAGRA",443,"LUNCA BRADULUI",118058,1,PART,PRCNCT,PRSD,PRSD_SV,"2025-05-18 21:47:21",344,213,151,62,0,212,1,400,187,117,95
28,MUREŞ,"ȘCOALA GIMNAZIALĂ ” PATAKY AGOTHA” MĂDĂRAȘ",444,MĂDĂRAŞ,120502,2,PART,PRCNCT,PRSD,PRSD_SV,"2025-05-19 01:59:25",1031,627,569,58,0,623,4,1100,473,72,551
28,MUREŞ,"ȘCOALA PRIMARĂ CU CLASELE I-IV FÂNAȚTELE MĂDĂRAȘULUI",445,MĂDĂRAŞ,120502,1,PART,PRCNCT,PRSD,PRSD_SV,"2025-05-18 21:33:56",224,150,134,16,0,148,2,249,99,11,137
28,MUREŞ,"ŞCOALA GIMNAZIALĂ MĂGHERANI",446,MĂGHERANI,118094,1,PART,PRCNCT,PRSD,PRSD_SV,"2025-05-18 21:40:27",634,365,271,40,54,360,5,700,335,67,293
28,MUREŞ,"ŞCOALA PRIMARĂ ŞILEA NIRAJULUI",447,MĂGHERANI,118094,1,PART,PRCNCT,PRSD,PRSD_SV,"2025-05-18 21:30:14",304,201,150,23,28,199,2,350,149,12,187
28,MUREŞ,"CĂMIN CULTURAL TORBA",448,MĂGHERANI,118094,1,PART,PRCNCT,PRSD,PRSD_SV,"2025-05-18 21:56:04",128,113,76,31,6,110,3,152,39,5,105
28,MUREŞ,"ȘCOALA PRIMARĂ MICA",449,MICA,118209,1,PART,PRCNCT,PRSD,PRSD_SV,"2025-05-18 21:50:17",565,271,226,45,0,270,1,650,379,89,181
28,MUREŞ,"ȘCOALA PRIMARĂ",450,MICA,118209,1,PART,PRCNCT,PRSD,PRSD_SV,"2025-05-18 21:29:12",227,136,112,23,1,135,1,250,114,64,71
28,MUREŞ,"ȘCOALA GIMNAZIALĂ ”BELLE JOZSEF”",451,MICA,118209,1,PART,PRCNCT,PRSD,PRSD_SV,"2025-05-18 21:32:12",725,253,231,22,0,249,4,800,547,48,201
28,MUREŞ,"ȘCOALA GIMNAZIALĂ DEAJ",452,MICA,118209,1,PART,PRCNCT,PRSD,PRSD_SV,"2025-05-18 21:38:52",1249,358,331,27,0,352,6,1299,941,155,197
28,MUREŞ,"ȘCOALA GIMNAZIALĂ HĂRĂNGLAB",453,MICA,118209,1,PART,PRCNCT,PRSD,PRSD_SV,"2025-05-18 21:31:18",634,300,273,27,0,295,5,700,400,99,196
28,MUREŞ,"ȘCOALA PRIMARĂ ȘOMOȘTELNIC",454,MICA,118209,1,PART,PRCNCT,PRSD,PRSD_SV,"2025-05-18 21:30:13",182,109,75,34,0,107,2,192,83,75,32
28,MUREŞ,"CĂMINUL CULTURAL MIHEȘU DE CÎMPIE",455,"MIHEŞU DE CÂMPIE",118370,1,PART,PRCNCT,PRSD,PRSD_SV,"2025-05-18 21:59:39",1190,516,473,42,1,512,4,1300,784,336,176
28,MUREŞ,"CĂMINUL CULTURAL RĂZOARE",456,"MIHEŞU DE CÂMPIE",118370,1,PART,PRCNCT,PRSD,PRSD_SV,"2025-05-18 21:33:58",492,224,177,47,0,222,2,550,326,135,87
28,MUREŞ,"FOSTĂ UNITATE DE ALIMENTAȚIE PUBLICĂ - PROPRIETATE PRIVATĂ BOCA ANA-MARIA",457,"MIHEŞU DE CÂMPIE",118370,1,PART,PRCNCT,PRSD,PRSD_SV,"2025-05-18 21:37:15",127,85,41,44,0,85,0,159,74,41,44
28,MUREŞ,"ŞCOALA GIMNAZIALĂ CORPUL A NADEŞ",458,NADEŞ,118469,1,PART,PRCNCT,PRSD,PRSD_SV,"2025-05-18 22:02:14",1184,357,327,28,2,354,3,1300,943,215,139
28,MUREŞ,"ŞCOALA PRIMARĂ MĂGHERUŞ",459,NADEŞ,118469,1,PART,PRCNCT,PRSD,PRSD_SV,"2025-05-18 21:19:54",99,51,38,13,0,51,0,150,99,39,12
28,MUREŞ,"CĂMINUL CULTURAL PIPEA",460,NADEŞ,118469,1,PART,PRCNCT,PRSD,PRSD_SV,"2025-05-18 21:20:35",35,29,14,15,0,29,0,60,31,8,21
28,MUREŞ,"ŞCOALA GIMNAZIALĂ ŢIGMANDRU",461,NADEŞ,118469,2,PART,PRCNCT,PRSD,PRSD_SV,"2025-05-19 00:51:13",970,357,298,59,0,353,4,1050,693,221,132
28,MUREŞ,"ŞCOALA GIMNAZIALĂ NEAUA",462,NEAUA,118511,1,PART,PRCNCT,PRSD,PRSD_SV,"2025-05-18 21:44:34",294,157,128,19,10,156,1,350,193,28,128
28,MUREŞ,"ŞCOALA PRIMARĂ GHINEȘTI",463,NEAUA,118511,1,PART,PRCNCT,PRSD,PRSD_SV,"2025-05-18 21:30:32",195,134,91,28,15,132,2,249,115,8,124
28,MUREŞ,"ŞCOALA PRIMARĂ RIGMANI",464,NEAUA,118511,1,PART,PRCNCT,PRSD,PRSD_SV,"2025-05-18 21:42:31",180,141,97,27,17,141,0,201,60,9,132
28,MUREŞ,"CĂMINUL CULTURAL SÎNSIMION",465,NEAUA,118511,1,PART,PRCNCT,PRSD,PRSD_SV,"2025-05-18 21:20:37",52,56,35,21,0,56,0,90,34,6,50
28,MUREŞ,"CĂMINUL CULTURAL VĂDAȘ",466,NEAUA,118511,1,PART,PRCNCT,PRSD,PRSD_SV,"2025-05-18 21:27:14",281,163,137,16,10,161,2,350,187,14,147
28,MUREŞ,"CĂMINUL CULTURAL OGRA",467,OGRA,118575,1,PART,PRCNCT,PRSD,PRSD_SV,"2025-05-18 21:43:32",1359,560,498,59,3,556,4,1450,890,261,295
28,MUREŞ,"CĂMIN CULTURAL DILEU VECHI",468,OGRA,118575,2,PART,PRCNCT,PRSD,PRSD_SV,"2025-05-18 23:02:17",123,75,43,32,0,75,0,150,75,33,42
28,MUREŞ,"CASA PAROHIALĂ GIULUȘ",469,OGRA,118575,1,PART,PRCNCT,PRSD,PRSD_SV,"2025-05-18 21:19:01",89,57,33,24,0,56,1,100,43,34,22
28,MUREŞ,"ŞCOALA PRIMARĂ LĂSCUD",470,OGRA,118575,1,PART,PRCNCT,PRSD,PRSD_SV,"2025-05-18 21:32:45",204,79,56,23,0,78,1,250,171,57,21
28,MUREŞ,"CAMIN CULTURAL VAIDEIU",471,OGRA,118575,1,PART,PRCNCT,PRSD,PRSD_SV,"2025-05-18 21:24:09",98,71,47,24,0,71,0,150,79,52,19
28,MUREŞ,"CAMIN CULTURAL",472,"PAPIU ILARIAN",118637,1,PART,PRCNCT,PRSD,PRSD_SV,"2025-05-18 21:40:21",688,367,322,35,10,366,1,800,433,157,209
28,MUREŞ,"GRĂDINIŢA CU PROGRAM NORMAL PĂNET",473,PĂNET,118691,1,PART,PRCNCT,PRSD,PRSD_SV,"2025-05-18 21:52:20",1062,752,693,43,16,748,4,1150,398,32,716
28,MUREŞ,"SEDIUL PRIMĂRIEI COMUNEI PĂNET",474,PĂNET,118691,1,PART,PRCNCT,PRSD,PRSD_SV,"2025-05-18 21:32:18",847,605,558,34,13,604,1,900,295,21,583
28,MUREŞ,"CĂMINUL CULTURAL BERGHIA",475,PĂNET,118691,1,PART,PRCNCT,PRSD,PRSD_SV,"2025-05-18 22:17:41",939,564,487,59,18,559,5,1000,436,120,439
28,MUREŞ,"ŞCOALA PRIMARĂ CUIEŞD",476,PĂNET,118691,1,PART,PRCNCT,PRSD,PRSD_SV,"2025-05-18 21:53:25",656,272,243,23,6,264,8,750,478,72,192
28,MUREŞ,"CĂMINUL CULTURAL HĂRŢĂU",477,PĂNET,118691,1,PART,PRCNCT,PRSD,PRSD_SV,"2025-05-18 21:34:58",272,133,116,17,0,129,4,300,167,35,94
28,MUREŞ,"CĂMINUL CULTURAL SÂNTIOANA DE MUREŞ",478,PĂNET,118691,1,PART,PRCNCT,PRSD,PRSD_SV,"2025-05-18 22:03:19",1111,686,622,58,6,681,5,1200,514,91,590
28,MUREŞ,"ŞCOALA GIMNANZIALĂ ”KISS GERGELY” PĂSĂRENI",479,PĂSĂRENI,118753,1,PART,PRCNCT,PRSD,PRSD_SV,"2025-05-18 21:47:46",684,520,451,44,25,518,2,700,180,29,489
28,MUREŞ,"CĂMIN CULTURAL BOLINTINENI, SAT BOLINTINENI",480,PĂSĂRENI,118753,1,PART,PRCNCT,PRSD,PRSD_SV,"2025-05-18 21:38:05",187,96,76,20,0,95,1,250,154,43,52
28,MUREŞ,"CĂMINUL CULTURAL GĂLĂȚENI",481,PĂSĂRENI,118753,1,PART,PRCNCT,PRSD,PRSD_SV,"2025-05-18 21:47:07",534,360,302,47,11,357,3,600,240,40,317
28,MUREŞ,"FOSTUL SEDIU AL POSTEI ROMANE",482,PETELEA,118799,1,PART,PRCNCT,PRSD,PRSD_SV,"2025-05-18 22:00:59",1117,436,406,30,0,428,8,1200,764,325,103
28,MUREŞ,"SEDIUL PRIMARIEI",483,PETELEA,118799,1,PART,PRCNCT,PRSD,PRSD_SV,"2025-05-18 21:57:07",970,477,421,54,2,475,2,1050,573,318,157
28,MUREŞ,"SCOALA PRIMARA HABIC",484,PETELEA,118799,1,PART,PRCNCT,PRSD,PRSD_SV,"2025-05-18 21:22:11",173,107,71,35,1,107,0,200,93,61,46
28,MUREŞ,"CĂMINUL CULTURAL POGĂCEAUA",485,POGĂCEAUA,118824,1,PART,PRCNCT,PRSD,PRSD_SV,"2025-05-18 22:16:43",1090,552,513,38,1,544,8,1200,648,400,144
28,MUREŞ,"ȘCOALA PRIMARĂ ”VASILE FLOREA” VĂLENI",486,POGĂCEAUA,118824,1,PART,PRCNCT,PRSD,PRSD_SV,"2025-05-18 22:05:37",418,209,178,30,1,207,2,500,291,160,47
28,MUREŞ,"ȘCOALA GIMNAZIALĂ RĂSTOLIȚA",487,RĂSTOLIŢA,118931,1,PART,PRCNCT,PRSD,PRSD_SV,"2025-05-18 22:10:26",1441,773,665,103,5,772,1,1600,827,453,319
28,MUREŞ,"CASA DE CULTURĂ ”VASILE CONȚIU” RÂCIU",488,RÂCIU,118995,1,PART,PRCNCT,PRSD,PRSD_SV,"2025-05-18 21:54:28",1238,714,611,103,0,704,10,1300,586,393,311
28,MUREŞ,"ȘCOALA PRIMARĂ COASTA MARE",489,RÂCIU,118995,1,PART,PRCNCT,PRSD,PRSD_SV,"2025-05-18 21:19:32",250,122,104,18,0,122,0,300,178,85,37
28,MUREŞ,"CĂMINUL CULTURAL NIMA RÂCIULUI",490,RÂCIU,118995,1,PART,PRCNCT,PRSD,PRSD_SV,"2025-05-18 21:09:47",127,83,48,35,0,83,0,150,67,35,48
28,MUREŞ,"ȘCOALA GIMNAZIALĂ”VASILE OPREA”",491,RÂCIU,118995,1,PART,PRCNCT,PRSD,PRSD_SV,"2025-05-18 21:38:37",715,409,337,72,0,407,2,800,391,216,191
28,MUREŞ,"ŞCOALA GIMNAZIALĂ ULIEŞ",492,RÂCIU,118995,1,PART,PRCNCT,PRSD,PRSD_SV,"2025-05-18 21:34:21",453,212,165,46,1,211,1,500,288,152,59
28,MUREŞ,"CĂMINUL CULTURAL",493,RUŞII-MUNŢI,119153,1,PART,PRCNCT,PRSD,PRSD_SV,"2025-05-18 22:24:43",1241,672,594,76,2,664,8,1300,628,410,254
28,MUREŞ,"CĂMINUL CULTURAL",494,RUŞII-MUNŢI,119153,1,PART,PRCNCT,PRSD,PRSD_SV,"2025-05-18 21:46:28",188,116,89,27,0,116,0,250,134,58,58
28,MUREŞ,"FOSTA SCOALA PRIMARA",495,RUŞII-MUNŢI,119153,1,PART,PRCNCT,PRSD,PRSD_SV,"2025-05-18 21:41:41",298,175,134,41,0,173,2,350,175,100,73
28,MUREŞ,"ȘCOALA GIMNAZIALĂ ”ION DACIAN”",496,SASCHIZ,119206,1,PART,PRCNCT,PRSD,PRSD_SV,"2025-05-18 21:39:59",1358,577,483,94,0,574,3,1450,873,326,248
28,MUREŞ,"CĂMIN CULTURAL CLOAȘTERF",497,SASCHIZ,119206,1,PART,PRCNCT,PRSD,PRSD_SV,"2025-05-18 21:36:45",145,81,66,13,2,81,0,301,220,52,29
28,MUREŞ,"CĂMIN CULTURAL MIHAI VITEAZU",498,SASCHIZ,119206,1,PART,PRCNCT,PRSD,PRSD_SV,"2025-05-18 21:39:51",249,132,100,32,0,128,4,199,67,54,74
28,MUREŞ,"PRIMĂRIA COMUNEI SĂRĂȚENI",499,SĂRĂŢENI,120496,1,PART,PRCNCT,PRSD,PRSD_SV,"2025-05-18 21:48:30",1279,551,499,47,5,536,15,1400,849,70,466
28,MUREŞ,"CĂMINUL CULTURAL SÎNCRAIU DE MUREŞ",500,"SÂNCRAIU DE MUREŞ",114382,2,PART,PRCNCT,PRSD,PRSD_SV,"2025-05-18 22:31:01",1446,1025,890,131,4,1016,9,1550,525,235,781
28,MUREŞ,"PRIMĂRIA SÎNCRAIU DE MUREŞ",501,"SÂNCRAIU DE MUREŞ",114382,1,PART,PRCNCT,PRSD,PRSD_SV,"2025-05-18 22:30:27",1580,1215,1003,208,4,1196,19,1700,485,289,907
28,MUREŞ,"ȘCOALA GIMNAZIALĂ SÂNCRAIU DE MUREȘ",502,"SÂNCRAIU DE MUREŞ",114382,1,PART,PRCNCT,PRSD,PRSD_SV,"2025-05-18 22:09:41",1434,781,666,115,0,775,6,1550,769,243,532
28,MUREŞ,"ȘCOALA GIMNAZIALĂ SÂNCRAIU DE MUREȘ",503,"SÂNCRAIU DE MUREŞ",114382,2,PART,PRCNCT,PRSD,PRSD_SV,"2025-05-18 23:40:31",1818,1123,1048,74,1,1116,7,2000,877,313,803
28,MUREŞ,"CĂMINUL CULTURAL NAZNA",504,"SÂNCRAIU DE MUREŞ",114382,1,PART,PRCNCT,PRSD,PRSD_SV,"2025-05-18 21:59:37",1342,868,774,92,2,853,15,1450,582,308,545
28,MUREŞ,"ŞCOALA GIMNAZIALĂ NAZNA",505,"SÂNCRAIU DE MUREŞ",114382,2,PART,PRCNCT,PRSD,PRSD_SV,"2025-05-19 00:13:35",1277,942,823,118,1,927,15,1400,458,429,498
28,MUREŞ,"ȘCOALA GIMNAZIALĂ ”SFÂNTUL GHEORGHE” SÂNGEORGIU DE MUREȘ",506,"SÂNGEORGIU DE MUREŞ",114417,1,PART,PRCNCT,PRSD,PRSD_SV,"2025-05-18 21:45:55",1381,850,765,84,1,840,10,1500,650,178,662
28,MUREŞ,"ȘCOALA GIMNAZIALĂ ”SFÂNTUL GHEORGHE” SÂNGEORGIU DE MUREȘ",507,"SÂNGEORGIU DE MUREŞ",114417,1,PART,PRCNCT,PRSD,PRSD_SV,"2025-05-18 21:51:46",1794,1116,1040,73,3,1107,9,1900,784,213,894
28,MUREŞ,"ȘCOALA GIMNAZIALĂ ”SFÂNTUL GHEORGHE” SÂNGEORGIU DE MUREȘ",508,"SÂNGEORGIU DE MUREŞ",114417,1,PART,PRCNCT,PRSD,PRSD_SV,"2025-05-18 21:43:09",1199,687,577,108,2,685,2,1300,613,192,493
28,MUREŞ,"ȘCOALA GIMNAZIALĂ ”SFÂNTUL GHEORGHE” SÂNGEORGIU DE MUREȘ",509,"SÂNGEORGIU DE MUREŞ",114417,1,PART,PRCNCT,PRSD,PRSD_SV,"2025-05-18 21:28:18",1267,721,661,59,1,716,5,1350,629,152,564
28,MUREŞ,"ȘCOALA GIMNAZIALĂ ”SFÂNTUL GHEORGHE” SÂNGEORGIU DE MUREȘ",510,"SÂNGEORGIU DE MUREŞ",114417,1,PART,PRCNCT,PRSD,PRSD_SV,"2025-05-18 21:25:42",1085,669,560,106,3,663,6,1200,531,115,548
28,MUREŞ,"GRĂDINIȚA CU PROGRAM PRELUNGIT ”BAMBI” SÂNGEORGIU DE MUREȘ",511,"SÂNGEORGIU DE MUREŞ",114417,2,PART,PRCNCT,PRSD,PRSD_SV,"2025-05-19 00:37:02",1657,1015,937,76,2,1008,7,1800,785,209,799
28,MUREŞ,"ȘCOALA GIMNAZIALĂ ”SFÂNTUL GHEORGHE” - ȘCOALA PRIMARĂ COTUȘ",512,"SÂNGEORGIU DE MUREŞ",114417,1,PART,PRCNCT,PRSD,PRSD_SV,"2025-05-18 21:25:57",448,222,197,25,0,215,7,500,278,81,134
28,MUREŞ,"GRADINITA CU PROGRAM NORMAL SANGER",513,SÂNGER,119386,1,PART,PRCNCT,PRSD,PRSD_SV,"2025-05-18 21:52:03",1243,524,470,52,2,519,5,1350,826,373,146
28,MUREŞ,"CAMINUL CULTURAL CIPAIENI",514,SÂNGER,119386,1,PART,PRCNCT,PRSD,PRSD_SV,"2025-05-18 21:32:58",520,226,194,32,0,219,7,600,374,139,80
28,MUREŞ,"CĂMINUL CULTURAL SÂNPAUL",515,SÂNPAUL,119466,1,PART,PRCNCT,PRSD,PRSD_SV,"2025-05-18 21:50:04",1407,797,681,92,24,788,9,1500,703,445,343
28,MUREŞ,"CĂMIN CULTURAL CHIRILEU",516,SÂNPAUL,119466,1,PART,PRCNCT,PRSD,PRSD_SV,"2025-05-18 21:16:21",730,402,354,47,1,401,1,800,398,267,134
28,MUREŞ,"CĂMINUL CULTURAL",517,SÂNPAUL,119466,1,PART,PRCNCT,PRSD,PRSD_SV,"2025-05-18 21:18:00",140,98,62,28,8,98,0,150,52,19,79
28,MUREŞ,"CĂMINUL CULTURAL",518,SÂNPAUL,119466,1,PART,PRCNCT,PRSD,PRSD_SV,"2025-05-18 21:32:09",219,116,89,27,0,114,2,250,134,69,45
28,MUREŞ,"CĂMINUL CULTURAL",519,SÂNPAUL,119466,1,PART,PRCNCT,PRSD,PRSD_SV,"2025-05-18 21:56:07",963,741,616,65,60,738,3,1050,309,165,573
28,MUREŞ,"CĂMINUL CULTURAL SÎNPETRU DE CÎMPIE",520,"SÂNPETRU DE CÂMPIE",119527,1,PART,PRCNCT,PRSD,PRSD_SV,"2025-05-18 21:42:12",803,376,323,49,4,376,0,900,524,267,109
28,MUREŞ,"CĂMINUL CULTURAL BÎRLIBAȘ",521,"SÂNPETRU DE CÂMPIE",119527,1,PART,PRCNCT,PRSD,PRSD_SV,"2025-05-18 21:20:24",113,74,56,18,0,73,1,150,76,46,27
28,MUREŞ,"CĂMINUL CULTURAL DÂMBU",522,"SÂNPETRU DE CÂMPIE",119527,1,PART,PRCNCT,PRSD,PRSD_SV,"2025-05-18 21:31:51",450,214,177,37,0,212,2,502,288,127,85
28,MUREŞ,"FOSTA ȘCOALA PRIMARA SATU -NOU",523,"SÂNPETRU DE CÂMPIE",119527,1,PART,PRCNCT,PRSD,PRSD_SV,"2025-05-18 21:34:41",169,102,79,23,0,99,3,200,98,71,28
28,MUREŞ,"CĂMINUL CULTURAL SÎNGEORGIU DE CÎMPIE",524,"SÂNPETRU DE CÂMPIE",119527,1,PART,PRCNCT,PRSD,PRSD_SV,"2025-05-18 21:26:49",258,141,114,27,0,140,1,300,159,63,77
28,MUREŞ,"CĂMINUL CULTURAL TUŞINU",525,"SÂNPETRU DE CÂMPIE",119527,1,PART,PRCNCT,PRSD,PRSD_SV,"2025-05-18 21:49:27",355,185,133,52,0,183,2,400,215,114,69
28,MUREŞ,"CĂMIN CULTURAL SÂNTANA DE MUREȘ",526,"SÂNTANA DE MUREŞ",114453,1,PART,PRCNCT,PRSD,PRSD_SV,"2025-05-18 22:24:22",1616,1003,881,117,5,992,11,1750,747,269,723
28,MUREŞ,"CĂMIN CULTURAL SÂNTANA DE MUREȘ",527,"SÂNTANA DE MUREŞ",114453,1,PART,PRCNCT,PRSD,PRSD_SV,"2025-05-18 22:11:55",1650,1134,962,170,2,1121,13,1800,666,302,819
28,MUREŞ,"CĂMINUL CULTURAL BĂRDEŞTI",528,"SÂNTANA DE MUREŞ",114453,1,PART,PRCNCT,PRSD,PRSD_SV,"2025-05-18 22:01:46",482,372,296,75,1,366,6,548,176,132,234
28,MUREŞ,"CÂMIN CULTURAL CHINARI",529,"SÂNTANA DE MUREŞ",114453,1,PART,PRCNCT,PRSD,PRSD_SV,"2025-05-18 21:47:22",627,369,330,24,15,366,3,700,331,111,255
28,MUREŞ,"CĂMIN CULTURAL CURTENI",530,"SÂNTANA DE MUREŞ",114453,1,PART,PRCNCT,PRSD,PRSD_SV,"2025-05-18 21:44:47",876,620,544,53,23,617,3,950,330,49,568
28,MUREŞ,"ŞCOALA GIMNAZIALĂ SOLOVĂSTRU",531,SOLOVĂSTRU,119590,2,PART,PRCNCT,PRSD,PRSD_SV,"2025-05-19 01:48:56",1527,794,715,79,0,789,5,1650,856,470,319
28,MUREŞ,"ŞCOALA GIMNAZIALĂ JABENIŢA",532,SOLOVĂSTRU,119590,1,PART,PRCNCT,PRSD,PRSD_SV,"2025-05-18 21:46:13",973,526,462,64,0,524,2,1050,524,271,253
28,MUREŞ,"CĂMIN CULTURAL STÎNCENI",533,STÂNCENI,119625,1,PART,PRCNCT,PRSD,PRSD_SV,"2025-05-18 22:18:09",1154,668,537,128,3,664,4,1300,632,326,338
28,MUREŞ,"CĂMINUL CULTURAL SUPLAC",534,SUPLAC,119661,1,PART,PRCNCT,PRSD,PRSD_SV,"2025-05-18 21:38:48",587,263,223,37,3,259,4,650,387,110,149
28,MUREŞ,"ȘCOALA GIMNAZIALĂ ” BORDI ANDRÁS ”IDRIFAIA",535,SUPLAC,119661,1,PART,PRCNCT,PRSD,PRSD_SV,"2025-05-18 21:44:13",496,330,293,28,9,327,3,550,220,49,278
28,MUREŞ,"CĂMINUL CULTURAL LASLĂU MARE",536,SUPLAC,119661,1,PART,PRCNCT,PRSD,PRSD_SV,"2025-05-18 21:18:59",297,166,145,21,0,164,2,350,184,102,62
28,MUREŞ,"ŞCOALA PRIMARĂ LASLĂU MIC",537,SUPLAC,119661,1,PART,PRCNCT,PRSD,PRSD_SV,"2025-05-18 21:23:36",423,148,125,23,0,148,0,500,352,118,30
28,MUREŞ,"ŞCOALA GIMNAZIALĂ SUSENI",538,SUSENI,119723,1,PART,PRCNCT,PRSD,PRSD_SV,"2025-05-18 21:45:37",1464,746,685,61,0,737,9,1600,854,342,395
28,MUREŞ,"FOSTA ŞCOALĂ GENERALĂ LUIERIU",539,SUSENI,119723,1,PART,PRCNCT,PRSD,PRSD_SV,"2025-05-18 21:54:46",493,265,219,45,1,264,1,550,285,124,140
28,MUREŞ,"CĂMINUL CULTURAL ȘĂULIA",540,ŞĂULIA,119750,1,PART,PRCNCT,PRSD,PRSD_SV,"2025-05-18 21:54:47",1256,615,546,58,11,607,8,1350,735,342,265
28,MUREŞ,"CLUBUL TINERETULUI ȘĂULIA",541,ŞĂULIA,119750,1,PART,PRCNCT,PRSD,PRSD_SV,"2025-05-18 21:40:05",261,191,127,62,2,191,0,300,109,117,74
28,MUREŞ,"CĂMINUL CULTURAL ȘINCAI",542,ŞINCAI,119803,1,PART,PRCNCT,PRSD,PRSD_SV,"2025-05-18 21:39:05",869,360,311,49,0,357,3,950,590,123,234
28,MUREŞ,"CENTRUL PENTRU ACTIVITĂȚI CULTURALE LECHINCIOARA",543,ŞINCAI,119803,1,PART,PRCNCT,PRSD,PRSD_SV,"2025-05-18 21:16:02",82,66,48,18,0,66,0,113,47,37,29
28,MUREŞ,"CĂMINUL CULTURAL PUSTA",544,ŞINCAI,119803,1,PART,PRCNCT,PRSD,PRSD_SV,"2025-05-18 21:17:50",85,60,42,18,0,60,0,101,41,42,18
28,MUREŞ,"CĂMINUL CULTURAL ȘINCAI-FÂNAȚE",545,ŞINCAI,119803,1,PART,PRCNCT,PRSD,PRSD_SV,"2025-05-18 21:26:48",159,76,49,27,0,76,0,197,121,61,15
28,MUREŞ,"PRIMĂRIA TĂURENI",546,TĂURENI,119858,1,PART,PRCNCT,PRSD,PRSD_SV,"2025-05-18 21:42:12",740,311,271,40,0,306,5,850,539,199,107
28,MUREŞ,"PRIMĂRIA COMUNEI VALEA LARGĂ",547,"VALEA LARGĂ",119974,1,PART,PRCNCT,PRSD,PRSD_SV,"2025-05-18 21:54:14",1041,317,298,18,1,315,2,1150,833,199,116
28,MUREŞ,"CĂMINUL CULTURAL VALEA LARGĂ",548,"VALEA LARGĂ",119974,1,PART,PRCNCT,PRSD,PRSD_SV,"2025-05-18 21:30:22",875,282,257,25,0,277,5,950,668,171,106
28,MUREŞ,"ŞCOALA PRIMARĂ VALEA FRĂŢIEI",549,"VALEA LARGĂ",119974,1,PART,PRCNCT,PRSD,PRSD_SV,"2025-05-18 21:29:53",490,177,151,26,0,177,0,550,373,127,50
28,MUREŞ,"ŞCOALA GIMNAZIALĂ VĂRGATA",550,VĂRGATA,120076,1,PART,PRCNCT,PRSD,PRSD_SV,"2025-05-18 22:01:45",658,309,269,25,15,309,0,750,441,25,284
28,MUREŞ,"ŞCOALA PRIMARĂ GRÂUŞORUL",551,VĂRGATA,120076,1,PART,PRCNCT,PRSD,PRSD_SV,"2025-05-18 21:33:27",165,66,43,23,0,64,2,200,134,27,37
28,MUREŞ,"ŞCOALA PRIMARĂ VADU",552,VĂRGATA,120076,1,PART,PRCNCT,PRSD,PRSD_SV,"2025-05-18 22:07:01",213,112,86,26,0,108,4,250,138,16,92
28,MUREŞ,"ŞCOALA PRIMARĂ VALEA",553,VĂRGATA,120076,1,PART,PRCNCT,PRSD,PRSD_SV,"2025-05-18 22:03:17",569,293,249,21,23,293,0,650,357,21,272
28,MUREŞ,"CĂMINUL CULTURAL VĂTAVA",554,VĂTAVA,120138,1,PART,PRCNCT,PRSD,PRSD_SV,"2025-05-18 21:41:59",601,329,291,38,0,329,0,650,321,174,155
28,MUREŞ,"ȘCOALA PRIMARĂ DUMBRAVA",555,VĂTAVA,120138,1,PART,PRCNCT,PRSD,PRSD_SV,"2025-05-18 21:36:49",488,270,227,42,1,268,2,550,280,141,127
28,MUREŞ,"ȘCOALA ”MIHAI TOMSA” RÎPA DE JOS",556,VĂTAVA,120138,1,PART,PRCNCT,PRSD,PRSD_SV,"2025-05-18 21:41:05",328,207,171,36,0,207,0,400,193,124,83
28,MUREŞ,"ŞCOALA GIMNAZIALĂ ” PETRE N. POPESCU ” VÎNĂTORI",557,VÂNĂTORI,120254,1,PART,PRCNCT,PRSD,PRSD_SV,"2025-05-18 21:49:10",1473,608,549,45,14,597,11,1600,992,319,278
28,MUREŞ,"GRĂDINIŢA CU PROGRAM NORMAL ARCHITA",558,VÂNĂTORI,120254,1,PART,PRCNCT,PRSD,PRSD_SV,"2025-05-18 21:37:49",700,264,235,29,0,263,1,750,486,199,64
28,MUREŞ,"CĂMINUL CULTURAL FELEAG",559,VÂNĂTORI,120254,1,PART,PRCNCT,PRSD,PRSD_SV,"2025-05-18 21:41:06",140,94,58,31,5,94,0,200,106,37,57
28,MUREŞ,"ŞCOALA PRIMARĂ MURENI",560,VÂNĂTORI,120254,1,PART,PRCNCT,PRSD,PRSD_SV,"2025-05-18 21:56:20",283,158,123,35,0,156,2,350,192,59,97
28,MUREŞ,"ŞCOALA PRIMARĂ ŞOARD",561,VÂNĂTORI,120254,1,PART,PRCNCT,PRSD,PRSD_SV,"2025-05-18 21:53:38",636,270,251,19,0,266,4,700,430,144,122
28,MUREŞ,"CĂMINUL CULTURAL VEȚCA",562,VEŢCA,120174,2,PART,PRCNCT,PRSD,PRSD_SV,"2025-05-19 00:21:58",355,212,171,41,0,211,1,400,188,10,201
28,MUREŞ,"CĂMINUL CULTURAL JACODU",563,VEŢCA,120174,1,PART,PRCNCT,PRSD,PRSD_SV,"2025-05-18 21:25:58",186,134,84,50,0,132,2,250,116,32,100
28,MUREŞ,"PRIMĂRIA VIIŞOARA",564,VIIŞOARA,120218,1,PART,PRCNCT,PRSD,PRSD_SV,"2025-05-18 21:35:39",662,229,204,25,0,226,3,750,521,147,79
28,MUREŞ,"ȘCOALA GIMNAZIALA ORMENIŞ",565,VIIŞOARA,120218,1,PART,PRCNCT,PRSD,PRSD_SV,"2025-05-18 21:34:02",377,142,123,19,0,141,1,450,308,116,25
28,MUREŞ,"CĂMINUL CULTURAL SÎNTIOANA",566,VIIŞOARA,120218,1,PART,PRCNCT,PRSD,PRSD_SV,"2025-05-18 21:39:21",470,186,160,26,0,185,1,550,364,145,40
28,MUREŞ,"ȘCOALA GIMNAZIALĂ VOIVODENI",567,VOIVODENI,120316,1,PART,PRCNCT,PRSD,PRSD_SV,"2025-05-18 21:38:59",1235,617,511,65,41,608,9,1350,733,169,439
28,MUREŞ,"CĂMINUL CULTURAL TOLDAL",568,VOIVODENI,120316,1,PART,PRCNCT,PRSD,PRSD_SV,"2025-05-18 21:15:47",164,129,94,34,1,128,1,200,71,52,76
28,MUREŞ,"PRIMARIA ZAGAR",569,ZAGĂR,120343,1,PART,PRCNCT,PRSD,PRSD_SV,"2025-05-18 21:27:10",1033,291,252,39,0,290,1,1150,859,159,131
28,MUREŞ,"ȘCOALA PRIMARĂ CLASELE 0-IV ZAU DE CÎMPIE",570,"ZAU DE CÂMPIE",120370,1,PART,PRCNCT,PRSD,PRSD_SV,"2025-05-18 21:34:06",915,452,390,47,15,448,4,1000,548,246,202
28,MUREŞ,"ŞCOALA GIMNAZIALĂ ZAU DE CÎMPIE",571,"ZAU DE CÂMPIE",120370,1,PART,PRCNCT,PRSD,PRSD_SV,"2025-05-18 21:45:34",1228,555,501,50,4,554,1,1300,745,331,223
28,MUREŞ,"ȘCOALA GIMNAZIALĂ BĂRBOȘI",572,"ZAU DE CÂMPIE",120370,1,PART,PRCNCT,PRSD,PRSD_SV,"2025-05-18 21:23:00",344,175,146,29,0,175,0,400,225,123,52
29,NEAMŢ,"ŞCOALA GIMNAZIALĂ NR.3",1,"MUNICIPIUL PIATRA-NEAMŢ",120726,1,PART,PRCNCT,PRSD,PRSD_SV,"2025-05-18 22:05:22",1079,525,409,115,1,521,4,1200,675,188,333
29,NEAMŢ,"ŞCOALA GIMNAZIALĂ NR.3",2,"MUNICIPIUL PIATRA-NEAMŢ",120726,1,PART,PRCNCT,PRSD,PRSD_SV,"2025-05-18 21:35:41",874,475,404,71,0,469,6,1000,525,141,328
29,NEAMŢ,"ȘCOALA GIMNAZIALĂ NR.3",3,"MUNICIPIUL PIATRA-NEAMŢ",120726,1,PART,PRCNCT,PRSD,PRSD_SV,"2025-05-18 21:47:52",861,456,403,53,0,447,9,900,444,145,302
29,NEAMŢ,"ȘCOALA GIMNAZIALĂ NR.3",4,"MUNICIPIUL PIATRA-NEAMŢ",120726,1,PART,PRCNCT,PRSD,PRSD_SV,"2025-05-18 21:31:27",1047,521,480,41,0,517,4,1100,579,150,367
29,NEAMŢ,"COLEGIUL NAȚIONAL ”PETRU RAREȘ”",5,"MUNICIPIUL PIATRA-NEAMŢ",120726,1,PART,PRCNCT,PRSD,PRSD_SV,"2025-05-18 21:38:14",1549,569,498,71,0,559,10,1700,1131,167,392
29,NEAMŢ,"LICEUL DE ARTE ”VICTOR BRAUNER” - CORPUL B",6,"MUNICIPIUL PIATRA-NEAMŢ",120726,1,PART,PRCNCT,PRSD,PRSD_SV,"2025-05-18 21:32:18",1139,639,548,91,0,631,8,1200,561,244,387
29,NEAMŢ,"COLEGIUL NAȚIONAL ”CALISTRAT HOGAȘ”",7,"MUNICIPIUL PIATRA-NEAMŢ",120726,1,PART,PRCNCT,PRSD,PRSD_SV,"2025-05-18 21:31:48",1267,548,472,76,0,540,8,1400,852,172,368
29,NEAMŢ,"LICEUL TEHNOLOGIC ”SPIRU HARET”",8,"MUNICIPIUL PIATRA-NEAMŢ",120726,1,PART,PRCNCT,PRSD,PRSD_SV,"2025-05-18 22:05:30",1167,604,540,64,0,588,16,1300,696,207,381
29,NEAMŢ,"LICEUL TEHOLOGIC ”SPIRU HARET”",9,"MUNICIPIUL PIATRA-NEAMŢ",120726,1,PART,PRCNCT,PRSD,PRSD_SV,"2025-05-18 21:53:59",1034,574,516,58,0,566,8,1100,526,196,370
29,NEAMŢ,"GRĂDINIȚA CU PROGRAM PRELUNGIT NR.3 CORP B",10,"MUNICIPIUL PIATRA-NEAMŢ",120726,1,PART,PRCNCT,PRSD,PRSD_SV,"2025-05-18 21:56:51",926,474,429,42,3,466,8,1000,526,175,291
29,NEAMŢ,"LICEUL CU PROGRAM SPORTIV",11,"MUNICIPIUL PIATRA-NEAMŢ",120726,1,PART,PRCNCT,PRSD,PRSD_SV,"2025-05-18 21:41:23",1234,634,597,36,1,622,12,1400,766,220,402
29,NEAMŢ,"LICEUL CU PROGRAM SPORTIV",12,"MUNICIPIUL PIATRA-NEAMŢ",120726,1,PART,PRCNCT,PRSD,PRSD_SV,"2025-05-18 21:35:10",1058,577,530,47,0,569,8,1200,623,171,398
29,NEAMŢ,"ŞCOALA GIMNAZIALĂ NR.8",13,"MUNICIPIUL PIATRA-NEAMŢ",120726,1,PART,PRCNCT,PRSD,PRSD_SV,"2025-05-18 21:44:35",1214,588,553,35,0,577,11,1300,712,237,340
29,NEAMŢ,"ȘCOALA GIMNAZIALĂ NR.8",14,"MUNICIPIUL PIATRA-NEAMŢ",120726,1,PART,PRCNCT,PRSD,PRSD_SV,"2025-05-18 21:53:01",1343,669,639,30,0,652,17,1500,831,262,390
29,NEAMŢ,"GRĂDINIȚA CUPLATĂ CU CREŞĂ NR.5",15,"MUNICIPIUL PIATRA-NEAMŢ",120726,1,PART,PRCNCT,PRSD,PRSD_SV,"2025-05-18 21:53:01",1351,659,619,40,0,649,10,1500,841,241,408
29,NEAMŢ,"GRĂDINIȚA CUPLATĂ CU CREŞĂ NR.5",16,"MUNICIPIUL PIATRA-NEAMŢ",120726,1,PART,PRCNCT,PRSD,PRSD_SV,"2025-05-18 21:52:05",971,455,426,29,0,451,4,1100,645,209,242
29,NEAMŢ,"GRĂDINIȚA CU PROGRAM PRELUNGIT NR.8",17,"MUNICIPIUL PIATRA-NEAMŢ",120726,1,PART,PRCNCT,PRSD,PRSD_SV,"2025-05-18 21:40:58",812,368,342,26,0,362,6,900,532,179,183
29,NEAMŢ,"„CENTRUL SOCIAL PIETRICICA”",18,"MUNICIPIUL PIATRA-NEAMŢ",120726,1,PART,PRCNCT,PRSD,PRSD_SV,"2025-05-18 22:10:12",1886,1073,977,79,17,1056,17,2100,1027,436,620
29,NEAMŢ,"CENTRUL DE SPRIJIN ȘI ASISTENȚĂ DE SPECIALITATE PENTRU COPII",19,"MUNICIPIUL PIATRA-NEAMŢ",120726,1,PART,PRCNCT,PRSD,PRSD_SV,"2025-05-18 21:39:22",1363,571,524,46,1,553,18,1500,929,258,295
29,NEAMŢ,"ȘCOALA GIMNAZIALĂ NR.11",20,"MUNICIPIUL PIATRA-NEAMŢ",120726,1,PART,PRCNCT,PRSD,PRSD_SV,"2025-05-18 21:57:19",1350,625,565,60,0,616,9,1500,875,284,332
29,NEAMŢ,"COLEGIUL NAȚIONAL ”GH. ASACHI”",21,"MUNICIPIUL PIATRA-NEAMŢ",120726,1,PART,PRCNCT,PRSD,PRSD_SV,"2025-05-18 21:40:15",870,343,309,34,0,335,8,1000,657,181,154
29,NEAMŢ,"COLEGIUL NAȚIONAL ”GH. ASACHI”",22,"MUNICIPIUL PIATRA-NEAMŢ",120726,1,PART,PRCNCT,PRSD,PRSD_SV,"2025-05-18 21:46:38",1055,392,360,32,0,384,8,1200,808,184,200
29,NEAMŢ,"ŞCOALA GIMNAZIALĂ NR.5",23,"MUNICIPIUL PIATRA-NEAMŢ",120726,1,PART,PRCNCT,PRSD,PRSD_SV,"2025-05-18 21:45:44",1349,608,562,46,0,599,9,1500,892,240,359
29,NEAMŢ,"ŞCOALA GIMNAZIALĂ NR.5",24,"MUNICIPIUL PIATRA-NEAMŢ",120726,1,PART,PRCNCT,PRSD,PRSD_SV,"2025-05-18 22:20:50",1268,689,627,60,2,673,16,1400,711,247,426
29,NEAMŢ,"GRĂDINIŢA CU PROGRAM PRELUNGIT NR.12",25,"MUNICIPIUL PIATRA-NEAMŢ",120726,1,PART,PRCNCT,PRSD,PRSD_SV,"2025-05-18 22:37:33",1266,594,552,41,1,581,13,1400,806,271,310
29,NEAMŢ,"GRĂDINIŢA CU PROGRAM PRELUNGIT NR.12",26,"MUNICIPIUL PIATRA-NEAMŢ",120726,1,PART,PRCNCT,PRSD,PRSD_SV,"2025-05-18 22:29:36",1168,573,515,58,0,562,11,1300,727,214,348
29,NEAMŢ,"GRĂDINIŢA CU PROGRAM PRELUNGIT NR.12",27,"MUNICIPIUL PIATRA-NEAMŢ",120726,1,PART,PRCNCT,PRSD,PRSD_SV,"2025-05-18 22:10:59",1233,571,540,31,0,557,14,1400,829,230,327
29,NEAMŢ,"CENTRUL SOCIAL PIETRICICA",28,"MUNICIPIUL PIATRA-NEAMŢ",120726,1,PART,PRCNCT,PRSD,PRSD_SV,"2025-05-18 22:09:27",1523,786,725,61,0,767,19,1700,914,255,512
29,NEAMŢ,"COLEGIUL NAȚIONAL DE INFORMATICĂ",29,"MUNICIPIUL PIATRA-NEAMŢ",120726,1,PART,PRCNCT,PRSD,PRSD_SV,"2025-05-18 22:39:31",1793,838,797,41,0,829,9,2000,1162,299,530
29,NEAMŢ,"COLEGIUL NAȚIONAL DE INFORMATICĂ",30,"MUNICIPIUL PIATRA-NEAMŢ",120726,1,PART,PRCNCT,PRSD,PRSD_SV,"2025-05-18 22:06:53",1706,942,892,49,1,923,19,1900,958,294,629
29,NEAMŢ,"COLEGIUL NAȚIONAL DE INFORMATICĂ",31,"MUNICIPIUL PIATRA-NEAMŢ",120726,1,PART,PRCNCT,PRSD,PRSD_SV,"2025-05-18 21:36:02",1573,718,684,34,0,705,13,1700,982,304,401
29,NEAMŢ,"COLEGIUL NAȚIONAL DE INFORMATICĂ",32,"MUNICIPIUL PIATRA-NEAMŢ",120726,1,PART,PRCNCT,PRSD,PRSD_SV,"2025-05-18 21:59:05",1224,653,598,55,0,640,13,1300,647,216,424
29,NEAMŢ,"COLEGIUL NAȚIONAL DE INFORMATICĂ",33,"MUNICIPIUL PIATRA-NEAMŢ",120726,1,PART,PRCNCT,PRSD,PRSD_SV,"2025-05-18 21:35:07",935,367,320,46,1,361,6,1000,633,205,156
29,NEAMŢ,"COLEGIUL NAȚIONAL DE INFORMATICĂ",34,"MUNICIPIUL PIATRA-NEAMŢ",120726,1,PART,PRCNCT,PRSD,PRSD_SV,"2025-05-18 21:46:00",883,423,379,43,1,415,8,1000,577,144,271
29,NEAMŢ,"ŞCOALA GIMNAZIALĂ NR.7",35,"MUNICIPIUL PIATRA-NEAMŢ",120726,1,PART,PRCNCT,PRSD,PRSD_SV,"2025-05-18 21:44:51",1531,657,635,22,0,646,11,1700,1043,450,196
29,NEAMŢ,"ȘCOALA CU 10 CLASE CARTIER SPERANȚA",36,"MUNICIPIUL PIATRA-NEAMŢ",120726,1,PART,PRCNCT,PRSD,PRSD_SV,"2025-05-18 21:55:40",907,495,444,50,1,487,8,1000,505,301,186
29,NEAMŢ,"CLĂDIRE „MONTE CARLO”",37,"MUNICIPIUL PIATRA-NEAMŢ",120726,1,PART,PRCNCT,PRSD,PRSD_SV,"2025-05-18 21:39:32",707,377,341,36,0,373,4,800,423,226,147
29,NEAMŢ,"ȘCOALA GIMNAZIALĂ NR.2",38,"MUNICIPIUL PIATRA-NEAMŢ",120726,1,PART,PRCNCT,PRSD,PRSD_SV,"2025-05-18 21:41:27",969,528,449,51,28,523,5,1100,572,172,351
29,NEAMŢ,"ȘCOALA GIMNAZIALĂ NR.2",39,"MUNICIPIUL PIATRA-NEAMŢ",120726,1,PART,PRCNCT,PRSD,PRSD_SV,"2025-05-18 21:56:47",835,487,397,60,30,482,5,900,413,213,269
29,NEAMŢ,"ȘCOALA GIMNAZIALĂ NR.2",40,"MUNICIPIUL PIATRA-NEAMŢ",120726,1,PART,PRCNCT,PRSD,PRSD_SV,"2025-05-18 21:54:48",829,534,450,51,33,517,17,900,366,209,308
29,NEAMŢ,"ŞCOALA GIMNAZIALĂ NR.2",41,"MUNICIPIUL PIATRA-NEAMŢ",120726,1,PART,PRCNCT,PRSD,PRSD_SV,"2025-05-18 21:43:11",1070,562,503,26,33,550,12,1200,638,210,340
29,NEAMŢ,"ŞCOALA GIMNAZIALĂ NR.2",42,"MUNICIPIUL PIATRA-NEAMŢ",120726,1,PART,PRCNCT,PRSD,PRSD_SV,"2025-05-18 21:49:57",1243,623,563,33,27,606,17,1400,777,205,401
29,NEAMŢ,"ȘCOALA GIMNAZIALĂ NR.2",43,"MUNICIPIUL PIATRA-NEAMŢ",120726,1,PART,PRCNCT,PRSD,PRSD_SV,"2025-05-18 21:41:51",1406,702,634,43,25,678,24,1500,798,238,440
29,NEAMŢ,"DIRECȚIA AGRICOLĂ",44,"MUNICIPIUL PIATRA-NEAMŢ",120726,1,PART,PRCNCT,PRSD,PRSD_SV,"2025-05-18 22:04:10",1219,618,567,51,0,609,9,1300,682,191,418
29,NEAMŢ,"S.C. APA SERV S.A.",45,"MUNICIPIUL PIATRA-NEAMŢ",120726,2,PART,PRCNCT,PRSD,PRSD_SV,"2025-05-18 21:57:33",1053,551,496,54,1,533,18,1100,549,170,363
29,NEAMŢ,"COMPLEXUL EXPOZIȚIONAL MUNICIPAL",46,"MUNICIPIUL PIATRA-NEAMŢ",120726,1,PART,PRCNCT,PRSD,PRSD_SV,"2025-05-18 21:51:31",1235,756,629,125,2,750,6,1400,644,288,462
29,NEAMŢ,"ȘCOALA GIMNAZIALĂ ”ELENA CUZA”",47,"MUNICIPIUL PIATRA-NEAMŢ",120726,1,PART,PRCNCT,PRSD,PRSD_SV,"2025-05-18 22:04:16",1322,745,629,116,0,730,15,1400,655,228,502
29,NEAMŢ,"ȘCOALA GIMNAZIALĂ ”ELENA CUZA”",48,"MUNICIPIUL PIATRA-NEAMŢ",120726,1,PART,PRCNCT,PRSD,PRSD_SV,"2025-05-18 22:25:01",1286,690,628,62,0,672,18,1400,710,210,462
29,NEAMŢ,"ŞCOALA GIMNAZIALĂ ”NICU ALBU”",49,"MUNICIPIUL PIATRA-NEAMŢ",120726,1,PART,PRCNCT,PRSD,PRSD_SV,"2025-05-18 21:56:43",1126,544,512,32,0,537,7,1200,656,161,376
29,NEAMŢ,"ŞCOALA GIMNAZIALĂ ”NICU ALBU”",50,"MUNICIPIUL PIATRA-NEAMŢ",120726,1,PART,PRCNCT,PRSD,PRSD_SV,"2025-05-18 21:58:28",1253,640,591,49,0,627,13,1400,760,223,404
29,NEAMŢ,"ŞCOALA GIMNAZIALĂ ”NICU ALBU”",51,"MUNICIPIUL PIATRA-NEAMŢ",120726,1,PART,PRCNCT,PRSD,PRSD_SV,"2025-05-18 21:25:57",1077,514,467,47,0,506,8,1200,686,194,312
29,NEAMŢ,"ŞCOALA GIMNAZIALĂ ”NICU ALBU”",52,"MUNICIPIUL PIATRA-NEAMŢ",120726,1,PART,PRCNCT,PRSD,PRSD_SV,"2025-05-18 21:32:14",1291,645,589,56,0,632,13,1400,755,243,389
29,NEAMŢ,"ŞCOALA GIMNAZIALĂ ”NICU ALBU”",53,"MUNICIPIUL PIATRA-NEAMŢ",120726,1,PART,PRCNCT,PRSD,PRSD_SV,"2025-05-18 21:34:59",1299,612,553,59,0,601,11,1400,788,234,367
29,NEAMŢ,"ŞCOALA GIMNAZIALĂ ”NICU ALBU”",54,"MUNICIPIUL PIATRA-NEAMŢ",120726,1,PART,PRCNCT,PRSD,PRSD_SV,"2025-05-18 21:54:23",1248,616,571,45,0,605,11,1400,784,220,385
29,NEAMŢ,"CASA CORPULUI DIDACTIC",55,"MUNICIPIUL PIATRA-NEAMŢ",120726,1,PART,PRCNCT,PRSD,PRSD_SV,"2025-05-18 22:48:52",1280,691,645,44,2,678,13,1400,709,295,383
29,NEAMŢ,"COLEGIUL TEHNIC DE TRANSPORTURI - CORP A",56,"MUNICIPIUL PIATRA-NEAMŢ",120726,1,PART,PRCNCT,PRSD,PRSD_SV,"2025-05-18 21:48:33",1084,561,522,39,0,550,11,1200,639,197,353
29,NEAMŢ,"COLEGIUL TEHNIC FORESTIER",57,"MUNICIPIUL PIATRA-NEAMŢ",120726,2,PART,PRCNCT,PRSD,PRSD_SV,"2025-05-18 22:56:43",1202,590,510,56,24,579,11,1300,710,227,352
29,NEAMŢ,"COLEGIUL TEHNIC FORESTIER",58,"MUNICIPIUL PIATRA-NEAMŢ",120726,1,PART,PRCNCT,PRSD,PRSD_SV,"2025-05-18 21:36:37",1293,709,653,53,3,699,10,1400,691,225,474
29,NEAMŢ,"LICEUL TEHNOLOGIC ECONOMIC ADMINISTRATIV",59,"MUNICIPIUL PIATRA-NEAMŢ",120726,1,PART,PRCNCT,PRSD,PRSD_SV,"2025-05-18 21:53:24",1292,740,657,81,2,726,14,1400,660,224,502
29,NEAMŢ,"LICEUL TEOLOGIC ORTODOX „SFINȚII ÎMPĂRAȚI CONSTANTIN ȘI ELENA” - CORP A (CORP DE GRĂDINIȚĂ)",60,"MUNICIPIUL PIATRA-NEAMŢ",120726,1,PART,PRCNCT,PRSD,PRSD_SV,"2025-05-18 21:43:38",1241,758,655,99,4,744,14,1300,542,223,521
29,NEAMŢ,"LICEUL TEOLOGIC ORTODOX „SFINȚII ÎMPĂRAȚI CONSTANTIN ȘI ELENA” - CORP A (CORP DE GRĂDINIȚĂ)",61,"MUNICIPIUL PIATRA-NEAMŢ",120726,1,PART,PRCNCT,PRSD,PRSD_SV,"2025-05-18 21:35:19",879,464,399,65,0,459,5,1000,536,145,314
29,NEAMŢ,"LICEUL TEOLOGIC ORTODOX „SFINȚII ÎMPĂRAȚI CONSTANTIN ȘI ELENA” - CORP A (CORP DE GRĂDINIȚĂ)",62,"MUNICIPIUL PIATRA-NEAMŢ",120726,1,PART,PRCNCT,PRSD,PRSD_SV,"2025-05-18 21:39:12",1218,691,640,51,0,672,19,1300,609,210,462
29,NEAMŢ,"LICEUL TEOLOGIC ORTODOX „SFINȚII ÎMPĂRAȚI CONSTANTIN ȘI ELENA” - CORP A",63,"MUNICIPIUL PIATRA-NEAMŢ",120726,1,PART,PRCNCT,PRSD,PRSD_SV,"2025-05-18 21:34:38",1189,474,447,27,0,462,12,1300,826,246,216
29,NEAMŢ,"LICEUL TEOLOGIC ORTODOX „SFINȚII ÎMPĂRAȚI CONSTANTIN ȘI ELENA” - CORP A",64,"MUNICIPIUL PIATRA-NEAMŢ",120726,1,PART,PRCNCT,PRSD,PRSD_SV,"2025-05-18 21:56:57",1583,658,628,30,0,643,15,1700,1042,267,376
29,NEAMŢ,"LICEUL TEOLOGIC ORTODOX „SFINȚII ÎMPĂRAȚI CONSTANTIN ȘI ELENA” - CORP A",65,"MUNICIPIUL PIATRA-NEAMŢ",120726,1,PART,PRCNCT,PRSD,PRSD_SV,"2025-05-18 22:03:09",912,393,379,13,1,384,9,1000,607,149,235
29,NEAMŢ,"LICEUL TEOLOGIC ORTODOX „SFINȚII ÎMPĂRAȚI CONSTANTIN ȘI ELENA” - CORP A",66,"MUNICIPIUL PIATRA-NEAMŢ",120726,1,PART,PRCNCT,PRSD,PRSD_SV,"2025-05-18 22:04:11",1149,493,478,15,0,486,7,1300,807,184,302
29,NEAMŢ,"LICEUL TEOLOGIC ORTODOX „SFINȚII ÎMPĂRAȚI CONSTANTIN ȘI ELENA” - CORP A",67,"MUNICIPIUL PIATRA-NEAMŢ",120726,1,PART,PRCNCT,PRSD,PRSD_SV,"2025-05-18 21:41:01",839,400,373,26,1,391,9,900,500,142,249
29,NEAMŢ,"LICEUL TEOLOGIC ORTODOX „SFINȚII ÎMPĂRAȚI CONSTANTIN ȘI ELENA” - CORP A",68,"MUNICIPIUL PIATRA-NEAMŢ",120726,1,PART,PRCNCT,PRSD,PRSD_SV,"2025-05-18 21:44:34",1633,633,590,43,0,617,16,1800,1167,284,333
29,NEAMŢ,"ŞCOALA GIMNAZIALĂ NR.1",69,"MUNICIPIUL PIATRA-NEAMŢ",120726,1,PART,PRCNCT,PRSD,PRSD_SV,"2025-05-18 21:54:38",1888,940,898,42,0,924,16,2000,1060,359,565
29,NEAMŢ,"LICEUL TEHNOLOGIC ”DIMITRIE LEONIDA”, CORP A",70,"MUNICIPIUL PIATRA-NEAMŢ",120726,1,PART,PRCNCT,PRSD,PRSD_SV,"2025-05-18 22:07:59",1037,570,542,28,0,560,10,1100,530,268,292
29,NEAMŢ,"LICEUL TEHNOLOGIC ”DIMITRIE LEONIDA”",71,"MUNICIPIUL PIATRA-NEAMŢ",120726,1,PART,PRCNCT,PRSD,PRSD_SV,"2025-05-18 21:41:41",1329,622,590,31,1,608,14,1500,878,292,316
29,NEAMŢ,"LICEUL TEHNOLOGIC ”DIMITRIE LEONIDA”",72,"MUNICIPIUL PIATRA-NEAMŢ",120726,1,PART,PRCNCT,PRSD,PRSD_SV,"2025-05-18 22:10:04",1218,698,644,54,0,688,10,1300,602,367,321
29,NEAMŢ,"LICEUL TEHNOLOGIC ”DIMITRIE LEONIDA” CORP B",73,"MUNICIPIUL PIATRA-NEAMŢ",120726,1,PART,PRCNCT,PRSD,PRSD_SV,"2025-05-18 21:29:03",1020,537,503,34,0,524,13,1100,563,284,240
29,NEAMŢ,"GRĂDINIŢA CU PROGRAM PRELUNGIT ”FLOARE DE COLŢ”",74,"MUNICIPIUL PIATRA-NEAMŢ",120726,1,PART,PRCNCT,PRSD,PRSD_SV,"2025-05-18 22:18:23",1432,646,595,51,0,639,7,1600,954,231,408
29,NEAMŢ,"GRĂDINIŢA CU PROGRAM PRELUNGIT ”FLOARE DE COLŢ”",75,"MUNICIPIUL PIATRA-NEAMŢ",120726,1,PART,PRCNCT,PRSD,PRSD_SV,"2025-05-18 22:03:46",1183,583,547,36,0,571,12,1300,717,226,345
29,NEAMŢ,"COLEGIUL NAȚIONAL ”ROMAN VODĂ” - CORP A",76,"MUNICIPIUL ROMAN",120860,1,PART,PRCNCT,PRSD,PRSD_SV,"2025-05-18 21:34:55",1122,664,505,110,49,652,12,1200,536,248,404
29,NEAMŢ,"ȘCOALA GIMNAZIALĂ ”VASILE ALECSANDRI”(CLĂDIRE GRADINIȚĂ NR. 2 D. GHEREA PROGRAM NORMAL)",77,"MUNICIPIUL ROMAN",120860,1,PART,PRCNCT,PRSD,PRSD_SV,"2025-05-18 22:02:54",1086,638,533,63,42,632,6,1200,562,200,432
29,NEAMŢ,"GRĂDINIŢA DE COPII NR. 6 CU PROGRAM PRELUNGIT",78,"MUNICIPIUL ROMAN",120860,1,PART,PRCNCT,PRSD,PRSD_SV,"2025-05-18 21:40:14",1179,575,536,39,0,567,8,1300,725,266,301
29,NEAMŢ,"ŞCOALA GIMNAZIALĂ ”CALISTRAT HOGAŞ”",79,"MUNICIPIUL ROMAN",120860,1,PART,PRCNCT,PRSD,PRSD_SV,"2025-05-18 22:09:51",1533,594,533,61,0,584,10,1700,1106,290,294
29,NEAMŢ,"ŞCOALA GIMNAZIALĂ ”CALISTRAT HOGAŞ”",80,"MUNICIPIUL ROMAN",120860,1,PART,PRCNCT,PRSD,PRSD_SV,"2025-05-18 22:00:30",1660,472,430,41,1,465,7,1797,1325,250,215
29,NEAMŢ,"ŞCOALA GIMNAZIALĂ ”CALISTRAT HOGAŞ”",81,"MUNICIPIUL ROMAN",120860,1,PART,PRCNCT,PRSD,PRSD_SV,"2025-05-18 22:11:09",1349,507,445,62,0,498,9,1500,993,282,216
29,NEAMŢ,"ȘCOALA GIMNAZIALĂ ”CALISTRAT HOGAȘ”",82,"MUNICIPIUL ROMAN",120860,1,PART,PRCNCT,PRSD,PRSD_SV,"2025-05-18 21:59:58",1224,561,482,79,0,550,11,1300,739,265,285
29,NEAMŢ,"CENTRUL DE PERMANENŢĂ DE LA DISPENSARUL MEDICAL NR. 6",83,"MUNICIPIUL ROMAN",120860,1,PART,PRCNCT,PRSD,PRSD_SV,"2025-05-18 21:30:27",1165,507,482,25,0,498,9,1300,793,266,232
29,NEAMŢ,"GRĂDINIŢA DE COPII NR. 6 CU PROGRAM NORMAL",84,"MUNICIPIUL ROMAN",120860,1,PART,PRCNCT,PRSD,PRSD_SV,"2025-05-18 21:49:09",1402,671,635,36,0,656,15,1498,827,316,340
29,NEAMŢ,"LICEUL TEHNOLOGIC „VASILE SAV”",85,"MUNICIPIUL ROMAN",120860,1,PART,PRCNCT,PRSD,PRSD_SV,"2025-05-18 21:48:15",999,440,400,40,0,432,8,1100,660,200,232
29,NEAMŢ,"LICEUL TEHNOLOGIC „VASILE SAV”",86,"MUNICIPIUL ROMAN",120860,1,PART,PRCNCT,PRSD,PRSD_SV,"2025-05-18 21:57:56",929,466,424,42,0,453,13,1000,534,186,267
29,NEAMŢ,"COLEGIUL TEHNIC „MIRON COSTIN” (CLĂDIRE PAVILION C+L)",87,"MUNICIPIUL ROMAN",120860,1,PART,PRCNCT,PRSD,PRSD_SV,"2025-05-18 21:38:50",1131,432,392,40,0,426,6,1200,768,306,120
29,NEAMŢ,"COLEGIUL TEHNIC „MIRON COSTIN” (CLĂDIRE PAVILION A)",88,"MUNICIPIUL ROMAN",120860,1,PART,PRCNCT,PRSD,PRSD_SV,"2025-05-18 21:55:15",1315,632,587,45,0,625,7,1400,768,269,356
29,NEAMŢ,"ŞCOALA GIMNAZIALĂ ”CAROL I”",89,"MUNICIPIUL ROMAN",120860,1,PART,PRCNCT,PRSD,PRSD_SV,"2025-05-18 22:11:07",1531,755,722,33,0,732,23,1700,945,439,293
29,NEAMŢ,"ŞCOALA GIMNAZIALĂ ”CAROL I”",90,"MUNICIPIUL ROMAN",120860,1,PART,PRCNCT,PRSD,PRSD_SV,"2025-05-18 22:32:13",1395,733,690,43,0,718,15,1500,767,380,338
29,NEAMŢ,"ŞCOALA DE ARTĂ ”SERGIU CELIBIDACHE” - CORP A",91,"MUNICIPIUL ROMAN",120860,1,PART,PRCNCT,PRSD,PRSD_SV,"2025-05-18 21:42:16",1212,544,491,53,0,535,9,1300,756,203,332
29,NEAMŢ,"ŞCOALA DE ARTĂ ”SERGIU CELIBIDACHE” - CORP A",92,"MUNICIPIUL ROMAN",120860,1,PART,PRCNCT,PRSD,PRSD_SV,"2025-05-18 22:00:37",1255,603,572,31,0,590,13,1400,797,259,331
29,NEAMŢ,"ŞCOALA DE ARTĂ ”SERGIU CELIBIDACHE” - CORP B",93,"MUNICIPIUL ROMAN",120860,1,PART,PRCNCT,PRSD,PRSD_SV,"2025-05-18 22:23:57",1293,624,587,36,1,614,10,1400,776,241,373
29,NEAMŢ,"GRĂDINIŢA DE COPII NR. 4 CU PROGRAM NORMAL",94,"MUNICIPIUL ROMAN",120860,1,PART,PRCNCT,PRSD,PRSD_SV,"2025-05-18 21:46:27",1284,622,575,47,0,614,8,1400,778,251,363
29,NEAMŢ,"GRĂDINIŢA DE COPII NR. 5 CU PROGRAM PRELUNGIT",95,"MUNICIPIUL ROMAN",120860,1,PART,PRCNCT,PRSD,PRSD_SV,"2025-05-18 22:21:56",1460,698,660,38,0,690,8,1600,902,242,448
29,NEAMŢ,"CREŞA SMIRODAVA",96,"MUNICIPIUL ROMAN",120860,1,PART,PRCNCT,PRSD,PRSD_SV,"2025-05-18 21:42:07",1299,578,532,44,2,568,10,1400,822,236,332
29,NEAMŢ,"GRĂDINIŢA DE COPII NR. 1 CU PROGRAM PRELUNGIT",97,"MUNICIPIUL ROMAN",120860,1,PART,PRCNCT,PRSD,PRSD_SV,"2025-05-18 21:37:35",1342,594,556,38,0,582,12,1500,906,267,315
29,NEAMŢ,"GRĂDINIŢA DE COPII NR. 1 CU PROGRAM PRELUNGIT",98,"MUNICIPIUL ROMAN",120860,1,PART,PRCNCT,PRSD,PRSD_SV,"2025-05-18 21:42:08",1315,582,548,33,1,573,9,1400,818,247,326
29,NEAMŢ,"COLEGIUL TEHNIC „MIRON COSTIN”",99,"MUNICIPIUL ROMAN",120860,1,PART,PRCNCT,PRSD,PRSD_SV,"2025-05-18 21:51:09",1146,420,385,35,0,411,9,1300,880,243,168
29,NEAMŢ,"LICEUL CU PROGRAM SPORTIV",100,"MUNICIPIUL ROMAN",120860,1,PART,PRCNCT,PRSD,PRSD_SV,"2025-05-18 21:53:30",997,481,401,38,42,469,12,1100,619,225,244
29,NEAMŢ,"ŞCOALA GIMNAZIALĂ ”VASILE ALECSANDRI” - LOCAL NOU",101,"MUNICIPIUL ROMAN",120860,1,PART,PRCNCT,PRSD,PRSD_SV,"2025-05-18 21:53:50",1178,572,543,29,0,564,8,1300,728,212,352
29,NEAMŢ,"ŞCOALA GIMNAZIALĂ ”VASILE ALECSANDRI” - LOCAL NOU",102,"MUNICIPIUL ROMAN",120860,1,PART,PRCNCT,PRSD,PRSD_SV,"2025-05-18 21:48:57",1303,623,558,65,0,613,10,1400,777,241,372
29,NEAMŢ,"CENTRUL DE ÎNGRIJIRE ŞI ASISTENŢĂ BĂTRÂNI (DISPENSAR 7)",103,"MUNICIPIUL ROMAN",120860,1,PART,PRCNCT,PRSD,PRSD_SV,"2025-05-18 22:13:55",1850,1116,1044,71,1,1098,18,2000,884,462,636
29,NEAMŢ,"DIRECŢIA DE ASISTENŢĂ SOCIALĂ ROMAN",104,"MUNICIPIUL ROMAN",120860,1,PART,PRCNCT,PRSD,PRSD_SV,"2025-05-18 21:46:22",996,480,433,46,1,473,7,1100,620,155,318
29,NEAMŢ,"LICEUL TEOLOGIC „EPISCOP MELCHISEDEC”",105,"MUNICIPIUL ROMAN",120860,1,PART,PRCNCT,PRSD,PRSD_SV,"2025-05-18 22:05:55",1190,594,524,47,23,589,5,1300,706,254,335
29,NEAMŢ,"ŞCOALA GIMNAZIALĂ ”ROMAN MUŞAT”",106,"MUNICIPIUL ROMAN",120860,1,PART,PRCNCT,PRSD,PRSD_SV,"2025-05-18 21:49:35",1242,585,543,42,0,579,6,1400,815,232,347
29,NEAMŢ,"ŞCOALA GIMNAZIALĂ ”ROMAN MUŞAT”",107,"MUNICIPIUL ROMAN",120860,1,PART,PRCNCT,PRSD,PRSD_SV,"2025-05-18 21:59:32",1171,554,473,81,0,538,16,1300,746,237,301
29,NEAMŢ,"ŞCOALA GIMNAZIALĂ ”ROMAN MUŞAT”",108,"MUNICIPIUL ROMAN",120860,1,PART,PRCNCT,PRSD,PRSD_SV,"2025-05-18 21:45:50",1262,600,531,69,0,589,11,1400,800,224,365
29,NEAMŢ,"GRĂDINIŢA DE COPII NR. 5 CU PROGRAM NORMAL",109,"MUNICIPIUL ROMAN",120860,1,PART,PRCNCT,PRSD,PRSD_SV,"2025-05-18 21:49:27",1408,658,592,66,0,642,16,1500,842,253,389
29,NEAMŢ,"ŞCOALA GIMNAZIALĂ ”COSTACHE NEGRI” - LOCAL NOU",110,"MUNICIPIUL ROMAN",120860,1,PART,PRCNCT,PRSD,PRSD_SV,"2025-05-18 21:41:58",891,404,363,41,0,398,6,1000,596,167,231
29,NEAMŢ,"ŞCOALA GIMNAZIALĂ ”COSTACHE NEGRI” - LOCAL NOU",111,"MUNICIPIUL ROMAN",120860,1,PART,PRCNCT,PRSD,PRSD_SV,"2025-05-18 21:58:29",1390,675,645,30,0,657,18,1500,825,353,304
29,NEAMŢ,"COLEGIUL TEHNIC „PETRU PONI” - CORP A",112,"MUNICIPIUL ROMAN",120860,1,PART,PRCNCT,PRSD,PRSD_SV,"2025-05-18 22:03:51",1092,584,480,103,1,570,14,1200,616,280,290
29,NEAMŢ,"COLEGIUL TEHNIC „PETRU PONI” - CORP B",113,"MUNICIPIUL ROMAN",120860,1,PART,PRCNCT,PRSD,PRSD_SV,"2025-05-18 21:49:44",1368,682,623,59,0,674,8,1500,818,272,402
29,NEAMŢ,"ŞCOALA GIMNAZIALĂ „ALEXANDRU IOAN CUZA”(ŞCOALA NR. 5)",114,"MUNICIPIUL ROMAN",120860,2,PART,PRCNCT,PRSD,PRSD_SV,"2025-05-19 00:18:09",1477,717,667,50,0,706,11,1600,883,237,469
29,NEAMŢ,"ŞCOALA GIMNAZIALĂ „ALEXANDRU IOAN CUZA”(ŞCOALA NR. 5)",115,"MUNICIPIUL ROMAN",120860,1,PART,PRCNCT,PRSD,PRSD_SV,"2025-05-18 21:38:01",1194,560,518,41,1,549,11,1300,740,229,320
29,NEAMŢ,"ŞCOALA GIMNAZIALĂ „ALEXANDRU IOAN CUZA” CORP C(GRĂDINIŢA DE COPII NR. 3 CU PROGRAM PRELUNGIT)",116,"MUNICIPIUL ROMAN",120860,1,PART,PRCNCT,PRSD,PRSD_SV,"2025-05-18 22:12:03",1209,673,561,112,0,668,5,1300,627,242,426
29,NEAMŢ,"ŞCOALA GIMNAZIALĂ „ALEXANDRU IOAN CUZA” CORP B(GRĂDINIŢA DE COPII NR. 12 CU PROGRAM NORMAL)",117,"MUNICIPIUL ROMAN",120860,1,PART,PRCNCT,PRSD,PRSD_SV,"2025-05-18 21:37:14",1097,557,496,61,0,550,7,1200,643,246,304
29,NEAMŢ,"COLEGIUL TEHNIC „DANUBIANA”",118,"MUNICIPIUL ROMAN",120860,1,PART,PRCNCT,PRSD,PRSD_SV,"2025-05-18 22:02:50",1180,581,472,78,31,570,11,1300,719,273,297
29,NEAMŢ,"PRIMARIA ORASULUI BICAZ",119,"ORAŞ BICAZ",120968,1,PART,PRCNCT,PRSD,PRSD_SV,"2025-05-18 22:23:58",1101,627,476,113,38,612,15,1200,573,264,348
29,NEAMŢ,"SCOALA GENERALA NR. 1 MARCENI",120,"ORAŞ BICAZ",120968,2,PART,PRCNCT,PRSD,PRSD_SV,"2025-05-19 00:16:20",750,365,313,51,1,363,2,800,435,169,194
29,NEAMŢ,"SCOALA GENERALA NR. 1 MARCENI",121,"ORAŞ BICAZ",120968,1,PART,PRCNCT,PRSD,PRSD_SV,"2025-05-18 22:05:48",1109,492,453,38,1,484,8,1200,708,233,251
29,NEAMŢ,"LICEUL CAROL I",122,"ORAŞ BICAZ",120968,1,PART,PRCNCT,PRSD,PRSD_SV,"2025-05-18 21:43:21",998,539,445,93,1,532,7,1100,561,274,258
29,NEAMŢ,"SCOALA GENERALA NR.2 DODENI",123,"ORAŞ BICAZ",120968,1,PART,PRCNCT,PRSD,PRSD_SV,"2025-05-18 21:56:33",886,338,319,19,0,335,3,1000,662,188,147
29,NEAMŢ,"SCOALA GENERALA NR.2 DODENI",124,"ORAŞ BICAZ",120968,1,PART,PRCNCT,PRSD,PRSD_SV,"2025-05-18 22:04:21",979,339,321,18,0,333,6,1100,761,207,126
29,NEAMŢ,"CENTRUL CULTURAL IZVORU MUNTELUI",125,"ORAŞ BICAZ",120968,1,PART,PRCNCT,PRSD,PRSD_SV,"2025-05-18 21:34:12",391,257,189,67,1,250,7,400,143,150,100
29,NEAMŢ,"SCOALA GENERALA NR.1 MARCENI",126,"ORAŞ BICAZ",120968,1,PART,PRCNCT,PRSD,PRSD_SV,"2025-05-18 21:13:23",99,51,34,17,0,50,1,200,149,17,33
29,NEAMŢ,"SCOALA GENERALA NR.1 MARCENI",127,"ORAŞ BICAZ",120968,1,PART,PRCNCT,PRSD,PRSD_SV,"2025-05-18 21:45:07",202,99,82,17,0,94,5,300,201,61,33
29,NEAMŢ,"SCOALA GENERALA NR.1 MARCENI",128,"ORAŞ BICAZ",120968,1,PART,PRCNCT,PRSD,PRSD_SV,"2025-05-18 21:09:01",59,22,11,11,0,21,1,100,78,12,9
29,NEAMŢ,"ȘCOALA GENERALĂ ROZNOV",129,"ORAŞ ROZNOV",124117,1,PART,PRCNCT,PRSD,PRSD_SV,"2025-05-18 21:37:39",1669,796,702,94,0,783,13,1800,1004,452,331
29,NEAMŢ,"DISPENSARUL UMAN ROZNOV",130,"ORAŞ ROZNOV",124117,1,PART,PRCNCT,PRSD,PRSD_SV,"2025-05-18 21:45:16",1523,715,641,74,0,698,17,1700,985,411,287
29,NEAMŢ,"CĂMINUL PENTRU PERSOANE VÂRSTNICE ROZNOV",131,"ORAŞ ROZNOV",124117,1,PART,PRCNCT,PRSD,PRSD_SV,"2025-05-18 21:42:19",1405,652,590,62,0,640,12,1500,848,443,197
29,NEAMŢ,"PAROHIA ”SF. ILIE” CHINTINICI",132,"ORAŞ ROZNOV",124117,1,PART,PRCNCT,PRSD,PRSD_SV,"2025-05-18 21:36:03",925,457,420,36,1,450,7,1000,543,271,179
29,NEAMŢ,"ȘCOALA SLOBOZIA",133,"ORAŞ ROZNOV",124117,1,PART,PRCNCT,PRSD,PRSD_SV,"2025-05-18 22:01:24",1382,576,534,42,0,570,6,1500,924,341,229
29,NEAMŢ,"ȘCOALA GENERALĂ SLOBOZIA",134,"ORAŞ ROZNOV",124117,1,PART,PRCNCT,PRSD,PRSD_SV,"2025-05-18 21:48:38",1306,584,547,37,0,574,10,1400,816,363,211
29,NEAMŢ,"SALA DE SPORT PARC CETATE",135,"ORAŞ TÂRGU-NEAMŢ",121055,1,PART,PRCNCT,PRSD,PRSD_SV,"2025-05-18 21:42:49",799,506,424,82,0,496,10,900,394,232,264
29,NEAMŢ,"GRĂDINIŢA CU PROGRAM PRELUNGIT NR.2",136,"ORAŞ TÂRGU-NEAMŢ",121055,1,PART,PRCNCT,PRSD,PRSD_SV,"2025-05-18 21:26:33",497,295,230,39,26,286,9,600,305,130,156
29,NEAMŢ,"SCOALA GIMNAZIALĂ DOMNEASCĂ ”GRIGORE GHICA VODĂ”",137,"ORAŞ TÂRGU-NEAMŢ",121055,1,PART,PRCNCT,PRSD,PRSD_SV,"2025-05-18 22:01:39",1595,942,786,132,24,927,15,1700,758,392,535
29,NEAMŢ,"LICEUL ”VASILE CONTA”",138,"ORAŞ TÂRGU-NEAMŢ",121055,1,PART,PRCNCT,PRSD,PRSD_SV,"2025-05-18 22:00:05",1541,823,711,112,0,807,16,1700,877,377,430
29,NEAMŢ,"COLEGIUL NAŢIONAL ”ŞTEFAN CEL MARE”, CORP B, SALA 1",139,"ORAŞ TÂRGU-NEAMŢ",121055,1,PART,PRCNCT,PRSD,PRSD_SV,"2025-05-18 21:54:43",1551,789,663,126,0,772,17,1700,911,340,432
29,NEAMŢ,"COLEGIUL NAŢIONAL ”ŞTEFAN CEL MARE”, CORP B, SALA 2 (FOSTA SECŢIE DE LA CASA CULTURII)",140,"ORAŞ TÂRGU-NEAMŢ",121055,2,PART,PRCNCT,PRSD,PRSD_SV,"2025-05-19 00:48:48",1559,742,704,38,0,723,19,1700,958,314,409
29,NEAMŢ,"COLEGIUL NAŢIONAL ”ŞTEFAN CEL MARE”, CORP A, SALA 1",141,"ORAŞ TÂRGU-NEAMŢ",121055,1,PART,PRCNCT,PRSD,PRSD_SV,"2025-05-18 22:01:26",1906,1042,928,114,0,1024,18,2100,1058,404,620
29,NEAMŢ,"CLUBUL COPIILOR",142,"ORAŞ TÂRGU-NEAMŢ",121055,1,PART,PRCNCT,PRSD,PRSD_SV,"2025-05-18 21:48:16",1724,841,783,58,0,818,23,1900,1059,380,438
29,NEAMŢ,"COLEGIUL TEHNIC ”ION CREANGĂ”, CORP B",143,"ORAŞ TÂRGU-NEAMŢ",121055,1,PART,PRCNCT,PRSD,PRSD_SV,"2025-05-18 21:54:02",1708,993,925,68,0,971,22,1900,907,487,484
29,NEAMŢ,"COLEGIUL TEHNIC ”ION CREANGĂ”, CORP B",144,"ORAŞ TÂRGU-NEAMŢ",121055,1,PART,PRCNCT,PRSD,PRSD_SV,"2025-05-18 21:30:51",1792,150,56,91,3,145,5,1900,1750,80,65
29,NEAMŢ,"CĂMINUL CULTURAL LOC.BLEBEA",145,"ORAŞ TÂRGU-NEAMŢ",121055,1,PART,PRCNCT,PRSD,PRSD_SV,"2025-05-18 21:45:01",703,356,327,29,0,352,4,800,444,172,180
29,NEAMŢ,"ŞCOALA GIMNAZIALĂ ”ION CREANGĂ”, CORP B, LOC. HUMULEŞTI",146,"ORAŞ TÂRGU-NEAMŢ",121055,1,PART,PRCNCT,PRSD,PRSD_SV,"2025-05-18 21:43:43",1607,807,768,38,1,795,12,1800,993,498,297
29,NEAMŢ,"ŞCOALA GIMNAZIALĂ ”ION CREANGĂ”, CORP A, LOC. HUMULEŞTI",147,"ORAŞ TÂRGU-NEAMŢ",121055,1,PART,PRCNCT,PRSD,PRSD_SV,"2025-05-18 21:53:49",1638,859,814,45,0,842,17,1800,941,410,432
29,NEAMŢ,"ŞCOALA GIMNAZIALĂ ”ION CREANGĂ”, CORP A1, LOC. HUMULEŞTI",148,"ORAŞ TÂRGU-NEAMŢ",121055,1,PART,PRCNCT,PRSD,PRSD_SV,"2025-05-18 21:21:19",472,222,198,24,0,221,1,500,278,107,114
29,NEAMŢ,"ŞCOALA GIMNAZIALĂ NICOLAE GRIGORESCU AGAPIA",149,AGAPIA,121108,1,PART,PRCNCT,PRSD,PRSD_SV,"2025-05-18 21:46:09",1414,788,670,117,1,777,11,1600,812,497,280
29,NEAMŢ,"ŞCOALA GIMNAZIALĂ MIHAI EMINESCU FILIOARA",150,AGAPIA,121108,1,PART,PRCNCT,PRSD,PRSD_SV,"2025-05-18 21:30:37",820,470,439,31,0,461,9,900,430,274,187
29,NEAMŢ,"ŞCOALA PRIMARĂ SĂCĂLUŞEŞTI",151,AGAPIA,121108,1,PART,PRCNCT,PRSD,PRSD_SV,"2025-05-18 21:43:24",554,318,277,39,2,318,0,600,282,154,164
29,NEAMŢ,"ŞCOALA NOUĂ VĂRATEC",152,AGAPIA,121108,1,PART,PRCNCT,PRSD,PRSD_SV,"2025-05-18 21:42:30",681,497,386,109,2,471,26,800,303,343,128
29,NEAMŢ,"SEDIUL S.V.S.U.",153,"ALEXANDRU CEL BUN",124938,1,PART,PRCNCT,PRSD,PRSD_SV,"2025-05-18 21:57:47",997,559,477,81,1,549,10,1100,541,280,269
29,NEAMŢ,"ȘCOALA GIMNAZIALĂ VADURI (CLĂDIREA FOSTEI ȘCOLI DIN SATUL AGÂRCIA)",154,"ALEXANDRU CEL BUN",124938,1,PART,PRCNCT,PRSD,PRSD_SV,"2025-05-18 21:31:16",283,207,114,44,49,201,6,300,93,92,109
29,NEAMŢ,"SCOALA GIMNAZIALĂ VADURI",155,"ALEXANDRU CEL BUN",124938,1,PART,PRCNCT,PRSD,PRSD_SV,"2025-05-18 22:06:59",1842,1088,917,169,2,1080,8,2000,912,488,592
29,NEAMŢ,"SCOALA GIMNAZIALĂ VADURI",156,"ALEXANDRU CEL BUN",124938,1,PART,PRCNCT,PRSD,PRSD_SV,"2025-05-18 21:32:07",858,555,403,114,38,541,14,900,345,279,262
29,NEAMŢ,"SCOALA GIMNAZIALĂ VADURI",157,"ALEXANDRU CEL BUN",124938,1,PART,PRCNCT,PRSD,PRSD_SV,"2025-05-18 22:15:24",1148,722,617,79,26,710,12,1300,578,363,347
29,NEAMŢ,"ȘCOALA GIMNAZIALĂ COMUNA BAHNA",158,BAHNA,121153,1,PART,PRCNCT,PRSD,PRSD_SV,"2025-05-18 21:37:22",463,215,180,34,1,213,2,500,285,110,103
29,NEAMŢ,"GRĂDINIŢA CU PROGRAM NORMAL,LOCALITATEA BĂHNIŞOARA",159,BAHNA,121153,1,PART,PRCNCT,PRSD,PRSD_SV,"2025-05-18 22:03:11",338,197,159,29,9,195,2,400,203,95,100
29,NEAMŢ,"GRĂDINIŢĂ CU PROGRAM NORMAL,LOCALITATEA BROŞTENI",160,BAHNA,121153,1,PART,PRCNCT,PRSD,PRSD_SV,"2025-05-18 21:17:17",317,234,156,60,18,234,0,400,166,103,131
29,NEAMŢ,"ŞCOALA GIMNAZIALĂ,LOCALITATEA IZVOARE",161,BAHNA,121153,1,PART,PRCNCT,PRSD,PRSD_SV,"2025-05-18 21:59:24",1107,488,440,47,1,482,6,1200,712,391,91
29,NEAMŢ,"FOSTA ŞCOALA CU CLASELE I-IV,LOCALITATEA ŢUŢCANII DIN VALE",162,BAHNA,121153,1,PART,PRCNCT,PRSD,PRSD_SV,"2025-05-18 21:14:33",234,129,104,21,4,129,0,300,171,58,71
29,NEAMŢ,"PRIMĂRIA COMUNEI BĂLŢĂTEŞTI",163,BĂLŢĂTEŞTI,121242,1,PART,PRCNCT,PRSD,PRSD_SV,"2025-05-18 21:50:33",1664,1013,829,184,0,997,16,1800,787,459,538
29,NEAMŢ,"CONTAINER MODULAR",164,BĂLŢĂTEŞTI,121242,1,PART,PRCNCT,PRSD,PRSD_SV,"2025-05-18 21:30:00",497,225,206,19,0,223,2,600,375,152,71
29,NEAMŢ,"ŞCOALA GIMNAZIALĂ",165,BĂLŢĂTEŞTI,121242,1,PART,PRCNCT,PRSD,PRSD_SV,"2025-05-18 21:22:42",1153,552,504,46,2,546,6,1200,648,324,222
29,NEAMŢ,"PRIMĂRIA BÎRGĂUANI",166,BÂRGĂUANI,121466,1,PART,PRCNCT,PRSD,PRSD_SV,"2025-05-18 21:18:31",387,171,139,31,1,170,1,400,229,88,82
29,NEAMŢ,"FOSTA GRĂDINIȚĂ DE COPII BÎRGĂUANI DEAL",167,BÂRGĂUANI,121466,1,PART,PRCNCT,PRSD,PRSD_SV,"2025-05-18 21:22:09",409,227,171,55,1,225,2,500,273,98,127
29,NEAMŢ,"ȘCOALA PRIMARĂ BĂLĂNEȘTI",168,BÂRGĂUANI,121466,1,PART,PRCNCT,PRSD,PRSD_SV,"2025-05-18 21:29:09",517,260,212,48,0,258,2,600,340,187,71
29,NEAMŢ,"FOSTA ȘCOALĂ PRIMARĂ BREAZA",169,BÂRGĂUANI,121466,1,PART,PRCNCT,PRSD,PRSD_SV,"2025-05-18 21:21:37",155,94,81,13,0,94,0,200,106,59,35
29,NEAMŢ,"FOSTA ȘCOALĂ PRIMARĂ CERTIENI",170,BÂRGĂUANI,121466,1,PART,PRCNCT,PRSD,PRSD_SV,"2025-05-18 21:35:39",159,93,68,25,0,92,1,200,107,50,42
29,NEAMŢ,"CĂMINUL CULTURAL HÎRTOP",171,BÂRGĂUANI,121466,1,PART,PRCNCT,PRSD,PRSD_SV,"2025-05-18 21:35:28",170,133,91,42,0,133,0,200,67,82,51
29,NEAMŢ,"ȘCOALA PRIMARĂ TALPA",172,BÂRGĂUANI,121466,1,PART,PRCNCT,PRSD,PRSD_SV,"2025-05-18 21:13:42",484,273,207,66,0,269,4,500,227,167,102
29,NEAMŢ,"FOSTA ȘCOALĂ PRIMARĂ VLĂDICENI",173,BÂRGĂUANI,121466,1,PART,PRCNCT,PRSD,PRSD_SV,"2025-05-18 21:26:59",423,213,172,41,0,212,1,500,287,102,110
29,NEAMŢ,"CAMIN CULTURAL",174,BICAZ-CHEI,121297,1,PART,PRCNCT,PRSD,PRSD_SV,"2025-05-18 21:41:35",1103,527,453,72,2,519,8,1200,673,387,132
29,NEAMŢ,"SCOALA GIMNAZIALA NR. 2",175,BICAZ-CHEI,121297,1,PART,PRCNCT,PRSD,PRSD_SV,"2025-05-18 21:32:04",769,375,335,40,0,373,2,800,425,311,62
29,NEAMŢ,"SCOALA GIMNAZIALA NR.1",176,BICAZ-CHEI,121297,1,PART,PRCNCT,PRSD,PRSD_SV,"2025-05-18 21:44:48",999,530,487,42,1,524,6,1100,570,388,136
29,NEAMŢ,"ȘCOALA GIMNAZIALĂ NR.1",177,BICAZ-CHEI,121297,1,PART,PRCNCT,PRSD,PRSD_SV,"2025-05-18 21:35:09",707,334,306,28,0,331,3,800,466,224,107
29,NEAMŢ,"CĂMIN CULTURAL",178,"BICAZU ARDELEAN",121340,1,PART,PRCNCT,PRSD,PRSD_SV,"2025-05-18 21:39:44",1278,598,530,64,4,594,4,1400,802,408,186
29,NEAMŢ,"ŞCOALA GIMNAZIALA NR.2",179,"BICAZU ARDELEAN",121340,1,PART,PRCNCT,PRSD,PRSD_SV,"2025-05-18 21:31:36",1023,485,437,48,0,481,4,1100,615,326,155
29,NEAMŢ,"GRĂDINIȚA CU PROGRAM NORMAL NR. 1",180,"BICAZU ARDELEAN",121340,1,PART,PRCNCT,PRSD,PRSD_SV,"2025-05-18 21:19:43",380,186,168,18,0,184,2,400,214,133,51
29,NEAMŢ,"ȘCOALA PRIMARĂ NOUĂ TICOȘ",181,"BICAZU ARDELEAN",121340,1,PART,PRCNCT,PRSD,PRSD_SV,"2025-05-18 21:22:33",232,155,127,28,0,154,1,300,145,107,47
29,NEAMŢ,"CĂMINUL CULTURAL BIRA",182,BIRA,121386,1,PART,PRCNCT,PRSD,PRSD_SV,"2025-05-18 21:32:22",608,269,228,41,0,265,4,700,431,123,142
29,NEAMŢ,"ANEXĂ ȘCOALA NEGREȘTI",183,BIRA,121386,1,PART,PRCNCT,PRSD,PRSD_SV,"2025-05-18 21:22:33",149,91,65,26,0,87,4,200,109,49,38
29,NEAMŢ,"ȘCOALA GIMNAZIALĂ ”ANTONIE MUREȘIANU”- GRĂDINIȚA",184,BIRA,121386,1,PART,PRCNCT,PRSD,PRSD_SV,"2025-05-18 21:43:30",554,262,246,16,0,260,2,600,338,142,118
29,NEAMŢ,"ȘCOALA REDIU 1",185,BIRA,121386,1,PART,PRCNCT,PRSD,PRSD_SV,"2025-05-18 21:16:55",218,123,99,24,0,123,0,300,177,86,37
29,NEAMŢ,"ŞCOALA CU CLASELE I-IV",186,BODEŞTI,121607,1,PART,PRCNCT,PRSD,PRSD_SV,"2025-05-18 21:51:08",851,469,389,77,3,460,9,900,431,220,240
29,NEAMŢ,"ŞCOALA CU CLASELE I-IV",187,BODEŞTI,121607,1,PART,PRCNCT,PRSD,PRSD_SV,"2025-05-18 21:39:16",787,391,336,52,3,380,11,900,509,193,187
29,NEAMŢ,"GRĂDINIŢĂ - (CĂTUNĂ)",188,BODEŞTI,121607,1,PART,PRCNCT,PRSD,PRSD_SV,"2025-05-18 21:37:58",500,266,222,43,1,261,5,600,334,143,118
29,NEAMŢ,"ŞCOALA CU CLASELE I-VIII",189,BODEŞTI,121607,1,PART,PRCNCT,PRSD,PRSD_SV,"2025-05-18 21:38:04",707,347,301,46,0,345,2,800,453,158,187
29,NEAMŢ,ŞCOALA,190,BODEŞTI,121607,1,PART,PRCNCT,PRSD,PRSD_SV,"2025-05-18 21:27:57",116,104,64,29,11,101,3,200,96,51,50
29,NEAMŢ,ŞCOALA,191,BODEŞTI,121607,1,PART,PRCNCT,PRSD,PRSD_SV,"2025-05-18 21:32:30",754,404,366,38,0,398,6,800,396,180,218
29,NEAMŢ,"ȘCOALA GIMNAZIALĂ BOGHICEA",192,BOGHICEA,125178,1,PART,PRCNCT,PRSD,PRSD_SV,"2025-05-18 21:16:48",1021,465,411,48,6,460,5,1100,635,288,172
29,NEAMŢ,"ȘCOALA PRIMARĂ CĂUȘENI",193,BOGHICEA,125178,1,PART,PRCNCT,PRSD,PRSD_SV,"2025-05-18 21:15:49",142,82,67,13,2,82,0,200,118,44,38
29,NEAMŢ,"ȘCOALA PRIMARĂ NISTRIA",194,BOGHICEA,125178,1,PART,PRCNCT,PRSD,PRSD_SV,"2025-05-18 21:18:09",226,97,85,12,0,97,0,300,203,63,34
29,NEAMŢ,"ȘCOALA GIMNAZIALĂ SLOBOZIA",195,BOGHICEA,125178,1,PART,PRCNCT,PRSD,PRSD_SV,"2025-05-18 21:20:50",605,288,273,14,1,280,8,700,412,142,138
29,NEAMŢ,"LICEUL ”MIHAIL SADOVEANU”(CORPUL B)",196,BORCA,121652,1,PART,PRCNCT,PRSD,PRSD_SV,"2025-05-18 21:40:14",819,435,376,59,0,427,8,900,465,284,143
29,NEAMŢ,"SALA DE FESTIVITĂŢI MADEI",197,BORCA,121652,1,PART,PRCNCT,PRSD,PRSD_SV,"2025-05-18 21:36:01",829,467,404,63,0,460,7,900,433,318,142
29,NEAMŢ,"ŞCOALA PRIMARĂ NR.3 LOCALITATEA PÎRÎUL CÎRJEI",198,BORCA,121652,1,PART,PRCNCT,PRSD,PRSD_SV,"2025-05-18 21:34:55",562,312,287,25,0,309,3,600,288,238,71
29,NEAMŢ,"ŞCOALA PRIMARĂ NR.2 LOCALITATEA PÎRÎUL PÎNTEI",199,BORCA,121652,1,PART,PRCNCT,PRSD,PRSD_SV,"2025-05-18 21:36:18",402,226,201,25,0,225,1,500,274,156,69
29,NEAMŢ,"GRĂDINIŢA CU PROGRAM NORMAL - BORCA CENTRU",200,BORCA,121652,1,PART,PRCNCT,PRSD,PRSD_SV,"2025-05-18 21:51:01",725,439,372,67,0,435,4,800,361,285,150
29,NEAMŢ,"CĂMIN CULTURAL SABASA",201,BORCA,121652,1,PART,PRCNCT,PRSD,PRSD_SV,"2025-05-18 21:43:10",948,447,423,24,0,442,5,1000,553,349,93
29,NEAMŢ,"ŞCOALA PRIMARĂ NR.1 LOCALITATEA SOCI",202,BORCA,121652,1,PART,PRCNCT,PRSD,PRSD_SV,"2025-05-18 21:40:44",735,389,368,21,0,385,4,800,411,319,66
29,NEAMŢ,"SCOALA GIMNAZIALĂ BORLEŞTI",203,BORLEŞTI,121732,1,PART,PRCNCT,PRSD,PRSD_SV,"2025-05-18 21:48:19",1509,651,615,35,1,640,11,1600,949,362,278
29,NEAMŢ,"ȘCOALA GIMNAZIALĂ",204,BORLEŞTI,121732,2,PART,PRCNCT,PRSD,PRSD_SV,"2025-05-18 23:20:43",803,321,299,22,0,316,5,900,579,195,121
29,NEAMŢ,"ŞCOALA GIMNAZIALĂ ”ŞTEFAN CEL MARE”",205,BORLEŞTI,121732,1,PART,PRCNCT,PRSD,PRSD_SV,"2025-05-18 21:24:51",1477,611,573,38,0,607,4,1600,989,355,252
29,NEAMŢ,"”CĂMIN CULTURAL”",206,BORLEŞTI,121732,1,PART,PRCNCT,PRSD,PRSD_SV,"2025-05-18 21:20:42",238,140,79,61,0,137,3,300,160,83,54
29,NEAMŢ,"GRĂDINIȚA CU PROGRAM NORMAL NR.3",207,BORLEŞTI,121732,1,PART,PRCNCT,PRSD,PRSD_SV,"2025-05-18 21:22:20",870,407,376,31,0,401,6,1000,593,243,158
29,NEAMŢ,"ŞCOALA GIMNAZIALA ” IOAN GRIGORE TEODORESCU”",208,BORLEŞTI,121732,1,PART,PRCNCT,PRSD,PRSD_SV,"2025-05-18 21:31:04",837,368,325,43,0,365,3,900,532,237,128
29,NEAMŢ,"GRĂDINIȚA NR.2",209,BORLEŞTI,121732,1,PART,PRCNCT,PRSD,PRSD_SV,"2025-05-18 22:02:46",1357,591,552,39,0,580,11,1500,909,407,173
29,NEAMŢ,"ȘCOALA PRIMARĂ ȘOVOAIA",210,BORLEŞTI,121732,1,PART,PRCNCT,PRSD,PRSD_SV,"2025-05-18 21:25:59",398,164,146,18,0,162,2,400,236,120,42
29,NEAMŢ,"ŞCOALA CU CLASELE I-IV",211,BOTEŞTI,121796,1,PART,PRCNCT,PRSD,PRSD_SV,"2025-05-18 21:20:05",364,218,185,33,0,215,3,400,182,130,85
29,NEAMŢ,"SCOALA CU CLASELE I-VII",212,BOTEŞTI,121796,1,PART,PRCNCT,PRSD,PRSD_SV,"2025-05-18 21:34:27",1751,679,604,75,0,670,9,1900,1221,246,424
29,NEAMŢ,"LICEUL TEHNOLOGIC",213,BOTEŞTI,121796,1,PART,PRCNCT,PRSD,PRSD_SV,"2025-05-18 21:27:35",940,369,313,56,0,365,4,1000,631,185,180
29,NEAMŢ,"LICEUL TEHNOLOGIC",214,BOTEŞTI,121796,1,PART,PRCNCT,PRSD,PRSD_SV,"2025-05-18 21:42:15",1038,365,321,44,0,362,3,1100,735,180,182
29,NEAMŢ,"ȘCOALA GIMNAZIALĂ BOZIENI (ȘCOALA GENERALĂ BOZIENI)",215,BOZIENI,121876,1,PART,PRCNCT,PRSD,PRSD_SV,"2025-05-18 21:34:47",872,364,304,60,0,359,5,1000,636,201,158
29,NEAMŢ,"ȘCOALA GIMNAZIALĂ BOZIENI - ȘCOALA PRIMARĂ CUCI (ŞCOALA GENERALĂ BOZIENI)",216,BOZIENI,121876,1,PART,PRCNCT,PRSD,PRSD_SV,"2025-05-18 21:23:10",631,255,225,30,0,255,0,700,445,160,95
29,NEAMŢ,"ȘCOALA GIMNAZIALĂ BOZIENI - ȘCOALA PRIMARĂ IUCȘA (ŞCOALA GENERALĂ BOZIENI)",217,BOZIENI,121876,1,PART,PRCNCT,PRSD,PRSD_SV,"2025-05-18 21:37:57",633,248,213,35,0,248,0,700,452,178,70
29,NEAMŢ,"ŞCOALA GIMNAZIALĂ „IEREMIA IRIMESCU” BRUSTURI",218,BRUSTURI,121938,1,PART,PRCNCT,PRSD,PRSD_SV,"2025-05-18 21:26:45",1507,755,672,81,2,745,10,1600,845,571,174
29,NEAMŢ,"GRADINITA CU PROGRAM NORMAL GROSI",219,BRUSTURI,121938,1,PART,PRCNCT,PRSD,PRSD_SV,"2025-05-18 21:32:41",391,184,156,28,0,179,5,400,216,129,50
29,NEAMŢ,"GRADINITA CU PROGRAM NORMAL POIANA",220,BRUSTURI,121938,1,PART,PRCNCT,PRSD,PRSD_SV,"2025-05-18 21:14:02",642,308,280,28,0,305,3,700,392,234,71
29,NEAMŢ,"ŞCOALA GIMNAZIALĂ „GRIGORE STURZU” TIRZIA",221,BRUSTURI,121938,1,PART,PRCNCT,PRSD,PRSD_SV,"2025-05-18 21:17:29",587,287,248,39,0,280,7,600,313,178,102
29,NEAMŢ,"ȘCOALA GIMNAZIALĂ",222,CÂNDEŞTI,122061,1,PART,PRCNCT,PRSD,PRSD_SV,"2025-05-18 21:23:43",1257,470,448,22,0,467,3,1400,930,258,209
29,NEAMŢ,"GRĂDINIȚA CU PROGRAM NORMAL",223,CÂNDEŞTI,122061,1,PART,PRCNCT,PRSD,PRSD_SV,"2025-05-18 21:31:14",663,302,277,25,0,300,2,700,398,193,107
29,NEAMŢ,"ȘCOALA PRIMARĂ",224,CÂNDEŞTI,122061,1,PART,PRCNCT,PRSD,PRSD_SV,"2025-05-18 21:15:11",300,107,89,18,0,106,1,400,293,67,39
29,NEAMŢ,"GRĂDINIȚA CU PROGRAM NORMAL",225,CÂNDEŞTI,122061,1,PART,PRCNCT,PRSD,PRSD_SV,"2025-05-18 21:24:54",1055,402,374,28,0,401,1,1100,698,233,168
29,NEAMŢ,"ŞCOALA GRIGORE UNGUREANU",226,CEAHLĂU,122025,1,PART,PRCNCT,PRSD,PRSD_SV,"2025-05-18 22:13:04",1395,853,641,187,25,848,5,1500,647,452,396
29,NEAMŢ,"ȘCOALA PRIMARĂ NR.1",227,CEAHLĂU,122025,1,PART,PRCNCT,PRSD,PRSD_SV,"2025-05-18 21:52:10",590,348,287,55,6,347,1,600,252,215,132
29,NEAMŢ,"ȘCOALA GIMNAZIALĂ NR. 1 - GRĂDINIŢA CU PROGRAM PRELUNGIT CORDUN",228,CORDUN,120888,1,PART,PRCNCT,PRSD,PRSD_SV,"2025-05-18 22:07:18",1528,828,755,73,0,815,13,1700,872,399,416
29,NEAMŢ,"ȘCOALA GIMNAZIALĂ NR. 1 - GRĂDINIŢA CU PROGRAM PRELUNGIT CORDUN",229,CORDUN,120888,1,PART,PRCNCT,PRSD,PRSD_SV,"2025-05-18 21:56:04",1075,622,559,62,1,607,15,1200,578,289,318
29,NEAMŢ,"ŞCOALA GIMNAZIALĂ NR.1 PILDEŞTI",230,CORDUN,120888,1,PART,PRCNCT,PRSD,PRSD_SV,"2025-05-18 21:51:14",1761,797,746,48,3,788,9,1900,1103,256,532
29,NEAMŢ,"ȘCOALA GIMNAZIALĂ NR. 1 PILDEŞTI",231,CORDUN,120888,1,PART,PRCNCT,PRSD,PRSD_SV,"2025-05-18 21:36:18",1770,759,723,33,3,747,12,1900,1141,267,480
29,NEAMŢ,"CĂMINUL CULTURAL",232,CORDUN,120888,1,PART,PRCNCT,PRSD,PRSD_SV,"2025-05-18 21:44:21",722,377,344,33,0,371,6,800,423,223,148
29,NEAMŢ,"ŞCOALA GIMNAZIALA SAT COSTISA",233,COSTIŞA,122132,1,PART,PRCNCT,PRSD,PRSD_SV,"2025-05-18 21:54:58",1381,709,617,85,7,705,4,1500,791,397,308
29,NEAMŢ,"CLADIRE ŞCOALĂ",234,COSTIŞA,122132,1,PART,PRCNCT,PRSD,PRSD_SV,"2025-05-18 21:20:28",185,102,82,20,0,102,0,200,98,52,50
29,NEAMŢ,"ŞCOALA PRIMARA SAT FRUNZENI",235,COSTIŞA,122132,1,PART,PRCNCT,PRSD,PRSD_SV,"2025-05-18 21:37:16",508,217,190,27,0,214,3,600,383,147,67
29,NEAMŢ,"ŞCOALA PRIMARA SAT MANOAIA",236,COSTIŞA,122132,1,PART,PRCNCT,PRSD,PRSD_SV,"2025-05-18 21:35:19",797,377,343,33,1,373,4,900,523,235,138
29,NEAMŢ,"ŞCOALA GIMNAZIALĂ ”GHEORGHE SĂVINESCU”",237,CRĂCĂOANI,122187,1,PART,PRCNCT,PRSD,PRSD_SV,"2025-05-18 21:38:54",834,431,381,50,0,427,4,900,469,286,141
29,NEAMŢ,"ŞCOALA GIMNAZIALĂ ”GHEORGHE SĂVINESCU”",238,CRĂCĂOANI,122187,1,PART,PRCNCT,PRSD,PRSD_SV,"2025-05-18 21:41:33",922,359,327,32,0,354,5,1000,641,256,98
29,NEAMŢ,"ŞCOALA GENERALĂ",239,CRĂCĂOANI,122187,1,PART,PRCNCT,PRSD,PRSD_SV,"2025-05-18 21:32:25",822,345,306,39,0,344,1,900,555,191,153
29,NEAMŢ,"ŞCOALA GENERALĂ",240,CRĂCĂOANI,122187,1,PART,PRCNCT,PRSD,PRSD_SV,"2025-05-18 21:28:40",573,293,267,26,0,293,0,600,307,188,105
29,NEAMŢ,"ŞCOALA GENERALĂ",241,CRĂCĂOANI,122187,1,PART,PRCNCT,PRSD,PRSD_SV,"2025-05-18 21:28:26",242,126,105,21,0,125,1,300,174,86,39
29,NEAMŢ,"CAMINUL CULTURAL DAMUC",242,DĂMUC,122249,1,PART,PRCNCT,PRSD,PRSD_SV,"2025-05-18 21:46:08",1272,594,560,34,0,589,5,1400,806,462,127
29,NEAMŢ,"ŞCOALA GIMNAZIALĂ-SALĂ DE EDUCAȚIE FIZICĂ ȘCOLARĂ",243,DĂMUC,122249,1,PART,PRCNCT,PRSD,PRSD_SV,"2025-05-18 21:23:08",489,245,233,12,0,240,5,500,255,190,50
29,NEAMŢ,"SCOALA GENERALA",244,DĂMUC,122249,1,PART,PRCNCT,PRSD,PRSD_SV,"2025-05-18 21:25:50",610,314,295,19,0,310,4,700,386,276,34
29,NEAMŢ,"CĂMINUL CULTURAL DOBRENI",245,DOBRENI,122285,1,PART,PRCNCT,PRSD,PRSD_SV,"2025-05-18 22:00:02",1527,858,720,136,2,842,16,1700,842,476,366
29,NEAMŢ,"ŞCOALA GIMNAZIALĂ NR.1",246,DOCHIA,125098,1,PART,PRCNCT,PRSD,PRSD_SV,"2025-05-18 21:35:03",775,375,323,52,0,369,6,900,525,225,144
29,NEAMŢ,"ŞCOALA GIMNAZIALĂ NR.1",247,DOCHIA,125098,1,PART,PRCNCT,PRSD,PRSD_SV,"2025-05-18 21:36:57",1076,531,471,60,0,520,11,1200,669,349,171
29,NEAMŢ,"CĂMINUL CULTURAL",248,DOCHIA,125098,1,PART,PRCNCT,PRSD,PRSD_SV,"2025-05-18 21:23:07",97,65,37,28,0,65,0,100,35,28,37
29,NEAMŢ,"CĂMINUL CULTURAL DOLJEȘTI",249,DOLJEŞTI,122347,1,PART,PRCNCT,PRSD,PRSD_SV,"2025-05-18 21:55:58",994,428,382,43,3,421,7,1100,672,225,196
29,NEAMŢ,"ŞCOALA PRIMARĂ NR.1 BUHONCA",250,DOLJEŞTI,122347,1,PART,PRCNCT,PRSD,PRSD_SV,"2025-05-18 21:37:00",557,215,194,16,5,215,0,600,385,100,115
29,NEAMŢ,"ŞCOALA GIMNAZIALĂ ”GHEORGHE PATRAŞCU” BURUIENEŞTI, CORP B",251,DOLJEŞTI,122347,1,PART,PRCNCT,PRSD,PRSD_SV,"2025-05-18 21:44:53",1686,526,502,23,1,521,5,1800,1274,256,265
29,NEAMŢ,"ŞCOALA GIMNAZIALĂ ”GHEORGHE PATRAŞCU” BURUIENESTI, CORP C",252,DOLJEŞTI,122347,1,PART,PRCNCT,PRSD,PRSD_SV,"2025-05-18 21:36:04",1517,485,446,35,4,477,8,1700,1215,252,225
29,NEAMŢ,"GRĂDINIȚA CU PROGRAM NORMAL ROTUNDA",253,DOLJEŞTI,122347,1,PART,PRCNCT,PRSD,PRSD_SV,"2025-05-18 21:50:54",1256,426,385,27,14,420,6,1400,974,213,207
29,NEAMŢ,"SCOALA GENERALA",254,DRAGOMIREŞTI,122392,1,PART,PRCNCT,PRSD,PRSD_SV,"2025-05-18 21:22:20",77,86,41,45,0,86,0,200,114,39,47
29,NEAMŢ,"ŞCOALA PRIMARĂ HLĂPEŞTI",255,DRAGOMIREŞTI,122392,1,PART,PRCNCT,PRSD,PRSD_SV,"2025-05-18 21:34:49",631,314,249,65,0,305,9,700,386,146,159
29,NEAMŢ,"SCOALA GENERALA",256,DRAGOMIREŞTI,122392,1,PART,PRCNCT,PRSD,PRSD_SV,"2025-05-18 21:17:46",162,95,69,26,0,94,1,200,105,34,60
29,NEAMŢ,"SCOALA GENERALA",257,DRAGOMIREŞTI,122392,1,PART,PRCNCT,PRSD,PRSD_SV,"2025-05-18 21:15:31",100,128,62,66,0,118,10,200,72,62,56
29,NEAMŢ,"GRĂDINIŢA CU PROGRAM NORMAL VAD",258,DRAGOMIREŞTI,122392,1,PART,PRCNCT,PRSD,PRSD_SV,"2025-05-18 22:01:52",691,362,299,61,2,356,6,800,438,213,143
29,NEAMŢ,"SCOALA GIMNAZIALA",259,DRĂGĂNEŞTI,125132,2,PART,PRCNCT,PRSD,PRSD_SV,"2025-05-18 23:24:48",536,326,260,58,8,325,1,600,274,194,131
29,NEAMŢ,"SCOALA PRIMARA",260,DRĂGĂNEŞTI,125132,1,PART,PRCNCT,PRSD,PRSD_SV,"2025-05-18 21:29:57",289,186,155,23,8,184,2,300,114,122,62
29,NEAMŢ,"SCOALA PRIMARA",261,DRĂGĂNEŞTI,125132,1,PART,PRCNCT,PRSD,PRSD_SV,"2025-05-18 21:21:49",396,240,193,44,3,237,3,400,160,144,93
29,NEAMŢ,"CĂMINUL CULTURAL DULCEȘTI",262,DULCEŞTI,122463,1,PART,PRCNCT,PRSD,PRSD_SV,"2025-05-18 21:37:18",885,479,382,64,33,477,2,1000,521,252,225
29,NEAMŢ,"CĂMINUL CULTURAL CÂRLIG",263,DULCEŞTI,122463,1,PART,PRCNCT,PRSD,PRSD_SV,"2025-05-18 21:23:40",429,224,177,38,9,221,3,500,276,116,105
29,NEAMŢ,"CĂMINUL CULTURAL CORHANA",264,DULCEŞTI,122463,1,PART,PRCNCT,PRSD,PRSD_SV,"2025-05-18 21:35:58",476,221,184,31,6,218,3,500,279,86,132
29,NEAMŢ,"ŞCOALA ROŞIORI",265,DULCEŞTI,122463,1,PART,PRCNCT,PRSD,PRSD_SV,"2025-05-18 21:16:05",275,171,126,41,4,170,1,300,129,109,61
29,NEAMŢ,"SCOALA GIMNAZIALA NR. 1 DUMBRAVA ROSIE",266,"DUMBRAVA ROŞIE",120771,1,PART,PRCNCT,PRSD,PRSD_SV,"2025-05-18 22:19:49",1661,889,759,130,0,879,10,1800,911,405,474
29,NEAMŢ,"SCOALA GIMNAZIALA NR. 1 DUMBRAVA ROSIE",267,"DUMBRAVA ROŞIE",120771,1,PART,PRCNCT,PRSD,PRSD_SV,"2025-05-18 21:55:05",1893,955,877,78,0,940,15,2000,1045,505,435
29,NEAMŢ,"SCOALA GIMNAZIALA NR 4 BRASAUTI",268,"DUMBRAVA ROŞIE",120771,1,PART,PRCNCT,PRSD,PRSD_SV,"2025-05-18 21:39:49",606,319,259,60,0,316,3,700,381,197,119
29,NEAMŢ,"ȘCOALA GIMNAZIALĂ NR. 3 CUT",269,"DUMBRAVA ROŞIE",120771,1,PART,PRCNCT,PRSD,PRSD_SV,"2025-05-18 21:43:12",898,471,403,68,0,466,5,1000,529,298,168
29,NEAMŢ,"ȘCOALA GIMNAZIALĂ NR. 3 CUT",270,"DUMBRAVA ROŞIE",120771,1,PART,PRCNCT,PRSD,PRSD_SV,"2025-05-18 21:55:48",1263,669,648,21,0,659,10,1400,731,418,241
29,NEAMŢ,"SCOALA GIMNAZIALA NR. 2 IZVOARE",271,"DUMBRAVA ROŞIE",120771,1,PART,PRCNCT,PRSD,PRSD_SV,"2025-05-18 21:42:28",1036,642,540,101,1,636,6,1100,458,325,311
29,NEAMŢ,"ŞCOALA GIMNAZIALĂ ” IOAN LUCA ”",272,FARCAŞA,122551,1,PART,PRCNCT,PRSD,PRSD_SV,"2025-05-18 22:00:39",1107,601,515,85,1,595,6,1200,599,420,175
29,NEAMŢ,"CĂMINUL CULTURAL",273,FARCAŞA,122551,1,PART,PRCNCT,PRSD,PRSD_SV,"2025-05-18 21:38:30",715,437,349,88,0,430,7,800,363,271,159
29,NEAMŢ,"ȘCOALA PRIMARĂ STEJARU",274,FARCAŞA,122551,1,PART,PRCNCT,PRSD,PRSD_SV,"2025-05-18 21:37:40",640,354,331,23,0,350,4,700,346,285,65
29,NEAMŢ,"SCOALA GIMNAZIALA, COMUNA FAUREI",275,FĂUREI,122613,1,PART,PRCNCT,PRSD,PRSD_SV,"2025-05-18 21:39:59",592,296,259,37,0,294,2,700,404,195,99
29,NEAMŢ,"SCOALA PRIMARA BUDESTI",276,FĂUREI,122613,1,PART,PRCNCT,PRSD,PRSD_SV,"2025-05-18 21:27:25",861,417,365,52,0,416,1,900,483,284,132
29,NEAMŢ,"BIBLIOTECA COMUNALA FAUREI",277,FĂUREI,122613,1,PART,PRCNCT,PRSD,PRSD_SV,"2025-05-18 21:23:04",205,119,88,31,0,116,3,300,181,60,56
29,NEAMŢ,"SCOALA GIMNAZIALA GADINTI (CORP 1)",278,GÂDINŢI,125150,1,PART,PRCNCT,PRSD,PRSD_SV,"2025-05-18 21:21:23",973,380,350,30,0,375,5,1100,720,214,161
29,NEAMŢ,"SCOALA GIMNAZIALA GADINTI (CORP 2)",279,GÂDINŢI,125150,1,PART,PRCNCT,PRSD,PRSD_SV,"2025-05-18 21:28:29",1066,450,412,38,0,443,7,1200,750,278,165
29,NEAMŢ,"ŞCOALA GIMNAZIALĂ ”EPISCOP MELCHISEDEC ŞTEFĂNESCU”, CORP A",280,GÂRCINA,122828,1,PART,PRCNCT,PRSD,PRSD_SV,"2025-05-18 21:39:30",1199,617,574,42,1,610,7,1300,683,295,315
29,NEAMŢ,"ŞCOALA GIMNAZIALĂ ”EPISCOP MELCHISEDEC ŞTEFĂNESCU”",281,GÂRCINA,122828,1,PART,PRCNCT,PRSD,PRSD_SV,"2025-05-18 21:42:34",1125,556,489,67,0,551,5,1200,644,310,241
29,NEAMŢ,"ŞCOALA ALMAŞ",282,GÂRCINA,122828,1,PART,PRCNCT,PRSD,PRSD_SV,"2025-05-18 21:31:50",613,375,308,67,0,369,6,700,325,197,172
29,NEAMŢ,"ŞCOALA GIMNAZIALĂ ”EPISCOP MELCHISEDEC ŞTEFĂNESCU”",283,GÂRCINA,122828,1,PART,PRCNCT,PRSD,PRSD_SV,"2025-05-18 21:50:12",1073,453,419,34,0,448,5,1200,747,277,171
29,NEAMŢ,"SCOALA GIMNAZIALA, COMUNA GHERAESTI",284,GHERĂEŞTI,122668,1,PART,PRCNCT,PRSD,PRSD_SV,"2025-05-18 22:01:03",1456,569,538,31,0,563,6,1600,1031,229,334
29,NEAMŢ,"SCOALA GIMNAZIALA, COMUNA GHERAESTI",285,GHERĂEŞTI,122668,1,PART,PRCNCT,PRSD,PRSD_SV,"2025-05-18 21:49:17",1346,532,504,28,0,528,4,1500,968,237,291
29,NEAMŢ,"SCOALA GIMNAZIALA, COMUNA GHERAESTI",286,GHERĂEŞTI,122668,1,PART,PRCNCT,PRSD,PRSD_SV,"2025-05-18 21:54:15",1430,522,491,30,1,514,8,1600,1078,232,282
29,NEAMŢ,"CĂMIN CULTURAL",287,GHERĂEŞTI,122668,1,PART,PRCNCT,PRSD,PRSD_SV,"2025-05-18 21:35:52",490,240,195,45,0,238,2,500,260,119,119
29,NEAMŢ,"SCOALA PRIMARA, TETCANI",288,GHERĂEŞTI,122668,1,PART,PRCNCT,PRSD,PRSD_SV,"2025-05-18 21:28:32",739,295,257,38,0,290,5,800,505,124,166
29,NEAMŢ,"CLĂDIREA ”SALA DE NUNŢI”",289,GHINDĂOANI,125114,1,PART,PRCNCT,PRSD,PRSD_SV,"2025-05-18 21:26:25",1459,711,618,92,1,701,10,1600,889,317,384
29,NEAMŢ,"SCOALA GIMNAZIALA ”PROF. GHEORGHE DUMITREASA” GIROV",290,GIROV,122702,1,PART,PRCNCT,PRSD,PRSD_SV,"2025-05-18 21:58:42",1382,757,621,134,2,746,11,1500,743,402,344
29,NEAMŢ,"SCOALA BOTESTI",291,GIROV,122702,1,PART,PRCNCT,PRSD,PRSD_SV,"2025-05-18 21:41:08",461,276,217,59,0,273,3,500,224,128,145
29,NEAMŢ,"SCOALA GIMNAZIALA NR. 1 CACIULESTI",292,GIROV,122702,2,PART,PRCNCT,PRSD,PRSD_SV,"2025-05-18 21:56:37",582,309,255,54,0,308,1,600,291,197,111
29,NEAMŢ,"SCOALA DANESTI",293,GIROV,122702,1,PART,PRCNCT,PRSD,PRSD_SV,"2025-05-18 21:37:23",263,164,129,35,0,160,4,299,135,83,77
29,NEAMŢ,"SCOALA DOINA",294,GIROV,122702,1,PART,PRCNCT,PRSD,PRSD_SV,"2025-05-18 21:20:05",242,172,134,38,0,170,2,300,128,88,82
29,NEAMŢ,"SCOALA PRIMARA GURA VAII",295,GIROV,122702,1,PART,PRCNCT,PRSD,PRSD_SV,"2025-05-18 21:33:39",600,272,236,36,0,271,1,700,428,147,124
29,NEAMŢ,"PENSIUNEA ELENA",296,GIROV,122702,1,PART,PRCNCT,PRSD,PRSD_SV,"2025-05-18 21:48:15",528,323,266,57,0,319,4,600,277,172,147
29,NEAMŢ,"SCOALA VERSESTI",297,GIROV,122702,1,PART,PRCNCT,PRSD,PRSD_SV,"2025-05-18 21:23:41",254,158,111,47,0,155,3,300,142,62,93
29,NEAMŢ,"CĂMINUL CULTURAL",298,GRINŢIEŞ,122864,1,PART,PRCNCT,PRSD,PRSD_SV,"2025-05-18 22:27:32",1291,635,560,64,11,628,7,1400,765,397,231
29,NEAMŢ,"CĂMINUL CULTURAL BRADU",299,GRINŢIEŞ,122864,1,PART,PRCNCT,PRSD,PRSD_SV,"2025-05-18 21:44:10",629,330,289,35,6,328,2,700,370,222,106
29,NEAMŢ,GRADINITA,300,GRUMĂZEŞTI,122908,1,PART,PRCNCT,PRSD,PRSD_SV,"2025-05-18 21:43:14",1309,666,620,44,2,656,10,1400,734,370,286
29,NEAMŢ,GRADINITA,301,GRUMĂZEŞTI,122908,1,PART,PRCNCT,PRSD,PRSD_SV,"2025-05-18 21:42:34",965,498,450,48,0,489,9,1100,602,282,207
29,NEAMŢ,"SCOALA PRIMARA",302,GRUMĂZEŞTI,122908,1,PART,PRCNCT,PRSD,PRSD_SV,"2025-05-18 21:32:00",576,250,223,27,0,248,2,600,350,184,64
29,NEAMŢ,SCOALA,303,GRUMĂZEŞTI,122908,1,PART,PRCNCT,PRSD,PRSD_SV,"2025-05-18 22:09:29",1315,702,624,78,0,689,13,1400,698,395,294
29,NEAMŢ,"ŞCOALA GIMNAZIALĂ,COMUNA HANGU",304,HANGU,122953,1,PART,PRCNCT,PRSD,PRSD_SV,"2025-05-18 21:35:00",916,432,345,85,2,426,6,1000,568,262,164
29,NEAMŢ,"ŞCOALA PRIMARĂ BOBOTENI",305,HANGU,122953,1,PART,PRCNCT,PRSD,PRSD_SV,"2025-05-18 21:17:52",442,198,175,23,0,197,1,500,302,141,56
29,NEAMŢ,"ŞCOALA GIMNAZIALĂ BUHALNIŢA",306,HANGU,122953,1,PART,PRCNCT,PRSD,PRSD_SV,"2025-05-18 21:20:33",617,267,232,35,0,264,3,700,433,173,91
29,NEAMŢ,"ŞCOALA PRIMARĂ CHIRIŢENI",307,HANGU,122953,1,PART,PRCNCT,PRSD,PRSD_SV,"2025-05-18 21:22:53",390,186,154,32,0,183,3,400,214,122,61
29,NEAMŢ,"ŞCOALA PRIMARĂ GROZĂVEŞTI",308,HANGU,122953,1,PART,PRCNCT,PRSD,PRSD_SV,"2025-05-18 21:13:30",315,148,132,15,1,145,3,400,252,101,44
29,NEAMŢ,"ŞCOALA PRIMARĂ RUGINEŞTI",309,HANGU,122953,1,PART,PRCNCT,PRSD,PRSD_SV,"2025-05-18 21:19:05",282,135,113,22,0,132,3,300,165,92,40
29,NEAMŢ,"SCOALA GIMNAZIALA ”CARMEN SYLVA”",310,HORIA,120922,1,PART,PRCNCT,PRSD,PRSD_SV,"2025-05-18 21:45:00",1608,819,756,63,0,809,10,1700,881,438,371
29,NEAMŢ,"CAMIN CULTURAL",311,HORIA,120922,1,PART,PRCNCT,PRSD,PRSD_SV,"2025-05-18 21:47:11",1771,869,799,70,0,857,12,1900,1031,482,375
29,NEAMŢ,"SCOALA GIMNAZIALA ” OTILIA CAZIMIR ” COTU VAMES",312,HORIA,120922,1,PART,PRCNCT,PRSD,PRSD_SV,"2025-05-18 21:40:09",1391,650,596,53,1,637,13,1500,850,376,261
29,NEAMŢ,"GRADINITA DE COPII",313,HORIA,120922,1,PART,PRCNCT,PRSD,PRSD_SV,"2025-05-18 21:49:44",1248,626,580,45,1,613,13,1400,774,375,238
29,NEAMŢ,"SCOALA GIMNAZIALA ICUSESTI",314,ICUŞEŞTI,123013,1,PART,PRCNCT,PRSD,PRSD_SV,"2025-05-18 21:29:19",630,283,230,53,0,280,3,700,417,183,97
29,NEAMŢ,"SCOALA GIMNAZIALA BALUSESTI",315,ICUŞEŞTI,123013,1,PART,PRCNCT,PRSD,PRSD_SV,"2025-05-18 21:30:05",795,298,265,33,0,296,2,900,602,187,109
29,NEAMŢ,"SCOALA GIMNAZIALA BALUSESTI",316,ICUŞEŞTI,123013,1,PART,PRCNCT,PRSD,PRSD_SV,"2025-05-18 21:32:56",1214,412,393,19,0,411,1,1300,888,279,132
29,NEAMŢ,"SCOALA PRIMARA MESTEACAN",317,ICUŞEŞTI,123013,1,PART,PRCNCT,PRSD,PRSD_SV,"2025-05-18 21:30:02",425,195,173,22,0,194,1,500,305,153,41
29,NEAMŢ,"SCOALA PRIMARA ROCNA",318,ICUŞEŞTI,123013,1,PART,PRCNCT,PRSD,PRSD_SV,"2025-05-18 21:52:54",428,200,167,33,0,196,4,500,300,138,58
29,NEAMŢ,"SCOALA PRIMARA SPIRIDONESTI",319,ICUŞEŞTI,123013,1,PART,PRCNCT,PRSD,PRSD_SV,"2025-05-18 21:32:12",165,88,66,22,0,88,0,200,112,45,43
29,NEAMŢ,"CĂMIN CULTURAL NOU ȘI BIBLIOTECĂ",320,"ION CREANGĂ",123102,1,PART,PRCNCT,PRSD,PRSD_SV,"2025-05-18 21:34:03",965,485,432,52,1,482,3,1100,615,327,155
29,NEAMŢ,"CĂMIN CULTURAL NOU ȘI BIBLIOTECĂ",321,"ION CREANGĂ",123102,1,PART,PRCNCT,PRSD,PRSD_SV,"2025-05-18 21:36:35",1136,534,502,31,1,526,8,1200,666,357,169
29,NEAMŢ,"CAMIN CULTURAL",322,"ION CREANGĂ",123102,1,PART,PRCNCT,PRSD,PRSD_SV,"2025-05-18 21:37:28",785,433,383,50,0,429,4,900,467,249,180
29,NEAMŢ,ŞCOALA,323,"ION CREANGĂ",123102,1,PART,PRCNCT,PRSD,PRSD_SV,"2025-05-18 21:18:36",379,192,164,28,0,191,1,400,208,141,50
29,NEAMŢ,"CĂMIN CULTURAL",324,"ION CREANGĂ",123102,2,PART,PRCNCT,PRSD,PRSD_SV,"2025-05-19 00:47:16",654,335,302,33,0,334,1,700,365,253,81
29,NEAMŢ,"CĂMIN CULTURAL",325,"ION CREANGĂ",123102,1,PART,PRCNCT,PRSD,PRSD_SV,"2025-05-18 21:45:23",652,292,258,34,0,290,2,700,408,185,105
29,NEAMŢ,"ŞCOALA GENERALĂ",326,MĂRGINENI,123175,1,PART,PRCNCT,PRSD,PRSD_SV,"2025-05-18 21:34:57",897,352,306,46,0,344,8,1000,648,174,170
29,NEAMŢ,GRĂDINIŢA,327,MĂRGINENI,123175,1,PART,PRCNCT,PRSD,PRSD_SV,"2025-05-18 21:21:38",841,332,303,29,0,327,5,900,568,182,145
29,NEAMŢ,"SCOALA GENERALA",328,MĂRGINENI,123175,1,PART,PRCNCT,PRSD,PRSD_SV,"2025-05-18 21:31:56",171,100,76,24,0,98,2,200,100,60,38
29,NEAMŢ,"ŞCOALA GENERALĂ",329,MĂRGINENI,123175,1,PART,PRCNCT,PRSD,PRSD_SV,"2025-05-18 21:17:31",712,349,294,55,0,341,8,800,451,183,158
29,NEAMŢ,"ŞCOALA GENERALĂ",330,MĂRGINENI,123175,1,PART,PRCNCT,PRSD,PRSD_SV,"2025-05-18 21:21:26",211,117,94,23,0,115,2,300,183,71,44
29,NEAMŢ,"SCOALA GIMNAZIALA SATUL MOLDOVENI",331,MOLDOVENI,123228,1,PART,PRCNCT,PRSD,PRSD_SV,"2025-05-18 21:31:49",982,484,421,63,0,475,9,1100,616,300,175
29,NEAMŢ,"FOSTA SCOALA CU CLASELE I-IV SATUL HOCIUNGI",332,MOLDOVENI,123228,1,PART,PRCNCT,PRSD,PRSD_SV,"2025-05-18 21:30:01",638,420,317,95,8,416,4,700,280,209,207
29,NEAMŢ,"SCOALA GIMNAZIALA ”DUMITRU ALMAS” NEGRESTI",333,NEGREŞTI,125169,1,PART,PRCNCT,PRSD,PRSD_SV,"2025-05-18 21:55:00",1118,577,464,110,3,573,4,1200,623,337,236
29,NEAMŢ,"GRADINITA CU PROGRAM NORMAL POIANA",334,NEGREŞTI,125169,1,PART,PRCNCT,PRSD,PRSD_SV,"2025-05-18 21:24:46",297,140,97,43,0,137,3,400,260,88,49
29,NEAMŢ,"ŞCOALA GENERALĂ",335,ONICENI,123255,1,PART,PRCNCT,PRSD,PRSD_SV,"2025-05-18 21:30:48",624,251,224,26,1,247,4,700,449,169,78
29,NEAMŢ,"ŞCOALA GENERALĂ",336,ONICENI,123255,1,PART,PRCNCT,PRSD,PRSD_SV,"2025-05-18 21:15:21",266,146,136,10,0,142,4,300,154,88,54
29,NEAMŢ,"ŞCOALA GENERALĂ",337,ONICENI,123255,1,PART,PRCNCT,PRSD,PRSD_SV,"2025-05-18 21:17:19",320,157,135,22,0,155,2,400,243,103,52
29,NEAMŢ,"ŞCOALA GENERALĂ",338,ONICENI,123255,1,PART,PRCNCT,PRSD,PRSD_SV,"2025-05-18 21:47:04",1059,519,481,38,0,512,7,1100,581,419,93
29,NEAMŢ,"ŞCOALA GENERALĂ",339,ONICENI,123255,1,PART,PRCNCT,PRSD,PRSD_SV,"2025-05-18 21:16:54",277,122,107,15,0,122,0,300,178,69,53
29,NEAMŢ,"ŞCOALA GIMNAZIALA, COMUNA PASTRAVENI",340,PĂSTRĂVENI,123371,1,PART,PRCNCT,PRSD,PRSD_SV,"2025-05-18 21:25:33",719,349,309,40,0,349,0,800,451,220,129
29,NEAMŢ,"ŞCOALA GIMNAZIALĂ COMUNA PĂSTRĂVENI",341,PĂSTRĂVENI,123371,1,PART,PRCNCT,PRSD,PRSD_SV,"2025-05-18 21:38:08",677,267,254,13,0,264,3,700,433,186,78
29,NEAMŢ,"CASA SOCIALĂ A PAROHIEI ZVORĂNEŞTI, FILIA LUNCA MOLDOVEI",342,PĂSTRĂVENI,123371,1,PART,PRCNCT,PRSD,PRSD_SV,"2025-05-18 21:17:53",242,165,132,33,0,163,2,300,135,102,61
29,NEAMŢ,"SCOALA GIMNAZIALA NR. 1 RADENI",343,PĂSTRĂVENI,123371,1,PART,PRCNCT,PRSD,PRSD_SV,"2025-05-18 21:44:10",736,296,265,31,0,290,6,800,504,165,125
29,NEAMŢ,"SCOALA PRIMARA NR. 2 RADENI",344,PĂSTRĂVENI,123371,1,PART,PRCNCT,PRSD,PRSD_SV,"2025-05-18 21:33:40",595,231,210,21,0,225,6,700,469,166,59
29,NEAMŢ,"ŞCOALA GIMNAZIALA ”VLAD DANULESCU ” PANCESTI",345,PÂNCEŞTI,125141,1,PART,PRCNCT,PRSD,PRSD_SV,"2025-05-18 21:56:05",920,411,371,40,0,408,3,1000,589,269,139
29,NEAMŢ,"ŞCOALA PRIMARA CIUREA",346,PÂNCEŞTI,125141,1,PART,PRCNCT,PRSD,PRSD_SV,"2025-05-18 21:23:43",196,103,85,18,0,102,1,200,97,46,56
29,NEAMŢ,"ŞCOALA GIMNAZIALĂ ”NICOLAE IORGA” -SAT PÎNGĂRAȚI - PUNCT CASTEL",347,PÂNGĂRAŢI,123601,1,PART,PRCNCT,PRSD,PRSD_SV,"2025-05-18 21:32:39",604,344,295,49,0,341,3,700,356,190,151
29,NEAMŢ,"ŞCOALA GIMNAZIALĂ ”NICOLAE IORGA” - SAT OANȚU",348,PÂNGĂRAŢI,123601,1,PART,PRCNCT,PRSD,PRSD_SV,"2025-05-18 21:38:56",1271,684,636,48,0,677,7,1400,716,492,185
29,NEAMŢ,"ŞCOALA GIMNAZIALĂ ”NICOLAE IORGA” - SAT PÎNGĂRĂCIOR",349,PÂNGĂRAŢI,123601,1,PART,PRCNCT,PRSD,PRSD_SV,"2025-05-18 22:11:21",1678,845,774,71,0,836,9,1800,955,493,343
29,NEAMŢ,"ŞCOALA GIMNAZIALĂ ”NICOLAE IORGA” - SAT STEJARU",350,PÂNGĂRAŢI,123601,1,PART,PRCNCT,PRSD,PRSD_SV,"2025-05-18 21:35:11",861,501,434,67,0,495,6,908,407,261,234
29,NEAMŢ,"LICEUL TEHNOLOGIC",351,PETRICANI,123424,1,PART,PRCNCT,PRSD,PRSD_SV,"2025-05-18 21:45:17",1423,671,613,58,0,664,7,1500,829,385,279
29,NEAMŢ,"SCOALA GENERALA",352,PETRICANI,123424,1,PART,PRCNCT,PRSD,PRSD_SV,"2025-05-18 21:21:45",733,397,368,29,0,392,5,800,403,213,179
29,NEAMŢ,"SCOALA GENERALA",353,PETRICANI,123424,1,PART,PRCNCT,PRSD,PRSD_SV,"2025-05-18 21:35:26",1072,474,422,52,0,468,6,1100,626,281,187
29,NEAMŢ,"SCOALA GENERALA",354,PETRICANI,123424,1,PART,PRCNCT,PRSD,PRSD_SV,"2025-05-18 21:42:26",1439,536,512,24,0,532,4,1500,964,463,69
29,NEAMŢ,"SCOALA GIMNAZIALA,COMUNA PIATRA SOIMULUI",355,"PIATRA ŞOIMULUI",123479,1,PART,PRCNCT,PRSD,PRSD_SV,"2025-05-18 21:39:10",1548,644,586,55,3,634,10,1700,1056,436,198
29,NEAMŢ,"ŞCOALA PRIMARA,COMUNA PIATRA SOIMULUI",356,"PIATRA ŞOIMULUI",123479,1,PART,PRCNCT,PRSD,PRSD_SV,"2025-05-18 21:24:56",1433,579,550,29,0,575,4,1500,921,401,174
29,NEAMŢ,"SCOALA GIMNAZIALA LUMINIS,COMUNA PIATRA SOIMULUI",357,"PIATRA ŞOIMULUI",123479,1,PART,PRCNCT,PRSD,PRSD_SV,"2025-05-18 21:25:08",1111,443,419,24,0,440,3,1200,757,276,164
29,NEAMŢ,"ŞCOALA GIMNAZIALA LUMINIS,COMUNA PIATRA SOIMULUI",358,"PIATRA ŞOIMULUI",123479,1,PART,PRCNCT,PRSD,PRSD_SV,"2025-05-18 21:32:31",993,430,404,26,0,425,5,1100,670,261,164
29,NEAMŢ,"GRADINITA CU PROGRAM NORMAL NEGULESTI,COMUNA PIATRA SOIMULUI",359,"PIATRA ŞOIMULUI",123479,1,PART,PRCNCT,PRSD,PRSD_SV,"2025-05-18 21:21:45",590,255,225,30,0,250,5,600,345,142,108
29,NEAMŢ,"SCOALA GIMNAZIALA POIENI,COMUNA PIATRA SOIMULUI",360,"PIATRA ŞOIMULUI",123479,1,PART,PRCNCT,PRSD,PRSD_SV,"2025-05-18 21:24:22",1115,514,498,16,0,508,6,1200,686,414,94
29,NEAMŢ,"SCOALA PIPIRIG NR. 2",361,PIPIRIG,123521,1,PART,PRCNCT,PRSD,PRSD_SV,"2025-05-18 21:20:38",901,441,422,19,0,437,4,1000,559,262,175
29,NEAMŢ,"SCOALA GIMNAZIALA NR. 1",362,PIPIRIG,123521,1,PART,PRCNCT,PRSD,PRSD_SV,"2025-05-18 21:21:56",1268,589,549,40,0,581,8,1400,811,415,166
29,NEAMŢ,"LICEUL TEHNOLOGIC ”ION CREANGA” PIPIRIG",363,PIPIRIG,123521,1,PART,PRCNCT,PRSD,PRSD_SV,"2025-05-18 21:30:34",1440,678,636,41,1,672,6,1600,922,462,210
29,NEAMŢ,"SCOALA CU CLASELE I-IV DOLHESTI",364,PIPIRIG,123521,1,PART,PRCNCT,PRSD,PRSD_SV,"2025-05-18 21:37:07",864,353,331,22,0,351,2,1000,647,225,126
29,NEAMŢ,"GRADINITA CU PROGRAM NORMAL",365,PIPIRIG,123521,1,PART,PRCNCT,PRSD,PRSD_SV,"2025-05-18 21:18:13",544,283,246,37,0,277,6,600,317,197,80
29,NEAMŢ,"SCOALA GIMNAZIALA PLUTON",366,PIPIRIG,123521,1,PART,PRCNCT,PRSD,PRSD_SV,"2025-05-18 21:22:47",824,404,375,29,0,403,1,900,496,302,101
29,NEAMŢ,"SCOALA GIMNAZIALA STINCA",367,PIPIRIG,123521,1,PART,PRCNCT,PRSD,PRSD_SV,"2025-05-18 21:37:46",1319,602,559,43,0,594,8,1400,798,474,120
29,NEAMŢ,"GRĂDINIŢA CU PROGRAM NORMAL NR. 2",368,PODOLENI,123674,1,PART,PRCNCT,PRSD,PRSD_SV,"2025-05-18 21:31:32",1240,557,500,57,0,553,4,1400,843,299,254
29,NEAMŢ,"ŞCOALA GIMNAZIALĂ ”ALEXANDRU PODOLEANU”",369,PODOLENI,123674,2,PART,PRCNCT,PRSD,PRSD_SV,"2025-05-18 22:47:53",989,428,394,32,2,420,8,1100,672,190,230
29,NEAMŢ,"ŞCOALA GIMNAZIALĂ ”ALEXANDRU PODOLEANU”",370,PODOLENI,123674,1,PART,PRCNCT,PRSD,PRSD_SV,"2025-05-18 21:26:11",1110,517,475,42,0,510,7,1200,683,218,292
29,NEAMŢ,"GRĂDINIŢA CU PROGRAM NORMAL NR. 3",371,PODOLENI,123674,1,PART,PRCNCT,PRSD,PRSD_SV,"2025-05-18 21:30:59",833,365,325,39,1,362,3,900,535,163,199
29,NEAMŢ,"ŞCOALA PRIMARĂ NEGRITEŞTI",372,PODOLENI,123674,1,PART,PRCNCT,PRSD,PRSD_SV,"2025-05-18 21:20:01",281,144,119,25,0,144,0,299,155,96,48
29,NEAMŢ,"ȘCOALA GIMNAZIALǍ ”IUSTIN PÎRVU”",373,"POIANA TEIULUI",123790,1,PART,PRCNCT,PRSD,PRSD_SV,"2025-05-18 21:53:32",1291,636,560,76,0,633,3,1400,764,409,224
29,NEAMŢ,"ŞCOALA GIMNAZIALA ”CONSTANTIN ROMANESCU” DREPTU",374,"POIANA TEIULUI",123790,1,PART,PRCNCT,PRSD,PRSD_SV,"2025-05-18 21:33:05",927,477,422,55,0,467,10,1000,523,290,177
29,NEAMŢ,"ŞCOALA GIMNAZIALA PETRU VODA",375,"POIANA TEIULUI",123790,1,PART,PRCNCT,PRSD,PRSD_SV,"2025-05-18 21:47:36",1073,622,497,100,25,613,9,1200,578,493,120
29,NEAMŢ,"SOCIETATEA COMERCIALǍ TCE PETROFOREST SRL",376,"POIANA TEIULUI",123790,1,PART,PRCNCT,PRSD,PRSD_SV,"2025-05-18 21:40:42",711,395,343,52,0,390,5,800,405,261,129
29,NEAMŢ,"SCOALA GIMNAZIALA NR. 1",377,POIENARI,123709,1,PART,PRCNCT,PRSD,PRSD_SV,"2025-05-18 21:36:30",935,498,430,67,1,494,4,1000,502,311,183
29,NEAMŢ,"SCOALA GIMNAZIALA STRUCTURA SACALENI",378,POIENARI,123709,1,PART,PRCNCT,PRSD,PRSD_SV,"2025-05-18 21:26:21",269,127,92,35,0,125,2,300,173,69,56
29,NEAMŢ,"ŞCOALA GIMNAZIALĂ NR. 1 RĂUCEŞTI",379,RĂUCEŞTI,123914,1,PART,PRCNCT,PRSD,PRSD_SV,"2025-05-18 21:38:41",1261,635,573,60,2,623,12,1400,765,340,283
29,NEAMŢ,"PAROHIA ORTODOXĂ „ADORMIREA MAICII DOMNULUI” RĂUCEȘTI",380,RĂUCEŞTI,123914,1,PART,PRCNCT,PRSD,PRSD_SV,"2025-05-18 21:32:16",485,244,213,31,0,242,2,500,256,131,111
29,NEAMŢ,"GRĂDINIŢA CU PROGRAM NORMAL NR. 2 RĂUCEŞTI",381,RĂUCEŞTI,123914,1,PART,PRCNCT,PRSD,PRSD_SV,"2025-05-18 21:41:09",770,421,383,38,0,419,2,800,379,245,174
29,NEAMŢ,"LICEUL TEHNOLOGIC OGLINZI",382,RĂUCEŞTI,123914,1,PART,PRCNCT,PRSD,PRSD_SV,"2025-05-18 21:29:32",1562,764,701,61,2,752,12,1700,936,440,312
29,NEAMŢ,"ŞCOALA PRIMARĂ NR. 2 OGLINZI",383,RĂUCEŞTI,123914,1,PART,PRCNCT,PRSD,PRSD_SV,"2025-05-18 21:28:34",913,457,407,50,0,448,9,1000,543,260,188
29,NEAMŢ,"LICEUL TEHNOLOGIC OGLINZI (GRĂDINIŢA NR. 1- CORP C)",384,RĂUCEŞTI,123914,1,PART,PRCNCT,PRSD,PRSD_SV,"2025-05-18 21:27:24",915,338,317,21,0,336,2,1000,662,256,80
29,NEAMŢ,"ŞCOALA SĂVEŞTI",385,RĂUCEŞTI,123914,1,PART,PRCNCT,PRSD,PRSD_SV,"2025-05-18 21:15:26",347,164,131,33,0,162,2,400,236,92,70
29,NEAMŢ,"ŞCOALA UNGHENI",386,RĂUCEŞTI,123914,1,PART,PRCNCT,PRSD,PRSD_SV,"2025-05-18 21:24:46",410,212,194,18,0,208,4,500,288,152,56
29,NEAMŢ,"SCOALA GENERALA CU CLASELE I-VIII",387,RĂZBOIENI,123969,1,PART,PRCNCT,PRSD,PRSD_SV,"2025-05-18 21:37:22",588,339,281,58,0,332,7,600,261,181,151
29,NEAMŢ,"SCOALA GENERALA",388,RĂZBOIENI,123969,1,PART,PRCNCT,PRSD,PRSD_SV,"2025-05-18 21:16:06",283,139,112,26,1,139,0,300,161,77,62
29,NEAMŢ,"SCOALA GENERALA CU CLASELE I-IV NR. 3",389,RĂZBOIENI,123969,1,PART,PRCNCT,PRSD,PRSD_SV,"2025-05-18 21:37:57",451,237,185,52,0,233,4,500,263,126,107
29,NEAMŢ,"SCOALA GENERALA",390,RĂZBOIENI,123969,1,PART,PRCNCT,PRSD,PRSD_SV,"2025-05-18 21:20:06",286,187,149,38,0,181,6,300,113,105,76
29,NEAMŢ,"SCOALA CU CLASELE I-VIII REDIU",391,REDIU,124028,1,PART,PRCNCT,PRSD,PRSD_SV,"2025-05-18 21:26:24",855,330,311,19,0,325,5,900,570,217,108
29,NEAMŢ,"ŞCOALA CU CLASELE I-VIII REDIU",392,REDIU,124028,1,PART,PRCNCT,PRSD,PRSD_SV,"2025-05-18 21:39:21",972,358,329,29,0,356,2,1100,742,225,131
29,NEAMŢ,"ŞCOALA CU CLASELE I-IV BETESTI",393,REDIU,124028,1,PART,PRCNCT,PRSD,PRSD_SV,"2025-05-18 21:23:21",599,282,267,15,0,280,2,700,418,190,90
29,NEAMŢ,"ŞCOALA CU CLASELE I-VIII POLOBOC",394,REDIU,124028,1,PART,PRCNCT,PRSD,PRSD_SV,"2025-05-18 21:37:21",1205,524,496,28,0,520,4,1300,776,352,168
29,NEAMŢ,"GRADINITA SOCEA",395,REDIU,124028,1,PART,PRCNCT,PRSD,PRSD_SV,"2025-05-18 21:31:39",607,249,216,31,2,248,1,700,451,181,67
29,NEAMŢ,"ŞCOALA CU CLASELE I-VIII",396,ROMÂNI,124073,1,PART,PRCNCT,PRSD,PRSD_SV,"2025-05-18 21:43:50",747,329,299,26,4,322,7,800,471,200,122
29,NEAMŢ,"ŞCOALA CU CLASELE I-VIII",397,ROMÂNI,124073,1,PART,PRCNCT,PRSD,PRSD_SV,"2025-05-18 21:51:12",759,351,292,59,0,347,4,800,449,231,116
29,NEAMŢ,"ŞCOALA CU CLASELE I-VIII",398,ROMÂNI,124073,1,PART,PRCNCT,PRSD,PRSD_SV,"2025-05-18 21:49:39",981,488,430,47,11,482,6,1100,612,284,198
29,NEAMŢ,"SCOALA CU CLASELE I-VIII SILISTEAII",399,ROMÂNI,124073,1,PART,PRCNCT,PRSD,PRSD_SV,"2025-05-18 21:48:41",800,359,317,40,2,358,1,900,541,217,141
29,NEAMŢ,"ȘCOALA GIMNAZIALĂ ” NICOLAE APOSTOL” RUGINOASA",400,RUGINOASA,125105,1,PART,PRCNCT,PRSD,PRSD_SV,"2025-05-18 21:28:07",573,387,300,56,31,384,3,600,213,162,222
29,NEAMŢ,"ȘCOALA GIMNAZIALĂ ” NICOLAE APOSTOL ” RUGINOASA",401,RUGINOASA,125105,1,PART,PRCNCT,PRSD,PRSD_SV,"2025-05-18 21:39:51",603,401,301,62,38,397,4,700,299,153,244
29,NEAMŢ,"FOSTA SCOALĂ BOZIENII DE SUS",402,RUGINOASA,125105,1,PART,PRCNCT,PRSD,PRSD_SV,"2025-05-18 21:17:08",294,166,118,30,18,163,3,300,134,68,95
29,NEAMŢ,"ŞCOALA GIMNAZIALĂ, COMUNA SAGNA",403,SAGNA,124153,1,PART,PRCNCT,PRSD,PRSD_SV,"2025-05-18 21:31:20",1689,677,632,45,0,667,10,1800,1123,384,283
29,NEAMŢ,"ŞCOALA GIMNAZIALĂ, COMUNA SAGNA",404,SAGNA,124153,1,PART,PRCNCT,PRSD,PRSD_SV,"2025-05-18 21:40:14",1522,649,596,53,0,645,4,1700,1051,351,294
29,NEAMŢ,"GRĂDINIŢA CU PROGRAM NORMAL LUŢCA",405,SAGNA,124153,1,PART,PRCNCT,PRSD,PRSD_SV,"2025-05-18 21:19:09",379,224,176,46,2,217,7,400,176,154,63
29,NEAMŢ,"ŞCOALA PRIMARĂ VULPĂŞEŞTI",406,SAGNA,124153,1,PART,PRCNCT,PRSD,PRSD_SV,"2025-05-18 21:29:57",656,312,264,48,0,310,2,700,388,207,103
29,NEAMŢ,"LICEUL TEORETIC ”VASILE ALECSANDRI” COMUNA SĂBĂOANI, CORP B",407,SĂBĂOANI,124206,1,PART,PRCNCT,PRSD,PRSD_SV,"2025-05-18 21:29:20",1076,384,356,20,8,377,7,1200,816,140,237
29,NEAMŢ,"LICEUL TEORETIC ”VASILE ALECSANDRI” COMUNA SĂBĂOANI, CORP B",408,SĂBĂOANI,124206,1,PART,PRCNCT,PRSD,PRSD_SV,"2025-05-18 21:38:15",1908,732,691,40,1,724,8,2100,1368,311,413
29,NEAMŢ,"LICEUL TEORETIC ”VASILE ALECSANDRI” COMUNA SĂBĂOANI, CORP B",409,SĂBĂOANI,124206,1,PART,PRCNCT,PRSD,PRSD_SV,"2025-05-18 21:35:24",1084,390,365,25,0,384,6,1200,810,149,235
29,NEAMŢ,"LICEUL TEORETIC ”VASILE ALECSANDRI” COMUNA SĂBĂOANI",410,SĂBĂOANI,124206,1,PART,PRCNCT,PRSD,PRSD_SV,"2025-05-18 21:47:57",1008,380,343,35,2,373,7,1100,720,140,233
29,NEAMŢ,"LICEUL TEORETIC ”VASILE ALECSANDRI” COMUNA SĂBĂOANI",411,SĂBĂOANI,124206,1,PART,PRCNCT,PRSD,PRSD_SV,"2025-05-18 21:35:14",882,350,338,12,0,345,5,1000,650,143,202
29,NEAMŢ,"LICEUL TEORETIC ”VASILE ALECSANDRI” COMUNA SĂBĂOANI",412,SĂBĂOANI,124206,1,PART,PRCNCT,PRSD,PRSD_SV,"2025-05-18 21:33:25",1432,459,430,29,0,455,4,1600,1141,192,263
29,NEAMŢ,"LICEUL TEORETIC ”VASILE ALECSANDRI” COMUNA SĂBĂOANI",413,SĂBĂOANI,124206,1,PART,PRCNCT,PRSD,PRSD_SV,"2025-05-18 21:29:29",1063,384,363,21,0,377,7,1200,816,150,227
29,NEAMŢ,"ŞCOALA GIMNAZIALĂ TRAIAN-SĂBĂOANI",414,SĂBĂOANI,124206,1,PART,PRCNCT,PRSD,PRSD_SV,"2025-05-18 21:36:20",1041,488,446,42,0,481,7,1100,612,158,323
29,NEAMŢ,"SCOALA GIMNAZIALA I.GERVESCU SAVINESTI",415,SĂVINEŞTI,120824,1,PART,PRCNCT,PRSD,PRSD_SV,"2025-05-18 21:29:24",1683,452,377,74,1,450,2,1800,1348,254,196
29,NEAMŢ,"GRADINITA CU PROGRAM NORMAL SAVINESTI",416,SĂVINEŞTI,120824,1,PART,PRCNCT,PRSD,PRSD_SV,"2025-05-18 21:31:42",689,296,263,33,0,290,6,800,504,144,146
29,NEAMŢ,"GRADINIŢA CU PROGRAM PRELUNGIT SAVINESTI",417,SĂVINEŞTI,120824,1,PART,PRCNCT,PRSD,PRSD_SV,"2025-05-18 21:30:02",546,249,224,25,0,247,2,600,351,92,155
29,NEAMŢ,"ŞCOALA GIMNAZIALA SĂVINESTI",418,SĂVINEŞTI,120824,1,PART,PRCNCT,PRSD,PRSD_SV,"2025-05-18 21:38:49",1437,738,637,94,7,731,7,1600,862,389,342
29,NEAMŢ,"SCOALA PRIMARA SAVINESTI",419,SĂVINEŞTI,120824,1,PART,PRCNCT,PRSD,PRSD_SV,"2025-05-18 21:33:08",1245,643,596,47,0,632,11,1300,657,313,319
29,NEAMŢ,"SCOALA PRIMARA DUMBRAVA DEAL",420,SĂVINEŞTI,120824,1,PART,PRCNCT,PRSD,PRSD_SV,"2025-05-18 21:40:00",341,207,174,33,0,201,6,400,193,111,90
29,NEAMŢ,"CĂMINUL CULTURAL",421,SECUIENI,124233,1,PART,PRCNCT,PRSD,PRSD_SV,"2025-05-18 21:28:21",735,375,320,54,1,369,6,800,425,218,151
29,NEAMŢ,"ȘCOALA BAȘTA",422,SECUIENI,124233,1,PART,PRCNCT,PRSD,PRSD_SV,"2025-05-18 21:30:46",548,325,283,42,0,319,6,600,275,189,130
29,NEAMŢ,"CĂMINUL CULTURAL",423,SECUIENI,124233,1,PART,PRCNCT,PRSD,PRSD_SV,"2025-05-18 21:23:53",851,418,373,45,0,407,11,900,482,215,192
29,NEAMŢ,CLĂDIRE,424,SECUIENI,124233,1,PART,PRCNCT,PRSD,PRSD_SV,"2025-05-18 21:14:28",197,118,84,34,0,118,0,200,82,79,39
29,NEAMŢ,"ȘCOALA SECUIENII NOI",425,SECUIENI,124233,1,PART,PRCNCT,PRSD,PRSD_SV,"2025-05-18 21:16:04",236,131,101,30,0,131,0,300,169,79,52
29,NEAMŢ,"SCOALA GIMNAZIALA COMUNA STANITA",426,STĂNIŢA,124331,1,PART,PRCNCT,PRSD,PRSD_SV,"2025-05-18 21:22:29",338,144,105,39,0,142,2,400,256,79,63
29,NEAMŢ,"SCOALA PRIMARA NR. 5 CHICEREA",427,STĂNIŢA,124331,1,PART,PRCNCT,PRSD,PRSD_SV,"2025-05-18 21:17:09",204,95,72,23,0,94,1,300,205,59,35
29,NEAMŢ,"SCOALA PRIMARA NR.2 GHIDION",428,STĂNIŢA,124331,1,PART,PRCNCT,PRSD,PRSD_SV,"2025-05-18 21:17:28",283,136,108,28,0,135,1,300,164,95,40
29,NEAMŢ,"SCOALA PRIMARA NR.4 POIENILE OANCEI",429,STĂNIŢA,124331,1,PART,PRCNCT,PRSD,PRSD_SV,"2025-05-18 21:19:37",190,86,68,18,0,83,3,200,114,57,26
29,NEAMŢ,"SCOALA PRIMARA NR.1 TODIRENI",430,STĂNIŢA,124331,1,PART,PRCNCT,PRSD,PRSD_SV,"2025-05-18 21:20:37",207,97,70,27,0,94,3,300,203,60,34
29,NEAMŢ,"SCOALA PRIMARA NR.3 VEJA",431,STĂNIŢA,124331,1,PART,PRCNCT,PRSD,PRSD_SV,"2025-05-18 21:18:53",263,114,103,11,0,114,0,300,186,75,39
29,NEAMŢ,"SCOALA GIMNAZIALA DR. EMANUIEL RIGLER",432,"ŞTEFAN CEL MARE",124411,1,PART,PRCNCT,PRSD,PRSD_SV,"2025-05-18 21:57:38",649,368,299,68,1,363,5,700,332,190,173
29,NEAMŢ,"SCOALA GIMNAZIALA DR. EMANUIEL RIGLER",433,"ŞTEFAN CEL MARE",124411,1,PART,PRCNCT,PRSD,PRSD_SV,"2025-05-18 21:47:20",669,320,290,29,1,314,6,700,380,178,136
29,NEAMŢ,"GRĂDINIŢA CU PROGRAM NORMAL",434,"ŞTEFAN CEL MARE",124411,1,PART,PRCNCT,PRSD,PRSD_SV,"2025-05-18 21:25:30",390,202,161,41,0,198,4,400,198,133,65
29,NEAMŢ,"SCOALA PRIMARA",435,"ŞTEFAN CEL MARE",124411,3,PART,PRCNCT,PRSD,PRSD_SV,"2025-05-18 22:11:02",465,273,207,65,1,272,1,500,227,180,92
29,NEAMŢ,ŞCOALA,436,"ŞTEFAN CEL MARE",124411,1,PART,PRCNCT,PRSD,PRSD_SV,"2025-05-18 21:45:13",256,153,111,42,0,153,0,300,147,94,59
29,NEAMŢ,"ŞCOLA GIMNAZIALĂ ”IULIA HĂLĂUCESCU”, COMUNA TARCĂU, JUDEŢUL NEAMŢ",437,TARCĂU,124493,1,PART,PRCNCT,PRSD,PRSD_SV,"2025-05-18 21:49:14",750,407,353,53,1,400,7,800,393,223,177
29,NEAMŢ,"ŞCOLA GIMNAZIALĂ ”IULIA HĂLĂUCESCU”, COMUNA TARCĂU, JUDEŢUL NEAMŢ",438,TARCĂU,124493,1,PART,PRCNCT,PRSD,PRSD_SV,"2025-05-18 21:34:51",809,398,358,38,2,394,4,900,502,233,161
29,NEAMŢ,GRĂDINIŢA,439,TARCĂU,124493,1,PART,PRCNCT,PRSD,PRSD_SV,"2025-05-18 21:27:59",265,168,123,45,0,166,2,300,132,85,81
29,NEAMŢ,GRĂDINIŢA,440,TARCĂU,124493,1,PART,PRCNCT,PRSD,PRSD_SV,"2025-05-18 21:29:29",425,230,204,26,0,225,5,500,270,137,88
29,NEAMŢ,GRĂDINIŢA,441,TARCĂU,124493,1,PART,PRCNCT,PRSD,PRSD_SV,"2025-05-18 21:32:57",525,278,236,41,1,272,6,600,322,177,95
29,NEAMŢ,"CAMIN CULTURAL",442,TAŞCA,124563,1,PART,PRCNCT,PRSD,PRSD_SV,"2025-05-18 21:43:31",1364,743,657,83,3,728,15,1500,757,484,244
29,NEAMŢ,"PUNCT DE INFORMARE NEAGRA",443,TAŞCA,124563,1,PART,PRCNCT,PRSD,PRSD_SV,"2025-05-18 21:23:44",768,413,353,58,2,408,5,800,387,277,131
29,NEAMŢ,"SCOALA GIMNAZIALA ”I.I. MIRONESCU”",444,TAZLĂU,124616,1,PART,PRCNCT,PRSD,PRSD_SV,"2025-05-18 21:38:59",1008,490,430,60,0,489,1,1100,610,281,208
29,NEAMŢ,"CAMINUL CULTURAL",445,TAZLĂU,124616,1,PART,PRCNCT,PRSD,PRSD_SV,"2025-05-18 21:38:44",1174,552,506,46,0,548,4,1300,748,295,253
29,NEAMŢ,GRADINITA,446,TĂMĂŞENI,124634,1,PART,PRCNCT,PRSD,PRSD_SV,"2025-05-18 21:34:49",1431,547,515,32,0,544,3,1600,1053,234,310
29,NEAMŢ,"SCOALA GIMNAZIALA COMUNA TAMASENI",447,TĂMĂŞENI,124634,1,PART,PRCNCT,PRSD,PRSD_SV,"2025-05-18 21:39:45",1470,554,513,41,0,543,11,1600,1046,258,285
29,NEAMŢ,"CAMINUL CULTURAL",448,TĂMĂŞENI,124634,1,PART,PRCNCT,PRSD,PRSD_SV,"2025-05-18 21:36:37",1040,411,366,44,1,404,7,1100,689,163,241
29,NEAMŢ,"LICEUL TEHNOLOGIC ADJUDENI",449,TĂMĂŞENI,124634,1,PART,PRCNCT,PRSD,PRSD_SV,"2025-05-18 21:31:50",1506,575,539,35,1,567,8,1600,1025,274,293
29,NEAMŢ,GRADINITA,450,TĂMĂŞENI,124634,1,PART,PRCNCT,PRSD,PRSD_SV,"2025-05-18 21:34:17",1037,357,334,23,0,348,9,1100,743,168,180
29,NEAMŢ,"CENTRUL MEDICAL ADJUDENI",451,TĂMĂŞENI,124634,1,PART,PRCNCT,PRSD,PRSD_SV,"2025-05-18 21:21:42",1534,538,510,28,0,529,9,1700,1162,241,288
29,NEAMŢ,"ŞCOALA GIMNAZIALĂ",452,TIMIŞEŞTI,124661,1,PART,PRCNCT,PRSD,PRSD_SV,"2025-05-18 21:36:47",1005,493,431,62,0,490,3,1100,607,254,236
29,NEAMŢ,"ŞCOALA GIMNAZIALĂ",453,TIMIŞEŞTI,124661,1,PART,PRCNCT,PRSD,PRSD_SV,"2025-05-18 21:31:34",1014,523,463,60,0,518,5,1101,578,293,225
29,NEAMŢ,"ŞCOALA PRIMARĂ",454,TIMIŞEŞTI,124661,1,PART,PRCNCT,PRSD,PRSD_SV,"2025-05-18 21:20:05",659,321,276,45,0,320,1,700,379,173,147
29,NEAMŢ,"ŞCOALA PRIMARĂ",455,TIMIŞEŞTI,124661,1,PART,PRCNCT,PRSD,PRSD_SV,"2025-05-18 21:24:17",449,255,228,26,1,250,5,500,245,150,100
29,NEAMŢ,"CASA DE PRĂZNUIRE A PAROHIEI ZVORĂNEŞTI",456,TIMIŞEŞTI,124661,1,PART,PRCNCT,PRSD,PRSD_SV,"2025-05-18 21:15:55",131,82,59,23,0,82,0,200,118,55,27
29,NEAMŢ,"ȘCOALA CU CLASELE I - VIII",457,TRIFEŞTI,124723,1,PART,PRCNCT,PRSD,PRSD_SV,"2025-05-18 21:51:48",1875,921,816,104,1,906,15,2000,1079,499,407
29,NEAMŢ,"ȘCOALA CU CLASELE I - IV",458,TRIFEŞTI,124723,1,PART,PRCNCT,PRSD,PRSD_SV,"2025-05-18 21:33:19",736,357,318,39,0,352,5,800,443,208,144
29,NEAMŢ,"ȘCOALA CU CLASELE I - VIII",459,TRIFEŞTI,124723,1,PART,PRCNCT,PRSD,PRSD_SV,"2025-05-18 21:38:53",800,350,310,40,0,345,5,900,550,165,180
29,NEAMŢ,"ȘCOALA CU CLASELE I-IV",460,TRIFEŞTI,124723,1,PART,PRCNCT,PRSD,PRSD_SV,"2025-05-18 21:27:45",656,305,252,53,0,303,2,700,395,204,99
29,NEAMŢ,"SCOALA CU CLASELE I-VIII",461,TUPILAŢI,124750,1,PART,PRCNCT,PRSD,PRSD_SV,"2025-05-18 21:37:57",854,490,392,98,0,483,7,900,410,292,191
29,NEAMŢ,"PRIMARIA TUPILAŢI",462,TUPILAŢI,124750,1,PART,PRCNCT,PRSD,PRSD_SV,"2025-05-18 21:22:21",605,298,262,36,0,292,6,700,402,181,111
29,NEAMŢ,"SCOALA CU CLASELE I-VIII",463,TUPILAŢI,124750,1,PART,PRCNCT,PRSD,PRSD_SV,"2025-05-18 21:27:53",267,148,111,37,0,145,3,300,152,97,48
29,NEAMŢ,"ȘCOALA GIMNAZIALĂ NR.1 ȚIBUCANI",464,ŢIBUCANI,124803,1,PART,PRCNCT,PRSD,PRSD_SV,"2025-05-18 22:00:37",1255,683,589,94,0,674,9,1400,717,367,307
29,NEAMŢ,"ŞCOALA GIMNAZIALĂ NR.3 ȚIBUCANI",465,ŢIBUCANI,124803,1,PART,PRCNCT,PRSD,PRSD_SV,"2025-05-18 21:57:36",788,402,355,47,0,396,6,900,498,222,174
29,NEAMŢ,"ȘCOALA GIMNAZIALĂ DAVIDENI",466,ŢIBUCANI,124803,1,PART,PRCNCT,PRSD,PRSD_SV,"2025-05-18 21:35:06",744,352,286,66,0,347,5,800,448,214,133
29,NEAMŢ,"FOSTA ȘCOALA PRIMARĂ (SALA DE FESTIVITĂȚI)",467,ŢIBUCANI,124803,1,PART,PRCNCT,PRSD,PRSD_SV,"2025-05-18 21:44:49",293,179,127,52,0,178,1,300,121,92,86
29,NEAMŢ,"SCOALA GIMNAZIALA URECHENI",468,URECHENI,124849,1,PART,PRCNCT,PRSD,PRSD_SV,"2025-05-18 21:23:48",569,247,215,28,4,246,1,600,353,137,109
29,NEAMŢ,"SCOALA GIMNAZIALA URECHENI",469,URECHENI,124849,1,PART,PRCNCT,PRSD,PRSD_SV,"2025-05-18 21:17:45",892,365,337,26,2,362,3,1000,635,214,148
29,NEAMŢ,"SCOALA GIMNAZIALA FUNDATURA",470,URECHENI,124849,1,PART,PRCNCT,PRSD,PRSD_SV,"2025-05-18 21:18:28",535,211,180,31,0,205,6,600,389,127,78
29,NEAMŢ,"GRADINITA CU PROGRAM NORMAL CATUNA",471,URECHENI,124849,1,PART,PRCNCT,PRSD,PRSD_SV,"2025-05-18 21:14:51",532,210,187,23,0,203,7,600,390,117,86
29,NEAMŢ,"SCOALA GIMNAZIALA INGARESTI",472,URECHENI,124849,2,PART,PRCNCT,PRSD,PRSD_SV,"2025-05-18 23:22:26",719,336,296,40,0,331,5,800,464,218,113
29,NEAMŢ,"CAMIN CULTURAL VALEA URSULUI",473,"VALEA URSULUI",124885,1,PART,PRCNCT,PRSD,PRSD_SV,"2025-05-18 21:24:03",741,290,248,42,0,288,2,800,510,230,58
29,NEAMŢ,"SCOALA BUCIUM , COMUNA VALEA URSULUI",474,"VALEA URSULUI",124885,1,PART,PRCNCT,PRSD,PRSD_SV,"2025-05-18 21:14:37",558,218,186,32,0,216,2,600,382,156,60
29,NEAMŢ,"SCOALA CHILII , COMUNA VALEA URSULUI",475,"VALEA URSULUI",124885,1,PART,PRCNCT,PRSD,PRSD_SV,"2025-05-18 21:32:07",925,428,393,35,0,422,6,1000,572,288,134
29,NEAMŢ,"SCOALA GIURGENI , COMUNA VALEA URSULUI",476,"VALEA URSULUI",124885,1,PART,PRCNCT,PRSD,PRSD_SV,"2025-05-18 21:20:45",482,223,170,53,0,221,2,500,277,169,52
29,NEAMŢ,"SCOALA MUNCEL , COMUNA VALEA URSULUI",477,"VALEA URSULUI",124885,1,PART,PRCNCT,PRSD,PRSD_SV,"2025-05-18 21:16:39",317,153,119,34,0,150,3,400,247,109,41
29,NEAMŢ,"ȘCOALA CU CLASELE I-VIII, SAT VĂLENI, COM. VĂLENI",478,VĂLENI,125123,1,PART,PRCNCT,PRSD,PRSD_SV,"2025-05-18 21:40:32",500,253,188,64,1,251,2,600,347,132,119
29,NEAMŢ,"ŞCOALA GIMNAZIALA COMUNA VALENI",479,VĂLENI,125123,1,PART,PRCNCT,PRSD,PRSD_SV,"2025-05-18 21:25:52",602,245,220,25,0,241,4,700,455,146,95
29,NEAMŢ,"SCOALA GIMNAZIALA ”ARHIM. CHIRIAC NICOLAU”",480,VÂNĂTORI-NEAMŢ,125016,1,PART,PRCNCT,PRSD,PRSD_SV,"2025-05-18 22:03:49",1299,659,609,49,1,654,5,1400,741,328,326
29,NEAMŢ,"GRADINITA NR.2 UNGURENI",481,VÂNĂTORI-NEAMŢ,125016,1,PART,PRCNCT,PRSD,PRSD_SV,"2025-05-18 21:36:38",1418,677,650,27,0,653,24,1600,923,409,244
29,NEAMŢ,"SCOALA GIMNAZIALA ”ARHIM. CHIRIAC NICOLAU” NR.2",482,VÂNĂTORI-NEAMŢ,125016,1,PART,PRCNCT,PRSD,PRSD_SV,"2025-05-18 21:37:43",1347,609,581,26,2,599,10,1500,891,363,236
29,NEAMŢ,"MANASTIREA SIHASTRIA",483,VÂNĂTORI-NEAMŢ,125016,1,PART,PRCNCT,PRSD,PRSD_SV,"2025-05-18 21:29:33",181,325,95,230,0,322,3,400,75,239,83
29,NEAMŢ,"SCOALA GIMNAZIALA ”ARHIM. CHIRIAC NICOLAU”",484,VÂNĂTORI-NEAMŢ,125016,1,PART,PRCNCT,PRSD,PRSD_SV,"2025-05-18 21:34:41",1125,545,507,38,0,540,5,1200,655,349,191
29,NEAMŢ,"MĂNĂSTIREA NEAMȚ",485,VÂNĂTORI-NEAMŢ,125016,1,PART,PRCNCT,PRSD,PRSD_SV,"2025-05-18 21:26:40",195,162,114,48,0,156,6,400,238,114,42
29,NEAMŢ,"SCOALA GIMNAZIALA”ARHIM.CHIRIAC NECULAU” NEMTISOR",486,VÂNĂTORI-NEAMŢ,125016,1,PART,PRCNCT,PRSD,PRSD_SV,"2025-05-18 21:31:43",1173,580,520,60,0,571,9,1300,720,419,152
29,NEAMŢ,"ŞCOALA GIMNAZIALĂ NR. 2, LOC ZĂNEŞTI",487,ZĂNEŞTI,125061,1,PART,PRCNCT,PRSD,PRSD_SV,"2025-05-18 21:36:23",1468,694,639,55,0,676,18,1600,906,358,318
29,NEAMŢ,"ŞCOALA GIMNAZIALĂ NR. 1, LOC ZĂNEŞTI",488,ZĂNEŞTI,125061,1,PART,PRCNCT,PRSD,PRSD_SV,"2025-05-18 22:04:24",1373,699,649,50,0,691,8,1500,801,325,366
29,NEAMŢ,"CENTRU CULTURAL MULTIFUNCTIONAL",489,ZĂNEŞTI,125061,1,PART,PRCNCT,PRSD,PRSD_SV,"2025-05-18 21:29:11",1154,573,503,70,0,566,7,1300,727,322,244
29,NEAMŢ,"GRĂDINIŢA CU PROGRAM NORMAL, LOC TRAIAN",490,ZĂNEŞTI,125061,1,PART,PRCNCT,PRSD,PRSD_SV,"2025-05-18 22:18:19",855,410,365,45,0,405,5,900,490,268,137
30,OLT,"COLEGIUL NAŢIONAL RADU GRECEANU",1,"MUNICIPIUL SLATINA",125347,1,PART,PRCNCT,PRSD,PRSD_SV,"2025-05-18 22:08:51",1263,667,624,43,0,655,12,1394,727,238,417
30,OLT,"COLEGIUL NAŢIONAL RADU GRECEANU",2,"MUNICIPIUL SLATINA",125347,1,PART,PRCNCT,PRSD,PRSD_SV,"2025-05-18 22:01:49",1503,812,702,109,1,803,9,1653,841,407,396
30,OLT,"COLEGIUL NAŢIONAL RADU GRECEANU",3,"MUNICIPIUL SLATINA",125347,1,PART,PRCNCT,PRSD,PRSD_SV,"2025-05-18 22:22:59",1880,821,774,47,0,803,18,1567,746,652,151
30,OLT,"ŞCOALA GIMNAZIALĂ NR. 1",4,"MUNICIPIUL SLATINA",125347,1,PART,PRCNCT,PRSD,PRSD_SV,"2025-05-18 21:56:31",1128,674,621,53,0,658,16,1241,567,290,368
30,OLT,"ŞCOALA GIMNAZIALĂ NR. 1",5,"MUNICIPIUL SLATINA",125347,1,PART,PRCNCT,PRSD,PRSD_SV,"2025-05-18 21:41:04",1034,633,586,47,0,622,11,1137,504,287,335
30,OLT,"COLEGIUL NAŢIONAL ION MINULESCU",6,"MUNICIPIUL SLATINA",125347,1,PART,PRCNCT,PRSD,PRSD_SV,"2025-05-18 21:48:00",1306,719,616,102,1,707,12,1438,719,305,402
30,OLT,"COLEGIUL NAŢIONAL ION MINULESCU",7,"MUNICIPIUL SLATINA",125347,1,PART,PRCNCT,PRSD,PRSD_SV,"2025-05-18 22:53:15",1439,727,648,78,1,714,13,1583,856,316,398
30,OLT,"COLEGIUL NAŢIONAL ION MINULESCU",8,"MUNICIPIUL SLATINA",125347,1,PART,PRCNCT,PRSD,PRSD_SV,"2025-05-18 22:20:37",1334,814,754,59,1,801,13,1470,656,312,489
30,OLT,"COLEGIUL NAŢIONAL ION MINULESCU",9,"MUNICIPIUL SLATINA",125347,1,PART,PRCNCT,PRSD,PRSD_SV,"2025-05-18 22:24:49",1296,728,678,50,0,712,16,1426,698,290,422
30,OLT,"ŞCOALA GIMNAZIALĂ ŞTEFAN PROTOPOPESCU",10,"MUNICIPIUL SLATINA",125347,1,PART,PRCNCT,PRSD,PRSD_SV,"2025-05-18 21:40:31",1609,848,755,93,0,827,21,1770,922,390,437
30,OLT,"ŞCOALA GIMNAZIALĂ ŞTEFAN PROTOPOPESCU",11,"MUNICIPIUL SLATINA",125347,2,PART,PRCNCT,PRSD,PRSD_SV,"2025-05-18 22:21:29",1595,772,663,108,1,764,8,1755,983,428,336
30,OLT,"LICEUL TEORETIC NICOLAE TITULESCU",12,"MUNICIPIUL SLATINA",125347,1,PART,PRCNCT,PRSD,PRSD_SV,"2025-05-18 22:13:42",1434,771,679,92,0,759,12,1577,806,308,451
30,OLT,"LICEUL TEORETIC NICOLAE TITULESCU",13,"MUNICIPIUL SLATINA",125347,1,PART,PRCNCT,PRSD,PRSD_SV,"2025-05-18 22:00:09",1393,747,684,63,0,736,11,1532,785,313,423
30,OLT,"LICEUL TEORETIC NICOLAE TITULESCU",14,"MUNICIPIUL SLATINA",125347,1,PART,PRCNCT,PRSD,PRSD_SV,"2025-05-18 21:58:22",1164,606,565,39,2,596,10,1280,674,236,360
30,OLT,"LICEUL TEORETIC NICOLAE TITULESCU",15,"MUNICIPIUL SLATINA",125347,1,PART,PRCNCT,PRSD,PRSD_SV,"2025-05-18 21:48:29",932,516,438,78,0,510,6,1025,509,261,249
30,OLT,"LICEUL TEORETIC NICOLAE TITULESCU",16,"MUNICIPIUL SLATINA",125347,1,PART,PRCNCT,PRSD,PRSD_SV,"2025-05-18 21:55:11",1131,584,542,42,0,567,17,1244,660,233,334
30,OLT,"ŞCOALA GIMNAZIALĂ NICOLAE IORGA",17,"MUNICIPIUL SLATINA",125347,1,PART,PRCNCT,PRSD,PRSD_SV,"2025-05-18 22:14:35",1387,758,687,71,0,741,17,1527,769,288,453
30,OLT,"ŞCOALA GIMNAZIALĂ NICOLAE IORGA",18,"MUNICIPIUL SLATINA",125347,1,PART,PRCNCT,PRSD,PRSD_SV,"2025-05-18 22:12:43",1196,701,606,84,11,688,13,1317,616,257,431
30,OLT,"ŞCOALA GIMNAZIALĂ EUGEN IONESCU",19,"MUNICIPIUL SLATINA",125347,1,PART,PRCNCT,PRSD,PRSD_SV,"2025-05-18 21:38:36",1493,841,744,97,0,835,6,1642,801,450,385
30,OLT,"ŞCOALA GIMNAZIALĂ EUGEN IONESCU",20,"MUNICIPIUL SLATINA",125347,3,PART,PRCNCT,PRSD,PRSD_SV,"2025-05-18 22:24:04",1142,613,566,47,0,608,5,1256,643,250,358
30,OLT,"ŞCOALA GIMNAZIALĂ EUGEN IONESCU",21,"MUNICIPIUL SLATINA",125347,1,PART,PRCNCT,PRSD,PRSD_SV,"2025-05-18 21:39:45",1127,515,488,27,0,503,12,1239,724,251,252
30,OLT,"ŞCOALA GIMNAZIALĂ VLAICU VODĂ",22,"MUNICIPIUL SLATINA",125347,2,PART,PRCNCT,PRSD,PRSD_SV,"2025-05-18 23:36:12",1344,736,597,66,73,722,14,1480,744,346,376
30,OLT,"ŞCOALA GIMNAZIALĂ VLAICU VODĂ",23,"MUNICIPIUL SLATINA",125347,1,PART,PRCNCT,PRSD,PRSD_SV,"2025-05-18 22:10:30",1112,698,568,53,77,685,13,1224,526,306,379
30,OLT,"ŞCOALA GIMNAZIALĂ VLAICU VODĂ",24,"MUNICIPIUL SLATINA",125347,1,PART,PRCNCT,PRSD,PRSD_SV,"2025-05-18 22:47:11",1373,825,712,37,76,815,10,1510,685,387,428
30,OLT,"LICEUL TEHNOLOGIC P.S. AURELIAN",25,"MUNICIPIUL SLATINA",125347,1,PART,PRCNCT,PRSD,PRSD_SV,"2025-05-18 22:01:12",1111,653,545,108,0,643,10,1222,569,308,335
30,OLT,"LICEUL TEHNOLOGIC P.S. AURELIAN",26,"MUNICIPIUL SLATINA",125347,1,PART,PRCNCT,PRSD,PRSD_SV,"2025-05-18 22:03:24",1604,741,672,69,0,728,13,1766,1025,387,341
30,OLT,"LICEUL CU PROGRAM SPORTIV",27,"MUNICIPIUL SLATINA",125347,1,PART,PRCNCT,PRSD,PRSD_SV,"2025-05-18 23:02:09",1693,917,803,114,0,898,19,1862,945,473,425
30,OLT,"LICEUL CU PROGRAM SPORTIV",28,"MUNICIPIUL SLATINA",125347,1,PART,PRCNCT,PRSD,PRSD_SV,"2025-05-18 22:25:07",1528,819,751,67,1,810,9,1681,862,396,414
30,OLT,"LICEUL CU PROGRAM SPORTIV",29,"MUNICIPIUL SLATINA",125347,1,PART,PRCNCT,PRSD,PRSD_SV,"2025-05-18 22:02:20",1383,717,638,53,26,699,18,1521,804,355,344
30,OLT,"ŞCOALA GIMNAZIALĂ NR. 3",30,"MUNICIPIUL SLATINA",125347,1,PART,PRCNCT,PRSD,PRSD_SV,"2025-05-18 22:15:25",1347,719,625,94,0,709,10,1482,763,351,358
30,OLT,"ŞCOALA GIMNAZIALĂ NR. 3",31,"MUNICIPIUL SLATINA",125347,1,PART,PRCNCT,PRSD,PRSD_SV,"2025-05-18 22:43:47",1188,643,573,69,1,632,11,1307,664,289,343
30,OLT,"ŞCOALA GIMNAZIALĂ NR. 3",32,"MUNICIPIUL SLATINA",125347,1,PART,PRCNCT,PRSD,PRSD_SV,"2025-05-18 21:28:32",794,421,382,39,0,413,8,873,452,169,244
30,OLT,"ŞCOALA GIMNAZIALĂ NR. 3",33,"MUNICIPIUL SLATINA",125347,2,PART,PRCNCT,PRSD,PRSD_SV,"2025-05-18 23:31:48",1424,686,657,29,0,681,5,1566,880,316,365
30,OLT,"LICEUL TEHNOLOGIC METALURGIC",34,"MUNICIPIUL SLATINA",125347,1,PART,PRCNCT,PRSD,PRSD_SV,"2025-05-18 21:56:01",1507,778,719,59,0,759,19,1659,881,392,367
30,OLT,"LICEUL TEHNOLOGIC METALURGIC",35,"MUNICIPIUL SLATINA",125347,1,PART,PRCNCT,PRSD,PRSD_SV,"2025-05-18 21:56:58",1504,673,628,45,0,670,3,1654,981,380,290
30,OLT,"LICEUL TEHNOLOGIC METALURGIC",36,"MUNICIPIUL SLATINA",125347,1,PART,PRCNCT,PRSD,PRSD_SV,"2025-05-18 21:42:34",784,456,419,37,0,446,10,864,408,166,280
30,OLT,"GRĂDINIȚA CU PROGRAM PRELUNGIT NR. 8",37,"MUNICIPIUL SLATINA",125347,1,PART,PRCNCT,PRSD,PRSD_SV,"2025-05-18 21:49:41",1037,558,474,83,1,551,7,1144,586,319,232
30,OLT,"GRĂDINIȚA CU PROGRAM PRELUNGIT NR. 8",38,"MUNICIPIUL SLATINA",125347,1,PART,PRCNCT,PRSD,PRSD_SV,"2025-05-18 21:38:01",1512,733,692,41,0,726,7,1663,930,426,300
30,OLT,"ŞCOALA GIMNAZIALĂ CONSTANTIN BRÂNCOVEANU",39,"MUNICIPIUL SLATINA",125347,1,PART,PRCNCT,PRSD,PRSD_SV,"2025-05-18 21:37:17",1239,611,522,89,0,604,7,1363,752,354,250
30,OLT,"ŞCOALA GIMNAZIALĂ CONSTANTIN BRÂNCOVEANU",40,"MUNICIPIUL SLATINA",125347,1,PART,PRCNCT,PRSD,PRSD_SV,"2025-05-18 22:11:11",1600,820,761,59,0,811,9,1760,940,451,360
30,OLT,"ŞCOALA GIMNAZIALĂ CONSTANTIN BRÂNCOVEANU",41,"MUNICIPIUL SLATINA",125347,1,PART,PRCNCT,PRSD,PRSD_SV,"2025-05-18 21:53:57",1523,784,734,50,0,769,15,1675,891,413,356
30,OLT,"GRĂDINIȚA CU PROGRAM NORMAL NR. 5",42,"MUNICIPIUL SLATINA",125347,1,PART,PRCNCT,PRSD,PRSD_SV,"2025-05-18 22:19:18",2021,1312,1226,86,0,1291,21,2222,910,572,719
30,OLT,"LICEUL TEHNOLOGIC ALEXE MARIN",43,"MUNICIPIUL SLATINA",125347,1,PART,PRCNCT,PRSD,PRSD_SV,"2025-05-18 21:31:32",1365,696,638,58,0,689,7,1500,804,375,314
30,OLT,"LICEUL TEHNOLOGIC ALEXE MARIN",44,"MUNICIPIUL SLATINA",125347,1,PART,PRCNCT,PRSD,PRSD_SV,"2025-05-18 21:40:32",1374,717,649,68,0,710,7,1511,794,322,388
30,OLT,"LICEUL TEHNOLOGIC ALEXE MARIN",45,"MUNICIPIUL SLATINA",125347,1,PART,PRCNCT,PRSD,PRSD_SV,"2025-05-18 21:41:08",1527,815,764,51,0,803,12,1679,864,412,391
30,OLT,"GRĂDINIȚA CU PROGRAM NORMAL",46,"MUNICIPIUL SLATINA",125347,1,PART,PRCNCT,PRSD,PRSD_SV,"2025-05-18 22:32:46",1366,872,829,43,0,855,17,1503,631,420,435
30,OLT,"ŞCOALA GIMNAZIALĂ GEORGE POBORAN",47,"MUNICIPIUL SLATINA",125347,2,PART,PRCNCT,PRSD,PRSD_SV,"2025-05-18 22:45:22",1358,842,719,122,1,825,17,1494,652,404,421
30,OLT,"ŞCOALA GIMNAZIALĂ GEORGE POBORAN",48,"MUNICIPIUL SLATINA",125347,1,PART,PRCNCT,PRSD,PRSD_SV,"2025-05-18 21:42:19",1077,563,486,77,0,551,12,1184,621,285,266
30,OLT,"LICEUL TEORETIC IONIŢĂ ASAN",49,"MUNICIPIUL CARACAL",125472,1,PART,PRCNCT,PRSD,PRSD_SV,"2025-05-18 22:12:04",1756,730,658,72,0,716,14,1931,1201,432,284
30,OLT,"GRĂDINIŢA CU PROGRAM PRELUNGIT NR.1",50,"MUNICIPIUL CARACAL",125472,1,PART,PRCNCT,PRSD,PRSD_SV,"2025-05-18 22:28:55",1820,804,748,55,1,793,11,2000,1196,416,377
30,OLT,"GRĂDINIŢA CU PROGRAM NORMAL NR.4",51,"MUNICIPIUL CARACAL",125472,1,PART,PRCNCT,PRSD,PRSD_SV,"2025-05-18 22:08:19",1490,782,707,75,0,770,12,1640,858,341,429
30,OLT,"LICEUL TEHNOLOGIC CONSTANTIN FILIPESCU",52,"MUNICIPIUL CARACAL",125472,1,PART,PRCNCT,PRSD,PRSD_SV,"2025-05-18 22:14:55",1771,862,792,69,1,849,13,1948,1086,418,431
30,OLT,"LICEUL MIHAI VITEAZUL",53,"MUNICIPIUL CARACAL",125472,1,PART,PRCNCT,PRSD,PRSD_SV,"2025-05-18 22:16:26",1249,735,572,71,92,723,12,1374,639,294,429
30,OLT,"LICEUL TEHNOLOGIC MATEI BASARAB",54,"MUNICIPIUL CARACAL",125472,1,PART,PRCNCT,PRSD,PRSD_SV,"2025-05-18 22:42:00",1632,774,719,55,0,763,11,1795,1021,374,389
30,OLT,"GRĂDINIŢA CU PROGRAM PRELUNGIT NR.3",55,"MUNICIPIUL CARACAL",125472,1,PART,PRCNCT,PRSD,PRSD_SV,"2025-05-18 22:00:56",1479,715,635,78,2,704,11,1629,914,358,346
30,OLT,"ŞCOALA GIMNAZIALĂ NICOLAE TITULESCU",56,"MUNICIPIUL CARACAL",125472,1,PART,PRCNCT,PRSD,PRSD_SV,"2025-05-18 22:13:44",1517,810,713,97,0,803,7,1669,859,386,417
30,OLT,"ŞCOALA GIMNAZIALĂ NICOLAE TITULESCU",57,"MUNICIPIUL CARACAL",125472,1,PART,PRCNCT,PRSD,PRSD_SV,"2025-05-18 22:02:23",1302,695,602,93,0,688,7,1432,737,305,383
30,OLT,"ŞCOALA GIMNAZIALĂ NR.2",58,"MUNICIPIUL CARACAL",125472,1,PART,PRCNCT,PRSD,PRSD_SV,"2025-05-18 22:22:48",1474,847,723,121,3,837,10,1621,774,371,466
30,OLT,"BIBLIOTECA ”VIRGIL CARIANOPOL”",59,"MUNICIPIUL CARACAL",125472,1,PART,PRCNCT,PRSD,PRSD_SV,"2025-05-18 21:41:16",1462,705,619,84,2,696,9,1608,903,310,386
30,OLT,"BIBLIOTECA ”VIRGIL CARIANOPOL”",60,"MUNICIPIUL CARACAL",125472,1,PART,PRCNCT,PRSD,PRSD_SV,"2025-05-18 21:48:20",1485,683,651,32,0,671,12,1635,952,337,334
30,OLT,"CENTRUL CULTURAL MUNICIPAL CARACAL",61,"MUNICIPIUL CARACAL",125472,2,PART,PRCNCT,PRSD,PRSD_SV,"2025-05-18 23:55:55",1125,680,603,74,3,668,12,1239,559,230,438
30,OLT,"ŞCOALA GIMNAZIALĂ GHEORGHE MAGHERU",62,"MUNICIPIUL CARACAL",125472,1,PART,PRCNCT,PRSD,PRSD_SV,"2025-05-18 21:51:17",1763,991,923,68,0,983,8,1939,948,519,464
30,OLT,"ŞCOALA GIMNAZIALĂ NR. 3",63,"MUNICIPIUL CARACAL",125472,1,PART,PRCNCT,PRSD,PRSD_SV,"2025-05-18 22:13:41",1639,942,890,51,1,929,13,1804,862,493,436
30,OLT,"ŞCOALA GIMNAZIALĂ NR. 3",64,"MUNICIPIUL CARACAL",125472,1,PART,PRCNCT,PRSD,PRSD_SV,"2025-05-18 22:22:17",1814,971,917,54,0,951,20,1996,1025,543,408
30,OLT,"ŞCOALA GIMNAZIALĂ NR.1",65,"MUNICIPIUL CARACAL",125472,1,PART,PRCNCT,PRSD,PRSD_SV,"2025-05-18 21:51:35",1509,866,802,61,3,852,14,1661,795,429,423
30,OLT,"SCOALA GIMNAZIALĂ NR 3 ROMANA",66,"ORAŞ BALŞ",125418,1,PART,PRCNCT,PRSD,PRSD_SV,"2025-05-18 21:35:00",881,414,387,27,0,406,8,970,556,231,175
30,OLT,"SCOALA GIMNAZIALĂ NR 2 VIRTINA",67,"ORAŞ BALŞ",125418,1,PART,PRCNCT,PRSD,PRSD_SV,"2025-05-18 21:52:52",1155,564,532,32,0,556,8,1272,708,287,269
30,OLT,"SCOALA GIMNAZIALA NR. 1 BALS",68,"ORAŞ BALŞ",125418,1,PART,PRCNCT,PRSD,PRSD_SV,"2025-05-18 21:36:58",1228,544,490,54,0,538,6,1352,808,294,244
30,OLT,"SCOALA GIMNAZIALA SPECIALA",69,"ORAŞ BALŞ",125418,1,PART,PRCNCT,PRSD,PRSD_SV,"2025-05-18 21:42:29",1709,717,660,57,0,707,10,1881,1164,384,323
30,OLT,"LICEUL TEORETIC PETRE PANDREA",70,"ORAŞ BALŞ",125418,1,PART,PRCNCT,PRSD,PRSD_SV,"2025-05-18 21:48:32",1324,608,522,86,0,599,9,1456,848,267,332
30,OLT,"LICEUL TEORETIC PETRE PANDREA",71,"ORAŞ BALŞ",125418,1,PART,PRCNCT,PRSD,PRSD_SV,"2025-05-18 22:16:56",1394,598,575,23,0,587,11,1535,937,268,319
30,OLT,"SCOALA GIMNAZIALĂ ”MIHAIL DRUMES”",72,"ORAŞ BALŞ",125418,1,PART,PRCNCT,PRSD,PRSD_SV,"2025-05-18 21:53:17",1618,782,689,92,1,769,13,1780,998,374,395
30,OLT,"SCOALA GIMNAZIALĂ ”MIHAIL DRUMES”",73,"ORAŞ BALŞ",125418,1,PART,PRCNCT,PRSD,PRSD_SV,"2025-05-18 21:52:25",1250,620,555,65,0,612,8,1376,756,280,332
30,OLT,"GRADINITA CU PROGRAM NORMAL NR 1",74,"ORAŞ BALŞ",125418,1,PART,PRCNCT,PRSD,PRSD_SV,"2025-05-18 21:56:30",1287,622,524,75,23,612,10,1416,794,312,300
30,OLT,"GRADINITA CU PROGRAM NORMAL NR 1",75,"ORAŞ BALŞ",125418,1,PART,PRCNCT,PRSD,PRSD_SV,"2025-05-18 21:41:23",1081,482,431,51,0,478,4,1191,709,263,215
30,OLT,"COLEGIUL TEHNIC",76,"ORAŞ BALŞ",125418,1,PART,PRCNCT,PRSD,PRSD_SV,"2025-05-18 21:50:56",1314,584,498,85,1,577,7,1445,861,332,245
30,OLT,"COLEGIUL TEHNIC",77,"ORAŞ BALŞ",125418,1,PART,PRCNCT,PRSD,PRSD_SV,"2025-05-18 21:45:16",1308,589,528,59,2,576,13,1439,850,324,252
30,OLT,"SCOALA GIMNAZIALA TEIS",78,"ORAŞ BALŞ",125418,1,PART,PRCNCT,PRSD,PRSD_SV,"2025-05-18 21:31:57",632,347,312,35,0,344,3,695,348,184,160
30,OLT,"SPĂLĂTORIE SOCIALĂ",79,"ORAŞ CORABIA",125542,1,PART,PRCNCT,PRSD,PRSD_SV,"2025-05-18 22:30:27",1386,613,558,54,1,599,14,1526,913,330,269
30,OLT,"ŞCOALA GIMNAZIALĂ DUMITRU BUZDUN",80,"ORAŞ CORABIA",125542,1,PART,PRCNCT,PRSD,PRSD_SV,"2025-05-18 22:14:21",1121,653,575,77,1,647,6,1233,580,280,367
30,OLT,"SCOALA GIMNAZIALAVIRGIL MAZILESCU",81,"ORAŞ CORABIA",125542,1,PART,PRCNCT,PRSD,PRSD_SV,"2025-05-18 22:10:43",967,448,362,58,28,440,8,1063,615,194,246
30,OLT,"ŞCOALA GIMNAZIALĂ VIRGIL MAZILESCU",82,"ORAŞ CORABIA",125542,1,PART,PRCNCT,PRSD,PRSD_SV,"2025-05-18 21:50:41",1060,473,432,41,0,472,1,1166,693,203,269
30,OLT,"ŞCOALA GIMNAZIALĂ VIRGIL MAZILESCU",83,"ORAŞ CORABIA",125542,1,PART,PRCNCT,PRSD,PRSD_SV,"2025-05-18 22:15:31",861,389,362,26,1,382,7,947,558,141,241
30,OLT,"COLEGIUL NAŢIONALAL I.CUZA",84,"ORAŞ CORABIA",125542,1,PART,PRCNCT,PRSD,PRSD_SV,"2025-05-18 21:47:18",855,366,320,46,0,361,5,941,575,183,178
30,OLT,"COLEGIUL NAŢIONALAL I.CUZA",85,"ORAŞ CORABIA",125542,1,PART,PRCNCT,PRSD,PRSD_SV,"2025-05-18 21:44:01",1094,523,483,39,1,519,4,1200,677,198,321
30,OLT,"ŞCOALA GIMNAZIALĂ MIHAIL EMINESCU",86,"ORAŞ CORABIA",125542,1,PART,PRCNCT,PRSD,PRSD_SV,"2025-05-18 21:51:22",1170,444,411,32,1,437,7,1288,844,257,180
30,OLT,"ŞCOALA GIMNAZIALĂMIHAIL EMINESCU",87,"ORAŞ CORABIA",125542,2,PART,PRCNCT,PRSD,PRSD_SV,"2025-05-19 00:02:07",1037,403,358,44,1,397,6,1141,738,246,151
30,OLT,"SCOALA CORABIA VECHE",88,"ORAŞ CORABIA",125542,1,PART,PRCNCT,PRSD,PRSD_SV,"2025-05-18 22:38:06",1412,649,561,79,9,640,9,1553,904,316,324
30,OLT,"ŞCOALA GIMNAZIALĂ CELEIU",89,"ORAŞ CORABIA",125542,1,PART,PRCNCT,PRSD,PRSD_SV,"2025-05-18 21:56:10",1337,733,674,59,0,719,14,1473,740,387,332
30,OLT,"ŞCOALA CARTIER SILIŞTIOARA",90,"ORAŞ CORABIA",125542,1,PART,PRCNCT,PRSD,PRSD_SV,"2025-05-18 21:56:14",368,229,185,42,2,226,3,405,176,110,116
30,OLT,"ŞCOALA GIMNAZIALĂ SAT TUDOR VLADIMIRESCU",91,"ORAŞ CORABIA",125542,1,PART,PRCNCT,PRSD,PRSD_SV,"2025-05-18 21:49:14",451,232,207,25,0,230,2,497,265,154,76
30,OLT,"GRĂDINIŢA SAT VÎRTOPU,CORP 2",92,"ORAŞ CORABIA",125542,1,PART,PRCNCT,PRSD,PRSD_SV,"2025-05-18 21:24:00",280,137,109,28,0,136,1,308,171,86,50
30,OLT,"LICEUL TEORETIC „TUDOR VLADIMIRESCU”",93,"ORAŞ DRĂGĂNEŞTI-OLT",125622,1,PART,PRCNCT,PRSD,PRSD_SV,"2025-05-18 22:41:17",1544,762,679,82,1,747,15,1706,944,457,290
30,OLT,"LICEUL TEORETIC „TUDOR VLADIMIRESCU”",94,"ORAŞ DRĂGĂNEŞTI-OLT",125622,1,PART,PRCNCT,PRSD,PRSD_SV,"2025-05-18 22:25:36",1392,664,618,45,1,659,5,1529,865,334,325
30,OLT,"LICEUL TEORETIC „TUDOR VLADIMIRESCU”",95,"ORAŞ DRĂGĂNEŞTI-OLT",125622,1,PART,PRCNCT,PRSD,PRSD_SV,"2025-05-18 22:22:09",1825,848,793,53,2,832,16,2005,1157,512,320
30,OLT,"CASA DE CULTURĂ",96,"ORAŞ DRĂGĂNEŞTI-OLT",125622,1,PART,PRCNCT,PRSD,PRSD_SV,"2025-05-18 22:15:25",1172,524,459,64,1,516,8,1289,765,327,189
30,OLT,"CASA DE CULTURĂ",97,"ORAŞ DRĂGĂNEŞTI-OLT",125622,1,PART,PRCNCT,PRSD,PRSD_SV,"2025-05-18 21:50:04",857,314,280,34,0,313,1,943,629,185,128
30,OLT,"GRĂDINIȚA COMANI",98,"ORAŞ DRĂGĂNEŞTI-OLT",125622,1,PART,PRCNCT,PRSD,PRSD_SV,"2025-05-18 22:05:24",1165,643,582,60,1,637,6,1280,637,401,236
30,OLT,"GRĂDINIȚA COMANI",99,"ORAŞ DRĂGĂNEŞTI-OLT",125622,1,PART,PRCNCT,PRSD,PRSD_SV,"2025-05-18 21:48:49",1202,559,494,63,2,554,5,1322,763,377,177
30,OLT,"SALA DE SPORT PIATRA - OLT",100,"ORAŞ PIATRA-OLT",128105,2,PART,PRCNCT,PRSD,PRSD_SV,"2025-05-18 23:10:25",957,499,431,55,13,493,6,1053,554,313,180
30,OLT,"SALA DE SPORT PIATRA - OLT",101,"ORAŞ PIATRA-OLT",128105,1,PART,PRCNCT,PRSD,PRSD_SV,"2025-05-18 22:19:25",952,599,505,88,6,587,12,1047,448,326,261
30,OLT,"SCOALA GENERALA CU CLASELE I-IV",102,"ORAŞ PIATRA-OLT",128105,1,PART,PRCNCT,PRSD,PRSD_SV,"2025-05-18 21:37:46",427,295,231,49,15,293,2,471,176,169,124
30,OLT,"GRADINITA CU PROGRAM NORMAL",103,"ORAŞ PIATRA-OLT",128105,1,PART,PRCNCT,PRSD,PRSD_SV,"2025-05-18 21:30:52",970,663,536,96,31,654,9,1067,404,388,266
30,OLT,"GRADINITA CU PROGRAM NORMAL",104,"ORAŞ PIATRA-OLT",128105,1,PART,PRCNCT,PRSD,PRSD_SV,"2025-05-18 21:39:34",263,177,147,30,0,176,1,289,112,113,63
30,OLT,"GRADINITA CU PROGRAM NORMAL PIATRA",105,"ORAŞ PIATRA-OLT",128105,1,PART,PRCNCT,PRSD,PRSD_SV,"2025-05-18 21:33:45",658,363,234,115,14,357,6,724,361,183,174
30,OLT,"GRADINITA PIATRA",106,"ORAŞ PIATRA-OLT",128105,1,PART,PRCNCT,PRSD,PRSD_SV,"2025-05-18 21:24:45",940,566,515,43,8,558,8,1034,468,326,232
30,OLT,"ŞCOALA CU CLASELE. I-IV FĂLCOIENI",107,"ORAŞ POTCOAVA",128374,1,PART,PRCNCT,PRSD,PRSD_SV,"2025-05-18 22:11:58",806,472,394,77,1,470,2,887,415,258,212
30,OLT,"LICEUL ”ŞTEFAN DIACONESCU” POTCOAVA",108,"ORAŞ POTCOAVA",128374,1,PART,PRCNCT,PRSD,PRSD_SV,"2025-05-18 22:26:09",1153,707,608,96,3,704,3,1269,562,413,291
30,OLT,"LICEUL ”ŞTEFAN DIACONESCU” POTCOAVA",109,"ORAŞ POTCOAVA",128374,1,PART,PRCNCT,PRSD,PRSD_SV,"2025-05-18 22:21:26",1129,617,564,47,6,611,6,1244,627,320,291
30,OLT,"ŞCOALA GENERALĂ SINEŞTI",110,"ORAŞ POTCOAVA",128374,1,PART,PRCNCT,PRSD,PRSD_SV,"2025-05-18 22:21:19",1511,941,832,102,7,928,13,1662,721,625,303
30,OLT,"GRUPUL SCOLAR AGRICOL SCORNICEŞTI",111,"ORAŞ SCORNICEŞTI",128711,1,PART,PRCNCT,PRSD,PRSD_SV,"2025-05-18 21:59:05",1667,863,793,51,19,852,11,1837,974,546,306
30,OLT,"SCOALA GEN.CLASELE I-VIII SCORNICESTI",112,"ORAŞ SCORNICEŞTI",128711,1,PART,PRCNCT,PRSD,PRSD_SV,"2025-05-18 22:38:28",1915,996,890,106,0,966,30,2103,1107,594,372
30,OLT,"SCOALA GENERLA BIRCII",113,"ORAŞ SCORNICEŞTI",128711,1,PART,PRCNCT,PRSD,PRSD_SV,"2025-05-18 22:28:02",876,527,467,60,0,520,7,964,437,332,188
30,OLT,"SCOALA GENERALA CHIȚEASCA",114,"ORAŞ SCORNICEŞTI",128711,1,PART,PRCNCT,PRSD,PRSD_SV,"2025-05-18 22:24:23",379,247,217,30,0,242,5,417,170,154,88
30,OLT,"GRADINITA CONSTANTINESTI",115,"ORAŞ SCORNICEŞTI",128711,1,PART,PRCNCT,PRSD,PRSD_SV,"2025-05-18 22:04:52",422,247,217,30,0,243,4,464,217,170,73
30,OLT,JITARU,116,"ORAŞ SCORNICEŞTI",128711,1,PART,PRCNCT,PRSD,PRSD_SV,"2025-05-18 22:30:10",833,550,485,65,0,548,2,916,366,423,125
30,OLT,"SCOALA GENERALA MĂRGINENI",117,"ORAŞ SCORNICEŞTI",128711,1,PART,PRCNCT,PRSD,PRSD_SV,"2025-05-18 22:39:28",1497,880,758,94,28,875,5,1647,767,527,348
30,OLT,"GRADINITA MOGOSESTI",118,"ORAŞ SCORNICEŞTI",128711,2,PART,PRCNCT,PRSD,PRSD_SV,"2025-05-18 23:01:20",405,251,208,43,0,250,1,450,199,157,93
30,OLT,"SCOALA GENERALA NEGRENI",119,"ORAŞ SCORNICEŞTI",128711,1,PART,PRCNCT,PRSD,PRSD_SV,"2025-05-18 21:37:29",947,492,430,62,0,488,4,1042,550,318,170
30,OLT,"GRADINITA ȘUICA",120,"ORAŞ SCORNICEŞTI",128711,1,PART,PRCNCT,PRSD,PRSD_SV,"2025-05-18 21:22:47",177,113,91,20,2,112,1,195,82,69,43
30,OLT,"GRADINITA TEIUS",121,"ORAŞ SCORNICEŞTI",128711,1,PART,PRCNCT,PRSD,PRSD_SV,"2025-05-18 21:30:48",449,270,230,40,0,269,1,494,224,168,101
30,OLT,"ŞCOALA GENERALĂ CU CLASELE I-VIII BALDOVINEŞTI",122,BALDOVINEŞTI,125677,1,PART,PRCNCT,PRSD,PRSD_SV,"2025-05-18 21:31:19",480,316,243,48,25,307,9,528,212,162,145
30,OLT,"ŞCOALA GENERALĂ CU CLASELE I-IV GUBANDRU",123,BALDOVINEŞTI,125677,1,PART,PRCNCT,PRSD,PRSD_SV,"2025-05-18 21:20:48",94,78,48,27,3,77,1,103,25,39,38
30,OLT,GRĂDINIŢĂ,124,BALDOVINEŞTI,125677,2,PART,PRCNCT,PRSD,PRSD_SV,"2025-05-18 23:28:40",274,167,125,28,14,161,6,301,134,66,95
30,OLT,"CĂMINUL CULTURAL BĂBICIU",125,BĂBICIU,125659,1,PART,PRCNCT,PRSD,PRSD_SV,"2025-05-18 21:46:47",669,410,335,47,28,404,6,736,326,218,186
30,OLT,"CĂMINUL CULTURAL BĂBICIU",126,BĂBICIU,125659,1,PART,PRCNCT,PRSD,PRSD_SV,"2025-05-18 21:50:55",990,646,490,127,29,639,7,1089,443,296,343
30,OLT,"ŞCOALA GIMNAZIALĂ ” ION I.GRAURE ” BĂLTENI",127,BĂLTENI,130286,1,PART,PRCNCT,PRSD,PRSD_SV,"2025-05-18 21:59:27",1322,743,655,88,0,735,8,1454,711,535,200
30,OLT,"ŞCOALA GENERALĂ CLASELE I-VIII",128,BĂRĂŞTI,125757,1,PART,PRCNCT,PRSD,PRSD_SV,"2025-05-18 22:07:20",618,618,363,239,16,612,6,731,113,405,207
30,OLT,"ŞCOALA GENERALĂ CLASELE I-IV.",129,BĂRĂŞTI,125757,1,PART,PRCNCT,PRSD,PRSD_SV,"2025-05-18 21:52:24",343,337,191,137,9,332,5,427,90,189,143
30,OLT,"SEDIU FOSTĂ BRIGADĂ AGRICOLĂ",130,BĂRĂŞTI,125757,1,PART,PRCNCT,PRSD,PRSD_SV,"2025-05-18 22:13:53",48,72,17,55,0,71,1,103,31,52,19
30,OLT,"ȘCOALA GIMNAZIALĂ BÎRZA",131,BÂRZA,125846,1,PART,PRCNCT,PRSD,PRSD_SV,"2025-05-18 21:37:53",865,426,386,40,0,419,7,952,526,261,158
30,OLT,"SCOALA GIMNAZIALĂ BRANEȚ",132,BÂRZA,125846,1,PART,PRCNCT,PRSD,PRSD_SV,"2025-05-18 21:58:27",1221,617,543,74,0,609,8,1343,726,382,227
30,OLT,"CAMINUL CULTURAL BOBICESTI",133,BOBICEŞTI,125873,1,PART,PRCNCT,PRSD,PRSD_SV,"2025-05-18 21:42:30",854,485,407,78,0,482,3,943,458,287,195
30,OLT,"SCOALA GENERALA BECHET",134,BOBICEŞTI,125873,1,PART,PRCNCT,PRSD,PRSD_SV,"2025-05-18 21:35:57",290,174,141,33,0,173,1,319,145,112,61
30,OLT,"SCOALA GENERALA CHINTESTI",135,BOBICEŞTI,125873,1,PART,PRCNCT,PRSD,PRSD_SV,"2025-05-18 21:22:56",218,138,112,26,0,137,1,240,102,87,50
30,OLT,"CĂMINUL CULTURAL",136,BOBICEŞTI,125873,1,PART,PRCNCT,PRSD,PRSD_SV,"2025-05-18 22:22:24",1265,722,633,88,1,712,10,1400,678,373,339
30,OLT,"ŞCOALA GENERALĂ CU CLASELE I-VIII BRASTAVĂŢU",137,BRASTAVĂŢU,125962,1,PART,PRCNCT,PRSD,PRSD_SV,"2025-05-18 21:38:15",1192,544,468,71,5,538,6,1312,768,346,192
30,OLT,"ŞCOALA GENERALĂ CU CLASELE I-VIII BRASTAVĂŢU",138,BRASTAVĂŢU,125962,1,PART,PRCNCT,PRSD,PRSD_SV,"2025-05-18 21:31:15",1306,645,544,92,9,640,5,1437,792,387,253
30,OLT,"ŞCOALA GENERALĂ CRUŞOVU",139,BRASTAVĂŢU,125962,1,PART,PRCNCT,PRSD,PRSD_SV,"2025-05-18 21:41:31",830,417,358,58,1,414,3,914,497,274,140
30,OLT,"ȘCOALA GIMNAZIALĂ ”VOIEVOD BRÂNCOVEANU”",140,BRÂNCOVENI,126022,1,PART,PRCNCT,PRSD,PRSD_SV,"2025-05-18 21:49:25",824,464,398,66,0,454,10,906,442,282,172
30,OLT,"ŞCOALA GIMNAZIALĂ MATEI BASARAB",141,BRÂNCOVENI,126022,1,PART,PRCNCT,PRSD,PRSD_SV,"2025-05-18 22:06:01",842,483,373,110,0,478,5,926,443,309,169
30,OLT,"GRĂDINIŢA CU PROGRAM NORMAL DOMNIŢA BĂLAŞA",142,BRÂNCOVENI,126022,1,PART,PRCNCT,PRSD,PRSD_SV,"2025-05-18 21:28:39",399,245,193,52,0,245,0,439,194,146,99
30,OLT,"ŞCOALA CU CLASELE I-IV BREBENI",143,BREBENI,125999,1,PART,PRCNCT,PRSD,PRSD_SV,"2025-05-18 21:57:49",915,608,462,136,10,604,4,1005,397,403,201
30,OLT,"ŞCOALA GIMNAZIALĂ BREBENI",144,BREBENI,125999,1,PART,PRCNCT,PRSD,PRSD_SV,"2025-05-18 22:03:44",1295,852,666,170,16,842,10,1426,574,537,305
30,OLT,"CĂMINUL CULTURAL",145,BUCINIŞU,126077,2,PART,PRCNCT,PRSD,PRSD_SV,"2025-05-19 01:08:36",1539,820,665,148,7,817,3,1693,873,489,328
30,OLT,"SCOALA GIMNAZIALA CALUI",146,CĂLUI,130295,1,PART,PRCNCT,PRSD,PRSD_SV,"2025-05-18 21:20:32",715,379,325,54,0,370,9,787,408,210,160
30,OLT,"CLĂDIRE ADMINISTRATIV SOCIALĂ 1",147,CĂLUI,130295,1,PART,PRCNCT,PRSD,PRSD_SV,"2025-05-18 21:30:01",444,188,144,44,0,187,1,490,302,141,46
30,OLT,"SCOALA GIMNAZIALĂ CÎRLOGANI",148,CÂRLOGANI,126166,1,PART,PRCNCT,PRSD,PRSD_SV,"2025-05-18 22:15:16",1111,555,456,99,0,547,8,1222,667,272,275
30,OLT,"SCOALA GIMNAZIALĂ CEPARI",149,CÂRLOGANI,126166,1,PART,PRCNCT,PRSD,PRSD_SV,"2025-05-18 21:54:16",662,395,311,84,0,389,6,728,333,200,189
30,OLT,"CĂMIN CULTURAL CEZIENI",150,CEZIENI,126102,1,PART,PRCNCT,PRSD,PRSD_SV,"2025-05-18 22:01:36",896,580,453,127,0,576,4,986,406,296,280
30,OLT,"CAMIN CULTURAL",151,CEZIENI,126102,1,PART,PRCNCT,PRSD,PRSD_SV,"2025-05-18 21:43:43",169,102,78,23,1,102,0,186,84,45,57
30,OLT,"CENTRUL SOCIAL",152,CEZIENI,126102,1,PART,PRCNCT,PRSD,PRSD_SV,"2025-05-18 21:51:51",233,166,118,48,0,164,2,256,90,105,59
30,OLT,"LICEUL TEHNOLOGIC ION POPESCU CILIENI",153,CILIENI,126148,1,PART,PRCNCT,PRSD,PRSD_SV,"2025-05-18 21:57:51",1232,580,512,68,0,572,8,1355,775,342,230
30,OLT,"LICEUL TEHNOLOGIC ION POPESCU CILIENI",154,CILIENI,126148,1,PART,PRCNCT,PRSD,PRSD_SV,"2025-05-18 21:51:42",1269,599,536,60,3,595,4,1396,797,360,235
30,OLT,"CAMINUL CULTURAL ILIE MARTIN",155,COLONEŞTI,126228,1,PART,PRCNCT,PRSD,PRSD_SV,"2025-05-18 21:32:36",515,418,250,124,44,417,1,567,149,290,127
30,OLT,"GRADINITA CU PROGRAM NORMAL BATARENI",156,COLONEŞTI,126228,1,PART,PRCNCT,PRSD,PRSD_SV,"2025-05-18 21:29:48",141,165,72,76,17,163,2,205,40,160,3
30,OLT,"SCOALA GENERALA MARIA TUDORACHE",157,COLONEŞTI,126228,1,PART,PRCNCT,PRSD,PRSD_SV,"2025-05-18 21:27:40",323,298,158,95,45,298,0,355,57,240,58
30,OLT,"GRADINITA CU PROGRAM NORMAL VLAICI",158,COLONEŞTI,126228,1,PART,PRCNCT,PRSD,PRSD_SV,"2025-05-18 21:31:23",251,252,127,98,27,251,1,326,74,198,53
30,OLT,"ŞCOALA GIMNAZIALĂ CORBU",159,CORBU,126326,1,PART,PRCNCT,PRSD,PRSD_SV,"2025-05-18 22:07:52",839,388,318,68,2,387,1,923,535,259,128
30,OLT,"ŞCOALA GIMNAZIALĂ BUZEŞTI",160,CORBU,126326,1,PART,PRCNCT,PRSD,PRSD_SV,"2025-05-18 21:42:23",466,321,255,66,0,314,7,513,192,202,112
30,OLT,"GRĂDINIŢA MILCOVENI",161,CORBU,126326,1,PART,PRCNCT,PRSD,PRSD_SV,"2025-05-18 21:34:26",340,228,180,45,3,226,2,374,146,156,70
30,OLT,"ŞCOALA GIMNAZIALĂ COTEANA",162,COTEANA,126380,1,PART,PRCNCT,PRSD,PRSD_SV,"2025-05-18 22:08:13",873,568,446,122,0,561,7,960,392,357,204
30,OLT,"ŞCOALA GIMNAZIALĂ COTEANA",163,COTEANA,126380,1,PART,PRCNCT,PRSD,PRSD_SV,"2025-05-18 21:54:54",801,570,440,130,0,561,9,883,313,340,221
30,OLT,"LICEUL TEHNOLOGIC CRÎMPOIA",164,CRÂMPOIA,126406,1,PART,PRCNCT,PRSD,PRSD_SV,"2025-05-18 21:41:57",1052,557,513,43,1,545,12,1157,600,347,198
30,OLT,"LICEUL TEHNOLOGIC CRÎMPOIA",165,CRÂMPOIA,126406,1,PART,PRCNCT,PRSD,PRSD_SV,"2025-05-18 22:20:21",1102,580,476,103,1,576,4,1213,633,380,196
30,OLT,"SCOALA CU CLASELE I-IV BUTA",166,CRÂMPOIA,126406,1,PART,PRCNCT,PRSD,PRSD_SV,"2025-05-18 21:39:55",618,369,311,58,0,361,8,681,312,249,112
30,OLT,"PRIMĂRIE,STR.PRIMĂRIEI,NR.8",167,CUNGREA,126503,1,PART,PRCNCT,PRSD,PRSD_SV,"2025-05-18 22:00:25",640,415,281,134,0,414,1,654,239,230,184
30,OLT,"ŞCOALA GIMNAZIALĂ CEPEŞTI",168,CUNGREA,126503,1,PART,PRCNCT,PRSD,PRSD_SV,"2025-05-18 21:52:03",615,441,352,89,0,438,3,677,236,255,183
30,OLT,"ŞCOALA GIMNAZIALĂ SPĂTARU",169,CUNGREA,126503,1,PART,PRCNCT,PRSD,PRSD_SV,"2025-05-18 21:41:23",200,208,107,101,0,203,5,270,62,107,96
30,OLT,"CĂMINUL CULTURAL ” DAMIAN STĂNOIU”",170,CURTIŞOARA,126433,1,PART,PRCNCT,PRSD,PRSD_SV,"2025-05-18 21:28:15",1226,727,585,130,12,722,5,1349,622,440,282
30,OLT,"ŞCOALA CU CLASELE I-VIII DOBROTINET",171,CURTIŞOARA,126433,1,PART,PRCNCT,PRSD,PRSD_SV,"2025-05-18 21:56:24",1408,879,753,116,10,868,11,1549,670,559,309
30,OLT,"ŞCOALA CU CLASELE I-IV PROASPEŢI",172,CURTIŞOARA,126433,1,PART,PRCNCT,PRSD,PRSD_SV,"2025-05-18 21:26:03",1040,623,518,92,13,617,6,1145,522,342,275
30,OLT,"CENTRUL SOCIAL DĂNEASA",173,DĂNEASA,126585,1,PART,PRCNCT,PRSD,PRSD_SV,"2025-05-18 22:17:55",1100,546,465,79,2,539,7,1211,665,357,182
30,OLT,"SCOALA BERINDEI",174,DĂNEASA,126585,1,PART,PRCNCT,PRSD,PRSD_SV,"2025-05-18 21:40:36",389,213,154,59,0,213,0,428,215,139,74
30,OLT,"GRADINITA CIOFLANU",175,DĂNEASA,126585,1,PART,PRCNCT,PRSD,PRSD_SV,"2025-05-18 21:23:47",493,238,195,42,1,237,1,542,304,167,70
30,OLT,"CAMINUL CULTURAL",176,DĂNEASA,126585,1,PART,PRCNCT,PRSD,PRSD_SV,"2025-05-18 21:49:43",424,245,196,49,0,245,0,466,221,179,66
30,OLT,"SCOALA ZANOAGA",177,DĂNEASA,126585,1,PART,PRCNCT,PRSD,PRSD_SV,"2025-05-18 21:46:27",318,175,152,23,0,172,3,350,175,123,49
30,OLT,"CĂMINUL CULTURAL DEVESELU-BIBLIOTECĂ",178,DEVESELU,126647,1,PART,PRCNCT,PRSD,PRSD_SV,"2025-05-18 22:12:35",1338,741,660,72,9,730,11,1472,731,461,269
30,OLT,"CASA ARMATEI",179,DEVESELU,126647,1,PART,PRCNCT,PRSD,PRSD_SV,"2025-05-18 21:33:36",207,119,88,31,0,118,1,228,109,74,44
30,OLT,"CĂMINUL CULTURAL",180,DEVESELU,126647,1,PART,PRCNCT,PRSD,PRSD_SV,"2025-05-18 21:53:49",1001,593,515,75,3,588,5,1101,508,406,182
30,OLT,"CĂMINUL CULTURAL CURTIŞOARA",181,DOBREŢU,126674,1,PART,PRCNCT,PRSD,PRSD_SV,"2025-05-18 21:43:15",589,295,236,58,1,294,1,648,353,197,97
30,OLT,"CĂMINUL CULTURAL HOREZU",182,DOBREŢU,126674,1,PART,PRCNCT,PRSD,PRSD_SV,"2025-05-18 22:08:42",356,238,178,60,0,237,1,393,155,154,83
30,OLT,"SCOALA GIMNAZIALA DOBROSLOVENI",183,DOBROSLOVENI,126718,1,PART,PRCNCT,PRSD,PRSD_SV,"2025-05-18 21:27:46",1087,582,536,46,0,577,5,1195,613,373,204
30,OLT,"GRADINITA CU PROGRAM NORMAL FRASINETU",184,DOBROSLOVENI,126718,1,PART,PRCNCT,PRSD,PRSD_SV,"2025-05-18 21:27:26",371,261,197,64,0,260,1,408,147,178,82
30,OLT,"GRADINITA CU PROGRAM NORMAL POTOPINU",185,DOBROSLOVENI,126718,1,PART,PRCNCT,PRSD,PRSD_SV,"2025-05-18 21:15:19",544,306,259,47,0,306,0,598,292,217,89
30,OLT,"SCOALA CU CLASELE I-VIII RESCA",186,DOBROSLOVENI,126718,1,PART,PRCNCT,PRSD,PRSD_SV,"2025-05-18 21:16:36",951,431,380,51,0,424,7,1046,615,283,141
30,OLT,"ŞCOALA GIMNAZIALĂ CU CLASELE I-VIII DOBROTEASA",187,DOBROTEASA,126772,1,PART,PRCNCT,PRSD,PRSD_SV,"2025-05-18 22:10:56",836,632,437,194,1,621,11,922,290,376,245
30,OLT,"GRADINITA CU PROGRAM NORMAL CÂMPU MARE",188,DOBROTEASA,126772,2,PART,PRCNCT,PRSD,PRSD_SV,"2025-05-19 01:42:53",389,250,184,63,3,247,3,428,178,137,110
30,OLT,"SCOALA DOBRUN",189,DOBRUN,126825,1,PART,PRCNCT,PRSD,PRSD_SV,"2025-05-18 21:35:53",547,363,274,72,17,360,3,602,239,193,167
30,OLT,"ȘCOALA ROȘIENII MARI",190,DOBRUN,126825,1,PART,PRCNCT,PRSD,PRSD_SV,"2025-05-18 21:27:53",582,296,269,27,0,296,0,640,344,172,124
30,OLT,"ŞCOALA GENERALĂ CU CLASELE I-VIII DRĂGHICENI",191,DRĂGHICENI,125490,1,PART,PRCNCT,PRSD,PRSD_SV,"2025-05-18 22:17:12",1506,935,758,124,53,928,7,1657,722,527,401
30,OLT,"ŞCOALA GIMNAZIALĂ FĂGEŢELU",192,FĂGEŢELU,126905,1,PART,PRCNCT,PRSD,PRSD_SV,"2025-05-18 22:07:21",412,326,169,149,8,319,7,453,127,174,145
30,OLT,"ŞCOALA CU CLASELE I-VIII CHILIA",193,FĂGEŢELU,126905,1,PART,PRCNCT,PRSD,PRSD_SV,"2025-05-18 21:37:53",240,281,113,165,3,279,2,314,33,123,156
30,OLT,"ŞCOALA CU CLASELE I-VIII FĂLCOIU",194,FĂLCOIU,126978,1,PART,PRCNCT,PRSD,PRSD_SV,"2025-05-18 21:35:20",950,446,344,50,52,444,2,1045,599,287,157
30,OLT,"ŞCOALA CU CLASELE I-VIII FĂLCOIU",195,FĂLCOIU,126978,1,PART,PRCNCT,PRSD,PRSD_SV,"2025-05-18 21:35:27",1040,438,330,82,26,431,7,1144,706,287,144
30,OLT,"ŞCOALA CU CLASELE I-VIII CIOROIU",196,FĂLCOIU,126978,1,PART,PRCNCT,PRSD,PRSD_SV,"2025-05-18 21:33:54",979,523,407,86,30,519,4,1077,554,360,159
30,OLT,"GRADINITA FARCASELE",197,FĂRCAŞELE,127019,1,PART,PRCNCT,PRSD,PRSD_SV,"2025-05-18 21:53:35",933,426,394,32,0,422,4,1027,601,290,132
30,OLT,"GRADINITA FARCASU DE JOS",198,FĂRCAŞELE,127019,1,PART,PRCNCT,PRSD,PRSD_SV,"2025-05-18 21:55:25",1395,690,605,85,0,683,7,1537,847,518,165
30,OLT,"SCOALA GIMNAZIALA FARCASELE",199,FĂRCAŞELE,127019,1,PART,PRCNCT,PRSD,PRSD_SV,"2025-05-18 21:50:21",690,339,302,37,0,334,5,760,421,237,97
30,OLT,"SCOALA GIMNAZIALA HOTARANI",200,FĂRCAŞELE,127019,1,PART,PRCNCT,PRSD,PRSD_SV,"2025-05-18 21:40:26",670,329,298,31,0,328,1,736,407,237,91
30,OLT,"ȘCOALA GENERALĂ GĂNEASA",201,GĂNEASA,127064,1,PART,PRCNCT,PRSD,PRSD_SV,"2025-05-18 22:12:39",1473,897,684,189,24,886,11,1620,723,573,313
30,OLT,"ȘCOALA GIMNAZIALĂ DRANOVĂȚU",202,GĂNEASA,127064,2,PART,PRCNCT,PRSD,PRSD_SV,"2025-05-18 22:55:50",854,588,432,135,21,577,11,939,351,329,248
30,OLT,"ŞCOALA PRIMARĂ IZVORU",203,GĂNEASA,127064,1,PART,PRCNCT,PRSD,PRSD_SV,"2025-05-18 21:26:56",578,414,329,72,13,411,3,636,222,298,113
30,OLT,"GRĂDINIŢA CU PROGRAM NORMAL GĂVĂNEŞTI",204,GĂVĂNEŞTI,130302,1,PART,PRCNCT,PRSD,PRSD_SV,"2025-05-18 21:39:23",548,295,237,50,8,292,3,603,308,158,134
30,OLT,"SCOALA CU CLASELE I-VIII BALEASA",205,GĂVĂNEŞTI,130302,1,PART,PRCNCT,PRSD,PRSD_SV,"2025-05-18 21:33:01",646,389,316,57,16,389,0,711,322,240,149
30,OLT,"SCOALA CU CLS.I-IV BROSTENI",206,GĂVĂNEŞTI,130302,1,PART,PRCNCT,PRSD,PRSD_SV,"2025-05-18 21:54:02",302,194,154,33,7,192,2,332,138,126,66
30,OLT,"GRĂDINIŢA CU PROGRAM NORMAL GÎRCOV",207,GÂRCOV,125588,1,PART,PRCNCT,PRSD,PRSD_SV,"2025-05-18 22:17:56",1146,549,505,44,0,546,3,1261,712,307,239
30,OLT,"GRĂDINIȚA CU PROGRAM NORMAL URSA",208,GÂRCOV,125588,1,PART,PRCNCT,PRSD,PRSD_SV,"2025-05-18 21:44:01",637,273,252,21,0,273,0,701,428,161,112
30,OLT,"ŞCOALA GIMNAZIALĂ GHIMPEŢENI",209,GHIMPEŢENI,130311,1,PART,PRCNCT,PRSD,PRSD_SV,"2025-05-18 21:45:11",744,456,366,66,24,455,1,818,362,261,194
30,OLT,"GRĂDINIŢA CU PROGRAM NORMAL",210,GHIMPEŢENI,130311,1,PART,PRCNCT,PRSD,PRSD_SV,"2025-05-18 21:55:29",362,247,206,31,10,247,0,399,152,163,84
30,OLT,"ŞCOALA CU CLASELE I-VIII GIUVĂRĂŞTI",211,GIUVĂRĂŞTI,127126,1,PART,PRCNCT,PRSD,PRSD_SV,"2025-05-18 21:43:02",877,509,410,79,20,502,7,965,456,214,288
30,OLT,"ŞCOALA CU CLASELE I-VIII GIUVĂRĂŞTI",212,GIUVĂRĂŞTI,127126,1,PART,PRCNCT,PRSD,PRSD_SV,"2025-05-18 21:52:40",826,493,428,35,30,488,5,911,418,185,303
30,OLT,"ŞCOALA GENERALĂ GOSTAVĂŢU",213,GOSTAVĂŢU,127144,1,PART,PRCNCT,PRSD,PRSD_SV,"2025-05-18 21:46:41",1212,618,493,123,2,612,6,1333,715,368,244
30,OLT,"CĂMINUL CULTURAL SLĂVENI",214,GOSTAVĂŢU,127144,1,PART,PRCNCT,PRSD,PRSD_SV,"2025-05-18 21:57:14",1017,564,485,78,1,557,7,1119,555,360,197
30,OLT,"ŞCOALA GIMNAZIALĂ GRĂDINARI",215,GRĂDINARI,127171,1,PART,PRCNCT,PRSD,PRSD_SV,"2025-05-18 21:47:32",764,431,321,104,6,428,3,840,409,267,161
30,OLT,"ŞCOALA PRIMARĂ PETCULEŞTI",216,GRĂDINARI,127171,1,PART,PRCNCT,PRSD,PRSD_SV,"2025-05-18 21:21:55",954,301,258,32,11,300,1,1049,748,252,48
30,OLT,"ŞCOALA GENERALĂ I-IV SATU NOU",217,GRĂDINARI,127171,1,PART,PRCNCT,PRSD,PRSD_SV,"2025-05-18 21:17:42",219,165,98,63,4,162,3,241,76,105,57
30,OLT,"CENTRU SOCIAL",218,GRĂDINILE,130320,1,PART,PRCNCT,PRSD,PRSD_SV,"2025-05-18 21:55:47",1166,688,540,110,38,683,5,1284,596,310,373
30,OLT,"GRĂDINIȚA CU PROGRAM NORMAL",219,GROJDIBODU,127224,1,PART,PRCNCT,PRSD,PRSD_SV,"2025-05-18 22:02:05",772,393,353,40,0,385,8,849,456,218,167
30,OLT,"GRĂDINIȚA CU PROGRAM NORMAL",220,GROJDIBODU,127224,1,PART,PRCNCT,PRSD,PRSD_SV,"2025-05-18 21:44:23",783,393,325,63,5,387,6,861,468,250,137
30,OLT,"GRĂDINIȚA CU PROGRAM NORMAL HOTARU",221,GROJDIBODU,127224,1,PART,PRCNCT,PRSD,PRSD_SV,"2025-05-18 21:43:23",524,257,212,43,2,256,1,576,319,157,99
30,OLT,"CĂMIN CULTURAL",222,"GURA PADINII",130339,1,PART,PRCNCT,PRSD,PRSD_SV,"2025-05-18 22:04:31",1340,698,624,53,21,692,6,1475,777,376,316
30,OLT,"ȘCOALA GIMNAZIALĂ ”ADA UMBRA”",223,IANCA,127251,1,PART,PRCNCT,PRSD,PRSD_SV,"2025-05-18 22:06:37",991,451,406,36,9,445,6,1093,642,284,161
30,OLT,"ȘCOALA GIMNAZIALĂ ”ADA UMBRA”",224,IANCA,127251,1,PART,PRCNCT,PRSD,PRSD_SV,"2025-05-18 21:39:15",934,508,422,77,9,501,7,1029,521,283,218
30,OLT,"SCOALA GIMNAZIALA GEORGE VISAN POTELU",225,IANCA,127251,1,PART,PRCNCT,PRSD,PRSD_SV,"2025-05-18 22:13:35",926,523,420,85,18,518,5,1019,496,323,195
30,OLT,"SCOALA GENERALA NR 1 IANCU JIANU",226,"IANCU JIANU",127288,1,PART,PRCNCT,PRSD,PRSD_SV,"2025-05-18 21:50:52",1409,546,496,49,1,540,6,1553,1007,322,218
30,OLT,"LICEUL IANCU JIANU",227,"IANCU JIANU",127288,1,PART,PRCNCT,PRSD,PRSD_SV,"2025-05-18 22:20:23",1254,605,516,89,0,600,5,1381,776,337,263
30,OLT,"ŞCOALA GIMNAZIALĂ DOBRICENI",228,"IANCU JIANU",127288,1,PART,PRCNCT,PRSD,PRSD_SV,"2025-05-18 22:00:31",777,337,283,54,0,334,3,853,516,223,111
30,OLT,"SCOALA GIMNAZIALA ICOANA",229,ICOANA,127322,1,PART,PRCNCT,PRSD,PRSD_SV,"2025-05-18 21:47:21",469,317,225,90,2,314,3,516,199,217,97
30,OLT,"CAMINUL CULTURAL FLORU",230,ICOANA,127322,1,PART,PRCNCT,PRSD,PRSD_SV,"2025-05-18 21:53:01",338,218,148,70,0,216,2,371,153,126,90
30,OLT,"SCOALA GIMNAZIALA URSOAIA",231,ICOANA,127322,1,PART,PRCNCT,PRSD,PRSD_SV,"2025-05-18 21:47:17",497,280,226,54,0,280,0,546,266,186,94
30,OLT,"GRĂDINIȚA CU PROGRAM NORMAL",232,IPOTEŞTI,130348,1,PART,PRCNCT,PRSD,PRSD_SV,"2025-05-18 21:47:53",1215,562,455,107,0,558,4,1337,775,430,128
30,OLT,"CLĂDIRE MUZEU",233,IZBICENI,127368,1,PART,PRCNCT,PRSD,PRSD_SV,"2025-05-18 22:27:24",891,471,411,57,3,469,2,970,499,247,222
30,OLT,"GRĂDINIŢA CU PROGRAM NORMAL IZBICENI",234,IZBICENI,127368,1,PART,PRCNCT,PRSD,PRSD_SV,"2025-05-18 22:16:09",1447,761,693,64,4,759,2,1592,831,431,328
30,OLT,"ŞCOALA NOUA",235,IZBICENI,127368,1,PART,PRCNCT,PRSD,PRSD_SV,"2025-05-18 22:35:07",1309,692,621,62,9,687,5,1440,748,312,375
30,OLT,"LICEUL TEHNOLOGIC IZVOARELE",236,IZVOARELE,127386,1,PART,PRCNCT,PRSD,PRSD_SV,"2025-05-18 21:53:40",846,412,346,66,0,410,2,931,519,314,96
30,OLT,"SCOALA GENERALA CU CLASELE I-VIII ALIMANESTI",237,IZVOARELE,127386,1,PART,PRCNCT,PRSD,PRSD_SV,"2025-05-18 22:06:09",1814,811,734,77,0,804,7,1997,1186,595,209
30,OLT,"CAMIN CULTURAL LELEASCA",238,LELEASCA,127411,1,PART,PRCNCT,PRSD,PRSD_SV,"2025-05-18 21:40:51",395,237,161,76,0,235,2,435,198,132,103
30,OLT,"SCOALA GENERALA TONESTI",239,LELEASCA,127411,1,PART,PRCNCT,PRSD,PRSD_SV,"2025-05-18 21:34:58",253,204,106,98,0,203,1,278,74,107,96
30,OLT,"CAMINUL CULTURAL URSI",240,LELEASCA,127411,1,PART,PRCNCT,PRSD,PRSD_SV,"2025-05-18 22:30:37",346,250,147,102,1,245,5,381,131,107,138
30,OLT,"ŞCOALA PRIMARĂ VIIŞOARA",241,MĂRUNŢEI,127493,1,PART,PRCNCT,PRSD,PRSD_SV,"2025-05-18 21:24:41",796,431,365,66,0,429,2,876,445,275,154
30,OLT,"ŞCOALA CU CLASELE I-VIII MĂRUNŢEI",242,MĂRUNŢEI,127493,1,PART,PRCNCT,PRSD,PRSD_SV,"2025-05-18 21:27:00",1131,578,498,80,0,577,1,1244,666,355,222
30,OLT,"ŞCOALA CU CLASELE I-VIII BĂLĂNEŞTI",243,MĂRUNŢEI,127493,1,PART,PRCNCT,PRSD,PRSD_SV,"2025-05-18 21:38:15",1097,528,455,73,0,519,9,1207,679,393,126
30,OLT,"ŞCOALA PRIMARĂ MALU-ROŞU",244,MĂRUNŢEI,127493,1,PART,PRCNCT,PRSD,PRSD_SV,"2025-05-18 21:26:17",118,95,55,40,0,95,0,130,35,78,17
30,OLT,"ŞCOALA MIHĂEŞTI",245,MIHĂEŞTI,127536,1,PART,PRCNCT,PRSD,PRSD_SV,"2025-05-18 22:16:53",607,356,273,83,0,347,9,669,313,214,133
30,OLT,"ŞCOALA BUSCA",246,MIHĂEŞTI,127536,1,PART,PRCNCT,PRSD,PRSD_SV,"2025-05-18 21:52:06",442,307,240,67,0,305,2,486,179,213,92
30,OLT,"CĂMINUL CULTURAL ULMI",247,MILCOV,127563,1,PART,PRCNCT,PRSD,PRSD_SV,"2025-05-18 21:53:11",544,331,266,65,0,331,0,598,267,241,90
30,OLT,"ŞCOALA GENERALĂ CU CLASELE I-VIII",248,MILCOV,127563,2,PART,PRCNCT,PRSD,PRSD_SV,"2025-05-18 23:00:50",554,361,272,89,0,358,3,608,247,214,144
30,OLT,"ŞCOALA GENERALĂ",249,MILCOV,127563,1,PART,PRCNCT,PRSD,PRSD_SV,"2025-05-18 21:24:57",211,165,126,39,0,161,4,233,68,65,96
30,OLT,"ȘCOALA PRIMARĂ",250,MORUNGLAV,127625,1,PART,PRCNCT,PRSD,PRSD_SV,"2025-05-18 21:59:53",1112,513,437,76,0,512,1,1223,710,269,243
30,OLT,"SCOALA GENERALA BARASTI",251,MORUNGLAV,127625,1,PART,PRCNCT,PRSD,PRSD_SV,"2025-05-18 21:39:48",270,166,130,36,0,165,1,297,131,87,78
30,OLT,"SCOALA GENERALA MORUNESTI",252,MORUNGLAV,127625,1,PART,PRCNCT,PRSD,PRSD_SV,"2025-05-18 21:40:32",455,213,173,40,0,211,2,501,288,137,74
30,OLT,"ŞCOALA MOVILENI",253,MOVILENI,127689,1,PART,PRCNCT,PRSD,PRSD_SV,"2025-05-18 21:54:21",986,548,454,65,29,536,12,1085,537,330,206
30,OLT,"SCOALA GENERALA MOVILENI ( GRADINITA)",254,MOVILENI,127689,1,PART,PRCNCT,PRSD,PRSD_SV,"2025-05-18 21:32:04",634,354,251,55,48,350,4,697,343,183,167
30,OLT,"ŞCOALA BACEA",255,MOVILENI,127689,1,PART,PRCNCT,PRSD,PRSD_SV,"2025-05-18 21:33:02",1002,579,483,60,36,575,4,1102,523,359,216
30,OLT,"SCOALA GIMNAZIALA",256,"NICOLAE TITULESCU",127714,1,PART,PRCNCT,PRSD,PRSD_SV,"2025-05-18 22:24:53",912,590,418,106,66,588,2,1003,413,352,236
30,OLT,"ŞCOALA CU CLASELE I-IV OBÎRŞIA",257,OBÂRŞIA,127750,1,PART,PRCNCT,PRSD,PRSD_SV,"2025-05-18 21:39:07",543,300,252,46,2,298,2,600,300,180,118
30,OLT,"ŞCOALA CU CLASELE I-IV CÎMPU PĂRULUI",258,OBÂRŞIA,127750,1,PART,PRCNCT,PRSD,PRSD_SV,"2025-05-18 21:31:36",238,132,109,23,0,129,3,261,129,80,49
30,OLT,"ŞCOALA CU CLASELE I-IV COTENI",259,OBÂRŞIA,127750,1,PART,PRCNCT,PRSD,PRSD_SV,"2025-05-18 21:20:39",162,98,72,26,0,96,2,178,80,58,38
30,OLT,"SCOALA CU CLASELE I-VIII OBARSIA NOUA",260,OBÂRŞIA,127750,1,PART,PRCNCT,PRSD,PRSD_SV,"2025-05-18 21:53:46",870,442,366,76,0,438,4,957,515,280,158
30,OLT,"ŞCOALA CU CLASELE I-IV TABONU",261,OBÂRŞIA,127750,1,PART,PRCNCT,PRSD,PRSD_SV,"2025-05-18 21:23:53",102,77,55,22,0,75,2,112,35,32,43
30,OLT,"ŞCOALA GIMNAZIALĂ OBOGA",262,OBOGA,127812,1,PART,PRCNCT,PRSD,PRSD_SV,"2025-05-18 22:49:10",980,649,526,86,37,631,18,1080,431,304,327
30,OLT,"ŞCOALA OBOGA DE JOS",263,OBOGA,127812,1,PART,PRCNCT,PRSD,PRSD_SV,"2025-05-18 21:49:06",402,286,218,50,18,285,1,442,156,99,186
30,OLT,"CĂMINUL CULTURAL OPORELU",264,OPORELU,127858,1,PART,PRCNCT,PRSD,PRSD_SV,"2025-05-18 21:59:06",842,516,377,138,1,510,6,931,415,315,195
30,OLT,"ŞCOALA GIMNAZIALĂ OPTAŞI MĂGURA",265,OPTAŞI-MĂGURA,127901,1,PART,PRCNCT,PRSD,PRSD_SV,"2025-05-18 21:25:21",916,593,438,155,0,584,9,1008,415,279,305
30,OLT,"CĂMINUL CULTURAL",266,ORLEA,127938,1,PART,PRCNCT,PRSD,PRSD_SV,"2025-05-18 22:07:58",1184,572,507,62,3,565,7,1302,730,304,261
30,OLT,"CĂMINUL CULTURAL",267,ORLEA,127938,1,PART,PRCNCT,PRSD,PRSD_SV,"2025-05-18 21:49:18",517,275,246,29,0,273,2,569,294,128,145
30,OLT,"ŞCOALA GIMNAZIALĂ OSICA DE JOS",268,"OSICA DE JOS",130357,1,PART,PRCNCT,PRSD,PRSD_SV,"2025-05-18 21:44:52",1201,790,623,141,26,788,2,1321,531,453,335
30,OLT,"CENTRU DE PROMOVARE A SĂNĂTĂŢII",269,"OSICA DE SUS",127983,1,PART,PRCNCT,PRSD,PRSD_SV,"2025-05-18 21:55:57",458,263,201,61,1,261,2,506,243,145,116
30,OLT,"ŞCOALA GENERALĂ GRECI",270,"OSICA DE SUS",127983,1,PART,PRCNCT,PRSD,PRSD_SV,"2025-05-18 21:53:06",754,425,353,72,0,423,2,829,404,305,118
30,OLT,"SPATIUL COMERCIAL DUDE GHEORGHE",271,"OSICA DE SUS",127983,2,PART,PRCNCT,PRSD,PRSD_SV,"2025-05-19 00:15:17",940,544,439,105,0,533,11,1033,489,307,226
30,OLT,"ŞCOALA GENERALĂ NR. 2",272,"OSICA DE SUS",127983,1,PART,PRCNCT,PRSD,PRSD_SV,"2025-05-18 22:27:43",1282,743,633,110,0,736,7,1410,667,439,297
30,OLT,"ŞCOALA PRIMARĂ TOMENI",273,"OSICA DE SUS",127983,1,PART,PRCNCT,PRSD,PRSD_SV,"2025-05-18 21:31:34",367,162,141,21,0,159,3,404,242,140,19
30,OLT,"SCOALA GIMNAZIALA PIRSCOVENI",274,PÂRŞCOVENI,128178,1,PART,PRCNCT,PRSD,PRSD_SV,"2025-05-18 22:52:56",1293,725,596,117,12,720,5,1423,698,486,234
30,OLT,"SCOALA GIMNAZIALA OLARI",275,PÂRŞCOVENI,128178,1,PART,PRCNCT,PRSD,PRSD_SV,"2025-05-18 22:00:06",1101,496,430,51,15,489,7,1211,715,379,110
30,OLT,"ŞCOALA GIMNAZIALĂ",276,PERIEŢI,128052,1,PART,PRCNCT,PRSD,PRSD_SV,"2025-05-18 22:14:45",1605,851,693,158,0,842,9,1766,915,560,282
30,OLT,"ŞCOALA GIMNAZIALĂ PLEŞOIU",277,PLEŞOIU,128221,1,PART,PRCNCT,PRSD,PRSD_SV,"2025-05-18 21:43:16",1242,723,567,156,0,709,14,1366,643,439,270
30,OLT,"ŞCOALA GIMNAZIALĂ DOBA",278,PLEŞOIU,128221,1,PART,PRCNCT,PRSD,PRSD_SV,"2025-05-18 22:04:33",1097,681,545,135,1,670,11,1207,526,389,281
30,OLT,"ŞCOALA GIMNAZIALĂ",279,POBORU,128301,1,PART,PRCNCT,PRSD,PRSD_SV,"2025-05-18 21:31:00",540,406,313,93,0,404,2,594,188,216,188
30,OLT,"GRĂDINIȚA CU PROGRAM NORMAL CORNĂȚELU",280,POBORU,128301,2,PART,PRCNCT,PRSD,PRSD_SV,"2025-05-19 00:53:22",706,426,342,84,0,419,7,777,351,271,148
30,OLT,"ŞCOALA PRIMARĂ",281,POBORU,128301,1,PART,PRCNCT,PRSD,PRSD_SV,"2025-05-18 21:23:17",213,136,122,14,0,135,1,234,98,116,19
30,OLT,"ŞCOALA GENERALĂ CU CLASELE I-IV PRISEACA",282,PRISEACA,128436,1,PART,PRCNCT,PRSD,PRSD_SV,"2025-05-18 22:17:08",1296,730,577,153,0,723,7,1426,696,432,291
30,OLT,"CĂMIN CULTURAL",283,RADOMIREŞTI,128472,1,PART,PRCNCT,PRSD,PRSD_SV,"2025-05-18 22:26:25",937,459,331,128,0,456,3,1033,574,274,182
30,OLT,"ŞCOALĂ GENERALĂ NOUĂ CĂLINEŞTI",284,RADOMIREŞTI,128472,1,PART,PRCNCT,PRSD,PRSD_SV,"2025-05-18 22:20:31",540,282,219,63,0,277,5,596,314,201,76
30,OLT,"CĂMINUL CULTURAL",285,RADOMIREŞTI,128472,1,PART,PRCNCT,PRSD,PRSD_SV,"2025-05-18 21:47:08",488,274,194,80,0,273,1,537,263,174,99
30,OLT,"ŞCOALA POIANA",286,RADOMIREŞTI,128472,1,PART,PRCNCT,PRSD,PRSD_SV,"2025-05-18 21:34:07",192,155,88,67,0,155,0,211,56,97,58
30,OLT,"ȘCOALA GIMNAZIALĂ REDEA",287,REDEA,128524,1,PART,PRCNCT,PRSD,PRSD_SV,"2025-05-18 22:19:21",833,457,379,62,16,454,3,916,459,268,186
30,OLT,"ȘCOALA GIMNAZIALĂ REDEA",288,REDEA,128524,1,PART,PRCNCT,PRSD,PRSD_SV,"2025-05-18 22:24:36",748,394,316,65,13,393,1,824,430,205,188
30,OLT,"CĂMINUL CULTURAL REDIŞOARA",289,REDEA,128524,1,PART,PRCNCT,PRSD,PRSD_SV,"2025-05-18 22:19:40",371,229,174,49,6,228,1,408,179,138,90
30,OLT,"CĂMINUL CULTURAL VALEA SOARELUI",290,REDEA,128524,1,PART,PRCNCT,PRSD,PRSD_SV,"2025-05-18 21:37:57",208,144,98,39,7,143,1,229,85,66,77
30,OLT,"SEDIUL FOSTEI C.A.P.",291,ROTUNDA,128560,1,PART,PRCNCT,PRSD,PRSD_SV,"2025-05-18 21:49:52",1005,561,469,92,0,558,3,1106,545,391,167
30,OLT,"SEDIUL FOSTEI C.A.P.",292,ROTUNDA,128560,1,PART,PRCNCT,PRSD,PRSD_SV,"2025-05-18 21:51:54",1128,596,521,75,0,592,4,1241,645,400,192
30,OLT,"ŞCOALA GENERALĂ NR.1",293,RUSĂNEŞTI,128588,1,PART,PRCNCT,PRSD,PRSD_SV,"2025-05-18 21:31:14",1204,651,561,86,4,646,5,1324,673,423,223
30,OLT,"ŞCOALA GENERALĂ NR.2",294,RUSĂNEŞTI,128588,1,PART,PRCNCT,PRSD,PRSD_SV,"2025-05-18 21:28:21",1182,580,501,77,2,579,1,1300,720,370,209
30,OLT,"ŞCOALA JIENI",295,RUSĂNEŞTI,128588,1,PART,PRCNCT,PRSD,PRSD_SV,"2025-05-18 21:30:19",924,510,453,57,0,502,8,1016,506,354,148
30,OLT,"ŞCOALA GIMNAZIALĂ SÎMBUREŞTI",296,SÂMBUREŞTI,128882,1,PART,PRCNCT,PRSD,PRSD_SV,"2025-05-18 21:59:42",781,580,404,137,39,573,7,859,279,384,189
30,OLT,"ŞCOALA GIMNAZIALĂ FLORIAN DIȚULEASA VITĂNEȘTI",297,"SÂRBII - MĂGURA",130366,1,PART,PRCNCT,PRSD,PRSD_SV,"2025-05-18 21:33:31",807,505,368,99,38,499,6,888,383,309,190
30,OLT,"CENTRUL DE ZI PENTRU COPII AFLAȚI ÎN SITUAȚII DE RISC",298,"SÂRBII - MĂGURA",130366,1,PART,PRCNCT,PRSD,PRSD_SV,"2025-05-18 21:24:19",635,433,308,91,34,428,5,700,267,331,97
30,OLT,"ŞCOALA GIMNAZIALĂ SCĂRIŞOARA",299,SCĂRIŞOARA,128613,1,PART,PRCNCT,PRSD,PRSD_SV,"2025-05-18 21:36:04",900,357,298,57,2,353,4,990,633,194,159
30,OLT,"ŞCOALA GIMNAZIALĂ SCĂRIŞOARA",300,SCĂRIŞOARA,128613,1,PART,PRCNCT,PRSD,PRSD_SV,"2025-05-18 21:43:54",891,406,346,59,1,403,3,980,574,238,165
30,OLT,"GRĂDINIŢA CU PROGRAM NORMAL PLĂVICENI",301,SCĂRIŞOARA,128613,1,PART,PRCNCT,PRSD,PRSD_SV,"2025-05-18 22:02:40",511,271,224,47,0,271,0,562,291,160,111
30,OLT,"ŞCOALA GIMNAZIALĂ SCHITU",302,SCHITU,128659,1,PART,PRCNCT,PRSD,PRSD_SV,"2025-05-18 22:06:02",1043,572,481,91,0,569,3,1147,575,356,213
30,OLT,"GRĂDINIȚĂ GRECI",303,SCHITU,128659,1,PART,PRCNCT,PRSD,PRSD_SV,"2025-05-18 21:24:57",724,498,367,83,48,496,2,796,298,309,187
30,OLT,"ŞCOALA PRIMARĂ LISA",304,SCHITU,128659,1,PART,PRCNCT,PRSD,PRSD_SV,"2025-05-18 21:33:29",302,170,121,49,0,165,5,332,162,115,50
30,OLT,"GRADINITA CU PROGRAM NORMAL SEACA",305,SEACA,128864,1,PART,PRCNCT,PRSD,PRSD_SV,"2025-05-18 22:42:22",1264,664,509,153,2,657,7,1390,726,392,265
30,OLT,"GRĂDINIŢA SLĂTIOARA",306,SLĂTIOARA,125374,1,PART,PRCNCT,PRSD,PRSD_SV,"2025-05-18 22:16:34",1029,786,595,187,4,776,10,1132,346,359,417
30,OLT,"GRĂDINIŢA SLĂTIOARA",307,SLĂTIOARA,125374,1,PART,PRCNCT,PRSD,PRSD_SV,"2025-05-18 21:52:55",944,598,517,76,5,589,9,1038,440,303,286
30,OLT,"ŞCOALA GENERALĂ SALCIA",308,SLĂTIOARA,125374,2,PART,PRCNCT,PRSD,PRSD_SV,"2025-05-18 22:14:00",335,243,185,57,1,241,2,321,78,126,115
30,OLT,"SC GENERALA ALUNISU",309,SPINENI,128962,1,PART,PRCNCT,PRSD,PRSD_SV,"2025-05-18 21:12:28",307,280,153,118,9,277,3,338,58,163,114
30,OLT,"ȘCOALA GENERALĂ PROFA",310,SPINENI,128962,1,PART,PRCNCT,PRSD,PRSD_SV,"2025-05-18 21:55:51",384,296,161,117,18,294,2,424,128,195,99
30,OLT,"CAMINUL CULTURAL SPINENI",311,SPINENI,128962,1,PART,PRCNCT,PRSD,PRSD_SV,"2025-05-18 21:18:59",461,348,209,100,39,346,2,506,158,204,142
30,OLT,"CAMINUL CULTURAL VIESPESTI",312,SPRÂNCENATA,129040,1,PART,PRCNCT,PRSD,PRSD_SV,"2025-05-18 22:26:52",1005,416,318,98,0,415,1,1106,690,264,151
30,OLT,"GPN BIRSESTII DE SUS",313,SPRÂNCENATA,129040,1,PART,PRCNCT,PRSD,PRSD_SV,"2025-05-18 21:40:39",333,172,122,50,0,168,4,367,195,114,54
30,OLT,"SCOALA VECHE FRUNZARU",314,SPRÂNCENATA,129040,1,PART,PRCNCT,PRSD,PRSD_SV,"2025-05-18 22:13:41",473,237,193,44,0,235,2,520,283,154,81
30,OLT,"CĂMINUL CULTURAL STOENEŞTI",315,STOENEŞTI,129095,1,PART,PRCNCT,PRSD,PRSD_SV,"2025-05-18 21:48:52",935,510,409,97,4,501,9,1029,519,272,229
30,OLT,"ŞCOALA GIMNAZIALĂ DIDU",316,STOENEŞTI,129095,1,PART,PRCNCT,PRSD,PRSD_SV,"2025-05-18 21:40:36",826,409,344,65,0,404,5,909,500,248,156
30,OLT,"SCOALA GENERALA",317,STOICĂNEŞTI,129111,1,PART,PRCNCT,PRSD,PRSD_SV,"2025-05-18 22:04:42",1083,496,434,58,4,492,4,1191,695,281,211
30,OLT,"SCOALA GENERALA",318,STOICĂNEŞTI,129111,1,PART,PRCNCT,PRSD,PRSD_SV,"2025-05-18 21:58:13",842,416,325,90,1,413,3,926,510,224,189
30,OLT,"GRĂDINIȚA CU PROGRAM NORMAL STREJEȘTII DE JOS",319,STREJEŞTI,129139,1,PART,PRCNCT,PRSD,PRSD_SV,"2025-05-18 21:43:45",768,441,357,84,0,436,5,845,404,262,174
30,OLT,"CAMIN C ULTURAL",320,STREJEŞTI,129139,1,PART,PRCNCT,PRSD,PRSD_SV,"2025-05-18 21:52:07",397,279,215,64,0,276,3,435,156,140,136
30,OLT,"SCOALA GIMNAZIALA",321,STREJEŞTI,129139,1,PART,PRCNCT,PRSD,PRSD_SV,"2025-05-18 22:10:37",1247,690,590,100,0,680,10,1369,679,433,247
30,OLT,"CAMIN CULTURAL STUDINA",322,STUDINA,129184,1,PART,PRCNCT,PRSD,PRSD_SV,"2025-05-18 22:05:35",1212,928,620,277,31,920,8,1333,405,470,450
30,OLT,"CAMIN CULTURAL STUDINIȚA",323,STUDINA,129184,1,PART,PRCNCT,PRSD,PRSD_SV,"2025-05-18 22:04:30",907,518,420,76,22,512,6,998,480,335,177
30,OLT,"ŞCOALA DUMITRU POPOVICI",324,ŞERBĂNEŞTI,129246,2,PART,PRCNCT,PRSD,PRSD_SV,"2025-05-19 00:40:00",805,485,403,67,15,477,8,886,401,156,321
30,OLT,"ŞCOALA DUMITRU POPOVICI",325,ŞERBĂNEŞTI,129246,1,PART,PRCNCT,PRSD,PRSD_SV,"2025-05-18 21:56:54",803,472,403,61,8,465,7,883,411,320,145
30,OLT,"GRĂDINIŢA ŞERBĂNEŞTII DE SUS",326,ŞERBĂNEŞTI,129246,1,PART,PRCNCT,PRSD,PRSD_SV,"2025-05-18 21:50:25",601,366,291,70,5,362,4,661,295,236,126
30,OLT,"ŞCOALA CU CLASELE I-VIII",327,ŞOPÂRLIŢA,130384,1,PART,PRCNCT,PRSD,PRSD_SV,"2025-05-18 21:50:03",958,800,606,141,53,788,12,1054,254,342,446
30,OLT,"CĂMINUL CULTURAL",328,"ŞTEFAN CEL MARE",129282,2,PART,PRCNCT,PRSD,PRSD_SV,"2025-05-19 03:10:36",840,585,445,99,41,585,0,925,340,244,341
30,OLT,"GRĂDINIŢA IANCA NOUĂ",329,"ŞTEFAN CEL MARE",129282,1,PART,PRCNCT,PRSD,PRSD_SV,"2025-05-18 21:35:34",426,295,244,40,11,293,2,467,172,156,137
30,OLT,"ŞCOALA GIMNAZIALĂ TĂTULEŞTI",330,TĂTULEŞTI,129317,1,PART,PRCNCT,PRSD,PRSD_SV,"2025-05-18 21:24:24",409,324,192,131,1,319,5,451,127,174,145
30,OLT,"ŞCOALA BĂRBĂLAI",331,TĂTULEŞTI,129317,1,PART,PRCNCT,PRSD,PRSD_SV,"2025-05-18 21:27:35",171,165,82,83,0,162,3,239,74,74,88
30,OLT,"ŞCOALA MIRCEŞTI",332,TĂTULEŞTI,129317,1,PART,PRCNCT,PRSD,PRSD_SV,"2025-05-18 21:33:27",118,120,61,59,0,118,2,180,60,65,53
30,OLT,"ŞCOALA GENERALĂ",333,TESLUI,129380,1,PART,PRCNCT,PRSD,PRSD_SV,"2025-05-18 21:47:26",1295,819,655,164,0,809,10,1425,606,471,338
30,OLT,"CĂMIN CULTURAL COMĂNIȚA",334,TESLUI,129380,1,PART,PRCNCT,PRSD,PRSD_SV,"2025-05-18 21:40:33",701,435,319,116,0,427,8,773,338,265,162
30,OLT,GRADINITA,335,"TIA MARE",129460,1,PART,PRCNCT,PRSD,PRSD_SV,"2025-05-18 21:51:28",1182,591,536,55,0,589,2,1301,710,326,263
30,OLT,"SCOALA GIMNAZIALA",336,"TIA MARE",129460,1,PART,PRCNCT,PRSD,PRSD_SV,"2025-05-18 21:37:53",953,521,474,44,3,517,4,1048,527,267,250
30,OLT,GRADINITA,337,"TIA MARE",129460,1,PART,PRCNCT,PRSD,PRSD_SV,"2025-05-18 21:37:29",1177,555,499,56,0,548,7,1295,740,325,223
30,OLT,"SCOALA GIMNAZIALA TOPANA",338,TOPANA,129503,1,PART,PRCNCT,PRSD,PRSD_SV,"2025-05-18 21:26:24",254,181,100,81,0,180,1,279,98,87,93
30,OLT,"SCOALA CANDELESTI",339,TOPANA,129503,1,PART,PRCNCT,PRSD,PRSD_SV,"2025-05-18 21:19:25",76,67,36,31,0,65,2,84,17,32,33
30,OLT,"SCOALA GOJGAREI",340,TOPANA,129503,1,PART,PRCNCT,PRSD,PRSD_SV,"2025-05-18 21:28:30",94,94,36,58,0,94,0,153,59,43,51
30,OLT,"SCOALA UNGURENI",341,TOPANA,129503,1,PART,PRCNCT,PRSD,PRSD_SV,"2025-05-18 21:46:08",83,93,41,52,0,93,0,141,48,57,36
30,OLT,"ŞCOALA GIMNAZIALĂ TRAIAN",342,TRAIAN,129567,1,PART,PRCNCT,PRSD,PRSD_SV,"2025-05-18 21:29:46",1105,578,493,80,5,573,5,1216,638,373,200
30,OLT,"ŞCOALA GIMNAZIALĂ TRAIAN",343,TRAIAN,129567,1,PART,PRCNCT,PRSD,PRSD_SV,"2025-05-18 21:46:21",1235,622,580,39,3,618,4,1359,737,384,234
30,OLT,"LICEUL TEHNOLOGIC TUFENI",344,TUFENI,129585,1,PART,PRCNCT,PRSD,PRSD_SV,"2025-05-18 21:55:32",1118,684,514,170,0,675,9,1230,546,396,279
30,OLT,"ŞCOALA STOBORĂŞTI",345,TUFENI,129585,1,PART,PRCNCT,PRSD,PRSD_SV,"2025-05-18 21:47:35",914,548,445,101,2,542,6,1005,457,398,144
30,OLT,"ȘCOALA VECHE - CORP 1",346,URZICA,129629,1,PART,PRCNCT,PRSD,PRSD_SV,"2025-05-18 21:40:53",1120,605,506,70,29,598,7,1232,627,400,198
30,OLT,"SCOALA VECHE STĂVARU",347,URZICA,129629,1,PART,PRCNCT,PRSD,PRSD_SV,"2025-05-18 21:36:55",552,290,224,51,15,285,5,607,317,152,133
30,OLT,"ȘCOALA GIMNAZIALĂ VALEA MARE",348,"VALEA MARE",129656,1,PART,PRCNCT,PRSD,PRSD_SV,"2025-05-18 21:56:16",1246,704,621,82,1,691,13,1371,667,472,219
30,OLT,"ȘCOALA GIMNAZIALĂ VALEA MARE",349,"VALEA MARE",129656,1,PART,PRCNCT,PRSD,PRSD_SV,"2025-05-18 21:49:55",666,356,267,89,0,351,5,733,377,233,118
30,OLT,"SCOALA GIMNAZIALA",350,"VALEA MARE",129656,1,PART,PRCNCT,PRSD,PRSD_SV,"2025-05-18 21:29:43",556,312,259,53,0,308,4,613,301,206,102
30,OLT,GRADINITA,351,"VALEA MARE",129656,1,PART,PRCNCT,PRSD,PRSD_SV,"2025-05-18 21:44:15",495,303,246,57,0,299,4,545,242,207,92
30,OLT,"CĂMINUL CULTURAL",352,VĂDASTRA,129718,1,PART,PRCNCT,PRSD,PRSD_SV,"2025-05-18 22:23:42",1039,688,518,130,40,680,8,1143,455,291,389
30,OLT,"CĂMINUL CULTURAL",353,VĂDĂSTRIŢA,129745,1,PART,PRCNCT,PRSD,PRSD_SV,"2025-05-18 22:10:45",1059,565,487,78,0,559,6,1165,600,356,203
30,OLT,"CĂMINUL CULTURAL",354,VĂDĂSTRIŢA,129745,1,PART,PRCNCT,PRSD,PRSD_SV,"2025-05-18 22:04:35",1417,701,633,68,0,697,4,1559,858,445,252
30,OLT,"ŞCOALA GENERALĂ VĂLENI",355,VĂLENI,129763,1,PART,PRCNCT,PRSD,PRSD_SV,"2025-05-18 22:06:32",766,418,347,62,9,414,4,844,426,257,157
30,OLT,"ŞCOALA GENERALĂ VĂLENI",356,VĂLENI,129763,1,PART,PRCNCT,PRSD,PRSD_SV,"2025-05-18 22:21:54",749,484,345,133,6,481,3,824,340,304,177
30,OLT,"CASA SPECIALISTULUI",357,VĂLENI,129763,1,PART,PRCNCT,PRSD,PRSD_SV,"2025-05-18 21:37:07",459,257,205,51,1,257,0,504,247,170,87
30,OLT,"ȘCOALA VÎLCELE",358,VÂLCELE,129987,1,PART,PRCNCT,PRSD,PRSD_SV,"2025-05-18 22:04:04",1236,786,593,160,33,780,6,1361,575,515,265
30,OLT,"ȘCOALA GENERALĂ",359,VÂLCELE,129987,1,PART,PRCNCT,PRSD,PRSD_SV,"2025-05-18 21:54:09",606,427,327,70,30,418,9,667,240,326,92
30,OLT,"GRADINITA CU PROGRAM NORMAL CUCUETI",360,VERGULEASA,129816,1,PART,PRCNCT,PRSD,PRSD_SV,"2025-05-18 21:49:15",658,411,319,92,0,410,1,724,313,241,169
30,OLT,"ŞCOALA GENERALĂ I-IV",361,VERGULEASA,129816,1,PART,PRCNCT,PRSD,PRSD_SV,"2025-05-18 21:40:56",542,366,261,105,0,362,4,596,230,217,145
30,OLT,"CĂMINUL CULTURAL POGANU",362,VERGULEASA,129816,1,PART,PRCNCT,PRSD,PRSD_SV,"2025-05-18 21:45:01",876,523,389,133,1,518,5,964,441,280,238
30,OLT,"GRĂDINIŢA DE COPII",363,VIŞINA,129898,1,PART,PRCNCT,PRSD,PRSD_SV,"2025-05-18 22:00:29",1046,725,530,114,81,715,10,1152,427,352,363
30,OLT,"GRĂDINIŢA DE COPII",364,VIŞINA,129898,1,PART,PRCNCT,PRSD,PRSD_SV,"2025-05-18 22:08:00",1205,789,662,58,69,783,6,1326,537,358,425
30,OLT,"BIBLIOTECA COMUNALĂ",365,"VIŞINA NOUĂ",130375,1,PART,PRCNCT,PRSD,PRSD_SV,"2025-05-18 22:12:22",1346,729,582,83,64,723,6,1481,752,421,302
30,OLT,"LICEUL TEHNOLOGIC VITOMIRESTI",366,VITOMIREŞTI,129914,1,PART,PRCNCT,PRSD,PRSD_SV,"2025-05-18 21:37:45",379,274,191,81,2,272,2,417,143,154,118
30,OLT,"SCOALA CU CLASELE I-IV BULIMANU",367,VITOMIREŞTI,129914,1,PART,PRCNCT,PRSD,PRSD_SV,"2025-05-18 21:19:18",142,116,67,49,0,113,3,157,41,69,44
30,OLT,"GRADINITA CU PROGRAM NORMAL DEJESTI",368,VITOMIREŞTI,129914,3,PART,PRCNCT,PRSD,PRSD_SV,"2025-05-19 00:29:24",503,304,236,68,0,302,2,554,250,203,99
30,OLT,"SCOALA CU CLASELE I-IV DONESTI",369,VITOMIREŞTI,129914,1,PART,PRCNCT,PRSD,PRSD_SV,"2025-05-18 21:20:10",177,139,80,59,0,138,1,295,156,88,50
30,OLT,"SCOALA CU CLASELE I-IV TREPTENI",370,VITOMIREŞTI,129914,1,PART,PRCNCT,PRSD,PRSD_SV,"2025-05-18 21:15:11",224,107,77,30,0,107,0,246,139,72,35
30,OLT,"ȘCOALA GIMNAZIALĂ VLĂDILA",371,VLĂDILA,130026,1,PART,PRCNCT,PRSD,PRSD_SV,"2025-05-18 21:55:59",816,446,369,77,0,443,3,898,452,294,149
30,OLT,"ȘCOALA GIMNAZIALĂ VLĂDILA",372,VLĂDILA,130026,1,PART,PRCNCT,PRSD,PRSD_SV,"2025-05-18 21:28:46",760,392,359,33,0,387,5,837,445,268,119
30,OLT,"SCOALA CU CLASELE I-VIII VOINEASA",373,VOINEASA,130062,1,PART,PRCNCT,PRSD,PRSD_SV,"2025-05-18 21:33:17",685,452,394,47,11,448,4,754,302,293,155
30,OLT,"SCOALA CU CLASELE I-VIII MARGARITESTI",374,VOINEASA,130062,1,PART,PRCNCT,PRSD,PRSD_SV,"2025-05-18 21:58:41",569,365,312,36,17,361,4,626,261,233,128
30,OLT,"SCOALA CU CLASELE I-IV RACOVITA",375,VOINEASA,130062,1,PART,PRCNCT,PRSD,PRSD_SV,"2025-05-18 21:50:06",409,288,228,47,13,284,4,450,162,183,101
30,OLT,"SCOALA GIMNAZIALA VULPENI-STRUCTURA GROPSANI",376,VULPENI,130124,1,PART,PRCNCT,PRSD,PRSD_SV,"2025-05-18 21:33:08",632,352,289,60,3,348,4,695,343,208,140
30,OLT,"FOSTA SC. CU CLASELE I-IV PRISACA",377,VULPENI,130124,1,PART,PRCNCT,PRSD,PRSD_SV,"2025-05-18 22:15:58",301,170,126,44,0,168,2,331,161,99,69
30,OLT,"SCOALA GIMNAZIALA VULPENI",378,VULPENI,130124,1,PART,PRCNCT,PRSD,PRSD_SV,"2025-05-18 22:04:58",736,456,325,131,0,453,3,810,354,254,199
30,OLT,"ŞCOALA GIMNAZIALĂ, COMUNA VULTUREȘTI",379,VULTUREŞTI,130231,1,PART,PRCNCT,PRSD,PRSD_SV,"2025-05-18 21:55:34",563,295,201,93,1,294,1,620,325,182,112
30,OLT,"ȘCOALA PRIMARĂ, SAT.DIENCI",380,VULTUREŞTI,130231,1,PART,PRCNCT,PRSD,PRSD_SV,"2025-05-18 21:58:09",755,531,386,142,3,527,4,831,300,336,191
30,OLT,"ŞCOALA CU CLASELE I-IV VALEA LUI ALB",381,VULTUREŞTI,130231,1,PART,PRCNCT,PRSD,PRSD_SV,"2025-05-18 21:36:58",470,256,195,58,3,255,1,517,261,142,113
31,PRAHOVA,"PALATUL CULTURII",1,"MUNICIPIUL PLOIEŞTI",130534,1,PART,PRCNCT,PRSD,PRSD_SV,"2025-05-18 22:17:09",1419,717,621,95,1,705,12,1500,783,208,497
31,PRAHOVA,"PALATUL CULTURII",2,"MUNICIPIUL PLOIEŞTI",130534,1,PART,PRCNCT,PRSD,PRSD_SV,"2025-05-18 22:28:18",825,582,422,157,3,571,11,900,318,164,407
31,PRAHOVA,"PALATUL CULTURII",3,"MUNICIPIUL PLOIEŞTI",130534,1,PART,PRCNCT,PRSD,PRSD_SV,"2025-05-18 22:03:49",932,685,525,160,0,679,6,1000,315,187,492
31,PRAHOVA,"COLEGIUL NAŢIONAL ”ALEXANDRU IOAN CUZA”",4,"MUNICIPIUL PLOIEŞTI",130534,1,PART,PRCNCT,PRSD,PRSD_SV,"2025-05-18 22:11:40",992,675,558,117,0,668,7,1100,425,204,464
31,PRAHOVA,"ŞCOALA GIMNAZIALĂ ”ELENA DOAMNA”",5,"MUNICIPIUL PLOIEŞTI",130534,1,PART,PRCNCT,PRSD,PRSD_SV,"2025-05-18 22:06:19",1222,795,724,68,3,780,15,1300,505,228,552
31,PRAHOVA,"ŞCOALA GIMNAZIALĂ ”ELENA DOAMNA”",6,"MUNICIPIUL PLOIEŞTI",130534,1,PART,PRCNCT,PRSD,PRSD_SV,"2025-05-18 21:40:37",1170,748,690,58,0,737,11,1300,552,227,510
31,PRAHOVA,"ŞCOALA GIMNAZIALĂ ”CANDIANO POPESCU”",7,"MUNICIPIUL PLOIEŞTI",130534,1,PART,PRCNCT,PRSD,PRSD_SV,"2025-05-18 21:47:34",1177,763,680,81,2,739,24,1300,537,233,506
31,PRAHOVA,"ŞCOALA GIMNAZIALĂ ”CANDIANO POPESCU”",8,"MUNICIPIUL PLOIEŞTI",130534,1,PART,PRCNCT,PRSD,PRSD_SV,"2025-05-18 21:36:41",1136,600,508,31,61,590,10,1200,600,320,270
31,PRAHOVA,"COLEGIUL NAŢIONAL ”ION LUCA CARAGIALE”",9,"MUNICIPIUL PLOIEŞTI",130534,1,PART,PRCNCT,PRSD,PRSD_SV,"2025-05-18 21:57:56",1389,786,673,111,2,775,11,1397,611,348,427
31,PRAHOVA,"COLEGIUL NAŢIONAL ”ION LUCA CARAGIALE”",10,"MUNICIPIUL PLOIEŞTI",130534,1,PART,PRCNCT,PRSD,PRSD_SV,"2025-05-18 21:57:56",1091,669,581,84,4,660,9,1200,531,221,439
31,PRAHOVA,"DIRECŢIA JUDEŢEANĂ PENTRU SPORT ŞI TINERET PRAHOVA",11,"MUNICIPIUL PLOIEŞTI",130534,2,PART,PRCNCT,PRSD,PRSD_SV,"2025-05-18 23:57:23",1134,695,637,58,0,683,12,1200,505,278,405
31,PRAHOVA,"DIRECŢIA JUDEŢEANĂ PENTRU SPORT ŞI TINERET PRAHOVA",12,"MUNICIPIUL PLOIEŞTI",130534,1,PART,PRCNCT,PRSD,PRSD_SV,"2025-05-18 21:57:24",1218,766,685,47,34,751,15,1300,534,299,452
31,PRAHOVA,"LICEUL TEHNOLOGIC UCECOM ”SPIRU HARET” (FOST GRUPUL SCOLAR DE ARTE SI MESERII ”SPIRU HARET”)",13,"MUNICIPIUL PLOIEŞTI",130534,1,PART,PRCNCT,PRSD,PRSD_SV,"2025-05-18 21:49:55",1029,600,525,75,0,589,11,1100,500,242,347
31,PRAHOVA,"ANEXA ŞCOLII GIMNAZIALE ”SFÂNTA VINERI”",14,"MUNICIPIUL PLOIEŞTI",130534,2,PART,PRCNCT,PRSD,PRSD_SV,"2025-05-18 23:03:19",895,555,487,68,0,544,11,1000,445,211,333
31,PRAHOVA,"MUZEUL JUDEŢEAN DE ISTORIE ŞI ARHEOLOGIE PRAHOVA",15,"MUNICIPIUL PLOIEŞTI",130534,1,PART,PRCNCT,PRSD,PRSD_SV,"2025-05-18 21:36:22",661,484,349,131,4,474,10,700,216,164,310
31,PRAHOVA,"COLEGIUL NAŢIONAL ”MIHAI VITEAZUL”",16,"MUNICIPIUL PLOIEŞTI",130534,1,PART,PRCNCT,PRSD,PRSD_SV,"2025-05-18 21:55:25",619,425,316,108,1,419,6,700,275,149,270
31,PRAHOVA,"COLEGIUL NAŢIONAL ”MIHAI VITEAZUL”",17,"MUNICIPIUL PLOIEŞTI",130534,2,PART,PRCNCT,PRSD,PRSD_SV,"2025-05-19 00:08:45",780,499,433,65,1,496,3,900,401,168,328
31,PRAHOVA,"S.C. ”ELECTRICA” S.A.",18,"MUNICIPIUL PLOIEŞTI",130534,1,PART,PRCNCT,PRSD,PRSD_SV,"2025-05-18 22:12:44",1045,625,581,42,2,618,7,1100,475,245,373
31,PRAHOVA,"GRĂDINIŢA CU PROGRAM PRELUNGIT NR. 28 (GRADINITA NR. 28)",19,"MUNICIPIUL PLOIEŞTI",130534,1,PART,PRCNCT,PRSD,PRSD_SV,"2025-05-18 21:37:49",921,584,528,56,0,572,12,1008,424,185,387
31,PRAHOVA,"OCOLUL SILVIC",20,"MUNICIPIUL PLOIEŞTI",130534,1,PART,PRCNCT,PRSD,PRSD_SV,"2025-05-18 21:46:01",1283,826,742,82,2,812,14,1400,574,270,542
31,PRAHOVA,"ȘCOALA GIMNAZIALĂ ”FLORIN COMIȘEL”",21,"MUNICIPIUL PLOIEŞTI",130534,1,PART,PRCNCT,PRSD,PRSD_SV,"2025-05-18 21:51:05",1412,818,723,39,56,803,15,1500,682,378,425
31,PRAHOVA,"ŞCOALA GIMNAZIALĂ ”FLORIN COMIŞEL”",22,"MUNICIPIUL PLOIEŞTI",130534,1,PART,PRCNCT,PRSD,PRSD_SV,"2025-05-18 22:17:42",1362,831,722,51,58,817,14,1400,569,353,464
31,PRAHOVA,"ŞCOALA GIMNAZIALĂ ”NICOLAE TITULESCU”",23,"MUNICIPIUL PLOIEŞTI",130534,1,PART,PRCNCT,PRSD,PRSD_SV,"2025-05-18 22:09:20",1224,736,699,37,0,727,9,1300,564,219,508
31,PRAHOVA,"ŞCOALA GIMNAZIALĂ ”NICOLAE TITULESCU”",24,"MUNICIPIUL PLOIEŞTI",130534,1,PART,PRCNCT,PRSD,PRSD_SV,"2025-05-18 21:51:07",1283,788,728,60,0,773,15,1400,612,222,551
31,PRAHOVA,"ANEXA LICEULUI TEHNOLOGIC DE TRANSPORTURI (ANEXA GRUP SCOLAR INDUSTRIAL TRANSPORTURI (FOST LICEUL AUTO))",25,"MUNICIPIUL PLOIEŞTI",130534,1,PART,PRCNCT,PRSD,PRSD_SV,"2025-05-18 21:42:39",1555,929,879,49,1,913,16,1600,671,356,557
31,PRAHOVA,"ŞCOALA GIMNAZIALĂ ”SFÂNTUL VASILE”",26,"MUNICIPIUL PLOIEŞTI",130534,1,PART,PRCNCT,PRSD,PRSD_SV,"2025-05-18 21:54:14",1340,859,775,83,1,851,8,1400,541,234,617
31,PRAHOVA,"ŞCOALA GIMNAZIALĂ ”SFÂNTUL VASILE”",27,"MUNICIPIUL PLOIEŞTI",130534,1,PART,PRCNCT,PRSD,PRSD_SV,"2025-05-18 21:52:14",1238,782,681,97,4,769,13,1400,618,180,589
31,PRAHOVA,"ŞCOALA GIMNAZIALĂ ”SFÂNTUL VASILE”",28,"MUNICIPIUL PLOIEŞTI",130534,1,PART,PRCNCT,PRSD,PRSD_SV,"2025-05-18 22:04:12",1187,810,690,120,0,805,5,1300,490,214,591
31,PRAHOVA,"ŞCOALA GIMNAZIALĂ ”SFÂNTUL VASILE”",29,"MUNICIPIUL PLOIEŞTI",130534,1,PART,PRCNCT,PRSD,PRSD_SV,"2025-05-18 21:59:46",1188,772,719,50,3,762,10,1300,528,220,542
31,PRAHOVA,"ŞCOALA GIMNAZIALĂ NR. 13 (FOSTA ŞCOALĂ GIMNAZIALĂ ”DIMITRIE BOLINTINEANU”)",30,"MUNICIPIUL PLOIEŞTI",130534,1,PART,PRCNCT,PRSD,PRSD_SV,"2025-05-18 21:52:44",1086,664,616,48,0,658,6,1200,536,208,450
31,PRAHOVA,"ŞCOALA GIMNAZIALĂ NR. 13 (FOSTA ŞCOALĂ GIMNAZIALĂ ”DIMITRIE BOLINTINEANU”)",31,"MUNICIPIUL PLOIEŞTI",130534,1,PART,PRCNCT,PRSD,PRSD_SV,"2025-05-18 21:44:19",941,529,504,25,0,519,10,1000,471,195,324
31,PRAHOVA,"S.C. TRANSPORT CĂLĂTORI EXPRESS S.A.",32,"MUNICIPIUL PLOIEŞTI",130534,1,PART,PRCNCT,PRSD,PRSD_SV,"2025-05-18 21:33:27",1565,845,806,38,1,836,9,1700,855,592,244
31,PRAHOVA,"S.C. TRANSPORT CĂLĂTORI EXPRESS S.A.",33,"MUNICIPIUL PLOIEŞTI",130534,1,PART,PRCNCT,PRSD,PRSD_SV,"2025-05-18 21:31:40",1061,633,586,44,3,625,8,1200,567,229,396
31,PRAHOVA,"S.C. TRANSPORT CĂLĂTORI EXPRESS S.A.",34,"MUNICIPIUL PLOIEŞTI",130534,1,PART,PRCNCT,PRSD,PRSD_SV,"2025-05-18 21:33:43",993,587,531,55,1,577,10,1100,513,240,337
31,PRAHOVA,"ȘCOALA GIMNAZIALĂ ”CANDIANO POPESCU” PLOIEȘTI",35,"MUNICIPIUL PLOIEŞTI",130534,1,PART,PRCNCT,PRSD,PRSD_SV,"2025-05-18 21:48:21",1567,856,809,44,3,844,12,1600,744,359,485
31,PRAHOVA,"ŞCOALA GIMNAZIALĂ ”ANTON PANN”",36,"MUNICIPIUL PLOIEŞTI",130534,1,PART,PRCNCT,PRSD,PRSD_SV,"2025-05-18 22:13:20",1196,540,511,29,0,527,13,1300,760,284,243
31,PRAHOVA,"ŞCOALA GIMNAZIALĂ ”ANTON PANN”",37,"MUNICIPIUL PLOIEŞTI",130534,1,PART,PRCNCT,PRSD,PRSD_SV,"2025-05-18 22:14:18",1329,692,658,34,0,681,11,1508,816,368,313
31,PRAHOVA,"ŞCOALA GIMNAZIALĂ ”ANTON PANN”",38,"MUNICIPIUL PLOIEŞTI",130534,1,PART,PRCNCT,PRSD,PRSD_SV,"2025-05-18 21:22:27",738,426,334,92,0,417,9,800,374,271,146
31,PRAHOVA,"ȘCOALA GIMNAZIALĂ ”ANTON PANN”",39,"MUNICIPIUL PLOIEŞTI",130534,1,PART,PRCNCT,PRSD,PRSD_SV,"2025-05-18 21:48:20",1463,752,721,30,1,736,16,1600,848,440,296
31,PRAHOVA,"BLOCUL 24B PARTER",40,"MUNICIPIUL PLOIEŞTI",130534,1,PART,PRCNCT,PRSD,PRSD_SV,"2025-05-18 22:16:41",1213,694,637,54,3,687,7,1300,606,241,446
31,PRAHOVA,"CANTINA DE AJUTOR SOCIAL",41,"MUNICIPIUL PLOIEŞTI",130534,1,PART,PRCNCT,PRSD,PRSD_SV,"2025-05-18 21:41:54",1329,730,674,55,1,716,14,1400,670,320,396
31,PRAHOVA,"CANTINA DE AJUTOR SOCIAL",42,"MUNICIPIUL PLOIEŞTI",130534,1,PART,PRCNCT,PRSD,PRSD_SV,"2025-05-18 21:46:33",1378,835,767,53,15,818,17,1500,665,327,491
31,PRAHOVA,"CANTINA DE AJUTOR SOCIAL",43,"MUNICIPIUL PLOIEŞTI",130534,1,PART,PRCNCT,PRSD,PRSD_SV,"2025-05-18 21:44:02",1165,675,620,55,0,660,15,1300,625,244,416
31,PRAHOVA,"CANTINA DE AJUTOR SOCIAL",44,"MUNICIPIUL PLOIEŞTI",130534,1,PART,PRCNCT,PRSD,PRSD_SV,"2025-05-18 21:42:58",1262,693,629,64,0,680,13,1400,707,301,379
31,PRAHOVA,"LICEUL TEHNOLOGIC ”ANGHEL SALIGNY”",45,"MUNICIPIUL PLOIEŞTI",130534,1,PART,PRCNCT,PRSD,PRSD_SV,"2025-05-18 21:44:53",1143,570,496,74,0,562,8,1200,630,304,258
31,PRAHOVA,"GRĂDINIŢA CU PROGRAM NORMAL NR. 4 (FOSTA GRADINITA DE COPII NR. 4)",46,"MUNICIPIUL PLOIEŞTI",130534,1,PART,PRCNCT,PRSD,PRSD_SV,"2025-05-18 21:53:09",744,537,455,42,40,526,11,800,263,195,331
31,PRAHOVA,"ŞCOALA GIMNAZIALĂ ”IOAN GRIGORESCU”",47,"MUNICIPIUL PLOIEŞTI",130534,1,PART,PRCNCT,PRSD,PRSD_SV,"2025-05-18 21:39:19",1211,687,638,48,1,682,5,1300,613,324,358
31,PRAHOVA,"ŞCOALA GIMNAZIALĂ ”IOAN GRIGORESCU”",48,"MUNICIPIUL PLOIEŞTI",130534,1,PART,PRCNCT,PRSD,PRSD_SV,"2025-05-18 21:49:56",1015,534,497,37,0,522,12,1100,566,230,292
31,PRAHOVA,"ŞCOALA GIMNAZIALĂ ”IOAN GRIGORESCU”",49,"MUNICIPIUL PLOIEŞTI",130534,1,PART,PRCNCT,PRSD,PRSD_SV,"2025-05-18 21:57:34",1166,691,665,25,1,679,12,1200,509,294,385
31,PRAHOVA,"ŞCOALA GIMNAZIALĂ ”RAREŞ VODĂ”",50,"MUNICIPIUL PLOIEŞTI",130534,1,PART,PRCNCT,PRSD,PRSD_SV,"2025-05-18 21:36:21",903,567,509,56,2,560,7,1000,433,213,347
31,PRAHOVA,"CASA CORPULUI DIDACTIC",51,"MUNICIPIUL PLOIEŞTI",130534,1,PART,PRCNCT,PRSD,PRSD_SV,"2025-05-18 21:35:39",1069,666,609,57,0,659,7,1200,534,216,443
31,PRAHOVA,"CASA CORPULUI DIDACTIC",52,"MUNICIPIUL PLOIEŞTI",130534,1,PART,PRCNCT,PRSD,PRSD_SV,"2025-05-18 21:44:01",780,501,454,46,1,491,10,900,399,157,334
31,PRAHOVA,"COLEGIUL NAȚIONAL PEDAGOGIC ”REGINA MARIA” (FOST COLEGIUL NAȚIONAL ”JEAN MONNET”)”",53,"MUNICIPIUL PLOIEŞTI",130534,1,PART,PRCNCT,PRSD,PRSD_SV,"2025-05-18 22:18:06",1056,695,623,71,1,685,10,1200,505,214,471
31,PRAHOVA,"LICEUL TEHNOLOGIC ADMINISTRATIV ŞI DE SERVICII ”VICTOR SLĂVESCU” ( FOSTA SCOALA NR. 32)",54,"MUNICIPIUL PLOIEŞTI",130534,1,PART,PRCNCT,PRSD,PRSD_SV,"2025-05-18 22:09:20",1057,662,574,86,2,649,13,1200,538,210,439
31,PRAHOVA,"LICEUL TEHNOLOGIC ADMINISTRATIV ŞI DE SERVICII ”VICTOR SLĂVESCU” ( FOSTA SCOALA NR. 32)",55,"MUNICIPIUL PLOIEŞTI",130534,1,PART,PRCNCT,PRSD,PRSD_SV,"2025-05-18 21:53:08",1081,680,584,96,0,673,7,1200,520,259,414
31,PRAHOVA,"ŞCOALA GIMNAZIALĂ ”GEORGE COŞBUC”",56,"MUNICIPIUL PLOIEŞTI",130534,1,PART,PRCNCT,PRSD,PRSD_SV,"2025-05-18 21:38:50",1186,740,654,82,4,722,18,1300,560,248,474
31,PRAHOVA,"ŞCOALA GIMNAZIALĂ ”GEORGE COŞBUC”",57,"MUNICIPIUL PLOIEŞTI",130534,1,PART,PRCNCT,PRSD,PRSD_SV,"2025-05-18 22:04:34",1281,770,702,67,1,742,28,1400,630,263,479
31,PRAHOVA,"ŞCOALA GIMNAZIALĂ SPECIALĂ NR. 1",58,"MUNICIPIUL PLOIEŞTI",130534,1,PART,PRCNCT,PRSD,PRSD_SV,"2025-05-18 21:42:19",1117,589,560,29,0,580,9,1200,611,352,228
31,PRAHOVA,"ŞCOALA GIMNAZIALĂ SPECIALĂ NR. 1",59,"MUNICIPIUL PLOIEŞTI",130534,1,PART,PRCNCT,PRSD,PRSD_SV,"2025-05-18 21:31:17",765,410,390,20,0,402,8,800,390,209,193
31,PRAHOVA,"LICEUL TEHNOLOGIC ”1 MAI”",60,"MUNICIPIUL PLOIEŞTI",130534,1,PART,PRCNCT,PRSD,PRSD_SV,"2025-05-18 21:56:06",1359,816,715,101,0,804,12,1400,584,305,499
31,PRAHOVA,"LICEUL TEHNOLOGIC ”1 MAI”",61,"MUNICIPIUL PLOIEŞTI",130534,1,PART,PRCNCT,PRSD,PRSD_SV,"2025-05-18 22:15:11",1708,969,878,90,1,953,16,1800,831,543,410
31,PRAHOVA,"LICEUL TEHNOLOGIC ”LAZĂR EDELEANU” (FOST COLEGIUL TEHNIC ”LAZĂR EDELEANU”, FOST LICEUL DE CHIMIE)",62,"MUNICIPIUL PLOIEŞTI",130534,1,PART,PRCNCT,PRSD,PRSD_SV,"2025-05-18 22:07:34",1216,794,689,105,0,780,14,1300,506,292,488
31,PRAHOVA,"LICEUL TEHNOLOGIC ”LAZĂR EDELEANU” (FOST COLEGIUL TEHNIC ”LAZĂR EDELEANU”, FOST LICEUL DE CHIMIE)",63,"MUNICIPIUL PLOIEŞTI",130534,1,PART,PRCNCT,PRSD,PRSD_SV,"2025-05-18 21:51:43",1508,862,742,117,3,851,11,1600,738,361,490
31,PRAHOVA,"ŞCOALA GIMNAZIALĂ ”MIHAI EMINESCU”",64,"MUNICIPIUL PLOIEŞTI",130534,1,PART,PRCNCT,PRSD,PRSD_SV,"2025-05-18 21:40:40",1169,753,675,78,0,743,10,1300,547,224,519
31,PRAHOVA,"ŞCOALA GIMNAZIALĂ ”MIHAI EMINESCU”",65,"MUNICIPIUL PLOIEŞTI",130534,1,PART,PRCNCT,PRSD,PRSD_SV,"2025-05-18 21:35:30",1213,693,634,57,2,672,21,1300,607,231,441
31,PRAHOVA,"ŞCOALA NR. 19",66,"MUNICIPIUL PLOIEŞTI",130534,1,PART,PRCNCT,PRSD,PRSD_SV,"2025-05-18 21:39:33",1278,558,524,34,0,554,4,1400,842,425,129
31,PRAHOVA,"ŞCOALA GIMNAZIALĂ ”RADU STANIAN”",67,"MUNICIPIUL PLOIEŞTI",130534,1,PART,PRCNCT,PRSD,PRSD_SV,"2025-05-18 21:56:30",964,635,537,97,1,624,11,1100,465,210,414
31,PRAHOVA,"COLEGIUL DE ARTĂ ”CARMEN SYLVA”",68,"MUNICIPIUL PLOIEŞTI",130534,1,PART,PRCNCT,PRSD,PRSD_SV,"2025-05-18 22:30:10",846,492,438,54,0,482,10,900,408,146,336
31,PRAHOVA,"COLEGIUL DE ARTĂ ”CARMEN SYLVA”",69,"MUNICIPIUL PLOIEŞTI",130534,1,PART,PRCNCT,PRSD,PRSD_SV,"2025-05-18 21:47:42",764,489,456,33,0,483,6,800,311,138,345
31,PRAHOVA,"S.C.APA NOVA S.R.L.",70,"MUNICIPIUL PLOIEŞTI",130534,1,PART,PRCNCT,PRSD,PRSD_SV,"2025-05-18 22:10:27",956,700,558,63,79,682,18,1100,400,237,445
31,PRAHOVA,"S.C.APA NOVA S.R.L.",71,"MUNICIPIUL PLOIEŞTI",130534,1,PART,PRCNCT,PRSD,PRSD_SV,"2025-05-18 21:45:03",828,420,391,29,0,411,9,900,480,259,152
31,PRAHOVA,"COLEGIUL ”SPIRU HARET”(FOST LICEUL DE CONSTRUCTII MASINI)",72,"MUNICIPIUL PLOIEŞTI",130534,2,PART,PRCNCT,PRSD,PRSD_SV,"2025-05-18 23:51:42",823,655,437,73,145,649,6,900,245,336,313
31,PRAHOVA,"PALATUL COPIILOR (FOSTA SCOALA NR. 20)",73,"MUNICIPIUL PLOIEŞTI",130534,1,PART,PRCNCT,PRSD,PRSD_SV,"2025-05-18 22:35:27",1870,1195,1135,60,0,1175,20,2000,805,352,823
31,PRAHOVA,"PALATUL COPIILOR (FOSTA SCOALA NR. 20)",74,"MUNICIPIUL PLOIEŞTI",130534,1,PART,PRCNCT,PRSD,PRSD_SV,"2025-05-18 21:38:01",1148,681,638,43,0,674,7,1300,619,278,396
31,PRAHOVA,"PALATUL COPIILOR (FOSTA SCOALA NR. 20)",75,"MUNICIPIUL PLOIEŞTI",130534,1,PART,PRCNCT,PRSD,PRSD_SV,"2025-05-18 22:04:29",1277,807,705,102,0,796,11,1400,593,239,557
31,PRAHOVA,"PALATUL COPIILOR (FOSTA SCOALA NR. 20)",76,"MUNICIPIUL PLOIEŞTI",130534,1,PART,PRCNCT,PRSD,PRSD_SV,"2025-05-18 21:50:16",729,495,407,88,0,479,16,800,305,207,272
31,PRAHOVA,"PALATUL COPIILOR (FOSTA SCOALA NR. 20)",77,"MUNICIPIUL PLOIEŞTI",130534,1,PART,PRCNCT,PRSD,PRSD_SV,"2025-05-18 21:47:11",851,503,475,28,0,487,16,900,397,173,314
31,PRAHOVA,"ŞCOALA GIMNAZIALĂ ”I. A. BASSARABESCU” (ŞCOALA GIMNAZIALĂ I. A. BASARABESCU)",78,"MUNICIPIUL PLOIEŞTI",130534,2,PART,PRCNCT,PRSD,PRSD_SV,"2025-05-19 00:12:59",1471,1006,841,165,0,989,16,1600,595,364,625
31,PRAHOVA,"ŞCOALA GIMNAZIALĂ ”I. A. BASSARABESCU” (ŞCOALA GIMNAZIALĂ I. A. BASARABESCU)",79,"MUNICIPIUL PLOIEŞTI",130534,1,PART,PRCNCT,PRSD,PRSD_SV,"2025-05-18 21:41:44",1817,1109,1035,74,0,1090,19,2000,891,381,709
31,PRAHOVA,"ŞCOALA GIMNAZIALĂ ”I. A. BASSARABESCU” (ŞCOALA GIMNAZIALĂ I. A. BASARABESCU)",80,"MUNICIPIUL PLOIEŞTI",130534,1,PART,PRCNCT,PRSD,PRSD_SV,"2025-05-18 22:48:38",1777,1148,1095,53,0,1132,16,1900,752,371,761
31,PRAHOVA,"ŞCOALA GIMNAZIALĂ ”I. A. BASSARABESCU” (ŞCOALA GIMNAZIALĂ I. A. BASARABESCU)",81,"MUNICIPIUL PLOIEŞTI",130534,1,PART,PRCNCT,PRSD,PRSD_SV,"2025-05-18 22:30:07",1366,858,745,46,67,843,15,1500,642,298,545
31,PRAHOVA,"DIRECŢIA GENERALĂ DE ASISTENŢĂ SOCIALĂ ŞI PROTECŢIA COPILULUI PRAHOVA",82,"MUNICIPIUL PLOIEŞTI",130534,1,PART,PRCNCT,PRSD,PRSD_SV,"2025-05-18 22:20:22",1194,720,621,98,1,704,16,1300,580,317,387
31,PRAHOVA,"DIRECŢIA GENERALĂ DE ASISTENŢĂ SOCIALĂ ŞI PROTECŢIA COPILULUI PRAHOVA",83,"MUNICIPIUL PLOIEŞTI",130534,1,PART,PRCNCT,PRSD,PRSD_SV,"2025-05-18 21:54:12",1199,727,669,57,1,711,16,1300,573,259,452
31,PRAHOVA,"ŞCOALA GIMNAZIALĂ ”GEORGE EMIL PALADE”",84,"MUNICIPIUL PLOIEŞTI",130534,1,PART,PRCNCT,PRSD,PRSD_SV,"2025-05-18 21:29:41",1207,709,643,66,0,701,8,1300,591,226,475
31,PRAHOVA,"ŞCOALA GIMNAZIALĂ ”GEORGE EMIL PALADE”",85,"MUNICIPIUL PLOIEŞTI",130534,1,PART,PRCNCT,PRSD,PRSD_SV,"2025-05-18 22:10:44",1201,683,645,38,0,666,17,1300,617,283,383
31,PRAHOVA,"ŞCOALA GIMNAZIALĂ ”GEORGE EMIL PALADE”",86,"MUNICIPIUL PLOIEŞTI",130534,1,PART,PRCNCT,PRSD,PRSD_SV,"2025-05-18 22:01:36",1238,696,652,44,0,686,10,1400,704,279,407
31,PRAHOVA,"ŞCOALA GIMNAZIALĂ ”GEORGE EMIL PALADE”",87,"MUNICIPIUL PLOIEŞTI",130534,1,PART,PRCNCT,PRSD,PRSD_SV,"2025-05-18 21:40:30",1120,604,572,32,0,598,6,1200,596,222,376
31,PRAHOVA,"GRĂDINIŢA CU PROGRAM NORMAL NR. 50 (FOSTA GRĂDINIŢĂ NR. 50)",88,"MUNICIPIUL PLOIEŞTI",130534,1,PART,PRCNCT,PRSD,PRSD_SV,"2025-05-18 21:34:20",1012,609,583,26,0,603,6,1100,491,205,398
31,PRAHOVA,"GRĂDINIŢA CU PROGRAM NORMAL NR. 50 (FOSTA GRĂDINIŢĂ NR. 50)",89,"MUNICIPIUL PLOIEŞTI",130534,1,PART,PRCNCT,PRSD,PRSD_SV,"2025-05-18 21:38:43",1103,636,598,38,0,627,9,1200,564,210,417
31,PRAHOVA,"GRĂDINIŢA CU PROGRAM PRELUNGIT NR. 40 ( FOSTA GRĂDINIŢĂ NR. 40)",90,"MUNICIPIUL PLOIEŞTI",130534,1,PART,PRCNCT,PRSD,PRSD_SV,"2025-05-18 21:58:08",1033,595,546,49,0,586,9,1100,505,230,356
31,PRAHOVA,"GRĂDINIŢA CU PROGRAM PRELUNGIT NR. 40 ( FOSTA GRĂDINIŢĂ NR. 40)",91,"MUNICIPIUL PLOIEŞTI",130534,1,PART,PRCNCT,PRSD,PRSD_SV,"2025-05-18 21:27:44",816,486,444,42,0,479,7,900,414,191,288
31,PRAHOVA,"GRĂDINIŢA CU PROGRAM PRELUNGIT NR. 40 ( FOSTA GRĂDINIŢĂ NR. 40)",92,"MUNICIPIUL PLOIEŞTI",130534,1,PART,PRCNCT,PRSD,PRSD_SV,"2025-05-18 21:45:07",1282,719,673,43,3,710,9,1399,680,254,456
31,PRAHOVA,"ŞCOALA GIMNAZIALĂ ”TOMA CARAGIU”",93,"MUNICIPIUL PLOIEŞTI",130534,1,PART,PRCNCT,PRSD,PRSD_SV,"2025-05-18 21:47:43",1049,570,536,34,0,565,5,1200,630,201,364
31,PRAHOVA,"ŞCOALA GIMNAZIALĂ ”TOMA CARAGIU”",94,"MUNICIPIUL PLOIEŞTI",130534,1,PART,PRCNCT,PRSD,PRSD_SV,"2025-05-18 21:43:25",825,524,481,43,0,517,7,900,376,224,293
31,PRAHOVA,"ŞCOALA GIMNAZIALĂ ”TOMA CARAGIU”",95,"MUNICIPIUL PLOIEŞTI",130534,1,PART,PRCNCT,PRSD,PRSD_SV,"2025-05-18 21:43:33",1219,699,658,41,0,688,11,1300,601,255,433
31,PRAHOVA,"ŞCOALA GIMNAZIALĂ ”NICOLAE IORGA”",96,"MUNICIPIUL PLOIEŞTI",130534,1,PART,PRCNCT,PRSD,PRSD_SV,"2025-05-18 21:40:13",1235,679,613,66,0,673,6,1400,721,299,374
31,PRAHOVA,"ŞCOALA GIMNAZIALĂ ”NICOLAE IORGA”",97,"MUNICIPIUL PLOIEŞTI",130534,1,PART,PRCNCT,PRSD,PRSD_SV,"2025-05-18 21:50:56",1126,660,599,61,0,652,8,1200,540,225,427
31,PRAHOVA,"ŞCOALA GIMNAZIALĂ ”NICOLAE IORGA”",98,"MUNICIPIUL PLOIEŞTI",130534,1,PART,PRCNCT,PRSD,PRSD_SV,"2025-05-18 22:08:25",1191,694,616,78,0,680,14,1300,606,298,382
31,PRAHOVA,"GRĂDINIŢA CU PROGRAM NORMAL NR. 39 (FOSTA GRĂDINIŢĂ NR. 39)",99,"MUNICIPIUL PLOIEŞTI",130534,1,PART,PRCNCT,PRSD,PRSD_SV,"2025-05-18 21:26:41",817,491,448,43,0,488,3,900,409,167,321
31,PRAHOVA,"GRĂDINIŢA CU PROGRAM NORMAL NR. 39 (FOSTA GRĂDINIŢĂ NR. 39)",100,"MUNICIPIUL PLOIEŞTI",130534,1,PART,PRCNCT,PRSD,PRSD_SV,"2025-05-18 21:33:05",773,434,388,46,0,419,15,900,466,175,244
31,PRAHOVA,"GRĂDINIŢA CU PROGRAM NORMAL NR. 39 (FOSTA GRĂDINIŢĂ NR. 39)",101,"MUNICIPIUL PLOIEŞTI",130534,1,PART,PRCNCT,PRSD,PRSD_SV,"2025-05-18 22:02:53",1267,640,610,30,0,622,18,1400,760,313,309
31,PRAHOVA,"GRĂDINIŢA CU PROGRAM PRELUNGIT ”SF. MUCENIC MINA” (FOSTA GRĂDINIŢĂ NR. 36 ”SF. MUCENIC MINA”)",102,"MUNICIPIUL PLOIEŞTI",130534,1,PART,PRCNCT,PRSD,PRSD_SV,"2025-05-18 21:54:14",1261,749,652,96,1,730,19,1400,651,293,437
31,PRAHOVA,"GRĂDINIŢA CU PROGRAM PRELUNGIT ”SF. MUCENIC MINA” (FOSTA GRĂDINIŢĂ NR. 36 ”SF. MUCENIC MINA”)",103,"MUNICIPIUL PLOIEŞTI",130534,1,PART,PRCNCT,PRSD,PRSD_SV,"2025-05-18 21:59:01",1304,675,632,43,0,664,11,1400,725,284,380
31,PRAHOVA,"GRĂDINIŢA CU PROGRAM PRELUNGIT ”SF. MUCENIC MINA” (FOSTA GRĂDINIŢĂ NR. 36 ”SF. MUCENIC MINA”)",104,"MUNICIPIUL PLOIEŞTI",130534,2,PART,PRCNCT,PRSD,PRSD_SV,"2025-05-18 23:49:10",1038,570,531,39,0,554,16,1100,530,220,334
31,PRAHOVA,"GRĂDINIŢA CU PROGRAM PRELUNGIT ”SF. MUCENIC MINA” (FOSTA GRĂDINIŢĂ NR. 36 ”SF. MUCENIC MINA”)",105,"MUNICIPIUL PLOIEŞTI",130534,1,PART,PRCNCT,PRSD,PRSD_SV,"2025-05-18 21:48:35",925,457,424,33,0,452,5,1000,543,219,233
31,PRAHOVA,"GRĂDINIŢA CU PROGRAM PRELUNGIT NR. 47 (FOSTA GRĂDINIŢĂ NR. 47)",106,"MUNICIPIUL PLOIEŞTI",130534,1,PART,PRCNCT,PRSD,PRSD_SV,"2025-05-18 21:57:11",846,517,475,41,1,508,9,900,383,179,329
31,PRAHOVA,"GRĂDINIŢA CU PROGRAM PRELUNGIT NR. 47 (FOSTA GRĂDINIŢĂ NR. 47)",107,"MUNICIPIUL PLOIEŞTI",130534,1,PART,PRCNCT,PRSD,PRSD_SV,"2025-05-18 21:41:19",738,458,422,36,0,450,8,800,342,136,314
31,PRAHOVA,"GRĂDINIŢA CU PROGRAM PRELUNGIT NR. 47 (FOSTA GRĂDINIŢĂ NR. 47)",108,"MUNICIPIUL PLOIEŞTI",130534,2,PART,PRCNCT,PRSD,PRSD_SV,"2025-05-18 22:32:50",830,480,458,22,0,471,9,900,420,224,247
31,PRAHOVA,"SISTEMUL DE GOSPODĂRIRE A APELOR PRAHOVA",109,"MUNICIPIUL PLOIEŞTI",130534,1,PART,PRCNCT,PRSD,PRSD_SV,"2025-05-18 21:56:02",979,640,566,74,0,631,9,1100,460,174,457
31,PRAHOVA,"AGENŢIA PENTRU PROTECŢIA MEDIULUI PRAHOVA",110,"MUNICIPIUL PLOIEŞTI",130534,1,PART,PRCNCT,PRSD,PRSD_SV,"2025-05-18 22:21:05",1039,634,570,64,0,625,9,1100,466,250,375
31,PRAHOVA,"ȘCOALA GIMNAZIALĂ ”IENĂCHIȚĂ VĂCĂRESCU”",111,"MUNICIPIUL PLOIEŞTI",130534,1,PART,PRCNCT,PRSD,PRSD_SV,"2025-05-18 21:46:04",1030,600,564,36,0,586,14,1100,500,203,383
31,PRAHOVA,"ŞCOALA GIMNAZIALĂ ”IENĂCHIŢĂ VĂCĂRESCU”",112,"MUNICIPIUL PLOIEŞTI",130534,1,PART,PRCNCT,PRSD,PRSD_SV,"2025-05-18 21:58:33",1366,788,745,42,1,777,11,1500,712,277,500
31,PRAHOVA,"ŞCOALA GIMNAZIALĂ ”IENĂCHIŢĂ VĂCĂRESCU”",113,"MUNICIPIUL PLOIEŞTI",130534,1,PART,PRCNCT,PRSD,PRSD_SV,"2025-05-18 21:52:34",1291,773,747,26,0,760,13,1400,627,246,514
31,PRAHOVA,"ŞCOALA GIMNAZIALĂ ”IENĂCHIŢĂ VĂCĂRESCU”",114,"MUNICIPIUL PLOIEŞTI",130534,1,PART,PRCNCT,PRSD,PRSD_SV,"2025-05-18 21:37:59",1179,755,704,51,0,735,20,1300,545,214,521
31,PRAHOVA,"ŞCOALA GIMNAZIALĂ ”IENĂCHŢĂ VĂCĂRESCU”",115,"MUNICIPIUL PLOIEŞTI",130534,1,PART,PRCNCT,PRSD,PRSD_SV,"2025-05-18 21:36:56",848,536,488,48,0,524,12,900,364,174,350
31,PRAHOVA,"LICEUL TEHNOLOGIC ”TOMA N. SOCOLESCU” (FOST COLEGIUL TEHNIC ”TOMA N. SOCOLESCU”)",116,"MUNICIPIUL PLOIEŞTI",130534,1,PART,PRCNCT,PRSD,PRSD_SV,"2025-05-18 21:39:56",901,617,506,111,0,600,17,1000,383,249,351
31,PRAHOVA,"LICEUL TEHNOLOGIC ”TOMA N. SOCOLESCU” (FOST COLEGIUL TEHNIC ”TOMA N. SOCOLESCU”)",117,"MUNICIPIUL PLOIEŞTI",130534,1,PART,PRCNCT,PRSD,PRSD_SV,"2025-05-18 21:32:10",634,382,351,31,0,379,3,700,318,101,278
31,PRAHOVA,"LICEUL TEHNOLOGIC ”ELIE RADU” (FOST COLEGIUL TEHNIC ”ELIE RADU”)",118,"MUNICIPIUL PLOIEŞTI",130534,1,PART,PRCNCT,PRSD,PRSD_SV,"2025-05-18 22:47:25",1560,877,812,64,1,862,15,1700,823,319,543
31,PRAHOVA,"LICEUL TEHNOLOGIC ”ELIE RADU” (FOST COLEGIUL TEHNIC ”ELIE RADU”)",119,"MUNICIPIUL PLOIEŞTI",130534,1,PART,PRCNCT,PRSD,PRSD_SV,"2025-05-18 21:31:25",1242,681,615,65,1,667,14,1400,719,236,431
31,PRAHOVA,"LICEUL TEHNOLOGIC ”ELIE RADU” (FOST COLEGIUL TEHNIC ”ELIE RADU”)",120,"MUNICIPIUL PLOIEŞTI",130534,1,PART,PRCNCT,PRSD,PRSD_SV,"2025-05-18 21:35:30",788,551,441,110,0,542,9,900,349,175,367
31,PRAHOVA,"ŞCOALA GIMNAZIALĂ PROFESOR ”NICOLAE SIMACHE”",121,"MUNICIPIUL PLOIEŞTI",130534,1,PART,PRCNCT,PRSD,PRSD_SV,"2025-05-18 21:41:45",1025,673,568,104,1,660,13,1300,627,237,423
31,PRAHOVA,"ŞCOALA GIMNAZIALĂ PROFESOR ”NICOLAE SIMACHE”",122,"MUNICIPIUL PLOIEŞTI",130534,1,PART,PRCNCT,PRSD,PRSD_SV,"2025-05-18 22:05:55",1329,756,695,61,0,743,13,1500,744,278,465
31,PRAHOVA,"ŞCOALA GIMNAZIALĂ PROFESOR ”NICOLAE SIMACHE”",123,"MUNICIPIUL PLOIEŞTI",130534,1,PART,PRCNCT,PRSD,PRSD_SV,"2025-05-18 21:43:35",1158,642,586,56,0,625,17,1300,658,230,395
31,PRAHOVA,"ŞCOALA GIMNAZIALĂ ”NICOLAE BĂLCESCU”",124,"MUNICIPIUL PLOIEŞTI",130534,1,PART,PRCNCT,PRSD,PRSD_SV,"2025-05-18 21:49:33",1303,755,682,73,0,744,11,1400,645,282,462
31,PRAHOVA,"ŞCOALA GIMNAZIALĂ ”NICOLAE BĂLCESCU”",125,"MUNICIPIUL PLOIEŞTI",130534,1,PART,PRCNCT,PRSD,PRSD_SV,"2025-05-18 22:16:24",1319,729,676,53,0,719,10,1400,671,295,424
31,PRAHOVA,"ŞCOALA GIMNAZIALĂ ”NICOLAE BĂLCESCU”",126,"MUNICIPIUL PLOIEŞTI",130534,1,PART,PRCNCT,PRSD,PRSD_SV,"2025-05-18 21:36:52",1350,688,651,37,0,681,7,1500,812,290,391
31,PRAHOVA,"ŞCOALA GIMNAZIALĂ ”NICOLAE BĂLCESCU”",127,"MUNICIPIUL PLOIEŞTI",130534,1,PART,PRCNCT,PRSD,PRSD_SV,"2025-05-18 21:49:01",942,514,492,22,0,506,8,1000,486,192,314
31,PRAHOVA,"GRĂDINIŢA CU PROGRAM NORMAL NR. 10 (FOSTA GRRĂDINIŢĂ DE COPII NR. 10)",128,"MUNICIPIUL PLOIEŞTI",130534,1,PART,PRCNCT,PRSD,PRSD_SV,"2025-05-18 21:55:31",1173,619,580,39,0,609,10,1300,681,253,356
31,PRAHOVA,"GRĂDINIŢA CU PROGRAM NORMAL NR. 10 (FOSTA GRRĂDINIŢĂ DE COPII NR. 10)",129,"MUNICIPIUL PLOIEŞTI",130534,1,PART,PRCNCT,PRSD,PRSD_SV,"2025-05-18 21:42:10",840,473,424,49,0,467,6,900,427,208,259
31,PRAHOVA,"GRĂDINIŢA CU PROGRAM NORMAL NR. 10 (FOSTA GRRĂDINIŢĂ DE COPII NR. 10)",130,"MUNICIPIUL PLOIEŞTI",130534,1,PART,PRCNCT,PRSD,PRSD_SV,"2025-05-18 22:07:09",986,526,488,38,0,517,9,1100,574,201,316
31,PRAHOVA,"GRĂDINIȚA CU PROGRAM PRELUNGIT NR. 23",131,"MUNICIPIUL PLOIEŞTI",130534,1,PART,PRCNCT,PRSD,PRSD_SV,"2025-05-18 21:32:23",946,522,488,34,0,515,7,1000,478,198,317
31,PRAHOVA,"ŞCOALA GIMNAZIALĂ ”ION CREANGĂ”",132,"MUNICIPIUL PLOIEŞTI",130534,1,PART,PRCNCT,PRSD,PRSD_SV,"2025-05-18 22:03:22",1301,763,655,108,0,749,14,1399,636,339,410
31,PRAHOVA,"ŞCOALA GIMNAZIALĂ ”ION CREANGĂ”",133,"MUNICIPIUL PLOIEŞTI",130534,1,PART,PRCNCT,PRSD,PRSD_SV,"2025-05-18 21:57:43",1155,705,656,49,0,697,8,1300,595,226,471
31,PRAHOVA,"ŞCOALA GIMNAZIALĂ ”ION CREANGĂ”",134,"MUNICIPIUL PLOIEŞTI",130534,1,PART,PRCNCT,PRSD,PRSD_SV,"2025-05-18 21:45:19",1109,710,654,44,12,700,10,1200,490,206,494
31,PRAHOVA,"ŞCOALA GIMNAZIALĂ ”ION CREANGĂ”",135,"MUNICIPIUL PLOIEŞTI",130534,1,PART,PRCNCT,PRSD,PRSD_SV,"2025-05-18 21:42:08",1086,677,646,30,1,666,11,1200,523,228,438
31,PRAHOVA,"ŞCOALA GIMNAZIALĂ ”ION CREANGĂ”",136,"MUNICIPIUL PLOIEŞTI",130534,1,PART,PRCNCT,PRSD,PRSD_SV,"2025-05-18 21:43:20",1236,744,713,29,2,734,10,1400,656,222,512
31,PRAHOVA,"ŞCOALA GIMNAZIALĂ ”ANDREI MUREŞANU” (ŞCOALA GIMNAZIALĂ ”ANDREI MUREŞEANU”)",137,"MUNICIPIUL PLOIEŞTI",130534,1,PART,PRCNCT,PRSD,PRSD_SV,"2025-05-18 21:36:58",1424,815,768,46,1,794,21,1600,785,231,563
31,PRAHOVA,"ŞCOALA GIMNAZIALĂ ”ANDREI MUREŞANU” (ŞCOALA GIMNAZIALĂ ”ANDREI MUREŞEANU)",138,"MUNICIPIUL PLOIEŞTI",130534,1,PART,PRCNCT,PRSD,PRSD_SV,"2025-05-18 22:04:54",1201,679,631,46,2,670,9,1296,617,264,406
31,PRAHOVA,"ŞCOALA GIMNAZIALĂ ”ANDREI MUREŞANU” (ŞCOALA GIMNAZIALĂ ”ANDREI MUREŞEANU)",139,"MUNICIPIUL PLOIEŞTI",130534,1,PART,PRCNCT,PRSD,PRSD_SV,"2025-05-18 21:47:21",868,464,437,25,2,454,10,1000,536,131,323
31,PRAHOVA,"ŞCOALA GIMNAZIALĂ ”HENRI MATHIAS BERTHELOT”",140,"MUNICIPIUL PLOIEŞTI",130534,1,PART,PRCNCT,PRSD,PRSD_SV,"2025-05-18 21:38:01",786,509,417,92,0,503,6,900,391,175,328
31,PRAHOVA,"ŞCOALA GIMNAZIALĂ ”HENRI MATHIAS BERTHELOT”",141,"MUNICIPIUL PLOIEŞTI",130534,1,PART,PRCNCT,PRSD,PRSD_SV,"2025-05-18 21:30:46",1038,672,594,78,0,662,10,1100,428,226,436
31,PRAHOVA,"ŞCOALA GIMNAZIALĂ ”HENRI MATHIAS BERTHELOT”",142,"MUNICIPIUL PLOIEŞTI",130534,1,PART,PRCNCT,PRSD,PRSD_SV,"2025-05-18 21:57:31",1486,951,865,86,0,936,15,1600,649,285,651
31,PRAHOVA,"ŞCOALA GIMNAZIALĂ ”GRIGORE MOISIL”",143,"MUNICIPIUL PLOIEŞTI",130534,1,PART,PRCNCT,PRSD,PRSD_SV,"2025-05-18 21:57:14",975,579,491,88,0,570,9,1100,521,218,352
31,PRAHOVA,"ŞCOALA GIMNAZIALĂ ”GRIGORE MOISIL”",144,"MUNICIPIUL PLOIEŞTI",130534,1,PART,PRCNCT,PRSD,PRSD_SV,"2025-05-18 22:17:38",1016,619,531,88,0,606,13,1100,481,222,384
31,PRAHOVA,"COLEGIUL NAŢIONAL ”NICHITA STĂNESCU”",145,"MUNICIPIUL PLOIEŞTI",130534,1,PART,PRCNCT,PRSD,PRSD_SV,"2025-05-18 21:58:04",817,530,431,99,0,523,7,900,370,204,319
31,PRAHOVA,"COLEGIUL NAŢIONAL ”NICHITA STĂNESCU”",146,"MUNICIPIUL PLOIEŞTI",130534,1,PART,PRCNCT,PRSD,PRSD_SV,"2025-05-18 21:47:53",875,518,470,46,2,509,9,1000,482,187,322
31,PRAHOVA,"COLEGIUL NAŢIONAL ”NICHITA STĂNESCU”",147,"MUNICIPIUL PLOIEŞTI",130534,1,PART,PRCNCT,PRSD,PRSD_SV,"2025-05-18 21:21:09",863,507,475,32,0,502,5,1000,493,175,327
31,PRAHOVA,"COLEGIUL NAŢIONAL ”NICHITA STĂNESCU”",148,"MUNICIPIUL PLOIEŞTI",130534,1,PART,PRCNCT,PRSD,PRSD_SV,"2025-05-18 22:11:57",1198,671,633,38,0,659,12,1300,629,286,373
31,PRAHOVA,"ȘCOALA GIMNAZIALĂ ”ANDREI MUREȘANU”",149,"MUNICIPIUL PLOIEŞTI",130534,1,PART,PRCNCT,PRSD,PRSD_SV,"2025-05-18 21:27:57",1251,694,638,54,2,685,9,1400,706,252,433
31,PRAHOVA,"ȘCOALA GIMNAZIALĂ ”ANDREI MUREȘANU”",150,"MUNICIPIUL PLOIEŞTI",130534,1,PART,PRCNCT,PRSD,PRSD_SV,"2025-05-18 21:48:49",1218,736,664,71,1,726,10,1300,564,269,457
31,PRAHOVA,"LICEUL TEHNOLOGIC DE SERVICII ”SFÂNTUL APOSTOL ANDREI”",151,"MUNICIPIUL PLOIEŞTI",130534,1,PART,PRCNCT,PRSD,PRSD_SV,"2025-05-18 21:28:33",1210,687,627,60,0,673,14,1300,613,277,396
31,PRAHOVA,"LICEUL TEHNOLOGIC DE SERVICII ”SFÂNTUL APOSTOL ANDREI”",152,"MUNICIPIUL PLOIEŞTI",130534,1,PART,PRCNCT,PRSD,PRSD_SV,"2025-05-18 21:47:33",1294,849,719,130,0,833,16,1400,551,289,544
31,PRAHOVA,"LICEUL TEHNOLOGIC DE SERVICII ”SFÂNTUL APOSTOL ANDREI”",153,"MUNICIPIUL PLOIEŞTI",130534,1,PART,PRCNCT,PRSD,PRSD_SV,"2025-05-18 21:41:54",1272,809,642,54,113,794,15,1400,591,307,487
31,PRAHOVA,"LICEUL TEHNOLOGIC DE SERVICII ”SFÂNTUL APOSTOL ANDREI”",154,"MUNICIPIUL PLOIEŞTI",130534,1,PART,PRCNCT,PRSD,PRSD_SV,"2025-05-18 22:20:43",1245,677,623,54,0,669,8,1400,723,249,420
31,PRAHOVA,"LICEUL TEHNOLOGIC DE SERVICII ”SFÂNTUL APOSTOL ANDREI”",155,"MUNICIPIUL PLOIEŞTI",130534,1,PART,PRCNCT,PRSD,PRSD_SV,"2025-05-18 21:33:23",1132,622,596,25,1,601,21,1300,678,232,369
31,PRAHOVA,"ŞCOALA PRIMARĂ NR. 22 (FOSTA ŞCOALĂ GIMNAZIALĂ ”MITICĂ APOSTOL”)",156,"MUNICIPIUL PLOIEŞTI",130534,1,PART,PRCNCT,PRSD,PRSD_SV,"2025-05-18 22:06:29",1424,822,755,67,0,812,10,1600,778,415,397
31,PRAHOVA,"GARA PLOIEŞTI TRIAJ",157,"MUNICIPIUL PLOIEŞTI",130534,1,PART,PRCNCT,PRSD,PRSD_SV,"2025-05-18 21:37:19",159,87,68,19,0,87,0,200,113,49,38
31,PRAHOVA,"CASA DE CULTURĂ ”GEO BOGZA”- (HOL)",158,"MUNICIPIUL CÂMPINA",131256,1,PART,PRCNCT,PRSD,PRSD_SV,"2025-05-18 21:55:27",1236,777,648,126,3,766,11,1400,623,245,521
31,PRAHOVA,"COLEGIUL NAŢIONAL”NICOLAE GRIGORESCU” - (SALA DE CLASA)",159,"MUNICIPIUL CÂMPINA",131256,1,PART,PRCNCT,PRSD,PRSD_SV,"2025-05-18 21:25:42",1057,706,566,140,0,696,10,1200,494,239,457
31,PRAHOVA,"COLEGIUL NAŢIONAL”NICOLAE GRIGORESCU” - (SALA DE CLASA)",160,"MUNICIPIUL CÂMPINA",131256,1,PART,PRCNCT,PRSD,PRSD_SV,"2025-05-18 21:41:33",1162,823,643,180,0,805,18,1300,477,240,565
31,PRAHOVA,"CASA TINERETULUI (HOL MARE)",161,"MUNICIPIUL CÂMPINA",131256,1,PART,PRCNCT,PRSD,PRSD_SV,"2025-05-18 21:38:16",968,630,453,176,1,624,6,1100,470,293,331
31,PRAHOVA,"ŞCOALA GIMNAZIALĂ CENTRALĂ",162,"MUNICIPIUL CÂMPINA",131256,1,PART,PRCNCT,PRSD,PRSD_SV,"2025-05-18 21:57:30",1015,628,508,56,64,626,2,1100,472,246,380
31,PRAHOVA,"ŞCOALA GIMNAZIALĂ CENTRALĂ",163,"MUNICIPIUL CÂMPINA",131256,1,PART,PRCNCT,PRSD,PRSD_SV,"2025-05-18 21:35:32",1159,749,604,143,2,738,11,1300,551,250,488
31,PRAHOVA,"LICEUL TEHNOLOGIC ENERGETIC -(CORP A-SALA DE CLASA NR.5-INTRAREA SECUNDARA)",164,"MUNICIPIUL CÂMPINA",131256,1,PART,PRCNCT,PRSD,PRSD_SV,"2025-05-18 21:27:55",998,682,557,59,66,669,13,1100,418,223,446
31,PRAHOVA,"LICEUL TEHNOLOGIC ENERGETIC - (CORP A SALA DE CLASA NR.3-INTRAREA PRINCIPALA)",165,"MUNICIPIUL CÂMPINA",131256,1,PART,PRCNCT,PRSD,PRSD_SV,"2025-05-18 21:50:57",815,544,395,81,68,535,9,900,356,220,315
31,PRAHOVA,"ȘCOALA GIMNAZIALĂ ”B.P.HASDEU” - (SALA DE SPORT)",166,"MUNICIPIUL CÂMPINA",131256,1,PART,PRCNCT,PRSD,PRSD_SV,"2025-05-18 21:57:35",1195,603,530,73,0,593,10,1300,697,215,378
31,PRAHOVA,"CASA TINERETULUI (HOL MIC)",167,"MUNICIPIUL CÂMPINA",131256,1,PART,PRCNCT,PRSD,PRSD_SV,"2025-05-18 21:57:31",1344,745,685,59,1,739,6,1500,755,266,473
31,PRAHOVA,"COLEGIUL TEHNIC FORESTIER - (SALA DE SPORT)",168,"MUNICIPIUL CÂMPINA",131256,1,PART,PRCNCT,PRSD,PRSD_SV,"2025-05-18 21:44:20",1083,686,605,80,1,672,14,1200,514,205,467
31,PRAHOVA,"COLEGIUL TEHNIC FORESTIER - (SALA DE SPORT)",169,"MUNICIPIUL CÂMPINA",131256,1,PART,PRCNCT,PRSD,PRSD_SV,"2025-05-18 21:30:46",1172,680,623,55,2,669,11,1300,620,246,423
31,PRAHOVA,"COLEGIUL TEHNIC CONSTANTIN ISTRATI (CAMIN)",170,"MUNICIPIUL CÂMPINA",131256,1,PART,PRCNCT,PRSD,PRSD_SV,"2025-05-18 21:49:21",1534,900,825,74,1,886,14,1700,800,328,558
31,PRAHOVA,"COLEGIUL TEHNIC CONSTANTIN ISTRATI - SALA DE CLASA)",171,"MUNICIPIUL CÂMPINA",131256,1,PART,PRCNCT,PRSD,PRSD_SV,"2025-05-18 21:42:57",1489,917,803,83,31,900,17,1600,683,356,544
31,PRAHOVA,"ȘCOALA GENERALĂ NR.5 - (SALA DE CLASA)",172,"MUNICIPIUL CÂMPINA",131256,1,PART,PRCNCT,PRSD,PRSD_SV,"2025-05-18 21:47:36",1156,777,670,107,0,767,10,1300,523,266,501
31,PRAHOVA,"LICEUL TEHNOLOGIC MECANIC - (SALA DE SPORT)",173,"MUNICIPIUL CÂMPINA",131256,1,PART,PRCNCT,PRSD,PRSD_SV,"2025-05-18 22:09:13",1427,776,733,43,0,757,19,1600,824,287,470
31,PRAHOVA,"LICEUL TEHNOLOGIC MECANIC - (CORP A SALA 2)",174,"MUNICIPIUL CÂMPINA",131256,1,PART,PRCNCT,PRSD,PRSD_SV,"2025-05-18 21:43:25",1187,703,659,42,2,692,11,1300,597,258,434
31,PRAHOVA,"LICEUL TEHNOLOGIC MECANIC - (CORP A SALA 3)",175,"MUNICIPIUL CÂMPINA",131256,1,PART,PRCNCT,PRSD,PRSD_SV,"2025-05-18 21:59:40",1385,775,707,68,0,762,13,1500,725,371,391
31,PRAHOVA,"ȘCOALA GENERALĂ NR.6 - (SALA DE CLASA)",176,"MUNICIPIUL CÂMPINA",131256,1,PART,PRCNCT,PRSD,PRSD_SV,"2025-05-18 22:01:29",1498,841,774,67,0,826,15,1600,759,412,414
31,PRAHOVA,"ȘCOALA GIMNAZIALĂ ”ALEXANDRU IOAN CUZA” - (SALA DE CLASA-ETAJ 1)",177,"MUNICIPIUL CÂMPINA",131256,1,PART,PRCNCT,PRSD,PRSD_SV,"2025-05-18 21:55:22",1545,1130,919,208,3,1118,12,1700,570,336,782
31,PRAHOVA,"ȘCOALA GIMNAZIALĂ ”ALEXANDRU IOAN CUZA” - (SALA DE SPORT)",178,"MUNICIPIUL CÂMPINA",131256,1,PART,PRCNCT,PRSD,PRSD_SV,"2025-05-18 21:51:54",1586,1072,909,160,3,1063,9,1700,628,390,673
31,PRAHOVA,"GRADINITA CU PROGRAM NORMAL NR.3(SALA DE CLASA SI DE JOC)",179,"MUNICIPIUL CÂMPINA",131256,2,PART,PRCNCT,PRSD,PRSD_SV,"2025-05-19 01:45:41",1583,873,806,65,2,866,7,1700,827,415,451
31,PRAHOVA,"ȘCOALA GENERALĂ NR.3 - (SALA DE SPORT)",180,"MUNICIPIUL CÂMPINA",131256,1,PART,PRCNCT,PRSD,PRSD_SV,"2025-05-18 22:03:39",1743,1152,965,136,51,1136,16,1900,748,514,622
31,PRAHOVA,"LICEUL TEORETIC AZUGA",181,"ORAŞ AZUGA",130954,1,PART,PRCNCT,PRSD,PRSD_SV,"2025-05-18 22:29:06",1614,1078,799,238,41,1064,14,1800,722,564,500
31,PRAHOVA,"GRĂDINIŢA CU PROGRAM PRELUNGIT",182,"ORAŞ AZUGA",130954,1,PART,PRCNCT,PRSD,PRSD_SV,"2025-05-18 22:42:29",989,580,486,93,1,567,13,1100,520,266,301
31,PRAHOVA,"SALǍ DE SPORT CU TRIBUNǍ 180 LOCURI",183,"ORAŞ AZUGA",130954,1,PART,PRCNCT,PRSD,PRSD_SV,"2025-05-18 22:34:15",1147,776,604,172,0,764,12,1300,524,337,427
31,PRAHOVA,"SALA DE SPORT TINERETULUI",184,"ORAŞ BĂICOI",130981,1,PART,PRCNCT,PRSD,PRSD_SV,"2025-05-18 21:50:16",1039,768,615,111,42,754,14,1100,332,336,418
31,PRAHOVA,"GRADINITA CU PROGRAM NORMAL TUFENI",185,"ORAŞ BĂICOI",130981,1,PART,PRCNCT,PRSD,PRSD_SV,"2025-05-18 22:15:49",1198,748,678,70,0,741,7,1300,552,342,399
31,PRAHOVA,"CLUBUL ELEVILOR",186,"ORAŞ BĂICOI",130981,1,PART,PRCNCT,PRSD,PRSD_SV,"2025-05-18 21:23:47",1383,932,838,91,3,919,13,1500,568,399,520
31,PRAHOVA,"GR. SC. C-TIN CANTACUZINO",187,"ORAŞ BĂICOI",130981,1,PART,PRCNCT,PRSD,PRSD_SV,"2025-05-18 21:43:10",1134,719,623,96,0,703,16,1300,581,316,387
31,PRAHOVA,"GR. SC. C-TIN CANTACUZINO",188,"ORAŞ BĂICOI",130981,1,PART,PRCNCT,PRSD,PRSD_SV,"2025-05-18 21:40:11",1074,747,638,107,2,734,13,1200,453,295,439
31,PRAHOVA,"GRADINITA LILIESTI",189,"ORAŞ BĂICOI",130981,2,PART,PRCNCT,PRSD,PRSD_SV,"2025-05-18 23:01:20",995,567,545,22,0,555,12,1100,533,290,265
31,PRAHOVA,"GRADINITA LILIESTI",190,"ORAŞ BĂICOI",130981,1,PART,PRCNCT,PRSD,PRSD_SV,"2025-05-18 21:36:39",1007,654,586,67,1,646,8,1100,446,284,362
31,PRAHOVA,"SCOALA NUMARUL 3 LILIESTI",191,"ORAŞ BĂICOI",130981,1,PART,PRCNCT,PRSD,PRSD_SV,"2025-05-18 21:46:11",1359,754,705,49,0,740,14,1500,746,385,355
31,PRAHOVA,"SCOALA NUMARUL 3 LILIESTI SALA NR. 2",192,"ORAŞ BĂICOI",130981,1,PART,PRCNCT,PRSD,PRSD_SV,"2025-05-18 21:49:07",1534,988,900,88,0,973,15,1700,712,421,552
31,PRAHOVA,"CASA DE CULTURA LILIESTI",193,"ORAŞ BĂICOI",130981,1,PART,PRCNCT,PRSD,PRSD_SV,"2025-05-18 21:47:09",1355,919,802,98,19,908,11,1500,581,454,454
31,PRAHOVA,"GRĂDINIŢA DÂMBU",194,"ORAŞ BĂICOI",130981,1,PART,PRCNCT,PRSD,PRSD_SV,"2025-05-18 21:19:48",1080,586,546,40,0,582,4,1200,614,352,230
31,PRAHOVA,"SCOALA GENERALA TINTEA",195,"ORAŞ BĂICOI",130981,1,PART,PRCNCT,PRSD,PRSD_SV,"2025-05-18 21:45:07",1252,786,692,94,0,779,7,1400,614,425,354
31,PRAHOVA,"CASA DE CULTURA TINTEA",196,"ORAŞ BĂICOI",130981,2,PART,PRCNCT,PRSD,PRSD_SV,"2025-05-19 01:37:46",974,657,585,72,0,650,7,1100,443,324,326
31,PRAHOVA,"ȘCOALA GIMNAZIALĂ ”MIHAI VITEAZUL”",197,"ORAŞ BOLDEŞTI-SCĂENI",131069,1,PART,PRCNCT,PRSD,PRSD_SV,"2025-05-18 21:26:30",978,667,551,91,25,657,10,1100,433,315,342
31,PRAHOVA,"ȘCOALA GIMNAZIALĂ ”MIHAI VITEAZUL”",198,"ORAŞ BOLDEŞTI-SCĂENI",131069,1,PART,PRCNCT,PRSD,PRSD_SV,"2025-05-18 21:35:42",1117,728,674,54,0,717,11,1200,472,369,348
31,PRAHOVA,"ȘCOALA GIMNAZIALĂ ”MIHAI VITEAZUL”",199,"ORAŞ BOLDEŞTI-SCĂENI",131069,1,PART,PRCNCT,PRSD,PRSD_SV,"2025-05-18 21:53:21",1244,740,696,42,2,735,5,1400,660,372,363
31,PRAHOVA,"GRĂDINIŢA CU PROGRAM NORMAL, NR.1",200,"ORAŞ BOLDEŞTI-SCĂENI",131069,1,PART,PRCNCT,PRSD,PRSD_SV,"2025-05-18 21:35:12",1423,758,706,49,3,753,5,1600,842,454,299
31,PRAHOVA,"ȘCOALA GIMNAZIALĂ NR.2",201,"ORAŞ BOLDEŞTI-SCĂENI",131069,1,PART,PRCNCT,PRSD,PRSD_SV,"2025-05-18 21:37:43",909,583,533,47,3,578,5,1000,417,257,321
31,PRAHOVA,"ȘCOALA GIMNAZIALĂ NR.2",202,"ORAŞ BOLDEŞTI-SCĂENI",131069,1,PART,PRCNCT,PRSD,PRSD_SV,"2025-05-18 21:46:41",1049,720,631,88,1,708,12,1200,480,374,334
31,PRAHOVA,"CASA DE CULTURĂ ”MIHAI EMINESCU”",203,"ORAŞ BOLDEŞTI-SCĂENI",131069,1,PART,PRCNCT,PRSD,PRSD_SV,"2025-05-18 21:51:39",833,567,501,66,0,557,10,900,333,270,287
31,PRAHOVA,"LICEUL TEHNOLOGIC ”TEODOR DIAMANT”",204,"ORAŞ BOLDEŞTI-SCĂENI",131069,1,PART,PRCNCT,PRSD,PRSD_SV,"2025-05-18 21:45:49",978,599,530,69,0,590,9,1100,501,305,285
31,PRAHOVA,"ȘCOALA PRIMARĂ SECIU",205,"ORAŞ BOLDEŞTI-SCĂENI",131069,1,PART,PRCNCT,PRSD,PRSD_SV,"2025-05-18 21:22:51",814,486,421,65,0,481,5,900,414,279,202
31,PRAHOVA,"ȘCOALA GIMNAZIALĂ BREAZA DE JOS",206,"ORAŞ BREAZA",131103,1,PART,PRCNCT,PRSD,PRSD_SV,"2025-05-18 21:24:57",890,590,466,124,0,584,6,1000,410,195,389
31,PRAHOVA,"ȘCOALA GIMNAZIALĂ BREAZA DE JOS",207,"ORAŞ BREAZA",131103,1,PART,PRCNCT,PRSD,PRSD_SV,"2025-05-18 21:31:00",973,625,500,117,8,618,7,1100,475,222,396
31,PRAHOVA,"LICEUL TEORETIC ”AUREL VLAICU” BREAZA",208,"ORAŞ BREAZA",131103,1,PART,PRCNCT,PRSD,PRSD_SV,"2025-05-18 21:43:04",1357,997,721,274,2,978,19,1500,503,413,565
31,PRAHOVA,"LICEUL TEORETIC ”AUREL VLAICU” BREAZA",209,"ORAŞ BREAZA",131103,1,PART,PRCNCT,PRSD,PRSD_SV,"2025-05-18 21:38:04",1025,620,522,71,27,612,8,1100,480,194,418
31,PRAHOVA,"LICEUL TEORETIC ”AUREL VLAICU” BREAZA",210,"ORAŞ BREAZA",131103,1,PART,PRCNCT,PRSD,PRSD_SV,"2025-05-18 21:37:28",1513,910,817,93,0,902,8,1600,690,336,566
31,PRAHOVA,"LICEUL TEORETIC ”AUREL VLAICU” BREAZA",211,"ORAŞ BREAZA",131103,1,PART,PRCNCT,PRSD,PRSD_SV,"2025-05-18 21:36:06",808,651,420,231,0,642,9,900,249,233,409
31,PRAHOVA,"SALA DE SPORT VIRGIL DUDĂU BREAZA",212,"ORAŞ BREAZA",131103,1,PART,PRCNCT,PRSD,PRSD_SV,"2025-05-18 21:37:06",794,481,408,73,0,475,6,900,419,158,317
31,PRAHOVA,"ȘCOALA GIMNAZIALĂ ”CONSTANTIN BRÂNCOVEANU” BREAZA",213,"ORAŞ BREAZA",131103,1,PART,PRCNCT,PRSD,PRSD_SV,"2025-05-18 21:57:31",1253,958,753,201,4,951,7,1400,442,337,614
31,PRAHOVA,"GRĂDINIŢA CU PROGRAM NORMAL GURA BELIEI ”ALBINUŢA”",214,"ORAŞ BREAZA",131103,1,PART,PRCNCT,PRSD,PRSD_SV,"2025-05-18 21:54:38",1020,672,542,129,1,660,12,1098,426,308,352
31,PRAHOVA,"ȘCOALA GIMNAZIALĂ NISTOREȘTI",215,"ORAŞ BREAZA",131103,1,PART,PRCNCT,PRSD,PRSD_SV,"2025-05-18 21:53:28",1041,656,513,143,0,647,9,1200,544,275,372
31,PRAHOVA,"GRĂDINIȚA CU PROGRAM NORMAL PODU VADULUI",216,"ORAŞ BREAZA",131103,1,PART,PRCNCT,PRSD,PRSD_SV,"2025-05-18 21:39:32",1269,851,667,184,0,838,13,1400,549,335,503
31,PRAHOVA,"GRĂDINIȚA CU PROGRAM NORMAL VALEA TÂRSEI ”FREAMĂT DE CODRU”",217,"ORAŞ BREAZA",131103,1,PART,PRCNCT,PRSD,PRSD_SV,"2025-05-18 21:30:44",1211,643,583,60,0,635,8,1300,657,357,278
31,PRAHOVA,"COLEGIUL ION KALINDERU",218,"ORAŞ BUŞTENI",131210,1,PART,PRCNCT,PRSD,PRSD_SV,"2025-05-18 22:02:32",857,741,471,268,2,732,9,900,159,297,435
31,PRAHOVA,"ŞCOALA GIMNAZIALĂ ”NESTOR URECHIA”",219,"ORAŞ BUŞTENI",131210,1,PART,PRCNCT,PRSD,PRSD_SV,"2025-05-18 21:58:10",912,743,473,268,2,733,10,1000,257,292,441
31,PRAHOVA,"ŞCOALA GIMNAZIALĂ ”NESTOR URECHIA”",220,"ORAŞ BUŞTENI",131210,1,PART,PRCNCT,PRSD,PRSD_SV,"2025-05-18 21:55:40",884,799,477,320,2,780,19,1000,201,309,471
31,PRAHOVA,"GRĂDINIŢA CU PP SI PN ”FRAM - URSUL POLAR”",221,"ORAŞ BUŞTENI",131210,1,PART,PRCNCT,PRSD,PRSD_SV,"2025-05-18 21:38:37",528,412,285,127,0,407,5,600,188,138,269
31,PRAHOVA,"SEDIU FIRMĂ PAZĂ",222,"ORAŞ BUŞTENI",131210,1,PART,PRCNCT,PRSD,PRSD_SV,"2025-05-18 22:16:07",1361,1062,729,333,0,1049,13,1500,438,457,592
31,PRAHOVA,"ŞCOALA GIMNAZIALĂ ”REGINA ELISABETA”",223,"ORAŞ BUŞTENI",131210,1,PART,PRCNCT,PRSD,PRSD_SV,"2025-05-18 22:22:25",1235,927,705,221,1,914,13,1400,473,422,492
31,PRAHOVA,"ŞCOALA GIMNAZIALĂ ”CEZAR PETRESCU”",224,"ORAŞ BUŞTENI",131210,1,PART,PRCNCT,PRSD,PRSD_SV,"2025-05-18 21:51:04",1212,777,628,147,2,772,5,1300,523,407,365
31,PRAHOVA,"ŞCOALA GIMNAZIALĂ ”CEZAR PETRESCU”",225,"ORAŞ BUŞTENI",131210,1,PART,PRCNCT,PRSD,PRSD_SV,"2025-05-18 21:54:34",786,529,398,131,0,519,10,900,371,219,300
31,PRAHOVA,"LICEUL SIMION STOLNICU",226,"ORAŞ COMARNIC",131336,1,PART,PRCNCT,PRSD,PRSD_SV,"2025-05-18 21:50:17",1464,884,763,120,1,875,9,1600,716,351,524
31,PRAHOVA,"SCOALA GIMNAZIALA COMARNIC NR.2",227,"ORAŞ COMARNIC",131336,1,PART,PRCNCT,PRSD,PRSD_SV,"2025-05-18 21:34:50",774,495,438,57,0,490,5,900,405,179,311
31,PRAHOVA,"SCOALA GIMNAZIALA COMARNIC NR.2",228,"ORAŞ COMARNIC",131336,1,PART,PRCNCT,PRSD,PRSD_SV,"2025-05-18 22:01:07",1232,651,609,42,0,645,6,1400,749,314,331
31,PRAHOVA,"SCOALA PRIMARA GHIOȘEȘTI",229,"ORAŞ COMARNIC",131336,1,PART,PRCNCT,PRSD,PRSD_SV,"2025-05-18 21:29:03",1048,553,516,37,0,550,3,1200,647,303,247
31,PRAHOVA,"GRADINITA CU PROGRAM NORMAL GHIOȘEȘTI",230,"ORAŞ COMARNIC",131336,1,PART,PRCNCT,PRSD,PRSD_SV,"2025-05-18 21:35:43",1550,918,794,124,0,900,18,1700,782,449,451
31,PRAHOVA,"GRADINITA CU PROGRAM NORMAL PODUL LUNG",231,"ORAŞ COMARNIC",131336,1,PART,PRCNCT,PRSD,PRSD_SV,"2025-05-18 21:25:45",457,256,221,35,0,253,3,500,244,136,117
31,PRAHOVA,"SCOALA GIMNAZIALA COMARNIC",232,"ORAŞ COMARNIC",131336,1,PART,PRCNCT,PRSD,PRSD_SV,"2025-05-18 21:37:15",1360,775,695,80,0,770,5,1500,725,419,351
31,PRAHOVA,"GRADINITA CU PROGRAM NORMAL POIANA",233,"ORAŞ COMARNIC",131336,1,PART,PRCNCT,PRSD,PRSD_SV,"2025-05-18 21:37:01",822,478,432,46,0,475,3,900,422,213,262
31,PRAHOVA,"GRADINITA CU PROGRAM NORMAL POSADA",234,"ORAŞ COMARNIC",131336,1,PART,PRCNCT,PRSD,PRSD_SV,"2025-05-18 21:44:34",1066,599,540,59,0,592,7,1200,601,286,306
31,PRAHOVA,"SALA DE SPORT MIZIL",235,"ORAŞ MIZIL",131407,1,PART,PRCNCT,PRSD,PRSD_SV,"2025-05-18 21:39:22",1573,664,624,40,0,654,10,1700,1036,340,314
31,PRAHOVA,"ŞCOALA GIMNAZIALĂ ” SFÂNTUL NICOLAE ”MIZIL",236,"ORAŞ MIZIL",131407,1,PART,PRCNCT,PRSD,PRSD_SV,"2025-05-18 21:44:39",1237,549,510,39,0,546,3,1400,851,348,198
31,PRAHOVA,"ŞCOALA GIMNAZIALĂ NR.1 MIZIL",237,"ORAŞ MIZIL",131407,1,PART,PRCNCT,PRSD,PRSD_SV,"2025-05-18 21:44:05",945,444,417,27,0,440,4,1000,556,180,260
31,PRAHOVA,"LICEUL TEHNOLOGIC ”TASE DUMITRESCU” MIZIL",238,"ORAŞ MIZIL",131407,1,PART,PRCNCT,PRSD,PRSD_SV,"2025-05-18 21:33:18",834,472,397,75,0,465,7,900,428,183,282
31,PRAHOVA,"LICEUL TEHNOLOGIC ”TASE DUMITRESCU ” MIZIL",239,"ORAŞ MIZIL",131407,1,PART,PRCNCT,PRSD,PRSD_SV,"2025-05-18 21:38:55",1007,335,295,40,0,330,5,1100,765,208,122
31,PRAHOVA,"PRIMĂRIA ORAŞ MIZIL",240,"ORAŞ MIZIL",131407,1,PART,PRCNCT,PRSD,PRSD_SV,"2025-05-18 21:56:47",989,574,496,76,2,570,4,1100,526,206,364
31,PRAHOVA,"PRIMĂRIA ORAŞ MIZIL",241,"ORAŞ MIZIL",131407,1,PART,PRCNCT,PRSD,PRSD_SV,"2025-05-18 21:36:51",999,538,494,43,1,525,13,1100,562,215,310
31,PRAHOVA,"CENTRUL CULTURAL ”ADRIAN PĂUNESCU”",242,"ORAŞ MIZIL",131407,1,PART,PRCNCT,PRSD,PRSD_SV,"2025-05-18 21:49:46",1371,724,667,57,0,714,10,1500,776,411,303
31,PRAHOVA,"ŞCOALA GIMNAZIALĂ ” SFÂNTA MARIA ”MIZIL",243,"ORAŞ MIZIL",131407,1,PART,PRCNCT,PRSD,PRSD_SV,"2025-05-18 21:55:27",936,458,404,53,1,449,9,1000,542,225,224
31,PRAHOVA,"ŞCOALA GIMNAZIALĂ ” SFÂNTA MARIA ”MIZIL",244,"ORAŞ MIZIL",131407,1,PART,PRCNCT,PRSD,PRSD_SV,"2025-05-18 21:52:55",1025,598,549,49,0,592,6,1100,502,283,309
31,PRAHOVA,"LICEUL TEORETIC ” GRIGORE TOCILESCU” MIZIL",245,"ORAŞ MIZIL",131407,1,PART,PRCNCT,PRSD,PRSD_SV,"2025-05-18 21:53:01",979,497,452,44,1,493,4,1100,603,235,258
31,PRAHOVA,"CASA DE CULTURĂ PLOPENI",246,"ORAŞ PLOPENI",131443,1,PART,PRCNCT,PRSD,PRSD_SV,"2025-05-18 21:52:26",1190,735,646,80,9,715,20,1300,565,273,442
31,PRAHOVA,"SALA POLIVALENTĂ PLOPENI",247,"ORAŞ PLOPENI",131443,1,PART,PRCNCT,PRSD,PRSD_SV,"2025-05-18 21:54:39",1097,656,581,74,1,639,17,1200,544,289,350
31,PRAHOVA,"SALA POLIVALENTĂ PLOPENI",248,"ORAŞ PLOPENI",131443,1,PART,PRCNCT,PRSD,PRSD_SV,"2025-05-18 21:42:30",1016,604,554,49,1,584,20,1100,496,230,354
31,PRAHOVA,"LICEUL CAROL I ORAŞUL PLOPENI",249,"ORAŞ PLOPENI",131443,1,PART,PRCNCT,PRSD,PRSD_SV,"2025-05-18 21:39:14",1037,578,518,44,16,569,9,1100,522,234,335
31,PRAHOVA,"LICEUL CAROL I ORAŞUL PLOPENI",250,"ORAŞ PLOPENI",131443,1,PART,PRCNCT,PRSD,PRSD_SV,"2025-05-18 21:35:08",1357,754,707,45,2,742,12,1500,746,394,348
31,PRAHOVA,"LICEUL CAROL I ORAŞUL PLOPENI",251,"ORAŞ PLOPENI",131443,1,PART,PRCNCT,PRSD,PRSD_SV,"2025-05-18 21:38:37",1278,811,731,74,6,796,15,1400,589,334,462
31,PRAHOVA,"COLEGIUL ”MIHAIL CANTACUZINO” SALA AP.1",252,"ORAŞ SINAIA",131540,1,PART,PRCNCT,PRSD,PRSD_SV,"2025-05-18 21:52:01",1504,906,832,74,0,889,17,1700,794,362,527
31,PRAHOVA,"COLEGIUL ”MIHAIL CANTACUZINO” SALA AP.2",253,"ORAŞ SINAIA",131540,1,PART,PRCNCT,PRSD,PRSD_SV,"2025-05-18 21:55:09",960,618,507,111,0,604,14,800,182,227,377
31,PRAHOVA,"GRĂDINIȚA NR.2 CU PROGRAM NORMAL ”FLUTURAȘII”",254,"ORAŞ SINAIA",131540,1,PART,PRCNCT,PRSD,PRSD_SV,"2025-05-18 21:40:50",729,502,372,107,23,493,9,800,298,198,295
31,PRAHOVA,"SCOALA GIMNAZIALA ”PRINCIPESA MARIA”CORP A",255,"ORAŞ SINAIA",131540,1,PART,PRCNCT,PRSD,PRSD_SV,"2025-05-18 21:32:10",632,477,333,142,2,472,5,700,223,147,325
31,PRAHOVA,"SCOALA GIMNAZIALA ”PRINCIPESA MARIA”CORP A",256,"ORAŞ SINAIA",131540,1,PART,PRCNCT,PRSD,PRSD_SV,"2025-05-18 21:44:29",949,656,548,107,1,641,15,1000,344,250,391
31,PRAHOVA,"IMOBIL PROPRIETATE ORAS SINAIA",257,"ORAŞ SINAIA",131540,1,PART,PRCNCT,PRSD,PRSD_SV,"2025-05-18 21:49:30",833,502,424,76,2,490,12,900,398,170,320
31,PRAHOVA,"CLUBUL SPORTIV CARPAŢI - SALA DE SPORT",258,"ORAŞ SINAIA",131540,1,PART,PRCNCT,PRSD,PRSD_SV,"2025-05-18 21:53:17",733,519,354,165,0,514,5,600,81,227,287
31,PRAHOVA,"ŞCOALA GIMNAZIALA ”GEORGE ENESCU” SALA 3 B",259,"ORAŞ SINAIA",131540,1,PART,PRCNCT,PRSD,PRSD_SV,"2025-05-18 22:15:37",453,790,199,590,1,775,15,1000,210,261,514
31,PRAHOVA,"ŞCOALA GIMNAZIALA ”GEORGE ENESCU” SALA I B",260,"ORAŞ SINAIA",131540,1,PART,PRCNCT,PRSD,PRSD_SV,"2025-05-18 21:57:07",763,608,366,241,1,599,9,800,192,224,375
31,PRAHOVA,"CENTRUL CULTURAL ”CARMEN SYLVA”",261,"ORAŞ SINAIA",131540,1,PART,PRCNCT,PRSD,PRSD_SV,"2025-05-18 21:21:50",477,313,223,89,1,311,2,500,187,116,195
31,PRAHOVA,"CENTRU DE ZI PENTRU COPII ”ACUM AU NEVOIE DE NOI”",262,"ORAŞ SINAIA",131540,1,PART,PRCNCT,PRSD,PRSD_SV,"2025-05-18 21:38:43",521,318,267,50,1,313,5,400,82,125,188
31,PRAHOVA,"CENTRUL INTERNATIONAL DE CONFERINŢE CASINO",263,"ORAŞ SINAIA",131540,1,PART,PRCNCT,PRSD,PRSD_SV,"2025-05-18 21:31:46",561,1049,280,769,0,1033,16,1200,151,312,721
31,PRAHOVA,"LICEUL TEORETIC ”ŞERBAN VODĂ”",264,"ORAŞ SLĂNIC",131577,1,PART,PRCNCT,PRSD,PRSD_SV,"2025-05-18 21:32:47",1015,662,496,165,1,649,13,1100,438,329,320
31,PRAHOVA,"LICEUL TEORETIC ”ŞERBAN VODĂ”",265,"ORAŞ SLĂNIC",131577,1,PART,PRCNCT,PRSD,PRSD_SV,"2025-05-18 21:21:11",1113,720,524,190,6,711,9,1200,480,351,360
31,PRAHOVA,"SCOALA GROSANI",266,"ORAŞ SLĂNIC",131577,1,PART,PRCNCT,PRSD,PRSD_SV,"2025-05-18 21:33:08",1286,772,689,83,0,763,9,1400,628,464,299
31,PRAHOVA,"GRĂDINIȚA CU PROGRAM NORMAL NR.2",267,"ORAŞ SLĂNIC",131577,1,PART,PRCNCT,PRSD,PRSD_SV,"2025-05-18 21:47:54",912,615,512,100,3,601,14,1000,385,308,293
31,PRAHOVA,"GRĂDINIŢA DE COPII CU PROGRAM PRELUNGIT ”CLOPOȚICA” ORAȘUL URLAȚI",268,"ORAŞ URLAŢI",131620,1,PART,PRCNCT,PRSD,PRSD_SV,"2025-05-18 21:44:13",1520,868,799,69,0,855,13,1700,832,454,401
31,PRAHOVA,"LICEUL TEORETIC ”BRÂNCOVEANU VODĂ” ORAȘUL URLATI (CLADIREA VECHE)",269,"ORAŞ URLAŢI",131620,1,PART,PRCNCT,PRSD,PRSD_SV,"2025-05-18 22:11:06",1439,810,701,107,2,796,14,1600,790,374,422
31,PRAHOVA,"LICEUL TEORETIC ”BRÂNCOVEANU VODĂ” ORAȘUL URLAȚI",270,"ORAŞ URLAŢI",131620,1,PART,PRCNCT,PRSD,PRSD_SV,"2025-05-18 22:06:31",1421,813,679,116,18,800,13,1600,787,481,319
31,PRAHOVA,"ŞCOALA GIMNAZIALĂ ”CĂNUŢĂ IONESCU” ORAȘUL URLATI",271,"ORAŞ URLAŢI",131620,1,PART,PRCNCT,PRSD,PRSD_SV,"2025-05-18 21:37:29",1599,955,873,80,2,940,15,1800,845,527,413
31,PRAHOVA,"”CASA DE CULTURĂ” ORAȘUL URLAŢI",272,"ORAŞ URLAŢI",131620,1,PART,PRCNCT,PRSD,PRSD_SV,"2025-05-18 22:13:04",1403,876,758,116,2,862,14,1500,624,451,411
31,PRAHOVA,"GRĂDINIȚA CU PROGRAM NORMAL ”JERCĂLĂI” ORAȘUL URLAȚI",273,"ORAŞ URLAŢI",131620,1,PART,PRCNCT,PRSD,PRSD_SV,"2025-05-18 21:49:39",720,335,304,31,0,331,4,800,465,207,124
31,PRAHOVA,"GRĂDINIȚA CU PROGRAM NORMAL ”VALEA URLOI” ORAȘUL URLAȚI",274,"ORAŞ URLAŢI",131620,1,PART,PRCNCT,PRSD,PRSD_SV,"2025-05-18 21:37:56",901,510,447,63,0,505,5,1000,490,328,177
31,PRAHOVA,"CENTRUL CULTURAL ”NICOLAE IORGA” VĂLENII DE MUNTE (BIBLIOTECA ORĂȘENEASCĂ ”MIRON RADU PARASCHIVESCU”)",275,"ORAŞ VĂLENII DE MUNTE",131817,1,PART,PRCNCT,PRSD,PRSD_SV,"2025-05-18 21:57:01",960,542,483,59,0,530,12,1100,558,228,302
31,PRAHOVA,"CASA DE CULTURĂ (SALA MICĂ)",276,"ORAŞ VĂLENII DE MUNTE",131817,1,PART,PRCNCT,PRSD,PRSD_SV,"2025-05-18 22:17:09",1344,858,746,112,0,847,11,1500,642,447,400
31,PRAHOVA,"CASA DE CULTURĂ (FOAIER)",277,"ORAŞ VĂLENII DE MUNTE",131817,1,PART,PRCNCT,PRSD,PRSD_SV,"2025-05-18 21:58:20",1043,722,507,215,0,710,12,1100,378,350,360
31,PRAHOVA,"CLUBUL COPIILOR",278,"ORAŞ VĂLENII DE MUNTE",131817,1,PART,PRCNCT,PRSD,PRSD_SV,"2025-05-18 21:50:40",844,514,458,54,2,509,5,900,386,209,300
31,PRAHOVA,"ȘCOALA GIMNAZIALĂ ”INGINER GHEORGHE PĂNCULESCU”",279,"ORAŞ VĂLENII DE MUNTE",131817,1,PART,PRCNCT,PRSD,PRSD_SV,"2025-05-18 22:05:40",1229,824,699,122,3,813,11,1400,576,405,408
31,PRAHOVA,"GRĂDINIȚA CU PROGRAM NORMAL NR. 1",280,"ORAŞ VĂLENII DE MUNTE",131817,1,PART,PRCNCT,PRSD,PRSD_SV,"2025-05-18 22:01:06",1417,940,743,156,41,926,14,1600,660,473,453
31,PRAHOVA,"GRĂDINIȚA CU PROGRAM NORMAL NR. 4",281,"ORAŞ VĂLENII DE MUNTE",131817,1,PART,PRCNCT,PRSD,PRSD_SV,"2025-05-18 21:57:33",972,592,544,48,0,586,6,1100,508,350,236
31,PRAHOVA,"LICEUL TEHNOLOGIC AGROMONTAN ”ROMEO CONSTANTINESCU”",282,"ORAŞ VĂLENII DE MUNTE",131817,1,PART,PRCNCT,PRSD,PRSD_SV,"2025-05-18 22:00:47",946,632,556,75,1,621,11,1000,368,303,318
31,PRAHOVA,"ȘCOALA PRIMARĂ NR.4 (MIULEȘTI)",283,"ORAŞ VĂLENII DE MUNTE",131817,1,PART,PRCNCT,PRSD,PRSD_SV,"2025-05-18 22:05:15",1288,863,720,143,0,855,8,1400,537,433,422
31,PRAHOVA,"ȘCOALA PRIMARĂ NR.2 (VALEA GARDULUI)",284,"ORAŞ VĂLENII DE MUNTE",131817,1,PART,PRCNCT,PRSD,PRSD_SV,"2025-05-18 21:52:46",825,567,518,49,0,562,5,898,331,369,193
31,PRAHOVA,"CĂMIN CULTURAL",285,ADUNAŢI,131899,1,PART,PRCNCT,PRSD,PRSD_SV,"2025-05-18 21:41:57",805,500,408,86,6,496,4,900,400,219,277
31,PRAHOVA,"GRĂDINIȚA „CASTELUL PITICILOR”",286,ADUNAŢI,131899,1,PART,PRCNCT,PRSD,PRSD_SV,"2025-05-18 21:43:29",769,448,407,31,10,439,9,800,352,190,249
31,PRAHOVA,"SCOALA GIMNAZIALA CLASELE I-VIII ALBESTI PALEOLOGU",287,ALBEŞTI-PALEOLOGU,131933,1,PART,PRCNCT,PRSD,PRSD_SV,"2025-05-18 21:33:01",1448,896,755,141,0,892,4,1600,704,508,384
31,PRAHOVA,"SCOALA GIMNAZIALA CU CLASELE I-IV SAT ALBESTI MURU",288,ALBEŞTI-PALEOLOGU,131933,1,PART,PRCNCT,PRSD,PRSD_SV,"2025-05-18 21:33:30",828,506,431,74,1,503,3,900,394,264,239
31,PRAHOVA,"SCOALA GIMNAZIALA CU CLASELE I-VIII CIOCENI",289,ALBEŞTI-PALEOLOGU,131933,1,PART,PRCNCT,PRSD,PRSD_SV,"2025-05-18 21:38:06",730,429,373,56,0,424,5,800,371,289,135
31,PRAHOVA,"SCOALA GIMNAZIALA CLASELE I-VIII SAT VADU PĂRULUI",290,ALBEŞTI-PALEOLOGU,131933,1,PART,PRCNCT,PRSD,PRSD_SV,"2025-05-18 21:47:12",1490,860,758,102,0,854,6,1600,740,507,347
31,PRAHOVA,"SCOALA GIMNAZIALA GHEORGHE COSTESCU ALUNIS",291,ALUNIŞ,131988,1,PART,PRCNCT,PRSD,PRSD_SV,"2025-05-18 21:40:46",1087,693,599,92,2,670,23,1200,507,337,333
31,PRAHOVA,"SCOALA CU CLS. I-IV ALUNIS VALE",292,ALUNIŞ,131988,1,PART,PRCNCT,PRSD,PRSD_SV,"2025-05-18 21:50:06",694,463,377,86,0,458,5,800,337,279,179
31,PRAHOVA,"SCOALA GIMNAZIALA SAT OSTROVU",293,ALUNIŞ,131988,1,PART,PRCNCT,PRSD,PRSD_SV,"2025-05-18 21:29:00",760,528,425,100,3,519,9,800,272,259,260
31,PRAHOVA,"CONSILIUL LOCAL APOSTOLACHE",294,APOSTOLACHE,132011,1,PART,PRCNCT,PRSD,PRSD_SV,"2025-05-18 21:52:53",832,528,426,102,0,523,5,900,372,273,250
31,PRAHOVA,"CONSILIUL LOCAL APOSTOLACHE",295,APOSTOLACHE,132011,1,PART,PRCNCT,PRSD,PRSD_SV,"2025-05-18 21:53:16",776,397,344,53,0,395,2,900,503,248,147
31,PRAHOVA,"ȘCOALA GIMNAZIALĂ COMUNA ARICEȘTII RAHTIVANI NR. 96A",296,"ARICEŞTII RAHTIVANI",132075,1,PART,PRCNCT,PRSD,PRSD_SV,"2025-05-18 21:36:18",1222,776,654,122,0,769,7,1300,524,311,458
31,PRAHOVA,"CĂMINUL CULTURAL ARICEȘTII RAHTIVANI, NR. 527A",297,"ARICEŞTII RAHTIVANI",132075,2,PART,PRCNCT,PRSD,PRSD_SV,"2025-05-19 01:42:35",1068,815,625,91,99,798,17,1200,385,376,422
31,PRAHOVA,"GRĂDINIȚA CU PROGRAM NORMAL BUDA NR. 46 A",298,"ARICEŞTII RAHTIVANI",132075,1,PART,PRCNCT,PRSD,PRSD_SV,"2025-05-18 21:47:22",436,411,202,66,143,404,7,600,189,273,131
31,PRAHOVA,"GRĂDINIȚA CU PROGRAM NORMAL NEDELEA NR. 47A",299,"ARICEŞTII RAHTIVANI",132075,1,PART,PRCNCT,PRSD,PRSD_SV,"2025-05-18 21:36:02",803,602,445,34,123,595,7,900,298,347,248
31,PRAHOVA,"ȘCOALA GIMNAZIALĂ SAT NEDELEA, COMUNA ARICEȘTII RAHTIVANI, NR. 491",300,"ARICEŞTII RAHTIVANI",132075,1,PART,PRCNCT,PRSD,PRSD_SV,"2025-05-18 21:42:41",1113,695,640,55,0,686,9,1200,505,312,374
31,PRAHOVA,"CĂMIN CULTURAL STOENEȘTI",301,"ARICEŞTII RAHTIVANI",132075,1,PART,PRCNCT,PRSD,PRSD_SV,"2025-05-18 21:51:13",1149,803,626,83,94,795,8,1200,397,483,312
31,PRAHOVA,"CĂMIN CULTURAL TÂRGȘORU NOU",302,"ARICEŞTII RAHTIVANI",132075,1,PART,PRCNCT,PRSD,PRSD_SV,"2025-05-18 21:33:57",909,699,479,121,99,691,8,1000,301,394,297
31,PRAHOVA,"ŞCOALA GIMNAZIALĂ ATHANASIE JAN STOICESCU",303,"ARICEŞTII ZELETIN",132137,1,PART,PRCNCT,PRSD,PRSD_SV,"2025-05-18 21:31:42",870,519,421,94,4,516,3,1000,481,291,225
31,PRAHOVA,"CENTRUL CULTURAL BABA ANA",304,"BABA ANA",132164,1,PART,PRCNCT,PRSD,PRSD_SV,"2025-05-18 21:35:51",1495,751,677,73,1,742,9,1600,849,404,338
31,PRAHOVA,"SCOALA GIMNAZIALĂ CIREŞANU",305,"BABA ANA",132164,1,PART,PRCNCT,PRSD,PRSD_SV,"2025-05-18 21:51:15",642,324,282,42,0,319,5,700,376,219,100
31,PRAHOVA,"SCOALA GIMNAZIALĂ CONDURATU",306,"BABA ANA",132164,1,PART,PRCNCT,PRSD,PRSD_SV,"2025-05-18 21:55:08",984,534,465,69,0,529,5,1100,566,273,256
31,PRAHOVA,"SALĂ MULTIFUNCȚIONALĂ",307,"BABA ANA",132164,1,PART,PRCNCT,PRSD,PRSD_SV,"2025-05-18 21:13:54",92,55,33,22,0,54,1,100,45,30,24
31,PRAHOVA,"ȘCOALA GIMNAZIALĂ SFINȚII ÎMPĂRAȚI BALTA DOAMNEI",308,"BALTA DOAMNEI",132226,1,PART,PRCNCT,PRSD,PRSD_SV,"2025-05-18 21:52:54",1162,737,579,158,0,729,8,1300,563,414,315
31,PRAHOVA,"ȘCOALA PRIMARĂ DIN BÎRA",309,"BALTA DOAMNEI",132226,1,PART,PRCNCT,PRSD,PRSD_SV,"2025-05-18 21:56:03",713,428,283,145,0,425,3,800,372,226,199
31,PRAHOVA,"ŞCOALA CU CLASELE I-IV",310,BĂLŢEŞTI,132271,1,PART,PRCNCT,PRSD,PRSD_SV,"2025-05-18 21:52:55",1519,845,726,118,1,842,3,1700,855,539,303
31,PRAHOVA,"ŞCOALA PODENII VECHI",311,BĂLŢEŞTI,132271,1,PART,PRCNCT,PRSD,PRSD_SV,"2025-05-18 21:45:37",1384,864,755,106,3,856,8,1500,636,531,325
31,PRAHOVA,"ŞCOALA GIMNAZIALĂ ”IOAN DUHOVNICUL” BĂNEŞTI",312,BĂNEŞTI,132315,1,PART,PRCNCT,PRSD,PRSD_SV,"2025-05-18 21:34:34",1325,886,753,128,5,875,11,1500,614,339,536
31,PRAHOVA,"DISPENSAR UMAN BĂNEŞTI",313,BĂNEŞTI,132315,1,PART,PRCNCT,PRSD,PRSD_SV,"2025-05-18 21:44:47",1384,938,812,122,4,929,9,1500,562,364,565
31,PRAHOVA,"ŞCOALA GIMNAZIALĂ ”IOAN DUHOVNICUL” BĂNEŞTI",314,BĂNEŞTI,132315,1,PART,PRCNCT,PRSD,PRSD_SV,"2025-05-18 21:39:03",1067,689,597,90,2,685,4,1200,511,287,398
31,PRAHOVA,"ŞCOALA GIMNAZIALĂ ”IOAN DUHOVNICUL” BĂNEŞTI",315,BĂNEŞTI,132315,1,PART,PRCNCT,PRSD,PRSD_SV,"2025-05-18 21:28:22",928,602,497,103,2,595,7,1000,398,258,337
31,PRAHOVA,"ŞCOALA GIMNAZIALĂ ”GHEORGHE LAZĂR” COMUNA BĂRCĂNEŞTI",316,BĂRCĂNEŞTI,130552,1,PART,PRCNCT,PRSD,PRSD_SV,"2025-05-18 22:42:17",1299,710,608,102,0,703,7,1400,690,499,204
31,PRAHOVA,"ŞCOALA GIMNAZIALĂ ”GHEORGHE LAZĂR” COMUNA BĂRCĂNEŞTI",317,BĂRCĂNEŞTI,130552,1,PART,PRCNCT,PRSD,PRSD_SV,"2025-05-18 21:56:57",1361,697,633,64,0,689,8,1500,803,420,269
31,PRAHOVA,"SEDIUL FOSTEI ŞCOLI CU CLASELE I-IV GHIGHIU",318,BĂRCĂNEŞTI,130552,1,PART,PRCNCT,PRSD,PRSD_SV,"2025-05-18 21:25:29",608,456,364,92,0,451,5,700,244,239,212
31,PRAHOVA,"SEDIUL FOSTEI ŞCOLI CU CLASELE I-IV PUŞCAŞI",319,BĂRCĂNEŞTI,130552,1,PART,PRCNCT,PRSD,PRSD_SV,"2025-05-18 21:16:11",312,206,162,44,0,200,6,400,194,102,98
31,PRAHOVA,"ŞCOALA GIMNAZIALĂ ROMÂNEŞTI",320,BĂRCĂNEŞTI,130552,1,PART,PRCNCT,PRSD,PRSD_SV,"2025-05-18 22:01:19",1545,850,706,142,2,841,9,1700,850,527,314
31,PRAHOVA,"ŞCOALA GIMNAZIALĂ TĂTĂRANI",321,BĂRCĂNEŞTI,130552,1,PART,PRCNCT,PRSD,PRSD_SV,"2025-05-18 21:57:01",1185,746,645,101,0,740,6,1300,554,369,371
31,PRAHOVA,"ŞCOALA GIMNAZIALĂ TĂTĂRANI",322,BĂRCĂNEŞTI,130552,1,PART,PRCNCT,PRSD,PRSD_SV,"2025-05-18 21:57:50",1271,844,716,128,0,837,7,1400,556,372,465
31,PRAHOVA,"SCOALA GIMNAZIALA, COMUNA BATRANI",323,BĂTRÂNI,136278,1,PART,PRCNCT,PRSD,PRSD_SV,"2025-05-18 21:49:38",851,458,411,44,3,448,10,900,442,257,191
31,PRAHOVA,"GRADINITA DE COPII",324,BĂTRÂNI,136278,1,PART,PRCNCT,PRSD,PRSD_SV,"2025-05-18 21:38:29",714,390,355,33,2,385,5,800,410,220,165
31,PRAHOVA,"SCOALA GIMNAZIALA BERCENI,SALA DE SPORT PARTER",325,BERCENI,130614,1,PART,PRCNCT,PRSD,PRSD_SV,"2025-05-18 21:45:24",1340,857,727,130,0,844,13,1500,643,437,407
31,PRAHOVA,"GRADINITA CU PROGRAM NORMAL-SALA MICA PARTER,COM.BERCENI,SAT BERCENI,STR.GRADINITEI NR. 358 A",326,BERCENI,130614,1,PART,PRCNCT,PRSD,PRSD_SV,"2025-05-18 21:25:58",731,410,380,30,0,404,6,800,390,203,201
31,PRAHOVA,"SEDIU ADMINISTRATIV",327,BERCENI,130614,1,PART,PRCNCT,PRSD,PRSD_SV,"2025-05-18 21:32:19",379,295,229,66,0,293,2,400,105,140,153
31,PRAHOVA,"GRADINITA CU PROGRAM NORMAL,SALA MICA PARTER,COM.BERCENI,SAT CATUNU.STR.DEMOCRATIEI,NR.148 A",328,BERCENI,130614,1,PART,PRCNCT,PRSD,PRSD_SV,"2025-05-18 21:29:16",533,331,276,55,0,328,3,600,269,179,149
31,PRAHOVA,"CĂMIN CULTURAL",329,BERCENI,130614,1,PART,PRCNCT,PRSD,PRSD_SV,"2025-05-18 21:50:08",1203,739,659,78,2,729,10,1300,561,411,318
31,PRAHOVA,"GRADINITA CU PROGRAM NORMAL-SALA MARE PARTER,COM.BERCENI,SAT MOARA NOUA,STR.SCOLII,NR.106 C",330,BERCENI,130614,1,PART,PRCNCT,PRSD,PRSD_SV,"2025-05-18 21:50:38",944,508,416,57,35,500,8,1000,492,377,123
31,PRAHOVA,"GRADINITA DE COPII NR.1",331,BERTEA,132342,1,PART,PRCNCT,PRSD,PRSD_SV,"2025-05-18 22:06:59",1324,716,639,73,4,709,7,1500,784,394,315
31,PRAHOVA,"GRADINITA DE COPII NR.2",332,BERTEA,132342,1,PART,PRCNCT,PRSD,PRSD_SV,"2025-05-18 22:30:54",1074,539,484,55,0,533,6,1200,661,254,279
31,PRAHOVA,"ȘCOALA GIMNAZIALĂ ”RADU TUDORAN” BLEJOI, SAT BLEJOI, NR. 510",333,BLEJOI,130678,1,PART,PRCNCT,PRSD,PRSD_SV,"2025-05-18 21:32:08",1635,1040,932,105,3,1022,18,1800,760,486,536
31,PRAHOVA,"GRĂDINIȚA CU PROGRAM NORMAL BLEJOI, SAT BLEJOI, NR. 511",334,BLEJOI,130678,1,PART,PRCNCT,PRSD,PRSD_SV,"2025-05-18 21:49:16",1603,1039,910,129,0,1034,5,1800,761,491,543
31,PRAHOVA,"GRĂDINIȚA CU PROGRAM NORMAL PLOIEȘTIORI, SAT PLOIEȘTIORI, NR. 537",335,BLEJOI,130678,2,PART,PRCNCT,PRSD,PRSD_SV,"2025-05-18 23:54:48",1173,780,699,81,0,774,6,1300,520,368,406
31,PRAHOVA,"CĂMINUL CULTURAL ”GEO BOGZA”, SAT PLOIEȘTIORI, NR. 174 B",336,BLEJOI,130678,2,PART,PRCNCT,PRSD,PRSD_SV,"2025-05-19 02:32:29",2247,1345,1210,135,0,1333,12,2500,1155,484,849
31,PRAHOVA,"GRĂDINIȚA CU PROGRAM NORMAL ȚÎNȚĂRENI, SAT ȚÎNȚĂRENI, NR. 232 E",337,BLEJOI,130678,1,PART,PRCNCT,PRSD,PRSD_SV,"2025-05-18 21:55:21",1478,869,783,86,0,855,14,1600,731,384,471
31,PRAHOVA,"CĂMİN CULTURAL BOLDEŞTİ",338,BOLDEŞTI-GRADIŞTEA,132379,1,PART,PRCNCT,PRSD,PRSD_SV,"2025-05-18 21:51:38",571,310,252,58,0,309,1,600,290,169,140
31,PRAHOVA,"ŞCOALA GİMNAZİALĂ COMUNA BOLDEŞTİ-GRADİŞTEA,CORP B",339,BOLDEŞTI-GRADIŞTEA,132379,1,PART,PRCNCT,PRSD,PRSD_SV,"2025-05-18 21:36:08",630,378,316,62,0,374,4,700,322,197,177
31,PRAHOVA,"ŞCOALA GIMNAZIALĂ BRAZI",340,BRAZI,130712,1,PART,PRCNCT,PRSD,PRSD_SV,"2025-05-18 21:38:23",975,667,559,108,0,659,8,1100,433,379,280
31,PRAHOVA,"FOSTUL SEDIU AL GRADINŢEI DE COPII DIN COLONIA BRAZI",341,BRAZI,130712,1,PART,PRCNCT,PRSD,PRSD_SV,"2025-05-18 21:52:13",324,605,187,418,0,598,7,800,195,426,172
31,PRAHOVA,"SALA DE SPORT A ŞCOLII GIMNAZIALE ”DUMITRU HERA” BĂTEŞTI",342,BRAZI,130712,1,PART,PRCNCT,PRSD,PRSD_SV,"2025-05-18 22:29:02",1451,881,791,89,1,869,12,1600,719,441,428
31,PRAHOVA,"SALA DE FESTIVITĂŢI A PRIMĂRIEI COMUNEI BRAZI",343,BRAZI,130712,1,PART,PRCNCT,PRSD,PRSD_SV,"2025-05-18 21:38:48",638,404,354,50,0,396,8,700,296,209,187
31,PRAHOVA,"SALA DE SPORT A ŞCOLII GIMNAZIALE ”PROFESOR OPREA MIHAI” SAT NEGOIEŞTI",344,BRAZI,130712,1,PART,PRCNCT,PRSD,PRSD_SV,"2025-05-18 22:24:12",1541,1007,870,136,1,992,14,1700,694,453,539
31,PRAHOVA,"PUNCTUL DE LUCRU AL PRIMĂRIEI BRAZI DIN SATUL POPEŞTI",345,BRAZI,130712,1,PART,PRCNCT,PRSD,PRSD_SV,"2025-05-18 22:09:49",1462,883,784,96,3,875,8,1200,317,479,396
31,PRAHOVA,"FOSTUL SEDIU AL ŞCOLII GIMNAZIALE DIN SATUL STEJARU",346,BRAZI,130712,1,PART,PRCNCT,PRSD,PRSD_SV,"2025-05-18 21:29:57",503,242,207,35,0,240,2,600,358,157,83
31,PRAHOVA,"ŞCOALA GIMNAZIALĂ MATEI BASARAB CORP B, SAT BREBU MÎNĂSTIREI, NR.803",347,BREBU,132404,1,PART,PRCNCT,PRSD,PRSD_SV,"2025-05-18 21:44:37",880,701,493,207,1,693,8,1000,299,267,426
31,PRAHOVA,"ŞCOALA GIMNAZIALĂ MATEI BASARAB CORP A, SAT BREBU MÎNĂSTIREI, NR.799",348,BREBU,132404,1,PART,PRCNCT,PRSD,PRSD_SV,"2025-05-18 21:39:38",1492,995,803,192,0,989,6,1600,605,431,558
31,PRAHOVA,"ŞCOALA GIMNAZIALĂ MATEI BASARAB, ŞCOALĂ PRIMARĂ STRUCTURĂ, NR.2, SAT BREBU MEGIEŞESC, NR.53",349,BREBU,132404,1,PART,PRCNCT,PRSD,PRSD_SV,"2025-05-18 21:46:43",1439,929,790,138,1,916,13,1600,671,376,540
31,PRAHOVA,"ŞCOALA GIMNAZIALĂ MATEI BASARAB, ŞCOALĂ PRIMARĂ STRUCTURĂ, SAT BREBU MEGIEŞESC, NR.278",350,BREBU,132404,1,PART,PRCNCT,PRSD,PRSD_SV,"2025-05-18 21:47:28",1029,695,578,116,1,680,15,1100,405,289,391
31,PRAHOVA,"ŞCOALA GIMNAZIALĂ MATEI BASARAB, ŞCOALĂ GIMNAZIALĂ PIETRICEAUA, SAT PIETRICEAUA, NR.1",351,BREBU,132404,1,PART,PRCNCT,PRSD,PRSD_SV,"2025-05-18 21:37:29",867,429,387,41,1,425,4,1000,571,276,149
31,PRAHOVA,"ŞCOALA GIMNAZIALĂ MATEI BASARAB, ŞCOALĂ PRIMARĂ STRUCTURĂ, SAT PODU CHEII, NR.12",352,BREBU,132404,1,PART,PRCNCT,PRSD,PRSD_SV,"2025-05-18 21:24:21",122,124,90,34,0,120,4,200,76,71,49
31,PRAHOVA,"SALA DE SPORT BUCOV",353,BUCOV,130785,1,PART,PRCNCT,PRSD,PRSD_SV,"2025-05-18 21:41:10",1723,1024,901,110,13,1013,11,1900,876,436,577
31,PRAHOVA,"SALA DE SPORT BUCOV",354,BUCOV,130785,1,PART,PRCNCT,PRSD,PRSD_SV,"2025-05-18 21:39:22",1521,834,733,100,1,827,7,1700,866,508,319
31,PRAHOVA,"SALA DE SPORT BUCOV",355,BUCOV,130785,1,PART,PRCNCT,PRSD,PRSD_SV,"2025-05-18 21:39:13",1489,913,812,100,1,906,7,1600,687,404,502
31,PRAHOVA,"CAMIN CULTURAL CHITORANI",356,BUCOV,130785,1,PART,PRCNCT,PRSD,PRSD_SV,"2025-05-18 21:50:42",1327,901,762,139,0,886,15,1500,599,464,422
31,PRAHOVA,"CAMIN CULTURAL PLEASA",357,BUCOV,130785,1,PART,PRCNCT,PRSD,PRSD_SV,"2025-05-18 21:30:51",1262,825,736,88,1,819,6,1400,575,378,441
31,PRAHOVA,"CAMIN CULTURAL PLEASA",358,BUCOV,130785,1,PART,PRCNCT,PRSD,PRSD_SV,"2025-05-18 21:35:13",1299,837,765,72,0,821,16,1400,563,357,464
31,PRAHOVA,"CLUB PLEASA",359,BUCOV,130785,1,PART,PRCNCT,PRSD,PRSD_SV,"2025-05-18 21:28:52",1034,495,468,27,0,489,6,1100,605,340,149
31,PRAHOVA,"VECHIUL SEDIU AL PRIMARIEI",360,CĂLUGĂRENI,132459,1,PART,PRCNCT,PRSD,PRSD_SV,"2025-05-18 21:33:24",894,463,385,78,0,460,3,1000,537,297,163
31,PRAHOVA,"ŞCOALA GIMNAZIALĂ CĂRBUNEŞTI",361,CĂRBUNEŞTI,132486,1,PART,PRCNCT,PRSD,PRSD_SV,"2025-05-18 21:37:06",1323,628,512,115,1,620,8,1500,872,407,213
31,PRAHOVA,"SCOALA CU CLASELE I-VIII ”NICHITA STANESCU” CEPTURA",362,CEPTURA,132510,1,PART,PRCNCT,PRSD,PRSD_SV,"2025-05-18 21:37:33",922,557,469,88,0,550,7,1000,443,313,237
31,PRAHOVA,"SCOALA CU CLASELE I-VIII ”NICHITA STANESCU” CEPTURA",363,CEPTURA,132510,1,PART,PRCNCT,PRSD,PRSD_SV,"2025-05-18 21:23:53",906,476,419,57,0,474,2,1000,524,277,197
31,PRAHOVA,"SEDIUL SERVICIULUI PUBLIC DE GOSPODARIE COMUNALA CEPTURA",364,CEPTURA,132510,1,PART,PRCNCT,PRSD,PRSD_SV,"2025-05-18 21:21:34",479,287,228,59,0,284,3,500,213,165,119
31,PRAHOVA,"SCOALA CU CLASELE I - IV",365,CEPTURA,132510,1,PART,PRCNCT,PRSD,PRSD_SV,"2025-05-18 21:19:05",105,74,51,23,0,73,1,200,126,45,28
31,PRAHOVA,"SCOALA CU CLASELE I - VIII ROTARI",366,CEPTURA,132510,1,PART,PRCNCT,PRSD,PRSD_SV,"2025-05-18 21:34:32",586,282,248,34,0,278,4,600,318,186,92
31,PRAHOVA,"GRADINITA DE COPII SOIMESTI",367,CEPTURA,132510,1,PART,PRCNCT,PRSD,PRSD_SV,"2025-05-18 21:28:25",555,286,255,31,0,282,4,600,314,195,87
31,PRAHOVA,"LICEUL TEHNOLOGIC CERAŞU",368,CERAŞU,132574,1,PART,PRCNCT,PRSD,PRSD_SV,"2025-05-18 22:06:40",1186,727,621,106,0,712,15,1300,573,418,294
31,PRAHOVA,"ŞCOALA GIMNAZIALĂ SLON",369,CERAŞU,132574,1,PART,PRCNCT,PRSD,PRSD_SV,"2025-05-18 22:04:03",737,484,432,51,1,481,3,800,316,264,217
31,PRAHOVA,"ŞCOALA GIMNAZIALĂ SLON",370,CERAŞU,132574,1,PART,PRCNCT,PRSD,PRSD_SV,"2025-05-18 21:58:36",892,546,503,41,2,542,4,1000,454,360,182
31,PRAHOVA,"ŞCOALA GIMNAZIALĂ VALEA BORULUI",371,CERAŞU,132574,1,PART,PRCNCT,PRSD,PRSD_SV,"2025-05-18 21:53:31",668,436,333,103,0,431,5,700,264,239,192
31,PRAHOVA,"GRADINITA CHIOJDEANCA",372,CHIOJDEANCA,132645,1,PART,PRCNCT,PRSD,PRSD_SV,"2025-05-18 21:42:14",775,468,391,70,7,467,1,900,432,274,193
31,PRAHOVA,"SCOALA TRENU",373,CHIOJDEANCA,132645,1,PART,PRCNCT,PRSD,PRSD_SV,"2025-05-18 21:32:02",449,254,216,38,0,253,1,500,246,185,68
31,PRAHOVA,"LICEUL CIORANI",374,CIORANI,132681,1,PART,PRCNCT,PRSD,PRSD_SV,"2025-05-18 21:50:12",910,488,406,82,0,481,7,1000,512,279,202
31,PRAHOVA,"LICEUL CIORANI",375,CIORANI,132681,1,PART,PRCNCT,PRSD,PRSD_SV,"2025-05-18 22:07:34",1485,785,670,113,2,775,10,1600,815,515,260
31,PRAHOVA,"ȘCOALA CU CLASELE I-IV",376,CIORANI,132681,1,PART,PRCNCT,PRSD,PRSD_SV,"2025-05-18 22:17:37",954,482,442,40,0,477,5,1000,518,339,138
31,PRAHOVA,"ȘCOALA GENERALĂ CIORANII DE SUS",377,CIORANI,132681,1,PART,PRCNCT,PRSD,PRSD_SV,"2025-05-18 22:11:54",837,451,375,76,0,444,7,900,449,278,166
31,PRAHOVA,PRIMĂRIA,378,CIORANI,132681,1,PART,PRCNCT,PRSD,PRSD_SV,"2025-05-18 21:59:08",910,497,447,50,0,491,6,1000,503,285,206
31,PRAHOVA,"CASA DE CULTURA RURALA",379,"COCORĂŞTII COLŢ",136241,1,PART,PRCNCT,PRSD,PRSD_SV,"2025-05-18 22:21:37",1334,721,619,102,0,713,8,1500,779,430,283
31,PRAHOVA,"SCOALA PRIMARA COCORASTII GRIND",380,"COCORĂŞTII COLŢ",136241,1,PART,PRCNCT,PRSD,PRSD_SV,"2025-05-18 21:45:38",956,512,458,54,0,506,6,1100,588,310,196
31,PRAHOVA,"CĂMIN CULTURAL",381,"COCORĂŞTII MISLII",132716,1,PART,PRCNCT,PRSD,PRSD_SV,"2025-05-18 22:07:00",1524,995,895,95,5,978,17,1700,705,479,499
31,PRAHOVA,"CĂMIN CULTURAL",382,"COCORĂŞTII MISLII",132716,1,PART,PRCNCT,PRSD,PRSD_SV,"2025-05-18 21:54:55",1179,729,634,92,3,716,13,1300,571,331,385
31,PRAHOVA,"SCOALA GIMNAZIALA, COMUNA COLCEAG PJ",383,COLCEAG,132752,1,PART,PRCNCT,PRSD,PRSD_SV,"2025-05-18 21:30:42",1063,466,389,77,0,463,3,1200,734,253,210
31,PRAHOVA,"SCOALA GIMNAZIALA INOTESTI-COLCEAG-STRUCTURA",384,COLCEAG,132752,1,PART,PRCNCT,PRSD,PRSD_SV,"2025-05-18 21:40:53",1372,825,672,153,0,815,10,1500,675,420,395
31,PRAHOVA,"SCOALA GIMNAZIALA PAREPA-RUSANI-COLCEAG-STRUCTURA",385,COLCEAG,132752,1,PART,PRCNCT,PRSD,PRSD_SV,"2025-05-18 21:34:39",771,432,319,113,0,428,4,800,368,257,171
31,PRAHOVA,"SCOALA PRIMARA VILCELELE - COLCEAG - STRUCTURA",386,COLCEAG,132752,1,PART,PRCNCT,PRSD,PRSD_SV,"2025-05-18 21:31:35",433,168,145,23,0,168,0,500,332,109,59
31,PRAHOVA,"GRĂDINIŢA CU PROGRAM NORMAL",387,CORNU,132805,1,PART,PRCNCT,PRSD,PRSD_SV,"2025-05-18 21:52:20",1328,895,732,160,3,885,10,1500,605,364,521
31,PRAHOVA,"ŞCOALA GIMNAZIALĂ ”PROFESOR CRISTEA STĂNESCU”",388,CORNU,132805,1,PART,PRCNCT,PRSD,PRSD_SV,"2025-05-18 21:30:09",1426,1174,840,333,1,1158,16,1600,426,470,688
31,PRAHOVA,"GRĂDINIŢA CU PROGRAM NORMAL",389,CORNU,132805,1,PART,PRCNCT,PRSD,PRSD_SV,"2025-05-18 21:36:00",816,591,507,81,3,580,11,900,309,216,364
31,PRAHOVA,"BIBLIOTECA COMUNALĂ COSMINELE",390,COSMINELE,132841,1,PART,PRCNCT,PRSD,PRSD_SV,"2025-05-18 22:02:22",786,532,430,101,1,519,13,900,368,270,249
31,PRAHOVA,"ȘCOALA GIMNAZIALĂ DRAJNA DE SUS",391,DRAJNA,132896,1,PART,PRCNCT,PRSD,PRSD_SV,"2025-05-18 21:39:34",1227,739,602,137,0,730,9,1300,561,416,314
31,PRAHOVA,"ȘCOALA GIMNAZIALĂ ”PLATON MOCANU”",392,DRAJNA,132896,1,PART,PRCNCT,PRSD,PRSD_SV,"2025-05-18 21:42:29",1380,930,746,160,24,921,9,1500,570,441,480
31,PRAHOVA,"GRĂDINIȚA PLĂIȘANI",393,DRAJNA,132896,1,PART,PRCNCT,PRSD,PRSD_SV,"2025-05-18 22:06:53",697,426,378,36,12,422,4,800,374,212,210
31,PRAHOVA,"ȘCOALA GIMNAZIALĂ OGRETIN",394,DRAJNA,132896,1,PART,PRCNCT,PRSD,PRSD_SV,"2025-05-18 21:41:37",1038,582,507,73,2,578,4,1100,518,360,218
31,PRAHOVA,"GRĂDINIȚA DRĂGĂNEȘTI",395,DRĂGĂNEŞTI,133018,1,PART,PRCNCT,PRSD,PRSD_SV,"2025-05-18 21:49:42",1029,475,400,75,0,473,2,1100,625,272,201
31,PRAHOVA,"ȘCOALA PRIMARĂ ” LEONIDA SECRETEANU”",396,DRĂGĂNEŞTI,133018,1,PART,PRCNCT,PRSD,PRSD_SV,"2025-05-18 21:34:52",653,361,306,55,0,358,3,700,339,271,87
31,PRAHOVA,"ȘCOALA CU CLASELE I-IV BELCIUG",397,DRĂGĂNEŞTI,133018,1,PART,PRCNCT,PRSD,PRSD_SV,"2025-05-18 21:35:14",419,273,200,73,0,272,1,400,127,172,100
31,PRAHOVA,"ȘCOALA CU CLASELE I-IV CORNU DE JOS",398,DRĂGĂNEŞTI,133018,1,PART,PRCNCT,PRSD,PRSD_SV,"2025-05-18 21:23:14",478,260,201,59,0,258,2,500,240,146,112
31,PRAHOVA,"COOPERATIVA DE CONSUM",399,DRĂGĂNEŞTI,133018,1,PART,PRCNCT,PRSD,PRSD_SV,"2025-05-18 21:33:13",296,182,127,55,0,182,0,300,118,115,67
31,PRAHOVA,"ȘCOALA PRIMARĂ MERI",400,DRĂGĂNEŞTI,133018,1,PART,PRCNCT,PRSD,PRSD_SV,"2025-05-18 21:33:34",827,416,353,63,0,411,5,900,484,250,161
31,PRAHOVA,"CĂMIN CULTURAL LOCALITATEA DUMBRAVA",401,DUMBRAVA,133090,1,PART,PRCNCT,PRSD,PRSD_SV,"2025-05-18 21:58:06",1271,721,610,111,0,717,4,1400,679,435,282
31,PRAHOVA,"CĂMIN CULTURAL LOCALITATEA CIUPELNIŢA",402,DUMBRAVA,133090,1,PART,PRCNCT,PRSD,PRSD_SV,"2025-05-18 21:43:01",1445,717,633,84,0,712,5,1600,883,536,176
31,PRAHOVA,"CĂMIN CULTURAL LOCALITATEA ZĂNOAGA",403,DUMBRAVA,133090,1,PART,PRCNCT,PRSD,PRSD_SV,"2025-05-18 21:39:40",758,420,374,46,0,416,4,800,380,261,155
31,PRAHOVA,"ȘCOALA GIMNAZIALĂ SERGENT EROU GRIGORE IOAN DUMBRĂVEȘTI",404,DUMBRĂVEŞTI,131461,1,PART,PRCNCT,PRSD,PRSD_SV,"2025-05-18 21:44:09",1125,731,627,103,1,720,11,1200,469,382,338
31,PRAHOVA,"SALA DE UTILITATE PUBLICĂ",405,DUMBRĂVEŞTI,131461,1,PART,PRCNCT,PRSD,PRSD_SV,"2025-05-18 22:00:29",1264,780,703,77,0,772,8,1400,620,508,264
31,PRAHOVA,"FOSTA ŞCOALĂ SAT SFÂRLEANCA",406,DUMBRĂVEŞTI,131461,1,PART,PRCNCT,PRSD,PRSD_SV,"2025-05-18 21:39:02",478,333,284,49,0,329,4,500,167,182,147
31,PRAHOVA,"GRĂDINIȚA CU PROGRAM NORMAL FÂNTÂNELE",407,FÂNTÂNELE,133278,1,PART,PRCNCT,PRSD,PRSD_SV,"2025-05-18 21:55:02",790,494,384,110,0,489,5,900,406,283,206
31,PRAHOVA,"GRĂDINIȚA CU PROGRAM NORMAL FÂNTÂNELE",408,FÂNTÂNELE,133278,1,PART,PRCNCT,PRSD,PRSD_SV,"2025-05-18 21:45:01",788,443,394,42,7,438,5,900,457,270,168
31,PRAHOVA,"CLUBUL ”MINERUL”",409,"FILIPEŞTII DE PĂDURE",133161,1,PART,PRCNCT,PRSD,PRSD_SV,"2025-05-18 22:04:40",991,577,535,42,0,574,3,1100,523,332,242
31,PRAHOVA,"ȘCOALA VECHE",410,"FILIPEŞTII DE PĂDURE",133161,1,PART,PRCNCT,PRSD,PRSD_SV,"2025-05-18 21:58:52",1510,861,786,73,2,850,11,1700,839,456,394
31,PRAHOVA,"LICEUL TEORETIC",411,"FILIPEŞTII DE PĂDURE",133161,1,PART,PRCNCT,PRSD,PRSD_SV,"2025-05-18 21:49:15",1468,908,817,90,1,896,12,1600,692,505,391
31,PRAHOVA,"ȘCOALA GIMNAZIALĂ ”IOAN MOGA”",412,"FILIPEŞTII DE PĂDURE",133161,1,PART,PRCNCT,PRSD,PRSD_SV,"2025-05-18 21:57:38",1182,582,535,47,0,575,7,1300,718,404,171
31,PRAHOVA,"GRADINIȚA NR.1",413,"FILIPEŞTII DE PĂDURE",133161,1,PART,PRCNCT,PRSD,PRSD_SV,"2025-05-18 21:40:20",1088,526,500,26,0,521,5,1200,674,403,118
31,PRAHOVA,"GRADINIȚA NR. 2",414,"FILIPEŞTII DE PĂDURE",133161,1,PART,PRCNCT,PRSD,PRSD_SV,"2025-05-18 21:39:07",944,520,469,50,1,516,4,1000,480,322,194
31,PRAHOVA,"LICEUL TEHNOLOGIC",415,"FILIPEŞTII DE PĂDURE",133161,1,PART,PRCNCT,PRSD,PRSD_SV,"2025-05-18 22:33:12",1038,566,516,50,0,558,8,1100,534,395,163
31,PRAHOVA,"CǍMIN FILIPEŞTII DE TÎRG (SALĂ ȘEDINȚĂ VIDEOCLUB)",416,"FILIPEŞTII DE TÂRG",133214,1,PART,PRCNCT,PRSD,PRSD_SV,"2025-05-18 21:39:59",1035,631,567,64,0,622,9,1100,469,334,288
31,PRAHOVA,"ṢCOALA FILIPEṢTII DE TȊRG",417,"FILIPEŞTII DE TÂRG",133214,1,PART,PRCNCT,PRSD,PRSD_SV,"2025-05-18 21:31:29",1139,680,621,59,0,670,10,1300,620,300,370
31,PRAHOVA,"ṢCOALA GENERALǍ BRǍTǍṢANCA",418,"FILIPEŞTII DE TÂRG",133214,1,PART,PRCNCT,PRSD,PRSD_SV,"2025-05-18 22:03:54",1685,1090,1002,87,1,1078,12,1900,810,652,426
31,PRAHOVA,"ṢCOALA GENERALǍ MǍRGINENII DE JOS (ṢCOALA NOUǍ)",419,"FILIPEŞTII DE TÂRG",133214,1,PART,PRCNCT,PRSD,PRSD_SV,"2025-05-18 21:32:07",1591,677,644,33,0,672,5,1800,1123,495,177
31,PRAHOVA,"ṢCOALA GENERALǍ MǍRGINENII DE JOS (ṢCOALA VECHE)",420,"FILIPEŞTII DE TÂRG",133214,1,PART,PRCNCT,PRSD,PRSD_SV,"2025-05-18 21:39:53",1174,442,411,31,0,435,7,1300,858,371,64
31,PRAHOVA,"GRADINIȚA DIN SAT FLOREȘTI",421,FLOREŞTI,133330,1,PART,PRCNCT,PRSD,PRSD_SV,"2025-05-18 21:32:01",1001,640,513,51,76,631,9,1100,460,446,185
31,PRAHOVA,"SCOALA CU CLASELE I - VIII FLORESTI (LOCALUL NOU)",422,FLOREŞTI,133330,1,PART,PRCNCT,PRSD,PRSD_SV,"2025-05-18 21:44:38",1470,801,745,56,0,788,13,1600,799,593,195
31,PRAHOVA,"SCOALA CU CLASELE I-VIII FLORESTI (LOCALUL VECHI)",423,FLOREŞTI,133330,1,PART,PRCNCT,PRSD,PRSD_SV,"2025-05-18 22:00:38",1138,693,643,47,3,687,6,1300,607,416,271
31,PRAHOVA,"PRIMĂRIA COMUNEI FLOREȘTI",424,FLOREŞTI,133330,1,PART,PRCNCT,PRSD,PRSD_SV,"2025-05-18 22:07:31",563,343,305,38,0,340,3,600,257,208,132
31,PRAHOVA,"SCOALA CU CLASELE I-VIII CATINA",425,FLOREŞTI,133330,1,PART,PRCNCT,PRSD,PRSD_SV,"2025-05-18 21:33:04",816,540,426,55,59,533,7,900,360,275,258
31,PRAHOVA,"CAMINUL CULTURAL CALINESTI",426,FLOREŞTI,133330,1,PART,PRCNCT,PRSD,PRSD_SV,"2025-05-18 22:05:07",1084,676,601,75,0,665,11,1200,524,383,282
31,PRAHOVA,"CAMINUL CULTURAL FULGA DE JOS",427,FULGA,133394,1,PART,PRCNCT,PRSD,PRSD_SV,"2025-05-18 22:06:28",1171,627,522,105,0,622,5,1300,673,365,257
31,PRAHOVA,"SCOALA GIMNAZIALA ”LAURENTIU FULGA”",428,FULGA,133394,1,PART,PRCNCT,PRSD,PRSD_SV,"2025-05-18 22:12:33",1265,725,592,133,0,720,5,1400,675,370,350
31,PRAHOVA,"ŞCOALA GIMAZIALĂ GHERGHIŢA, NUMĂRUL 125",429,GHERGHIŢA,133429,1,PART,PRCNCT,PRSD,PRSD_SV,"2025-05-18 21:34:47",1021,707,546,112,49,700,7,1100,393,411,289
31,PRAHOVA,"ŞCOALA PRIMARĂ INDEPENDENŢA, NUMĂRUL 23",430,GHERGHIŢA,133429,1,PART,PRCNCT,PRSD,PRSD_SV,"2025-05-18 21:34:44",186,128,88,38,2,126,2,216,88,64,62
31,PRAHOVA,"GRĂDINIŢA CU PROGRAM NORMAL MALAMUC, NUMĂRUL 149C",431,GHERGHIŢA,133429,1,PART,PRCNCT,PRSD,PRSD_SV,"2025-05-18 21:22:29",323,217,150,54,13,214,3,400,183,137,77
31,PRAHOVA,"GRĂDINIȚA CU PROGRAM NORMAL SAT GORGOTA, COMUNA GORGOTA",432,GORGOTA,133508,1,PART,PRCNCT,PRSD,PRSD_SV,"2025-05-18 21:47:54",1129,735,644,91,0,728,7,1200,465,323,405
31,PRAHOVA,"ȘCOALA PRIMARĂ SAT CRIVINA, COMUNA GORGOTA",433,GORGOTA,133508,1,PART,PRCNCT,PRSD,PRSD_SV,"2025-05-18 22:00:32",725,422,361,61,0,419,3,800,378,205,214
31,PRAHOVA,"ȘCOALA GIMNAZIALĂ SAT POIENARII APOSTOLI, COMUNA GORGOTA",434,GORGOTA,133508,1,PART,PRCNCT,PRSD,PRSD_SV,"2025-05-18 21:41:49",1069,673,541,132,0,666,7,1200,527,341,325
31,PRAHOVA,"GRĂDINIȚA CU PROGRAM NORMAL POTIGRAFU, COMUNA GORGOTA",435,GORGOTA,133508,1,PART,PRCNCT,PRSD,PRSD_SV,"2025-05-18 22:01:33",1037,671,545,125,1,658,13,1100,429,319,339
31,PRAHOVA,"SCOALA GIMNAZIALA GORNET",436,GORNET,133562,1,PART,PRCNCT,PRSD,PRSD_SV,"2025-05-18 21:44:20",969,628,568,60,0,624,4,1100,472,337,287
31,PRAHOVA,"CĂMINUL CULTURAL GORNET",437,GORNET,133562,1,PART,PRCNCT,PRSD,PRSD_SV,"2025-05-18 21:41:22",928,582,534,48,0,574,8,1000,418,269,305
31,PRAHOVA,"SCOALA PRIMARA CUIB",438,GORNET,133562,1,PART,PRCNCT,PRSD,PRSD_SV,"2025-05-18 21:23:56",239,146,115,31,0,145,1,300,154,86,59
31,PRAHOVA,"SCOALA PRIMARA NUCET",439,GORNET,133562,1,PART,PRCNCT,PRSD,PRSD_SV,"2025-05-18 21:18:48",130,83,63,20,0,83,0,200,117,63,20
31,PRAHOVA,"CĂMIN CULTURAL GORNET-CRICOV",440,GORNET-CRICOV,133615,1,PART,PRCNCT,PRSD,PRSD_SV,"2025-05-18 21:55:14",736,546,401,130,15,540,6,800,254,260,280
31,PRAHOVA,"GRĂDINIȚA COȘERELE",441,GORNET-CRICOV,133615,1,PART,PRCNCT,PRSD,PRSD_SV,"2025-05-18 21:35:00",638,381,299,70,12,373,8,700,319,199,174
31,PRAHOVA,"GRĂDINIȚA DOBROTA",442,GORNET-CRICOV,133615,1,PART,PRCNCT,PRSD,PRSD_SV,"2025-05-18 21:18:43",357,225,176,43,6,225,0,400,175,137,88
31,PRAHOVA,"CĂMINUL CULTURAL, NR. 212",443,"GURA VADULUI",133688,1,PART,PRCNCT,PRSD,PRSD_SV,"2025-05-18 21:46:46",1087,609,501,105,3,601,8,1200,591,315,286
31,PRAHOVA,"CĂMIN CULTURAL",444,"GURA VADULUI",133688,1,PART,PRCNCT,PRSD,PRSD_SV,"2025-05-18 21:39:45",628,353,294,59,0,346,7,700,347,211,135
31,PRAHOVA,"SCOALA GIMNAZIALA GURA VITIOAREI",445,"GURA VITIOAREI",131835,1,PART,PRCNCT,PRSD,PRSD_SV,"2025-05-18 22:37:35",1651,976,857,118,1,969,7,1750,774,557,412
31,PRAHOVA,"SCOALA GIMNAZIALA BUGHEA DE JOS",446,"GURA VITIOAREI",131835,1,PART,PRCNCT,PRSD,PRSD_SV,"2025-05-18 21:35:02",849,521,459,62,0,520,1,900,379,355,165
31,PRAHOVA,"SCOALA PRIMARA FAGETU",447,"GURA VITIOAREI",131835,1,PART,PRCNCT,PRSD,PRSD_SV,"2025-05-18 21:39:41",930,574,493,81,0,570,4,950,376,265,305
31,PRAHOVA,"GRADINITA CU PROGRAM NORMAL FUNDENI",448,"GURA VITIOAREI",131835,1,PART,PRCNCT,PRSD,PRSD_SV,"2025-05-18 22:00:08",464,307,259,46,2,304,3,500,193,131,173
31,PRAHOVA,"SCOALA GIMNAZIALA POIANA COPACENI",449,"GURA VITIOAREI",131835,2,PART,PRCNCT,PRSD,PRSD_SV,"2025-05-19 02:26:21",852,527,477,49,1,523,4,900,373,359,164
31,PRAHOVA,"GRǍDINIȚA IORDǍCHEANU",450,IORDĂCHEANU,133722,1,PART,PRCNCT,PRSD,PRSD_SV,"2025-05-18 21:40:09",967,560,493,67,0,557,3,1100,540,338,219
31,PRAHOVA,"ŞCOALA MOCEŞTI",451,IORDĂCHEANU,133722,1,PART,PRCNCT,PRSD,PRSD_SV,"2025-05-18 21:55:16",995,520,468,52,0,516,4,1100,580,364,152
31,PRAHOVA,"CLǍDIRE NOUǍ - FOST SEDIU C.A.P.",452,IORDĂCHEANU,133722,1,PART,PRCNCT,PRSD,PRSD_SV,"2025-05-18 21:42:17",1038,621,539,81,1,617,4,1100,479,360,257
31,PRAHOVA,"ŞCOALA VǍRBILA",453,IORDĂCHEANU,133722,1,PART,PRCNCT,PRSD,PRSD_SV,"2025-05-18 21:48:51",1184,624,566,58,0,616,8,1300,676,483,133
31,PRAHOVA,"ŞCOALA GIMNAZIALĂ TRAIAN SĂVULESCU IZVOARELE",454,IZVOARELE,133795,1,PART,PRCNCT,PRSD,PRSD_SV,"2025-05-18 21:25:30",992,576,508,67,1,570,6,1100,524,269,301
31,PRAHOVA,"ŞCOALA GIMNAZIALĂ TRAIAN SĂVULESCU IZVOARELE",455,IZVOARELE,133795,1,PART,PRCNCT,PRSD,PRSD_SV,"2025-05-18 21:27:26",914,525,462,63,0,522,3,1000,475,291,231
31,PRAHOVA,"ŞCOALA GIMNAZIALĂ HOMORÎCIU",456,IZVOARELE,133795,1,PART,PRCNCT,PRSD,PRSD_SV,"2025-05-18 21:57:19",915,613,479,133,1,609,4,1000,387,279,330
31,PRAHOVA,"ŞCOALA GIMNAZIALĂ HOMORÎCIU",457,IZVOARELE,133795,1,PART,PRCNCT,PRSD,PRSD_SV,"2025-05-18 21:52:54",769,536,370,166,0,526,10,800,264,277,249
31,PRAHOVA,"ŞCOALA PRIMARĂ MALU-VÎNĂT",458,IZVOARELE,133795,1,PART,PRCNCT,PRSD,PRSD_SV,"2025-05-18 21:33:15",681,396,328,68,0,389,7,800,404,206,183
31,PRAHOVA,"ŞCOALA GIMNAZIALĂ SCHIULEȘTI",459,IZVOARELE,133795,1,PART,PRCNCT,PRSD,PRSD_SV,"2025-05-18 21:40:35",924,567,481,86,0,554,13,1000,433,277,277
31,PRAHOVA,"CĂMINUL CULTURAL",460,JUGURENI,133866,1,PART,PRCNCT,PRSD,PRSD_SV,"2025-05-18 21:32:49",397,301,205,65,31,298,3,400,99,159,139
31,PRAHOVA,"CĂMINUL CULTURAL",461,LAPOŞ,133919,1,PART,PRCNCT,PRSD,PRSD_SV,"2025-05-18 21:30:23",813,427,358,69,0,423,4,900,473,290,133
31,PRAHOVA,"CAMIN CULTURAL LIPANESTI SALA MARE PARTER",462,LIPĂNEŞTI,133964,1,PART,PRCNCT,PRSD,PRSD_SV,"2025-05-18 21:55:18",740,523,434,89,0,514,9,800,277,276,238
31,PRAHOVA,"CAMIN CULTURAL LIPANESTI SALA MARE PARTER",463,LIPĂNEŞTI,133964,1,PART,PRCNCT,PRSD,PRSD_SV,"2025-05-18 21:43:43",749,490,437,53,0,481,9,800,310,290,191
31,PRAHOVA,"GRĂDINIȚA CU PROGRAM PRELUNGIT” SFINȚII ÎMPĂRAȚI CONSTANTIN ȘI ELENA”",464,LIPĂNEŞTI,133964,1,PART,PRCNCT,PRSD,PRSD_SV,"2025-05-18 21:40:22",840,455,417,38,0,449,6,900,445,251,198
31,PRAHOVA,"GRĂDINIȚA CU PROGRAM PRELUNGIT” SFINȚII ÎMPĂRAȚI CONSTANTIN ȘI ELENA”",465,LIPĂNEŞTI,133964,1,PART,PRCNCT,PRSD,PRSD_SV,"2025-05-18 21:43:31",1037,603,534,67,2,591,12,1100,497,353,238
31,PRAHOVA,"SCOALA GIMNAZIALA ”SPIREA SORESCU”ZAMFIRA",466,LIPĂNEŞTI,133964,1,PART,PRCNCT,PRSD,PRSD_SV,"2025-05-18 21:54:08",956,620,538,81,1,613,7,1100,480,322,291
31,PRAHOVA,"ŞCOALA GIMNAZIALĂ COMUNA MĂGURELE-INVĂŢĂMÂNT PRIMAR",467,MĂGURELE,134014,1,PART,PRCNCT,PRSD,PRSD_SV,"2025-05-18 21:46:53",1237,775,654,121,0,767,8,1400,625,370,397
31,PRAHOVA,"ŞCOALA GIMNAZIALĂ COMUNA MAGURELE-INVĂŢĂMÂNT PRIMAR",468,MĂGURELE,134014,1,PART,PRCNCT,PRSD,PRSD_SV,"2025-05-18 21:53:13",1354,875,776,98,1,853,22,1500,625,433,420
31,PRAHOVA,"GRĂDINIŢA DE COPII SAT COADA MALULUI",469,MĂGURELE,134014,1,PART,PRCNCT,PRSD,PRSD_SV,"2025-05-18 21:25:43",696,440,391,49,0,436,4,800,360,259,177
31,PRAHOVA,"GRĂDINIŢA DE COPII SAT IAZU",470,MĂGURELE,134014,1,PART,PRCNCT,PRSD,PRSD_SV,"2025-05-18 21:39:34",499,356,303,53,0,352,4,500,144,197,155
31,PRAHOVA,"ȘCOALA PRIMARĂ MĂGURENI, CORP B, SAT MĂGURENI, NR.201",471,MĂGURENI,134050,1,PART,PRCNCT,PRSD,PRSD_SV,"2025-05-18 21:31:03",1361,840,724,116,0,829,11,1500,660,384,445
31,PRAHOVA,"ȘCOALA PRIMARĂ SATUL BANULUI, SAT MĂGURENI, NR.541",472,MĂGURENI,134050,1,PART,PRCNCT,PRSD,PRSD_SV,"2025-05-18 21:28:47",914,522,479,43,0,517,5,1000,478,259,258
31,PRAHOVA,"ȘCOALA GIMNAZIALĂ MĂGURENI,CORP A, SAT MĂGURENI, NR.982",473,MĂGURENI,134050,1,PART,PRCNCT,PRSD,PRSD_SV,"2025-05-18 21:45:10",1306,692,635,57,0,686,6,1400,708,331,355
31,PRAHOVA,"CĂMIN CULTURAL COCORĂȘTII CAPLII, SAT COCORĂȘTII CAPLII, NR.130",474,MĂGURENI,134050,1,PART,PRCNCT,PRSD,PRSD_SV,"2025-05-18 21:34:16",665,444,373,71,0,443,1,700,256,192,251
31,PRAHOVA,"ȘCOALA PRIMARĂ LUNCA PRAHOVEI, SAT LUNCA PRAHOVEI, NR.39",475,MĂGURENI,134050,1,PART,PRCNCT,PRSD,PRSD_SV,"2025-05-18 21:31:14",908,493,442,51,0,490,3,1000,507,341,149
31,PRAHOVA,"GRĂDINIȚA CU PROGRAM NORMAL NR.3",476,MĂNECIU,134096,1,PART,PRCNCT,PRSD,PRSD_SV,"2025-05-18 21:43:02",1292,776,701,73,2,765,11,1400,624,375,390
31,PRAHOVA,"ŞCOALA PRIMARĂ CHEIA, NR.1",477,MĂNECIU,134096,1,PART,PRCNCT,PRSD,PRSD_SV,"2025-05-18 22:14:43",314,405,158,246,1,400,5,600,195,159,241
31,PRAHOVA,"ŞCOALA MICĂ MĂNECIU",478,MĂNECIU,134096,1,PART,PRCNCT,PRSD,PRSD_SV,"2025-05-18 22:05:55",1184,710,623,85,2,702,8,1300,590,317,385
31,PRAHOVA,"COLEGIUL FERDINAND I",479,MĂNECIU,134096,1,PART,PRCNCT,PRSD,PRSD_SV,"2025-05-18 22:22:22",1226,717,630,87,0,714,3,1300,583,327,387
31,PRAHOVA,"COLEGIUL FERDINAND I",480,MĂNECIU,134096,1,PART,PRCNCT,PRSD,PRSD_SV,"2025-05-18 22:22:02",1054,620,544,76,0,613,7,1200,580,304,309
31,PRAHOVA,"ŞCOALA GIMNAZIALĂ MĂNECIU-PĂMÎNTENI, NR.267",481,MĂNECIU,134096,1,PART,PRCNCT,PRSD,PRSD_SV,"2025-05-18 22:16:30",851,538,479,59,0,534,4,900,362,297,237
31,PRAHOVA,"ŞCOALA GIMNAZIALĂ MĂNECIU-PĂMÎNTENI, NR.267",482,MĂNECIU,134096,1,PART,PRCNCT,PRSD,PRSD_SV,"2025-05-18 21:54:40",939,545,508,37,0,540,5,1000,455,271,269
31,PRAHOVA,"ŞCOALA GIMNAZIALĂ MĂNECIU-PĂMÎNTENI, NR.1229",483,MĂNECIU,134096,1,PART,PRCNCT,PRSD,PRSD_SV,"2025-05-18 22:43:00",1529,911,815,96,0,902,9,1600,689,508,394
31,PRAHOVA,"CĂMIN CULTURAL",484,MĂNEŞTI,134194,1,PART,PRCNCT,PRSD,PRSD_SV,"2025-05-18 21:50:05",851,525,430,95,0,518,7,900,375,299,219
31,PRAHOVA,"SALĂ MULTIFUNCȚIONALĂ BĂLTIȚA",485,MĂNEŞTI,134194,1,PART,PRCNCT,PRSD,PRSD_SV,"2025-05-18 21:43:37",699,387,333,54,0,387,0,800,413,226,161
31,PRAHOVA,"ȘCOALA COADA IZVORULUI",486,MĂNEŞTI,134194,1,PART,PRCNCT,PRSD,PRSD_SV,"2025-05-18 21:33:43",707,438,382,55,1,434,4,800,362,259,175
31,PRAHOVA,"SALĂ MULTIFUNCȚIONALĂ ZALHANAUA",487,MĂNEŞTI,134194,1,PART,PRCNCT,PRSD,PRSD_SV,"2025-05-18 21:27:46",829,469,414,55,0,460,9,900,431,301,159
31,PRAHOVA,"ȘCOALA GIMNAZIALӐ OLARI, SAT OLARI",488,OLARI,136250,1,PART,PRCNCT,PRSD,PRSD_SV,"2025-05-18 21:27:43",548,338,276,62,0,335,3,600,262,186,149
31,PRAHOVA,"ȘCOALA PRIMARӐ FȂNARI, SAT FȂNARI",489,OLARI,136250,1,PART,PRCNCT,PRSD,PRSD_SV,"2025-05-18 21:15:52",317,248,187,61,0,243,5,400,152,151,92
31,PRAHOVA,"ȘCOALA PRIMARӐ OLARII-VECHI, SAT OLARII-VECHI",490,OLARI,136250,1,PART,PRCNCT,PRSD,PRSD_SV,"2025-05-18 21:16:31",598,327,277,49,1,322,5,700,373,176,146
31,PRAHOVA,"GRĂDINIŢA CU PROGRAM NORMAL PĂCUREŢI",491,PĂCUREŢI,134336,1,PART,PRCNCT,PRSD,PRSD_SV,"2025-05-18 21:44:31",919,485,413,72,0,480,5,1000,515,303,177
31,PRAHOVA,"ŞCOALA GIMNAZIALĂ",492,PĂCUREŢI,134336,1,PART,PRCNCT,PRSD,PRSD_SV,"2025-05-18 21:42:17",596,308,259,48,1,305,3,600,292,214,91
31,PRAHOVA,"SCOALA GENERALA CU CL.I-VIII ARH.TOMA T.SOCOLESCU PAULESTI",493,PĂULEŞTI,130847,1,PART,PRCNCT,PRSD,PRSD_SV,"2025-05-18 21:52:20",1662,1384,1026,323,35,1364,20,1800,416,460,904
31,PRAHOVA,"CENTRUL CULTURAL ARH.TOMA T.SOCOLESCU PAULESTI",494,PĂULEŞTI,130847,1,PART,PRCNCT,PRSD,PRSD_SV,"2025-05-18 22:02:55",2019,1674,1355,316,3,1653,21,2200,526,477,1176
31,PRAHOVA,"SALA MULTIFUNCTIONALA COCOSESTI",495,PĂULEŞTI,130847,1,PART,PRCNCT,PRSD,PRSD_SV,"2025-05-18 21:32:00",949,784,625,158,1,775,9,1000,216,342,433
31,PRAHOVA,"SCOALA GENERALA CU CLS.I-VIII VLAD MUSATESCU GAGENI",496,PĂULEŞTI,130847,1,PART,PRCNCT,PRSD,PRSD_SV,"2025-05-18 21:36:23",856,659,486,118,55,645,14,900,241,309,336
31,PRAHOVA,"CAMINUL CULTURAL GAGENI",497,PĂULEŞTI,130847,1,PART,PRCNCT,PRSD,PRSD_SV,"2025-05-18 22:18:53",1260,921,788,133,0,911,10,1400,479,363,548
31,PRAHOVA,"SCOALA GIMNAZIALA COMUNA PLOPU",498,PLOPU,134390,1,PART,PRCNCT,PRSD,PRSD_SV,"2025-05-18 21:22:13",885,599,486,110,3,593,6,1000,401,333,260
31,PRAHOVA,"FOSTA SCOALA CU CLS. I - IV GALMEIA",499,PLOPU,134390,1,PART,PRCNCT,PRSD,PRSD_SV,"2025-05-18 21:14:32",218,196,127,69,0,194,2,300,104,110,84
31,PRAHOVA,"CASA HRAM - PAROHIA NISIPOASA HARSA",500,PLOPU,134390,1,PART,PRCNCT,PRSD,PRSD_SV,"2025-05-18 21:30:26",233,178,133,45,0,176,2,300,122,91,85
31,PRAHOVA,"SCOALA CU CLASELE I - IV NISIPOASA",501,PLOPU,134390,1,PART,PRCNCT,PRSD,PRSD_SV,"2025-05-18 21:26:11",680,457,357,99,1,450,7,700,243,238,212
31,PRAHOVA,"CĂMIN CULTURAL DIN SAT PODENII NOI",502,"PODENII NOI",134443,1,PART,PRCNCT,PRSD,PRSD_SV,"2025-05-18 21:49:02",1295,744,663,80,1,741,3,1400,656,516,225
31,PRAHOVA,"CĂMIN CULTURAL ÎN SAT MEHEDINȚA",503,"PODENII NOI",134443,1,PART,PRCNCT,PRSD,PRSD_SV,"2025-05-18 21:32:15",1348,720,623,97,0,710,10,1500,780,452,258
31,PRAHOVA,"GRADINITA DE COPII POPESTI",504,"PODENII NOI",134443,1,PART,PRCNCT,PRSD,PRSD_SV,"2025-05-18 21:25:52",458,284,228,56,0,282,2,500,216,194,88
31,PRAHOVA,"CĂMIN CULTURAL ÎN SAT VALEA DULCE",505,"PODENII NOI",134443,1,PART,PRCNCT,PRSD,PRSD_SV,"2025-05-18 21:28:18",760,439,402,37,0,437,2,800,361,294,143
31,PRAHOVA,"ŞCOALA GIMNAZIALĂ ”ÎNVĂŢĂTOR ION MATEESCU” POIANA-CĂMPINA",506,"POIANA CÂMPINA",131274,1,PART,PRCNCT,PRSD,PRSD_SV,"2025-05-18 21:34:24",987,629,523,106,0,615,14,1100,471,270,345
31,PRAHOVA,"PRIMĂRIA POIANA CÂMPINA-CLĂDIRE BIROURI",507,"POIANA CÂMPINA",131274,2,PART,PRCNCT,PRSD,PRSD_SV,"2025-05-19 00:06:07",1218,704,636,67,1,692,12,1300,596,284,408
31,PRAHOVA,"BIBLIOTECA ”DIMITRIE GUSTI” COMUNA POIANA-CĂMPINA",508,"POIANA CÂMPINA",131274,1,PART,PRCNCT,PRSD,PRSD_SV,"2025-05-18 21:30:27",586,388,323,65,0,381,7,600,212,172,209
31,PRAHOVA,"CĂMINUL CULTURAL BOBOLIA",509,"POIANA CÂMPINA",131274,1,PART,PRCNCT,PRSD,PRSD_SV,"2025-05-18 22:34:52",845,569,501,68,0,566,3,900,331,250,316
31,PRAHOVA,"ŞCOALA GENERALĂ PIETRIŞU",510,"POIANA CÂMPINA",131274,1,PART,PRCNCT,PRSD,PRSD_SV,"2025-05-18 21:32:23",449,263,240,22,1,256,7,500,237,138,118
31,PRAHOVA,"SCOALA GIMANZIALA POIENARII BURCHII",511,"POIENARII BURCHII",134559,1,PART,PRCNCT,PRSD,PRSD_SV,"2025-05-18 21:47:55",931,576,428,146,2,567,9,1000,424,294,273
31,PRAHOVA,"GRADINITA DE COPII SAT CARBUNARI",512,"POIENARII BURCHII",134559,1,PART,PRCNCT,PRSD,PRSD_SV,"2025-05-18 21:31:27",584,361,300,61,0,357,4,600,239,195,162
31,PRAHOVA,"ANEXA PRIMARIE SAT OLOGENI",513,"POIENARII BURCHII",134559,1,PART,PRCNCT,PRSD,PRSD_SV,"2025-05-18 21:45:07",1044,634,528,106,0,633,1,1200,566,438,195
31,PRAHOVA,"ŞCOALA GIMNAZIALÃ OLOGENI",514,"POIENARII BURCHII",134559,1,PART,PRCNCT,PRSD,PRSD_SV,"2025-05-18 21:32:35",408,257,185,72,0,251,6,500,243,148,103
31,PRAHOVA,"SCOALA POIENARII RALI",515,"POIENARII BURCHII",134559,1,PART,PRCNCT,PRSD,PRSD_SV,"2025-05-18 21:59:50",747,545,382,163,0,542,3,800,255,269,273
31,PRAHOVA,"CĂMINUL CULTURAL DIN SATUL POSEŞTII-PĂMÂNTENI",516,POSEŞTI,134648,1,PART,PRCNCT,PRSD,PRSD_SV,"2025-05-18 21:36:15",606,367,299,67,1,363,4,700,333,183,180
31,PRAHOVA,"CĂMINUL CULTURAL DIN SATUL NUCSOARA DE SUS",517,POSEŞTI,134648,1,PART,PRCNCT,PRSD,PRSD_SV,"2025-05-18 22:25:44",1187,684,611,73,0,675,9,1300,616,393,282
31,PRAHOVA,"FOSTA ŞCOALĂ GENERALĂ CU CLASELE I-IV DIN SATUL TÂRLEŞTI",518,POSEŞTI,134648,1,PART,PRCNCT,PRSD,PRSD_SV,"2025-05-18 21:35:20",425,219,177,42,0,217,2,500,281,123,94
31,PRAHOVA,"CĂMIN CULTURAL DIN SATUL VALEA PLOPULUI",519,POSEŞTI,134648,1,PART,PRCNCT,PRSD,PRSD_SV,"2025-05-18 21:59:42",764,402,345,57,0,397,5,800,398,258,139
31,PRAHOVA,"ȘCOALA GIMNAZIALĂ ”MĂNĂSTIREANU MIHAI” PREDEAL",520,PREDEAL-SĂRARI,134755,1,PART,PRCNCT,PRSD,PRSD_SV,"2025-05-18 21:24:41",702,425,377,46,2,421,4,800,375,264,157
31,PRAHOVA,"GRADINITA VITIOARA DE SUS",521,PREDEAL-SĂRARI,134755,1,PART,PRCNCT,PRSD,PRSD_SV,"2025-05-18 21:29:18",975,599,548,51,0,596,3,1098,499,356,240
31,PRAHOVA,"ȘCOALA ELEMENTARĂ ZÎMBROAIA",522,PREDEAL-SĂRARI,134755,1,PART,PRCNCT,PRSD,PRSD_SV,"2025-05-18 21:20:17",116,76,50,25,1,74,2,200,124,32,42
31,PRAHOVA,"SCOALA GIMNAZIALA PROVITA DE JOS",523,"PROVIŢA DE JOS",134853,1,PART,PRCNCT,PRSD,PRSD_SV,"2025-05-18 21:20:31",863,574,431,143,0,566,8,1000,426,281,285
31,PRAHOVA,"ȘCOALA PRIMARĂ, SAT DRĂGĂNEASA, COMUNA PROVIȚA DE JOS",524,"PROVIŢA DE JOS",134853,1,PART,PRCNCT,PRSD,PRSD_SV,"2025-05-18 21:29:18",894,535,452,83,0,530,5,1000,465,307,223
31,PRAHOVA,"ŞCOALA GIMNAZIALĂ CU CLASELE I-VIII”MITROPOLIT PIMEN GEORGESCU” PROVIŢA DE SUS",525,"PROVIŢA DE SUS",134899,1,PART,PRCNCT,PRSD,PRSD_SV,"2025-05-18 22:00:01",1287,866,672,170,24,858,8,1400,534,417,441
31,PRAHOVA,"GRĂDINŢA CU PROGRAM NORMAL IZVORU",526,"PROVIŢA DE SUS",134899,1,PART,PRCNCT,PRSD,PRSD_SV,"2025-05-18 21:29:50",282,200,147,53,0,195,5,300,100,107,88
31,PRAHOVA,"SCOALA GIMNAZIALA,COMUNA PUCHENII MARI",527,"PUCHENII MARI",134942,1,PART,PRCNCT,PRSD,PRSD_SV,"2025-05-18 21:51:45",986,692,547,143,2,686,6,1100,408,314,372
31,PRAHOVA,"SCOALA PRIMARA MIROSLAVESTI",528,"PUCHENII MARI",134942,1,PART,PRCNCT,PRSD,PRSD_SV,"2025-05-18 22:30:49",1407,824,726,98,0,814,10,1492,668,429,385
31,PRAHOVA,"GRADINITA CU PROGRAM NORMAL ODAILE",529,"PUCHENII MARI",134942,1,PART,PRCNCT,PRSD,PRSD_SV,"2025-05-18 22:30:44",1267,777,668,109,0,763,14,1400,623,437,326
31,PRAHOVA,"CAMINUL CULTURAL PIETROSANI",530,"PUCHENII MARI",134942,1,PART,PRCNCT,PRSD,PRSD_SV,"2025-05-18 22:02:31",923,595,485,110,0,585,10,1000,405,266,319
31,PRAHOVA,"GRADINITA CU PROGRAM NORMALPIETROSANI",531,"PUCHENII MARI",134942,1,PART,PRCNCT,PRSD,PRSD_SV,"2025-05-18 21:53:28",927,539,471,68,0,534,5,1000,461,260,274
31,PRAHOVA,"GRADINITA PUCHENII MOSNENI",532,"PUCHENII MARI",134942,1,PART,PRCNCT,PRSD,PRSD_SV,"2025-05-18 21:47:49",1170,744,661,82,1,739,5,1300,556,432,307
31,PRAHOVA,"FOSTUL SEDIU AL PRIMARIEI",533,RÂFOV,135020,1,PART,PRCNCT,PRSD,PRSD_SV,"2025-05-18 21:22:29",279,150,130,20,0,148,2,300,150,92,56
31,PRAHOVA,"FOSTUL SEDIU AL PRIMARIEI",534,RÂFOV,135020,1,PART,PRCNCT,PRSD,PRSD_SV,"2025-05-18 21:19:24",133,77,59,18,0,76,1,200,123,45,31
31,PRAHOVA,"SCOALA GIMNAZILA BUDA",535,RÂFOV,135020,1,PART,PRCNCT,PRSD,PRSD_SV,"2025-05-18 21:49:23",807,467,412,55,0,461,6,900,433,266,195
31,PRAHOVA,"SCOALA PRIMARA GOGA",536,RÂFOV,135020,2,PART,PRCNCT,PRSD,PRSD_SV,"2025-05-18 23:07:06",411,263,215,48,0,260,3,500,237,124,136
31,PRAHOVA,"SCOALA PRIMARA MALAIESTI",537,RÂFOV,135020,1,PART,PRCNCT,PRSD,PRSD_SV,"2025-05-18 21:33:22",635,386,345,41,0,381,5,700,314,209,172
31,PRAHOVA,"SCOALA PRIMARA MOARA DOMNEASCA",538,RÂFOV,135020,1,PART,PRCNCT,PRSD,PRSD_SV,"2025-05-18 21:49:00",796,418,374,44,0,413,5,900,482,261,152
31,PRAHOVA,"SCOALA PRIMARA PALANCA",539,RÂFOV,135020,1,PART,PRCNCT,PRSD,PRSD_SV,"2025-05-18 21:39:27",857,437,386,51,0,431,6,900,463,249,182
31,PRAHOVA,"SCOALA PRIMARA SICRITA",540,RÂFOV,135020,1,PART,PRCNCT,PRSD,PRSD_SV,"2025-05-18 21:29:39",427,232,193,39,0,228,4,500,268,156,72
31,PRAHOVA,"SCOALA GIMNAZIALA",541,SALCIA,135128,1,PART,PRCNCT,PRSD,PRSD_SV,"2025-05-18 21:23:46",742,405,330,75,0,400,5,800,395,249,151
31,PRAHOVA,"ȘCOALA GIMNAZIALĂ COMUNA SĂLCIILE",542,SĂLCIILE,135146,1,PART,PRCNCT,PRSD,PRSD_SV,"2025-05-18 23:14:43",670,432,319,83,30,429,3,700,268,237,192
31,PRAHOVA,"CAMINUL CULTURAL",543,SĂLCIILE,135146,1,PART,PRCNCT,PRSD,PRSD_SV,"2025-05-18 21:56:32",642,419,278,112,29,410,9,700,281,221,189
31,PRAHOVA,"GRĂDINIŢA CU PROGRAM NORMAL",544,SÂNGERU,135244,1,PART,PRCNCT,PRSD,PRSD_SV,"2025-05-18 21:35:30",1314,358,333,25,0,354,4,1500,1142,263,91
31,PRAHOVA,"GRĂDINIŢA CU PROGRAM NORMAL",545,SÂNGERU,135244,1,PART,PRCNCT,PRSD,PRSD_SV,"2025-05-18 21:32:42",675,262,224,38,0,261,1,700,438,159,102
31,PRAHOVA,"GRĂDINIŢA CU PROGRAM NORMAL",546,SÂNGERU,135244,1,PART,PRCNCT,PRSD,PRSD_SV,"2025-05-18 21:31:03",422,284,231,53,0,284,0,500,216,187,97
31,PRAHOVA,"GRADINITA CU PROGRAM NORMAL-CLADIRE ANEXA",547,SÂNGERU,135244,1,PART,PRCNCT,PRSD,PRSD_SV,"2025-05-18 21:33:47",1087,583,529,54,0,577,6,1200,617,410,167
31,PRAHOVA,"GRĂDINIŢA CU PROGRAM NORMAL",548,SÂNGERU,135244,1,PART,PRCNCT,PRSD,PRSD_SV,"2025-05-18 21:26:56",517,267,233,34,0,265,2,600,333,169,96
31,PRAHOVA,"SCOALA GIMNAZIALA SCORTENI",549,SCORŢENI,135164,1,PART,PRCNCT,PRSD,PRSD_SV,"2025-05-18 21:46:55",1148,711,618,91,2,702,9,1300,589,417,285
31,PRAHOVA,"GRADINITA BORDENII MARI",550,SCORŢENI,135164,1,PART,PRCNCT,PRSD,PRSD_SV,"2025-05-18 21:52:58",1176,770,682,85,3,765,5,1300,530,392,373
31,PRAHOVA,"SCOALA GIMNAZIALA MISLEA",551,SCORŢENI,135164,1,PART,PRCNCT,PRSD,PRSD_SV,"2025-05-18 22:09:31",1431,892,785,101,6,882,10,1600,708,522,360
31,PRAHOVA,"SCOALA GIMNAZIALA BORDENI",552,SCORŢENI,135164,1,PART,PRCNCT,PRSD,PRSD_SV,"2025-05-18 21:24:16",780,463,414,47,2,462,1,900,437,228,234
31,PRAHOVA,"ŞCOALA GIMNAZIALĂ COMUNA SECĂRIA",553,SECĂRIA,135226,1,PART,PRCNCT,PRSD,PRSD_SV,"2025-05-18 21:51:49",955,538,479,48,11,533,5,1000,462,229,304
31,PRAHOVA,"GRĂDINIŢA DE COPII DIN SATUL STARCHIOJD",554,STARCHIOJD,135315,1,PART,PRCNCT,PRSD,PRSD_SV,"2025-05-18 21:52:05",1263,724,620,104,0,720,4,1400,676,445,275
31,PRAHOVA,"GRĂDINIŢA DE COPII DIN GÎRBEASCA",555,STARCHIOJD,135315,1,PART,PRCNCT,PRSD,PRSD_SV,"2025-05-18 21:57:59",1122,589,539,49,1,581,8,1200,611,376,205
31,PRAHOVA,"ŞCOALA DIN SATUL VALEA ANEI",556,STARCHIOJD,135315,1,PART,PRCNCT,PRSD,PRSD_SV,"2025-05-18 21:51:26",364,212,153,59,0,206,6,400,188,135,71
31,PRAHOVA,"GRĂDINIȚA CU PROGRAM NORMAL SURANI",557,SURANI,135404,1,PART,PRCNCT,PRSD,PRSD_SV,"2025-05-18 21:47:35",1451,741,647,94,0,737,4,1600,859,483,254
31,PRAHOVA,"ŞCOALA PRIMARĂ, SAT ŞIRNA",558,ŞIRNA,135431,1,PART,PRCNCT,PRSD,PRSD_SV,"2025-05-18 21:24:37",599,299,268,31,0,294,5,700,401,153,141
31,PRAHOVA,"ŞCOALA PRIMARĂ, SAT BRĂTEŞTI",559,ŞIRNA,135431,1,PART,PRCNCT,PRSD,PRSD_SV,"2025-05-18 21:29:33",351,254,201,53,0,254,0,400,146,137,117
31,PRAHOVA,"ŞCOALA GIMNAZIALĂ, SAT HĂBUD",560,ŞIRNA,135431,1,PART,PRCNCT,PRSD,PRSD_SV,"2025-05-18 21:51:37",615,346,276,70,0,337,9,700,354,206,131
31,PRAHOVA,"ŞCOALA GIMNAZIALĂ, SAT TĂRICENI",561,ŞIRNA,135431,1,PART,PRCNCT,PRSD,PRSD_SV,"2025-05-18 21:33:42",825,453,389,64,0,451,2,900,447,213,238
31,PRAHOVA,"ŞCOALA GIMNAZIALĂ, SAT TĂRICENI",562,ŞIRNA,135431,1,PART,PRCNCT,PRSD,PRSD_SV,"2025-05-18 21:29:57",662,364,336,28,0,363,1,700,336,212,151
31,PRAHOVA,"GRĂDINIȚĂ CU PROGRAM NORMAL VARNIŢA",563,ŞIRNA,135431,1,PART,PRCNCT,PRSD,PRSD_SV,"2025-05-18 21:38:52",667,386,329,57,0,385,1,700,314,214,171
31,PRAHOVA,"ȘCOALA GIMNAZIALĂ ”MINERVA ALEXANDRESCU”",564,ŞOIMARI,135501,1,PART,PRCNCT,PRSD,PRSD_SV,"2025-05-18 21:41:13",1337,661,558,103,0,657,4,1500,839,478,179
31,PRAHOVA,"GRĂDINIȚA CU PROGRAM NORMAL",565,ŞOIMARI,135501,1,PART,PRCNCT,PRSD,PRSD_SV,"2025-05-18 21:31:42",557,282,261,21,0,281,1,600,318,203,78
31,PRAHOVA,"CĂMIN CULTURAL",566,ŞOIMARI,135501,1,PART,PRCNCT,PRSD,PRSD_SV,"2025-05-18 21:32:54",399,226,188,38,0,225,1,400,174,157,68
31,PRAHOVA,"ŞCOALA GIMNAZIALĂ, SAT SOTRILE, NR 364",567,ŞOTRILE,135547,1,PART,PRCNCT,PRSD,PRSD_SV,"2025-05-18 21:34:51",768,391,354,32,5,388,3,800,409,245,143
31,PRAHOVA,"ŞCOALA SAT LUNCA-MARE, NR 166",568,ŞOTRILE,135547,1,PART,PRCNCT,PRSD,PRSD_SV,"2025-05-18 21:36:41",366,268,201,67,0,266,2,400,132,146,120
31,PRAHOVA,"SCOALA SAT PLAIU CAMPINEI, NR 35",569,ŞOTRILE,135547,1,PART,PRCNCT,PRSD,PRSD_SV,"2025-05-18 21:32:35",685,261,231,30,0,259,2,800,539,148,111
31,PRAHOVA,"ŞCOALA SAT SECIURI, NR 17",570,ŞOTRILE,135547,1,PART,PRCNCT,PRSD,PRSD_SV,"2025-05-18 21:37:25",285,152,137,15,0,152,0,300,148,78,74
31,PRAHOVA,"ŞCOALA SAT VISTIERU, NR 25",571,ŞOTRILE,135547,1,PART,PRCNCT,PRSD,PRSD_SV,"2025-05-18 21:25:57",434,225,197,28,0,222,3,500,275,127,95
31,PRAHOVA,"SCOALA GIMNAZIALA STEFESTI",572,ŞTEFEŞTI,135618,1,PART,PRCNCT,PRSD,PRSD_SV,"2025-05-18 21:33:07",1241,688,596,92,0,683,5,1400,712,356,327
31,PRAHOVA,"GRĂDINIŢA DE COPII",573,ŞTEFEŞTI,135618,1,PART,PRCNCT,PRSD,PRSD_SV,"2025-05-18 21:43:53",602,306,277,28,1,304,2,700,394,217,87
31,PRAHOVA,"SCOALA GIMNAZIALA TALEA",574,TALEA,135654,1,PART,PRCNCT,PRSD,PRSD_SV,"2025-05-18 21:33:01",820,559,478,79,2,556,3,900,341,277,279
31,PRAHOVA,"CAMIN CULTURAL",575,TĂTARU,135681,1,PART,PRCNCT,PRSD,PRSD_SV,"2025-05-18 21:22:37",197,163,104,41,18,162,1,198,35,99,63
31,PRAHOVA,"CAMIN CULTURAL",576,TĂTARU,135681,1,PART,PRCNCT,PRSD,PRSD_SV,"2025-05-18 21:30:13",423,277,197,57,23,274,3,500,223,159,115
31,PRAHOVA,"BAZA SPORTIVĂ STREJNICU",577,"TÂRGŞORU VECHI",130892,1,PART,PRCNCT,PRSD,PRSD_SV,"2025-05-18 22:04:27",1866,1119,1007,112,0,1107,12,2000,881,601,506
31,PRAHOVA,"GRĂDINIŢA CU PROGRAM NORMAL STREJNICU",578,"TÂRGŞORU VECHI",130892,1,PART,PRCNCT,PRSD,PRSD_SV,"2025-05-18 21:41:13",1472,850,723,127,0,839,11,1600,750,465,374
31,PRAHOVA,"ŞCOALA GIMNAZIALĂ STREJNICU",579,"TÂRGŞORU VECHI",130892,2,PART,PRCNCT,PRSD,PRSD_SV,"2025-05-19 00:15:40",1899,1228,1047,181,0,1206,22,2100,872,584,622
31,PRAHOVA,"CĂMINUL CULTURAL STREJNICU",580,"TÂRGŞORU VECHI",130892,1,PART,PRCNCT,PRSD,PRSD_SV,"2025-05-18 21:52:40",1236,797,673,124,0,789,8,1400,603,308,481
31,PRAHOVA,"ŞCOALA GENERALĂ CU CLASELE I-IV STĂNCEŞTI",581,"TÂRGŞORU VECHI",130892,1,PART,PRCNCT,PRSD,PRSD_SV,"2025-05-18 21:31:28",849,426,384,42,0,424,2,900,474,242,182
31,PRAHOVA,"ŞCOALA GIMNAZIALĂ TIRGŞORU VECHI",582,"TÂRGŞORU VECHI",130892,1,PART,PRCNCT,PRSD,PRSD_SV,"2025-05-18 21:34:49",1086,638,552,85,1,631,7,1200,562,317,314
31,PRAHOVA,"GRĂDINIŢA CU PROGRAM NORMAL TÎRGŞORU VECHI",583,"TÂRGŞORU VECHI",130892,1,PART,PRCNCT,PRSD,PRSD_SV,"2025-05-18 21:41:46",993,599,538,60,1,589,10,1100,501,290,299
31,PRAHOVA,"ȘCOALA GIMNAZIALĂ ”DUMITRU BREZEANU”,SAT TEIȘANI,NR.160",584,TEIŞANI,135725,1,PART,PRCNCT,PRSD,PRSD_SV,"2025-05-18 23:06:43",1383,889,775,114,0,875,14,1500,611,501,374
31,PRAHOVA,"SCOALA GIMNAZIALĂ ”MOISE VASILESCU”, SAT OLTENI, NR.147",585,TEIŞANI,135725,1,PART,PRCNCT,PRSD,PRSD_SV,"2025-05-18 21:49:56",1369,884,763,121,0,870,14,1500,616,475,395
31,PRAHOVA,"SC ROM CABLU SRL, SAT VALEA STÎLPULUI,NR.2",586,TEIŞANI,135725,1,PART,PRCNCT,PRSD,PRSD_SV,"2025-05-18 21:16:52",174,159,111,48,0,155,4,200,41,76,79
31,PRAHOVA,"ŞCOALA GIMNAZIALA NR.1 TELEGA",587,TELEGA,135789,1,PART,PRCNCT,PRSD,PRSD_SV,"2025-05-18 21:46:30",1037,702,568,133,1,691,11,1100,398,293,398
31,PRAHOVA,"SCOALA GENERALA NR.2 TELEGA-VALE",588,TELEGA,135789,1,PART,PRCNCT,PRSD,PRSD_SV,"2025-05-18 21:35:05",1361,801,710,91,0,789,12,1500,699,402,387
31,PRAHOVA,"GRĂDINIŢA NR.1 TELEGA",589,TELEGA,135789,1,PART,PRCNCT,PRSD,PRSD_SV,"2025-05-18 21:55:41",1050,621,543,77,1,614,7,1200,579,302,312
31,PRAHOVA,"ŞCOALA GIMNAZIALĂ SAT BUŞTENARI",590,TELEGA,135789,1,PART,PRCNCT,PRSD,PRSD_SV,"2025-05-18 21:18:55",451,251,205,46,0,251,0,500,249,122,129
31,PRAHOVA,"SCOALA PRIMARA SAT MELICEŞTI",591,TELEGA,135789,1,PART,PRCNCT,PRSD,PRSD_SV,"2025-05-18 21:14:21",345,179,154,25,0,179,0,400,221,73,106
31,PRAHOVA,"CĂMINUL CULTURAL",592,TINOSU,135850,1,PART,PRCNCT,PRSD,PRSD_SV,"2025-05-18 21:49:06",882,500,413,87,0,495,5,1000,500,231,264
31,PRAHOVA,"ŞCOALA PRIMARĂ SAT PISCULEŞTI, LOCALITATEA PISCULEŞTI",593,TINOSU,135850,1,PART,PRCNCT,PRSD,PRSD_SV,"2025-05-18 21:23:55",471,238,197,41,0,233,5,500,262,138,95
31,PRAHOVA,"ŞCOALA PRIMARĂ SAT PREDEŞTI, LOCALITATEA PREDEŞTI",594,TINOSU,135850,1,PART,PRCNCT,PRSD,PRSD_SV,"2025-05-18 21:29:01",500,316,268,48,0,312,4,600,284,166,146
31,PRAHOVA,"CĂMIN CULTURAL LOLOIASCA, SAT LOLOIASCA, NR. 6V",595,TOMŞANI,135896,1,PART,PRCNCT,PRSD,PRSD_SV,"2025-05-18 21:52:16",1203,673,592,81,0,665,8,1300,627,445,220
31,PRAHOVA,"ŞCOALA GIMNAZIALĂ ”PROF.DINU MIHAIL-DAN” SAT MAGULA, COMUNA TOMŞANI, JUDEŢUL PRAHOVA",596,TOMŞANI,135896,1,PART,PRCNCT,PRSD,PRSD_SV,"2025-05-18 21:45:08",1313,803,696,107,0,798,5,1400,597,416,382
31,PRAHOVA,"ṢCOALA VECHE MAGULA, SAT MAGULA, NR. 406A",597,TOMŞANI,135896,1,PART,PRCNCT,PRSD,PRSD_SV,"2025-05-18 21:35:00",976,514,459,53,2,509,5,1100,586,314,195
31,PRAHOVA,"ȘCOALĂ GIMNAZIALĂ VADU SĂPAT, COMUNA VADU SĂPAT, SAT VADU SĂPAT",598,"VADU SĂPAT",136269,1,PART,PRCNCT,PRSD,PRSD_SV,"2025-05-18 21:40:59",1315,721,577,141,3,718,3,1400,679,389,329
31,PRAHOVA,"SCOALA GIMNAZIALA ION IONESCU VALEA CALUGAREASCA",599,"VALEA CĂLUGĂREASCĂ",135949,1,PART,PRCNCT,PRSD,PRSD_SV,"2025-05-18 21:44:13",1341,777,691,85,1,772,5,1500,723,368,404
31,PRAHOVA,"SCOALA GIMNAZIALA ION IONESCU VALEA CALUGAREASCA",600,"VALEA CĂLUGĂREASCĂ",135949,1,PART,PRCNCT,PRSD,PRSD_SV,"2025-05-18 21:28:20",936,477,421,55,1,474,3,1000,523,247,227
31,PRAHOVA,"CAMIN CULTURAL",601,"VALEA CĂLUGĂREASCĂ",135949,1,PART,PRCNCT,PRSD,PRSD_SV,"2025-05-18 21:36:23",1140,700,625,75,0,695,5,1200,500,371,324
31,PRAHOVA,"GRADINITA COSLEGI",602,"VALEA CĂLUGĂREASCĂ",135949,1,PART,PRCNCT,PRSD,PRSD_SV,"2025-05-18 21:25:00",535,303,251,52,0,303,0,600,297,206,97
31,PRAHOVA,"GRADINITA DIRVARI",603,"VALEA CĂLUGĂREASCĂ",135949,1,PART,PRCNCT,PRSD,PRSD_SV,"2025-05-18 21:31:17",487,289,251,38,0,288,1,500,211,128,160
31,PRAHOVA,"SCOAL PRIMARA PANTAZI",604,"VALEA CĂLUGĂREASCĂ",135949,1,PART,PRCNCT,PRSD,PRSD_SV,"2025-05-18 21:34:07",954,519,470,49,0,518,1,1000,481,297,221
31,PRAHOVA,"GRADINITA CU PROGRAM NORMAL CASUTA FERMECATA SAT RACHIERI",605,"VALEA CĂLUGĂREASCĂ",135949,1,PART,PRCNCT,PRSD,PRSD_SV,"2025-05-18 21:36:11",1218,541,514,27,0,538,3,1300,759,445,93
31,PRAHOVA,"GRADINITA RADILA",606,"VALEA CĂLUGĂREASCĂ",135949,1,PART,PRCNCT,PRSD,PRSD_SV,"2025-05-18 21:20:05",237,137,118,18,1,137,0,300,163,78,59
31,PRAHOVA,"CABANA DE VANATOARE",607,"VALEA CĂLUGĂREASCĂ",135949,1,PART,PRCNCT,PRSD,PRSD_SV,"2025-05-18 21:18:04",90,65,42,23,0,63,2,100,35,43,20
31,PRAHOVA,"SCOAL GIMNAZIALA NICOVANI",608,"VALEA CĂLUGĂREASCĂ",135949,1,PART,PRCNCT,PRSD,PRSD_SV,"2025-05-18 21:32:36",1157,671,612,58,1,667,4,1300,629,330,337
31,PRAHOVA,"COLEGIUL AGRICOL GHEORGHE IONESCU SISESTI",609,"VALEA CĂLUGĂREASCĂ",135949,1,PART,PRCNCT,PRSD,PRSD_SV,"2025-05-18 21:41:50",770,454,395,59,0,448,6,800,346,225,223
31,PRAHOVA,"LICEUL TEHNOLOGIC ”CAROL I” VALEA DOFTANEI",610,"VALEA DOFTANEI",136107,1,PART,PRCNCT,PRSD,PRSD_SV,"2025-05-18 21:51:54",1276,661,577,83,1,655,6,1400,739,301,354
31,PRAHOVA,"GRĂDINIŢA NR.1 TEŞILA",611,"VALEA DOFTANEI",136107,1,PART,PRCNCT,PRSD,PRSD_SV,"2025-05-18 21:54:49",1087,583,490,93,0,578,5,1200,617,266,312
31,PRAHOVA,"GRĂDINIŢA NR.2 TEŞILA",612,"VALEA DOFTANEI",136107,1,PART,PRCNCT,PRSD,PRSD_SV,"2025-05-18 21:46:14",937,584,504,80,0,580,4,1000,416,284,296
31,PRAHOVA,"PRIMĂRIA TRĂISTENI",613,"VALEA DOFTANEI",136107,1,PART,PRCNCT,PRSD,PRSD_SV,"2025-05-18 21:39:43",923,557,422,135,0,555,2,1000,443,234,321
31,PRAHOVA,"ŞCOALA CU CLASELE I-VIII ”EROU INV.I.DRĂGĂNESCU”TRĂISTENI",614,"VALEA DOFTANEI",136107,1,PART,PRCNCT,PRSD,PRSD_SV,"2025-05-18 22:07:03",979,604,506,97,1,601,3,1100,496,261,340
31,PRAHOVA,"ȘCOALA PRIMARĂ VĂRBILĂU",615,VĂRBILĂU,136134,1,PART,PRCNCT,PRSD,PRSD_SV,"2025-05-18 21:40:04",827,419,359,59,1,415,4,900,481,233,182
31,PRAHOVA,"ȘCOALA PRIMARĂ VĂRBILĂU",616,VĂRBILĂU,136134,1,PART,PRCNCT,PRSD,PRSD_SV,"2025-05-18 21:29:05",781,417,362,55,0,411,6,900,483,229,182
31,PRAHOVA,"ȘCOALA GIMNAZIALĂ VĂRBILĂU",617,VĂRBILĂU,136134,1,PART,PRCNCT,PRSD,PRSD_SV,"2025-05-18 21:48:32",1089,585,502,82,1,580,5,1200,615,335,245
31,PRAHOVA,"ȘCOALA PRIMARĂ COȚOFENEȘTI",618,VĂRBILĂU,136134,1,PART,PRCNCT,PRSD,PRSD_SV,"2025-05-18 21:56:16",702,433,368,62,3,427,6,800,367,213,214
31,PRAHOVA,"ȘCOALA PRIMARĂ LIVADEA",619,VĂRBILĂU,136134,1,PART,PRCNCT,PRSD,PRSD_SV,"2025-05-18 21:56:11",827,475,405,70,0,473,2,900,425,221,252
31,PRAHOVA,"ȘCOALA PRIMARĂ POIANA VĂRBILĂU",620,VĂRBILĂU,136134,1,PART,PRCNCT,PRSD,PRSD_SV,"2025-05-18 21:46:45",1070,579,531,45,3,567,12,1200,621,420,147
31,PRAHOVA,"CENTRUL CULTURAL VÎLCĂNEŞTI",621,VÂLCĂNEŞTI,136198,1,PART,PRCNCT,PRSD,PRSD_SV,"2025-05-18 22:01:12",1375,731,675,55,1,725,6,1508,777,372,353
31,PRAHOVA,"GRĂDINIŢA CU PROGRAM NORMAL NR.2 VÎLCĂNEŞTI",622,VÂLCĂNEŞTI,136198,1,PART,PRCNCT,PRSD,PRSD_SV,"2025-05-18 21:47:47",707,431,397,34,0,429,2,800,369,218,211
31,PRAHOVA,"ŞCOALA GIMNAZIALĂ,COMUNA VÎLCĂNEŞTI, SAT CÎRJARI",623,VÂLCĂNEŞTI,136198,1,PART,PRCNCT,PRSD,PRSD_SV,"2025-05-18 21:53:12",570,333,279,51,3,330,3,591,258,146,184
31,PRAHOVA,"ȘCOALA CU CLASELE I-IV TRESTIOARA",624,VÂLCĂNEŞTI,136198,1,PART,PRCNCT,PRSD,PRSD_SV,"2025-05-18 21:31:59",328,182,155,27,0,180,2,400,218,111,69
32,"SATU MARE","GRADINITA CU PROGRAM PRELUNGIT ”DRAGA MEA” (GRADINITA ”DRAGA MEA”(",1,"MUNICIPIUL SATU MARE",136483,1,PART,PRCNCT,PRSD,PRSD_SV,"2025-05-18 22:33:29",1907,686,638,47,1,674,12,2000,1314,307,367
32,"SATU MARE","GRADINITA CU PROGRAM PRELUNGIT ”DRAGA MEA” (GRADINITA ”DRAGA MEA”(",2,"MUNICIPIUL SATU MARE",136483,1,PART,PRCNCT,PRSD,PRSD_SV,"2025-05-18 22:05:38",1536,742,693,47,2,735,7,1600,858,219,516
32,"SATU MARE","ASOCIAŢIA CARITAS SATU MARE CANTRUL SOCIAL DESCHIS LA CASA PRIETENIEI",3,"MUNICIPIUL SATU MARE",136483,1,PART,PRCNCT,PRSD,PRSD_SV,"2025-05-18 21:54:39",1004,555,467,88,0,547,8,1100,545,160,387
32,"SATU MARE","ȘCOALA GIMNAZIALĂ ” ION CREANGĂ ”(ŞC. CU CLS.I-VIII” ION CREANGĂ ”)",4,"MUNICIPIUL SATU MARE",136483,2,PART,PRCNCT,PRSD,PRSD_SV,"2025-05-19 01:16:33",1265,670,607,62,1,664,6,1300,630,167,497
32,"SATU MARE","ȘCOALA GIMNAZIALĂ ” ION CREANGĂ ”(ŞC. CU CLS.I-VIII” ION CREANGĂ ”)",5,"MUNICIPIUL SATU MARE",136483,1,PART,PRCNCT,PRSD,PRSD_SV,"2025-05-18 21:28:39",1120,578,540,38,0,574,4,1200,622,165,409
32,"SATU MARE","ȘCOALA GIMNAZIALĂ ” ION CREANGĂ ”(ŞC. CU CLS.I-VIII” ION CREANGĂ ”)",6,"MUNICIPIUL SATU MARE",136483,1,PART,PRCNCT,PRSD,PRSD_SV,"2025-05-18 21:54:40",1153,619,590,28,1,612,7,1300,681,165,447
32,"SATU MARE","ȘCOALA GIMNAZIALĂ ” ION CREANGĂ ”(ŞC. CU CLS.I-VIII” ION CREANGĂ ”)",7,"MUNICIPIUL SATU MARE",136483,1,PART,PRCNCT,PRSD,PRSD_SV,"2025-05-18 22:19:44",1494,818,773,35,10,809,9,1600,782,216,593
32,"SATU MARE","ȘCOALA GIMNAZIALĂ ” LUCIAN BLAGA ” (ŞC. CU CLS.I-VIII ” LUCIAN BLAGA ”)",8,"MUNICIPIUL SATU MARE",136483,1,PART,PRCNCT,PRSD,PRSD_SV,"2025-05-18 21:57:40",1228,627,552,75,0,616,11,1300,673,206,410
32,"SATU MARE","ȘCOALA GIMNAZIALĂ ” LUCIAN BLAGA ” (ŞC. CU CLS.I-VIII ” LUCIAN BLAGA ”)",9,"MUNICIPIUL SATU MARE",136483,1,PART,PRCNCT,PRSD,PRSD_SV,"2025-05-18 21:45:44",1171,593,539,54,0,588,5,1300,707,170,418
32,"SATU MARE","ȘCOALA GIMNAZIALĂ ” LUCIAN BLAGA ” (ŞC. CU CLS.I-VIII ” LUCIAN BLAGA ”)",10,"MUNICIPIUL SATU MARE",136483,1,PART,PRCNCT,PRSD,PRSD_SV,"2025-05-18 22:17:56",1074,548,524,24,0,544,4,1200,652,171,373
32,"SATU MARE","ȘCOALA GIMNAZIALĂ ” LUCIAN BLAGA ” (ŞC. CU CLS.I-VIII ” LUCIAN BLAGA ”)",11,"MUNICIPIUL SATU MARE",136483,1,PART,PRCNCT,PRSD,PRSD_SV,"2025-05-18 21:36:44",1207,612,578,34,0,610,2,1300,688,173,437
32,"SATU MARE","ȘCOALA GIMNAZIALĂ ” OCTAVIAN GOGA ” (ŞC. CU CLS.I-VIII” OCTAVIAN GOGA ”)",12,"MUNICIPIUL SATU MARE",136483,1,PART,PRCNCT,PRSD,PRSD_SV,"2025-05-18 21:35:52",1145,568,485,83,0,565,3,1300,732,176,389
32,"SATU MARE","ȘCOALA GIMNAZIALĂ ” OCTAVIAN GOGA ” (ŞC. CU CLS.I-VIII” OCTAVIAN GOGA ”)",13,"MUNICIPIUL SATU MARE",136483,1,PART,PRCNCT,PRSD,PRSD_SV,"2025-05-18 21:50:52",1106,542,499,43,0,542,0,1200,658,186,356
32,"SATU MARE","ȘCOALA GIMNAZIALĂ ” OCTAVIAN GOGA ” (ŞC. CU CLS.I-VIII” OCTAVIAN GOGA ”)",14,"MUNICIPIUL SATU MARE",136483,1,PART,PRCNCT,PRSD,PRSD_SV,"2025-05-18 21:32:58",1310,649,589,60,0,641,8,1400,751,196,445
32,"SATU MARE","ȘCOALA GIMNAZIALĂ ” OCTAVIAN GOGA ” (ŞC. CU CLS.I-VIII” OCTAVIAN GOGA ”)",15,"MUNICIPIUL SATU MARE",136483,2,PART,PRCNCT,PRSD,PRSD_SV,"2025-05-18 23:30:16",1362,653,628,24,1,648,5,1500,847,170,478
32,"SATU MARE","GRĂDINIŢA CU PROGRAM NORMAL NR.21",16,"MUNICIPIUL SATU MARE",136483,1,PART,PRCNCT,PRSD,PRSD_SV,"2025-05-18 21:37:19",1212,614,546,67,1,611,3,1300,686,177,434
32,"SATU MARE","GRĂDINIŢA CU PROGRAM NORMAL NR.21",17,"MUNICIPIUL SATU MARE",136483,2,PART,PRCNCT,PRSD,PRSD_SV,"2025-05-19 00:49:13",1801,941,868,71,2,933,8,2000,1059,304,629
32,"SATU MARE","UNIVERSITATEA TEHNICĂ CLUJ NAPOCA - FILIALA SATU MARE (GRĂDINIŢA CU PROGRAM NORMAL NR.21)",18,"MUNICIPIUL SATU MARE",136483,1,PART,PRCNCT,PRSD,PRSD_SV,"2025-05-18 22:07:36",1724,967,922,45,0,957,10,1800,833,276,681
32,"SATU MARE","UNIVERSITATEA TEHNICĂ CLUJ NAPOCA - FILIALA SATU MARE (GRĂDINIŢA CU PROGRAM NORMAL NR.21)",19,"MUNICIPIUL SATU MARE",136483,1,PART,PRCNCT,PRSD,PRSD_SV,"2025-05-18 22:14:04",1507,783,744,37,2,772,11,1600,817,297,475
32,"SATU MARE","ŞC. CU CLS.I-VIII NR. 9",20,"MUNICIPIUL SATU MARE",136483,1,PART,PRCNCT,PRSD,PRSD_SV,"2025-05-18 21:41:47",1258,645,603,41,1,637,8,1399,754,289,348
32,"SATU MARE","LICEUL TEORETIC GERMAN ” JOHANN ETTINGER ”",21,"MUNICIPIUL SATU MARE",136483,1,PART,PRCNCT,PRSD,PRSD_SV,"2025-05-18 21:58:14",1749,960,866,94,0,955,5,1800,840,366,589
32,"SATU MARE","COLEGIUL TEHNIC ” ELISA ZAMFIRESCU ” (COL.TEHNIC ELISA ZAMFIRESCU(GRUP ŞC. DE INDUSTRIE UŞOARĂ ))",22,"MUNICIPIUL SATU MARE",136483,1,PART,PRCNCT,PRSD,PRSD_SV,"2025-05-18 21:37:31",1334,779,702,76,1,769,10,1400,621,202,567
32,"SATU MARE","ȘCOALA GIMNAZIALĂ ” MIRCEA ELIADE ” ( ŞC. CU CLS.I-VIII” MIRCEA ELIADE ”)",23,"MUNICIPIUL SATU MARE",136483,1,PART,PRCNCT,PRSD,PRSD_SV,"2025-05-18 21:36:01",1270,617,549,67,1,612,5,1400,783,175,437
32,"SATU MARE","ȘCOALA GIMNAZIALĂ ” MIRCEA ELIADE ” ( ŞC. CU CLS.I-VIII” MIRCEA ELIADE ”)",24,"MUNICIPIUL SATU MARE",136483,1,PART,PRCNCT,PRSD,PRSD_SV,"2025-05-18 21:59:54",1534,710,657,52,1,704,6,1600,890,200,504
32,"SATU MARE","ȘCOALA GIMNAZIALĂ ” MIRCEA ELIADE ” ( ŞC. CU CLS.I-VIII” MIRCEA ELIADE ”)",25,"MUNICIPIUL SATU MARE",136483,3,PART,PRCNCT,PRSD,PRSD_SV,"2025-05-18 23:03:39",1271,455,428,27,0,455,0,1400,945,213,242
32,"SATU MARE","ȘCOALA GIMNAZIALĂ ” MIRCEA ELIADE ” ( ŞC. CU CLS.I-VIII” MIRCEA ELIADE ”)",26,"MUNICIPIUL SATU MARE",136483,1,PART,PRCNCT,PRSD,PRSD_SV,"2025-05-18 21:41:13",1075,543,506,37,0,538,5,1200,657,135,403
32,"SATU MARE","GRĂDINIŢA CU PROGRAM PRELUNGIT NR. 9",27,"MUNICIPIUL SATU MARE",136483,1,PART,PRCNCT,PRSD,PRSD_SV,"2025-05-18 21:57:22",1193,516,466,48,2,513,3,1301,785,203,310
32,"SATU MARE","GRĂDINIŢA CU PROGRAM PRELUNGIT NR. 9",28,"MUNICIPIUL SATU MARE",136483,1,PART,PRCNCT,PRSD,PRSD_SV,"2025-05-18 22:13:22",1256,442,402,38,2,440,2,1400,958,180,260
32,"SATU MARE","ȘCOALA GIMNAZIALĂ ” BĂLCESCU-PETOFI ” (ŞC. CU CLS.I-VIII ” BĂLCESCU-PETOFI ”)",29,"MUNICIPIUL SATU MARE",136483,1,PART,PRCNCT,PRSD,PRSD_SV,"2025-05-18 22:04:08",1297,715,633,82,0,713,2,1499,784,220,493
32,"SATU MARE","ȘCOALA GIMNAZIALĂ ” BĂLCESCU-PETOFI ” (ŞC. CU CLS.I-VIII ” BĂLCESCU-PETOFI ”)",30,"MUNICIPIUL SATU MARE",136483,1,PART,PRCNCT,PRSD,PRSD_SV,"2025-05-18 21:38:50",1694,797,760,33,4,791,6,1900,1103,194,597
32,"SATU MARE","ȘCOALA GIMNAZIALĂ ” BĂLCESCU-PETOFI ” (ŞC. CU CLS.I-VIII ” BĂLCESCU-PETOFI ”)",31,"MUNICIPIUL SATU MARE",136483,1,PART,PRCNCT,PRSD,PRSD_SV,"2025-05-18 21:45:40",1271,692,533,29,130,689,3,1600,908,231,458
32,"SATU MARE","GRĂDINIŢA CU PROGRAM PRELUNGIT NR.13",32,"MUNICIPIUL SATU MARE",136483,2,PART,PRCNCT,PRSD,PRSD_SV,"2025-05-18 22:01:06",1171,606,549,57,0,595,11,1300,694,130,465
32,"SATU MARE","GRĂDINIŢA CU PROGRAM PRELUNGIT NR. 5",33,"MUNICIPIUL SATU MARE",136483,1,PART,PRCNCT,PRSD,PRSD_SV,"2025-05-18 21:35:36",1094,523,489,34,0,518,5,1200,677,115,403
32,"SATU MARE","GRĂDINIŢA CU PROGRAM PRELUNGIT NR. 5",34,"MUNICIPIUL SATU MARE",136483,2,PART,PRCNCT,PRSD,PRSD_SV,"2025-05-18 23:17:21",1225,591,556,35,0,586,5,1300,709,161,425
32,"SATU MARE","ȘCOALA GIMNAZIALĂ ” AVRAM IANCU ” (ŞC. CU CLS.I-VIII” AVRAM IANCU ”) (GRĂDINIŢA CU PROGRAM PRELUNGIT ”VOINICELUL” CORP ” B ”)",35,"MUNICIPIUL SATU MARE",136483,3,PART,PRCNCT,PRSD,PRSD_SV,"2025-05-18 23:44:49",1100,544,487,55,2,538,6,1200,656,143,395
32,"SATU MARE","ȘCOALA GIMNAZIALĂ ” AVRAM IANCU ” ( ŞC. CU CLS.I-VIII ” AVRAM IANCU ”)",36,"MUNICIPIUL SATU MARE",136483,1,PART,PRCNCT,PRSD,PRSD_SV,"2025-05-18 21:35:51",1104,545,502,43,0,538,7,1200,655,141,397
32,"SATU MARE","ȘCOALA GIMNAZIALĂ ” AVRAM IANCU ” (ŞC. CU CLS.I-VIII” AVRAM IANCU ”)",37,"MUNICIPIUL SATU MARE",136483,1,PART,PRCNCT,PRSD,PRSD_SV,"2025-05-18 21:48:55",1244,634,574,58,2,630,4,1300,666,155,475
32,"SATU MARE","ȘCOALA GIMNAZIALĂ ” AVRAM IANCU ” (ŞC. CU CLS.I-VIII” AVRAM IANCU ”)",38,"MUNICIPIUL SATU MARE",136483,1,PART,PRCNCT,PRSD,PRSD_SV,"2025-05-18 21:50:21",1365,668,637,30,1,660,8,1500,832,173,487
32,"SATU MARE","ȘCOALA GIMNAZIALĂ ” AVRAM IANCU ” (ŞC. CU CLS.I-VIII” AVRAM IANCU ”)",39,"MUNICIPIUL SATU MARE",136483,1,PART,PRCNCT,PRSD,PRSD_SV,"2025-05-18 21:34:01",1201,570,528,41,1,562,8,1300,730,148,414
32,"SATU MARE","ȘCOALA GIMNAZIALĂ ” AVRAM IANCU ” (ŞC. CU CLS.I-VIII” AVRAM IANCU ”) (GRĂDINIŢA CU PROGRAM PRELUNGIT ”VOINICELUL”)",40,"MUNICIPIUL SATU MARE",136483,1,PART,PRCNCT,PRSD,PRSD_SV,"2025-05-18 21:40:11",1224,587,555,30,2,580,7,1300,713,157,423
32,"SATU MARE","LICEUL TEHNOLOGIC IND. ALIM ” GEORGE EMIL PALADE ”. ( GRUPUL ŞCOLAR DE IND. ALIMENTARĂ ”GEORGE EMIL PALADE” )",41,"MUNICIPIUL SATU MARE",136483,1,PART,PRCNCT,PRSD,PRSD_SV,"2025-05-18 21:26:48",1290,583,561,22,0,579,4,1400,817,154,425
32,"SATU MARE","LICEUL TEHNOLOGIC IND. ALIM ” GEORGE EMIL PALADE ”. ( GRUPUL ŞCOLAR DE IND. ALIMENTARĂ ”GEORGE EMIL PALADE” )",42,"MUNICIPIUL SATU MARE",136483,1,PART,PRCNCT,PRSD,PRSD_SV,"2025-05-18 21:35:10",1279,646,603,42,1,642,4,1400,754,186,456
32,"SATU MARE","LICEUL TEHNOLOGIC IND. ALIM ” GEORGE EMIL PALADE ”. ( GRUPUL ŞCOLAR DE IND. ALIMENTARĂ ”GEORGE EMIL PALADE” )",43,"MUNICIPIUL SATU MARE",136483,1,PART,PRCNCT,PRSD,PRSD_SV,"2025-05-18 21:30:48",1191,593,559,32,2,587,6,1300,707,152,435
32,"SATU MARE","LICEUL TEHNOLOGIC IND. ALIM ” GEORGE EMIL PALADE ”. ( GRUPUL ŞCOLAR DE IND. ALIMENTARĂ ”GEORGE EMIL PALADE” )",44,"MUNICIPIUL SATU MARE",136483,1,PART,PRCNCT,PRSD,PRSD_SV,"2025-05-18 21:41:13",1637,820,778,41,1,810,10,1700,880,225,585
32,"SATU MARE","LICEUL TEHNOLOGIC IND. ALIM ” GEORGE EMIL PALADE ”. ( GRUPUL ŞCOLAR DE IND. ALIMENTARĂ ”GEORGE EMIL PALADE” )",45,"MUNICIPIUL SATU MARE",136483,1,PART,PRCNCT,PRSD,PRSD_SV,"2025-05-18 21:36:53",1262,621,581,39,1,614,7,1400,779,183,431
32,"SATU MARE","ASOCIAŢIA JUDEŢEANĂ DE FOTBAL ( ŞC. NR.15 )",46,"MUNICIPIUL SATU MARE",136483,2,PART,PRCNCT,PRSD,PRSD_SV,"2025-05-19 00:00:00",1957,1152,1070,80,2,1145,7,2008,856,215,930
32,"SATU MARE","SECŢIA DE DRUMURI NAŢIONALE",47,"MUNICIPIUL SATU MARE",136483,1,PART,PRCNCT,PRSD,PRSD_SV,"2025-05-18 22:16:35",1748,995,927,43,25,989,6,1800,805,275,714
32,"SATU MARE","CENTRUL JUDEȚEAN DE EXCELENȚĂ SATU MARE",48,"MUNICIPIUL SATU MARE",136483,1,PART,PRCNCT,PRSD,PRSD_SV,"2025-05-18 21:48:38",1632,903,806,92,5,899,4,1700,797,189,710
32,"SATU MARE","ȘCOALA GIMNAZIALĂ ” DR. VASILE LUCACIU ” ( SC. CU CL. I-VIII ”DR. V. LUCACIU” )",49,"MUNICIPIUL SATU MARE",136483,1,PART,PRCNCT,PRSD,PRSD_SV,"2025-05-18 21:31:11",1161,678,587,88,3,671,7,1300,622,137,534
32,"SATU MARE","ȘCOALA GIMNAZIALĂ ” DR. VASILE LUCACIU ” ( SC. CU CL. I-VIII ”DR. V. LUCACIU” )",50,"MUNICIPIUL SATU MARE",136483,1,PART,PRCNCT,PRSD,PRSD_SV,"2025-05-18 21:44:26",957,587,542,40,5,583,4,1100,513,123,460
32,"SATU MARE","GRĂDINIŢA NR.15",51,"MUNICIPIUL SATU MARE",136483,1,PART,PRCNCT,PRSD,PRSD_SV,"2025-05-18 22:06:57",1629,936,849,76,11,933,3,1700,764,185,748
32,"SATU MARE","LICEUL TEOLOGIC”NICOLAE STEINHARDT ”",52,"MUNICIPIUL SATU MARE",136483,1,PART,PRCNCT,PRSD,PRSD_SV,"2025-05-18 21:53:18",1450,562,532,29,1,559,3,1500,938,173,386
32,"SATU MARE","LICEUL TEOLOGIC”NICOLAE STEINHARDT ”",53,"MUNICIPIUL SATU MARE",136483,1,PART,PRCNCT,PRSD,PRSD_SV,"2025-05-18 22:03:18",1475,746,710,34,2,740,6,1501,755,189,551
32,"SATU MARE","GRĂDINIŢA CU PROGRAM PRELUNGIT NR.12",54,"MUNICIPIUL SATU MARE",136483,1,PART,PRCNCT,PRSD,PRSD_SV,"2025-05-18 21:44:30",1262,504,412,29,63,485,19,1400,896,160,325
32,"SATU MARE","GRĂDINIŢA CU PROGRAM PRELUNGIT – ” 14 MAI ”",55,"MUNICIPIUL SATU MARE",136483,1,PART,PRCNCT,PRSD,PRSD_SV,"2025-05-18 21:49:59",1431,646,608,38,0,638,8,1500,854,168,470
32,"SATU MARE","GRĂDINIŢA CU PROGRAM PRELUNGIT – ” 14 MAI ”",56,"MUNICIPIUL SATU MARE",136483,1,PART,PRCNCT,PRSD,PRSD_SV,"2025-05-18 22:19:47",1012,473,450,21,2,470,3,1100,627,136,334
32,"SATU MARE","LICEUL TEHNOLOGIC ” CONSTANTIN BRÂNCUȘ ” (GRUP SCOLAR ”CONSTANTIN BRANCUS ” SATU MARE)",57,"MUNICIPIUL SATU MARE",136483,1,PART,PRCNCT,PRSD,PRSD_SV,"2025-05-18 22:15:48",1303,714,653,54,7,710,4,1400,686,158,552
32,"SATU MARE","LICEUL CU PROGRAM SPORTIV",58,"MUNICIPIUL SATU MARE",136483,1,PART,PRCNCT,PRSD,PRSD_SV,"2025-05-18 21:47:31",1173,623,581,42,0,618,5,1300,677,108,510
32,"SATU MARE","ȘCOALA GIMNAZIALĂ ” GRIGORE MOISIL ” (ŞC. CU CLS.I-VIII” GRIGORE MOISIL ”)",59,"MUNICIPIUL SATU MARE",136483,1,PART,PRCNCT,PRSD,PRSD_SV,"2025-05-18 21:52:58",1076,779,579,65,135,775,4,1460,681,247,528
32,"SATU MARE","ȘCOALA GIMNAZIALĂ ” GRIGORE MOISIL ” (ŞC. CU CLS.I-VIII” GRIGORE MOISIL ”)",60,"MUNICIPIUL SATU MARE",136483,1,PART,PRCNCT,PRSD,PRSD_SV,"2025-05-18 22:04:41",916,671,334,225,112,662,9,1200,529,204,458
32,"SATU MARE","COLEGIUL TEHNIC DE TRANSP. ŞI TELECOMUNICAŢII ” I.C. BRĂTIANU ”",61,"MUNICIPIUL SATU MARE",136483,1,PART,PRCNCT,PRSD,PRSD_SV,"2025-05-18 21:28:46",1192,694,598,76,20,687,7,1300,606,195,492
32,"SATU MARE","LICEUL TEOLOGIC ROMANO-CATOLIC ” HÁM JÁNOS ”",62,"MUNICIPIUL SATU MARE",136483,1,PART,PRCNCT,PRSD,PRSD_SV,"2025-05-18 21:38:37",765,392,319,73,0,388,4,800,408,91,297
32,"SATU MARE","LICEUL REFORMAT ( LICEUL TEOLOGIC REFORMAT)",63,"MUNICIPIUL SATU MARE",136483,1,PART,PRCNCT,PRSD,PRSD_SV,"2025-05-18 22:07:26",929,552,457,35,60,547,5,1100,548,101,446
32,"SATU MARE","GRĂDINIŢA CU PROG. PRELUNGIT ” DUMBRAVA MINUNATĂ ” (GRĂDINIŢA ”DUMBRAVA MINUNATĂ” )",64,"MUNICIPIUL SATU MARE",136483,2,PART,PRCNCT,PRSD,PRSD_SV,"2025-05-19 01:19:34",1246,681,643,37,1,677,4,1300,619,129,548
32,"SATU MARE","COLEGIUL NAŢIONAL ” DOAMNA STANCA ”",65,"MUNICIPIUL SATU MARE",136483,1,PART,PRCNCT,PRSD,PRSD_SV,"2025-05-18 21:44:35",823,551,381,77,93,545,6,1000,449,164,381
32,"SATU MARE","ȘCOALA GIMNAZIALĂ ” RÁKÓCZI FERENC ”",66,"MUNICIPIUL SATU MARE",136483,1,PART,PRCNCT,PRSD,PRSD_SV,"2025-05-18 21:59:15",1188,657,614,42,1,652,5,1300,643,83,569
32,"SATU MARE","ȘCOALA GIMNAZIALĂ ” RÁKÓCZI FERENC ”",67,"MUNICIPIUL SATU MARE",136483,1,PART,PRCNCT,PRSD,PRSD_SV,"2025-05-18 21:42:51",1591,918,867,50,1,912,6,1700,782,139,773
32,"SATU MARE","ȘCOALA GIMNAZIALĂ ” CONSTANTIN BRÂNCOVEANU ”",68,"MUNICIPIUL SATU MARE",136483,1,PART,PRCNCT,PRSD,PRSD_SV,"2025-05-18 23:17:09",1389,764,655,108,1,756,8,1500,736,167,589
32,"SATU MARE","COLEGIUL NAŢIONAL” MIHAI EMINESCU ”",69,"MUNICIPIUL SATU MARE",136483,1,PART,PRCNCT,PRSD,PRSD_SV,"2025-05-18 21:26:09",946,549,443,106,0,544,5,1000,451,122,422
32,"SATU MARE","COLEGIUL ECONOMIC ” GHEORGHE DRAGOŞ ” (GRUP ŞC. ECONOMIC” GHEORGHE DRAGOŞ ”)",70,"MUNICIPIUL SATU MARE",136483,1,PART,PRCNCT,PRSD,PRSD_SV,"2025-05-18 22:12:02",1599,991,864,108,19,976,15,1700,709,269,707
32,"SATU MARE","GRĂDINIŢA CU PROGRAM PRELUNGIT",71,"MUNICIPIUL SATU MARE",136483,1,PART,PRCNCT,PRSD,PRSD_SV,"2025-05-18 22:32:42",952,459,407,52,0,459,0,1001,542,152,307
32,"SATU MARE","GRĂDINIŢA CU PROGRAM PRELUNGIT",72,"MUNICIPIUL SATU MARE",136483,1,PART,PRCNCT,PRSD,PRSD_SV,"2025-05-18 21:26:31",1242,599,562,37,0,595,4,1300,701,224,371
32,"SATU MARE","CENTRUL ȘCOLAR PENTRU EDUCAȚIE INCLUZIVĂ",73,"MUNICIPIUL SATU MARE",136483,1,PART,PRCNCT,PRSD,PRSD_SV,"2025-05-18 21:37:26",1068,498,465,33,0,493,5,1200,702,176,317
32,"SATU MARE","ȘCOALA GIMNAZIALĂ - SĂTMĂREL ( ŞC. CU CLS.I-VIII - SĂTMĂREL)",74,"MUNICIPIUL SATU MARE",136483,1,PART,PRCNCT,PRSD,PRSD_SV,"2025-05-18 21:29:00",1212,549,527,22,0,547,2,1300,751,289,258
32,"SATU MARE","LICEUL ROMANO-CATOLIC”JOSEPHUS CALASANTIUS”",75,"MUNICIPIUL CAREI",136526,2,PART,PRCNCT,PRSD,PRSD_SV,"2025-05-19 02:04:07",1561,661,610,50,1,645,16,1700,1039,199,446
32,"SATU MARE","COLEGIUL TEHNIC ”IULIU MANIU”",76,"MUNICIPIUL CAREI",136526,1,PART,PRCNCT,PRSD,PRSD_SV,"2025-05-18 22:10:58",1261,618,585,31,2,610,8,1300,682,120,490
32,"SATU MARE","LICEUL TEHNOLOGIC ”SIMION BĂRNUŢIU”",77,"MUNICIPIUL CAREI",136526,1,PART,PRCNCT,PRSD,PRSD_SV,"2025-05-18 21:48:45",1550,788,744,44,0,780,8,1600,812,143,637
32,"SATU MARE","ŞCOALA GIMNAZIALĂ NR.1",78,"MUNICIPIUL CAREI",136526,1,PART,PRCNCT,PRSD,PRSD_SV,"2025-05-18 22:37:25",1462,696,619,77,0,692,4,1600,904,147,545
32,"SATU MARE","ŞCOALA GIMNAZIALĂ ”VASILE LUCACIU” NR.2",79,"MUNICIPIUL CAREI",136526,1,PART,PRCNCT,PRSD,PRSD_SV,"2025-05-18 21:50:18",1599,754,714,40,0,749,5,1700,946,172,577
32,"SATU MARE","GRĂDINIŢA CU PROGRAM NORMAL NR.9",80,"MUNICIPIUL CAREI",136526,1,PART,PRCNCT,PRSD,PRSD_SV,"2025-05-18 21:53:50",1065,483,451,30,2,480,3,1200,717,75,405
32,"SATU MARE","GRĂDINIŢA CU PROGRAM NORMAL NR.10",81,"MUNICIPIUL CAREI",136526,1,PART,PRCNCT,PRSD,PRSD_SV,"2025-05-18 22:03:50",1754,733,681,51,1,731,2,1800,1067,179,552
32,"SATU MARE","ŞCOALA GIMNAZIALĂ NR.3",82,"MUNICIPIUL CAREI",136526,1,PART,PRCNCT,PRSD,PRSD_SV,"2025-05-18 21:59:23",1468,758,699,58,1,749,9,1601,843,175,574
32,"SATU MARE","LICEUL TEORETIC CAREI",83,"MUNICIPIUL CAREI",136526,1,PART,PRCNCT,PRSD,PRSD_SV,"2025-05-18 21:39:11",1533,611,563,46,2,607,4,1600,989,149,458
32,"SATU MARE","GRĂDINIŢA CU PROGRAM NORMAL NR.5",84,"MUNICIPIUL CAREI",136526,1,PART,PRCNCT,PRSD,PRSD_SV,"2025-05-18 22:04:06",1942,828,784,44,0,818,10,2000,1172,223,595
32,"SATU MARE","GRĂDINIŢA CU PROGRAM NORMAL NR.8",85,"MUNICIPIUL CAREI",136526,1,PART,PRCNCT,PRSD,PRSD_SV,"2025-05-18 21:47:35",1379,752,683,68,1,749,3,1500,748,144,605
32,"SATU MARE","SALĂ SPORT LICEUL TEORETIC CAREI",86,"MUNICIPIUL CAREI",136526,1,PART,PRCNCT,PRSD,PRSD_SV,"2025-05-18 21:34:50",1920,889,856,32,1,886,3,2000,1111,230,656
32,"SATU MARE","SALĂ SPORT LICEUL TEORETIC CAREI",87,"MUNICIPIUL CAREI",136526,1,PART,PRCNCT,PRSD,PRSD_SV,"2025-05-18 22:13:04",932,472,360,48,64,468,4,1200,728,114,354
32,"SATU MARE","GRĂDINIŢA CU PROGRAM NORMAL IANCULEŞTI",88,"MUNICIPIUL CAREI",136526,1,PART,PRCNCT,PRSD,PRSD_SV,"2025-05-18 21:18:54",276,161,134,27,0,160,1,300,139,109,51
32,"SATU MARE","LICEUL TEHNOLOGIC",89,"ORAŞ ARDUD",136848,1,PART,PRCNCT,PRSD,PRSD_SV,"2025-05-18 22:09:38",1450,598,520,76,2,591,7,1500,902,217,374
32,"SATU MARE","BIBLIOTECA ARDUD",90,"ORAŞ ARDUD",136848,1,PART,PRCNCT,PRSD,PRSD_SV,"2025-05-18 21:34:20",1613,528,499,29,0,527,1,1700,1172,197,330
32,"SATU MARE","GRĂDINIȚA CU PROGRAM PRELUNGIT ARDUD",91,"ORAŞ ARDUD",136848,1,PART,PRCNCT,PRSD,PRSD_SV,"2025-05-18 21:27:03",925,417,390,27,0,415,2,1000,583,237,178
32,"SATU MARE","SCOALA GENERALĂ MĂDĂRAS",92,"ORAŞ ARDUD",136848,1,PART,PRCNCT,PRSD,PRSD_SV,"2025-05-18 21:31:39",1032,490,418,72,0,487,3,1100,610,271,216
32,"SATU MARE","CĂMINUL CULTURAL BABA NOVAC",93,"ORAŞ ARDUD",136848,1,PART,PRCNCT,PRSD,PRSD_SV,"2025-05-18 21:23:40",467,219,175,43,1,218,1,500,281,156,62
32,"SATU MARE","CĂMINUL CULTURAL GERĂUŞA",94,"ORAŞ ARDUD",136848,1,PART,PRCNCT,PRSD,PRSD_SV,"2025-05-18 21:32:36",409,191,165,26,0,191,0,500,309,137,54
32,"SATU MARE","SCOALA GIMNAZIALĂ ”PETOFI SANDOR” LIVADA",95,"ORAŞ LIVADA",138039,1,PART,PRCNCT,PRSD,PRSD_SV,"2025-05-18 21:26:24",993,470,426,33,11,465,5,1100,630,97,368
32,"SATU MARE","GRADINITA CU PROGRAM NORMAL LIVADA",96,"ORAŞ LIVADA",138039,1,PART,PRCNCT,PRSD,PRSD_SV,"2025-05-18 21:22:37",1438,615,574,37,4,611,4,1600,985,233,378
32,"SATU MARE","ŞCOALA GIMNAZIALĂ PETOFI SANDOR LIVADA",97,"ORAŞ LIVADA",138039,1,PART,PRCNCT,PRSD,PRSD_SV,"2025-05-18 21:44:13",1685,786,707,62,17,776,10,1800,1014,196,580
32,"SATU MARE","ŞCOALA PRIMARĂ ADRIAN",98,"ORAŞ LIVADA",138039,1,PART,PRCNCT,PRSD,PRSD_SV,"2025-05-18 21:11:59",462,221,203,18,0,216,5,500,279,53,163
32,"SATU MARE","ŞCOALA GIMNAZIALĂ ”IOSIF ŢIPROC” DUMBRAVA",99,"ORAŞ LIVADA",138039,1,PART,PRCNCT,PRSD,PRSD_SV,"2025-05-18 21:22:50",980,353,327,26,0,351,2,1100,747,260,91
32,"SATU MARE","GRĂDINIŢA LIVADA MICĂ",100,"ORAŞ LIVADA",138039,1,PART,PRCNCT,PRSD,PRSD_SV,"2025-05-18 21:26:46",247,127,101,26,0,127,0,299,172,87,40
32,"SATU MARE","CREŞA ”CASTELUL PITICILOR”",101,"ORAŞ NEGREŞTI-OAŞ",136599,1,PART,PRCNCT,PRSD,PRSD_SV,"2025-05-18 21:37:04",1194,358,337,21,0,357,1,1300,942,193,164
32,"SATU MARE","CREŞA ” CASTELUL PITICILOR”",102,"ORAŞ NEGREŞTI-OAŞ",136599,1,PART,PRCNCT,PRSD,PRSD_SV,"2025-05-18 21:41:22",1186,319,302,17,0,314,5,1300,981,199,115
32,"SATU MARE","SCOALA GEN.NR,3",103,"ORAŞ NEGREŞTI-OAŞ",136599,1,PART,PRCNCT,PRSD,PRSD_SV,"2025-05-18 21:31:37",1154,427,378,49,0,418,9,1300,873,181,237
32,"SATU MARE","SCOALA GEN.NR.3",104,"ORAŞ NEGREŞTI-OAŞ",136599,1,PART,PRCNCT,PRSD,PRSD_SV,"2025-05-18 21:44:27",1436,416,400,16,0,411,5,1600,1184,219,192
32,"SATU MARE","SCOALA GENERALA NR.3",105,"ORAŞ NEGREŞTI-OAŞ",136599,1,PART,PRCNCT,PRSD,PRSD_SV,"2025-05-18 21:37:50",1388,510,482,26,2,499,11,1500,990,219,280
32,"SATU MARE","SCOALA GEN.NR.1",106,"ORAŞ NEGREŞTI-OAŞ",136599,1,PART,PRCNCT,PRSD,PRSD_SV,"2025-05-18 21:41:21",990,390,338,52,0,382,8,1100,710,169,213
32,"SATU MARE","SCOALA GEN,NR.1",107,"ORAŞ NEGREŞTI-OAŞ",136599,1,PART,PRCNCT,PRSD,PRSD_SV,"2025-05-18 21:29:14",888,351,308,41,2,345,6,1000,649,163,182
32,"SATU MARE","LICEUL TEORETIC",108,"ORAŞ NEGREŞTI-OAŞ",136599,2,PART,PRCNCT,PRSD,PRSD_SV,"2025-05-19 00:39:23",1394,559,474,32,53,556,3,1500,941,262,294
32,"SATU MARE","LICEUL TEORETIC",109,"ORAŞ NEGREŞTI-OAŞ",136599,1,PART,PRCNCT,PRSD,PRSD_SV,"2025-05-18 21:31:48",1263,439,380,58,1,435,4,1400,961,223,212
32,"SATU MARE","LICEUL TEORETIC",110,"ORAŞ NEGREŞTI-OAŞ",136599,1,PART,PRCNCT,PRSD,PRSD_SV,"2025-05-18 21:31:34",1279,440,408,32,0,431,9,1400,960,219,212
32,"SATU MARE","CLADIRE DISPENSAR TUR",111,"ORAŞ NEGREŞTI-OAŞ",136599,1,PART,PRCNCT,PRSD,PRSD_SV,"2025-05-18 21:28:18",1595,400,379,21,0,397,3,1700,1300,218,179
32,"SATU MARE","ŞCOALA GIMNAZIALĂ TĂŞNAD",112,"ORAŞ TĂŞNAD",136642,1,PART,PRCNCT,PRSD,PRSD_SV,"2025-05-18 22:16:49",1171,628,514,113,1,624,4,1600,972,198,426
32,"SATU MARE","ŞCOALA GIMNAZIALĂ TĂŞNAD",113,"ORAŞ TĂŞNAD",136642,1,PART,PRCNCT,PRSD,PRSD_SV,"2025-05-18 22:03:37",1403,658,558,100,0,650,8,1497,839,237,413
32,"SATU MARE","ŞCOALA GIMNAZIALĂ TĂŞNAD",114,"ORAŞ TĂŞNAD",136642,1,PART,PRCNCT,PRSD,PRSD_SV,"2025-05-18 21:57:08",1504,806,729,66,11,800,6,1600,794,228,572
32,"SATU MARE","CASA DE CULTURĂ",115,"ORAŞ TĂŞNAD",136642,1,PART,PRCNCT,PRSD,PRSD_SV,"2025-05-18 21:50:35",1700,782,714,67,1,769,13,2000,1218,247,522
32,"SATU MARE","GRĂDINIŢA CU PROGRAM NORMAL BLAJA",116,"ORAŞ TĂŞNAD",136642,1,PART,PRCNCT,PRSD,PRSD_SV,"2025-05-18 21:20:46",173,105,93,12,0,101,4,300,195,49,52
32,"SATU MARE","CĂMIN CULTURAL CIG",117,"ORAŞ TĂŞNAD",136642,1,PART,PRCNCT,PRSD,PRSD_SV,"2025-05-18 21:38:34",326,146,126,19,1,141,5,400,254,90,51
32,"SATU MARE","ŞCOALA GIMNAZIALĂ SĂRĂUAD",118,"ORAŞ TĂŞNAD",136642,1,PART,PRCNCT,PRSD,PRSD_SV,"2025-05-18 21:50:27",859,345,329,15,1,342,3,908,563,198,144
32,"SATU MARE","GRĂDINIŢA CU PROGRAM NORMAL VALEA MORII",119,"ORAŞ TĂŞNAD",136642,1,PART,PRCNCT,PRSD,PRSD_SV,"2025-05-18 21:18:00",148,97,81,16,0,96,1,200,103,64,32
32,"SATU MARE","CAMIN CULTURAL",120,ACÂŞ,136713,1,PART,PRCNCT,PRSD,PRSD_SV,"2025-05-18 21:41:33",1538,618,563,55,0,600,18,1600,982,203,397
32,"SATU MARE","ŞCOALA GENERALĂ MIHAIENI",121,ACÂŞ,136713,1,PART,PRCNCT,PRSD,PRSD_SV,"2025-05-18 21:13:38",363,151,118,33,0,144,7,400,249,48,96
32,"SATU MARE","ŞCOALA GENERALĂ UNIMĂT",122,ACÂŞ,136713,1,PART,PRCNCT,PRSD,PRSD_SV,"2025-05-18 21:16:58",314,149,119,30,0,147,2,400,251,87,60
32,"SATU MARE","PRIMARIA AGRIS",123,AGRIŞ,179873,1,PART,PRCNCT,PRSD,PRSD_SV,"2025-05-18 21:22:48",892,399,365,34,0,397,2,1000,601,87,310
32,"SATU MARE","ȘCOALA GENERALĂ AGRIȘ",124,AGRIŞ,179873,1,PART,PRCNCT,PRSD,PRSD_SV,"2025-05-18 21:17:11",271,104,86,18,0,103,1,300,196,91,12
32,"SATU MARE","ŞCOALA PRIMARĂ CIUPERCENI",125,AGRIŞ,179873,1,PART,PRCNCT,PRSD,PRSD_SV,"2025-05-18 21:14:05",498,197,162,35,0,194,3,600,403,117,77
32,"SATU MARE","SC. GIMNAZIALA ANDRID",126,ANDRID,136768,1,PART,PRCNCT,PRSD,PRSD_SV,"2025-05-18 22:22:57",980,501,447,42,12,495,6,1101,600,200,295
32,"SATU MARE","SC. PRIMARA DINDESTI",127,ANDRID,136768,1,PART,PRCNCT,PRSD,PRSD_SV,"2025-05-18 21:43:14",605,323,289,30,4,323,0,700,377,155,168
32,"SATU MARE","SC. GIMNAZIALA IRINA",128,ANDRID,136768,1,PART,PRCNCT,PRSD,PRSD_SV,"2025-05-18 22:02:05",438,266,239,21,6,263,3,499,233,28,235
32,"SATU MARE","CENTRU CULTURAL ”EMIL MATEI” APA",129,APA,136802,1,PART,PRCNCT,PRSD,PRSD_SV,"2025-05-18 21:22:10",1034,571,462,109,0,569,2,1100,529,308,261
32,"SATU MARE","SCOALA GIMNAZIALĂ ”VASILE LUCACIU” APA",130,APA,136802,1,PART,PRCNCT,PRSD,PRSD_SV,"2025-05-18 21:22:25",883,449,360,85,4,436,13,1000,551,261,175
32,"SATU MARE","CĂMINUL CULTURAL SOMEȘENII",131,APA,136802,1,PART,PRCNCT,PRSD,PRSD_SV,"2025-05-18 21:14:15",229,162,122,40,0,161,1,300,138,87,74
32,"SATU MARE","SCOALA GIMNAZIALA BĂTARCI",132,BĂTARCI,136919,1,PART,PRCNCT,PRSD,PRSD_SV,"2025-05-18 22:32:50",1855,576,550,26,0,571,5,2000,1424,429,142
32,"SATU MARE","CĂMIN CULTURAL COMLĂUȘA",133,BĂTARCI,136919,1,PART,PRCNCT,PRSD,PRSD_SV,"2025-05-18 21:30:01",856,285,261,24,0,281,4,900,615,185,96
32,"SATU MARE","CĂMIN CULTURAL TĂMĂŞENI",134,BĂTARCI,136919,1,PART,PRCNCT,PRSD,PRSD_SV,"2025-05-18 21:43:12",312,190,163,27,0,188,2,400,210,29,159
32,"SATU MARE","PRIMARIA BÂRSĂU",135,BÂRSĂU,137103,1,PART,PRCNCT,PRSD,PRSD_SV,"2025-05-18 21:59:52",1304,697,613,84,0,691,6,1400,703,503,188
32,"SATU MARE","SEDIU ADMINISTRATIV",136,BÂRSĂU,137103,1,PART,PRCNCT,PRSD,PRSD_SV,"2025-05-18 21:25:38",493,266,221,45,0,257,9,600,334,146,111
32,"SATU MARE","SCOALA GIMNAZIALA BELTIUG",137,BELTIUG,136964,1,PART,PRCNCT,PRSD,PRSD_SV,"2025-05-18 21:27:19",1082,497,455,40,2,494,3,1200,703,218,276
32,"SATU MARE","CĂMINUL CULTURAL BOLDA",138,BELTIUG,136964,1,PART,PRCNCT,PRSD,PRSD_SV,"2025-05-18 21:11:29",32,36,11,25,0,36,0,100,64,14,22
32,"SATU MARE","ŞCOALA PRIMARĂ GHIRIŞA",139,BELTIUG,136964,1,PART,PRCNCT,PRSD,PRSD_SV,"2025-05-18 21:29:28",604,319,284,18,17,317,2,701,382,28,289
32,"SATU MARE","CĂMINUL CULTURAL GIUNGI",140,BELTIUG,136964,1,PART,PRCNCT,PRSD,PRSD_SV,"2025-05-18 21:14:24",124,74,47,27,0,74,0,200,126,38,36
32,"SATU MARE","ŞCOALA GIMNAZIALĂ RĂTEŞTI",141,BELTIUG,136964,1,PART,PRCNCT,PRSD,PRSD_SV,"2025-05-18 21:18:45",594,232,174,52,6,226,6,700,468,107,119
32,"SATU MARE","GRĂDINIŢA DE COPII ŞANDRA",142,BELTIUG,136964,1,PART,PRCNCT,PRSD,PRSD_SV,"2025-05-18 21:27:49",224,92,74,18,0,92,0,300,208,73,19
32,"SATU MARE","SCOALA GENERALA BERVENI",143,BERVENI,137032,2,PART,PRCNCT,PRSD,PRSD_SV,"2025-05-19 02:00:47",1603,767,682,34,51,758,9,1700,933,65,693
32,"SATU MARE","SCOALA GENERALA LUCACENI",144,BERVENI,137032,1,PART,PRCNCT,PRSD,PRSD_SV,"2025-05-18 22:04:19",1229,563,512,40,11,558,5,1300,737,247,311
32,"SATU MARE","SCOALA GENERALA BIXAD",145,BIXAD,137069,1,PART,PRCNCT,PRSD,PRSD_SV,"2025-05-18 21:16:12",1190,303,286,16,1,302,1,1300,997,204,98
32,"SATU MARE","SCOALA GENERALA BIXAD",146,BIXAD,137069,1,PART,PRCNCT,PRSD,PRSD_SV,"2025-05-18 21:37:15",1141,318,304,14,0,315,3,1200,882,229,86
32,"SATU MARE","BOINESTI SCOALA GENERALA",147,BIXAD,137069,1,PART,PRCNCT,PRSD,PRSD_SV,"2025-05-18 21:15:52",1442,380,343,37,0,379,1,1600,1220,263,116
32,"SATU MARE","TRIP SCOALA GENERALA",148,BIXAD,137069,1,PART,PRCNCT,PRSD,PRSD_SV,"2025-05-18 21:25:05",1352,423,361,32,30,419,4,1400,977,283,136
32,"SATU MARE","TRIP SCOALA GENERALA",149,BIXAD,137069,1,PART,PRCNCT,PRSD,PRSD_SV,"2025-05-18 21:47:01",1212,277,260,15,2,276,1,1300,1023,201,75
32,"SATU MARE","PRIMARIA COMUNEI BOGDAND",150,BOGDAND,137130,1,PART,PRCNCT,PRSD,PRSD_SV,"2025-05-18 21:44:45",746,368,321,11,36,367,1,800,432,21,346
32,"SATU MARE","CĂMIN CULTURAL BABȚA",151,BOGDAND,137130,1,PART,PRCNCT,PRSD,PRSD_SV,"2025-05-18 21:43:29",474,237,189,48,0,236,1,500,263,148,88
32,"SATU MARE","ŞCOALA CU CLASELE I-VIII",152,BOGDAND,137130,1,PART,PRCNCT,PRSD,PRSD_SV,"2025-05-18 21:19:05",370,190,159,31,0,190,0,400,210,131,59
32,"SATU MARE","ŞCOALA CU CLASELE I-IV",153,BOGDAND,137130,1,PART,PRCNCT,PRSD,PRSD_SV,"2025-05-18 21:37:39",561,225,206,17,2,223,2,600,375,12,211
32,"SATU MARE","PRIMARIA BOTIZ",154,BOTIZ,137185,1,PART,PRCNCT,PRSD,PRSD_SV,"2025-05-18 21:20:49",1476,598,542,54,2,596,2,1600,1002,274,322
32,"SATU MARE","SCOALA GIMNAZIALA CU CLASELE I-IV OSVAREU",155,BOTIZ,137185,1,PART,PRCNCT,PRSD,PRSD_SV,"2025-05-18 21:42:30",1838,781,678,94,9,774,7,2000,1219,443,331
32,"SATU MARE","PRIMARIA CALINESTI OAS",156,CĂLINEŞTI-OAŞ,137229,1,PART,PRCNCT,PRSD,PRSD_SV,"2025-05-18 21:54:37",1373,421,402,18,1,418,3,1500,1079,291,127
32,"SATU MARE","SPCLEP CALINESTI OAS",157,CĂLINEŞTI-OAŞ,137229,1,PART,PRCNCT,PRSD,PRSD_SV,"2025-05-18 21:44:05",923,276,260,16,0,274,2,1000,724,174,100
32,"SATU MARE","SCOALA COCA",158,CĂLINEŞTI-OAŞ,137229,1,PART,PRCNCT,PRSD,PRSD_SV,"2025-05-18 21:26:33",898,255,237,18,0,252,3,1000,745,196,56
32,"SATU MARE","SCOALA LECHINTA",159,CĂLINEŞTI-OAŞ,137229,1,PART,PRCNCT,PRSD,PRSD_SV,"2025-05-18 21:34:31",690,231,215,16,0,231,0,800,569,175,56
32,"SATU MARE","SCOALA PASUNEA MARE",160,CĂLINEŞTI-OAŞ,137229,1,PART,PRCNCT,PRSD,PRSD_SV,"2025-05-18 21:22:46",356,128,106,22,0,128,0,400,272,113,15
32,"SATU MARE","PRIMARIA COM. CAMARZANA",161,CĂMĂRZANA,137274,1,PART,PRCNCT,PRSD,PRSD_SV,"2025-05-18 21:41:57",1051,302,246,33,23,301,1,1200,898,230,71
32,"SATU MARE","SCOALA GENERALA CAMARZANA",162,CĂMĂRZANA,137274,1,PART,PRCNCT,PRSD,PRSD_SV,"2025-05-18 21:25:30",908,291,258,12,21,289,2,1000,709,195,94
32,"SATU MARE","SCOALA GIMNAZIALA CAMIN",163,CĂMIN,179677,1,PART,PRCNCT,PRSD,PRSD_SV,"2025-05-18 21:25:10",1119,582,544,22,16,581,1,1200,618,52,529
32,"SATU MARE","PRIMĂRIA COMUNEI CĂPLENI",164,CĂPLENI,136553,1,PART,PRCNCT,PRSD,PRSD_SV,"2025-05-18 21:26:24",1197,626,575,22,29,625,1,1300,674,36,589
32,"SATU MARE","ŞCOALA GIMNAZIALĂ ” FÉNYI ISTVÁN ” CĂPLENI",165,CĂPLENI,136553,1,PART,PRCNCT,PRSD,PRSD_SV,"2025-05-18 21:23:11",1442,725,664,30,31,725,0,1500,775,57,668
32,"SATU MARE","ȘCOALA GIMNAZIALĂ",166,CĂUAŞ,137292,1,PART,PRCNCT,PRSD,PRSD_SV,"2025-05-18 21:16:36",565,258,236,22,0,249,9,600,342,140,109
32,"SATU MARE","CĂMINUL CULTURAL",167,CĂUAŞ,137292,1,PART,PRCNCT,PRSD,PRSD_SV,"2025-05-18 21:10:20",101,50,32,18,0,49,1,200,150,23,26
32,"SATU MARE","CĂMINUL CULTURAL",168,CĂUAŞ,137292,1,PART,PRCNCT,PRSD,PRSD_SV,"2025-05-18 21:15:16",1006,530,470,58,2,524,6,1100,570,93,431
32,"SATU MARE","ȘCOALA GENERALĂ",169,CĂUAŞ,137292,1,PART,PRCNCT,PRSD,PRSD_SV,"2025-05-18 21:11:02",66,35,22,13,0,33,2,100,65,24,9
32,"SATU MARE","CĂMINUL CULTURAL",170,CĂUAŞ,137292,1,PART,PRCNCT,PRSD,PRSD_SV,"2025-05-18 21:15:44",120,90,62,28,0,88,2,199,109,50,38
32,"SATU MARE","CASĂ DE LOCUIT",171,CĂUAŞ,137292,1,PART,PRCNCT,PRSD,PRSD_SV,"2025-05-18 21:15:31",88,49,28,21,0,48,1,100,51,31,17
32,"SATU MARE","CAMIN CULTURAL",172,CEHAL,137363,1,PART,PRCNCT,PRSD,PRSD_SV,"2025-05-18 21:33:28",481,282,236,32,14,281,1,500,218,51,230
32,"SATU MARE","SCOALA CEHAL",173,CEHAL,137363,1,PART,PRCNCT,PRSD,PRSD_SV,"2025-05-18 21:29:13",554,333,279,29,25,327,6,600,267,159,168
32,"SATU MARE","CLADIRE PRIMARIE",174,CEHAL,137363,1,PART,PRCNCT,PRSD,PRSD_SV,"2025-05-18 21:29:50",161,100,68,28,4,98,2,199,99,50,48
32,"SATU MARE","SCOALA GIMNAZIALA CERTEZE",175,CERTEZE,137407,1,PART,PRCNCT,PRSD,PRSD_SV,"2025-05-18 21:26:21",1439,290,255,31,4,290,0,1500,1210,167,123
32,"SATU MARE","SCOALA GIMNAZIALA CERTEZE",176,CERTEZE,137407,1,PART,PRCNCT,PRSD,PRSD_SV,"2025-05-18 21:26:44",1424,344,312,32,0,343,1,1500,1156,235,108
32,"SATU MARE","ȘCOALA HUTA-CERTEZE",177,CERTEZE,137407,1,PART,PRCNCT,PRSD,PRSD_SV,"2025-05-18 21:25:11",967,290,262,22,6,290,0,1100,810,147,143
32,"SATU MARE","GRĂDINIŢA CU PROGRAM NORMAL MOIŞENI",178,CERTEZE,137407,1,PART,PRCNCT,PRSD,PRSD_SV,"2025-05-18 21:27:21",1179,256,234,22,0,253,3,1300,1044,150,103
32,"SATU MARE","CĂMINUL CULTURAL",179,CIUMEŞTI,179882,1,PART,PRCNCT,PRSD,PRSD_SV,"2025-05-18 21:39:30",1109,511,452,49,10,508,3,1200,689,59,449
32,"SATU MARE","PRIMARIA CRAIDOROLT",180,CRAIDOROLŢ,137443,1,PART,PRCNCT,PRSD,PRSD_SV,"2025-05-18 21:47:29",846,293,257,36,0,288,5,900,607,171,117
32,"SATU MARE","ŞCOALA PRIMARĂ CRIŞENI",181,CRAIDOROLŢ,137443,1,PART,PRCNCT,PRSD,PRSD_SV,"2025-05-18 21:10:08",135,55,39,16,0,54,1,200,145,35,19
32,"SATU MARE","ŞCOALA PRIMARĂ ERIU SÂNCRAI",182,CRAIDOROLŢ,137443,1,PART,PRCNCT,PRSD,PRSD_SV,"2025-05-18 21:28:59",480,210,176,31,3,206,4,500,290,126,80
32,"SATU MARE","ŞCOALA PRIMARĂ SATU MIC",183,CRAIDOROLŢ,137443,1,PART,PRCNCT,PRSD,PRSD_SV,"2025-05-18 21:20:04",166,95,76,19,0,93,2,200,105,68,25
32,"SATU MARE","SCOALA CU CLASELE I-IV CRUCISOR",184,CRUCIŞOR,137504,1,PART,PRCNCT,PRSD,PRSD_SV,"2025-05-18 21:33:22",459,281,226,55,0,279,2,500,219,161,118
32,"SATU MARE","SCOALA CU CLS. I-IV IEGHERISTE",185,CRUCIŞOR,137504,1,PART,PRCNCT,PRSD,PRSD_SV,"2025-05-18 21:35:27",405,231,195,34,2,231,0,492,261,170,61
32,"SATU MARE","SCOALA GIMNAZIALA POIANA CODRULUI",186,CRUCIŞOR,137504,1,PART,PRCNCT,PRSD,PRSD_SV,"2025-05-18 21:31:10",1225,588,545,38,5,580,8,1300,712,396,184
32,"SATU MARE","SEDIUL CONSILIULUI LOCAL AL COMUNEI CULCIU",187,CULCIU,137540,1,PART,PRCNCT,PRSD,PRSD_SV,"2025-05-18 21:36:57",685,305,254,45,6,303,2,800,495,123,180
32,"SATU MARE","GRADINIŢA APATEU",188,CULCIU,137540,1,PART,PRCNCT,PRSD,PRSD_SV,"2025-05-18 21:12:06",264,121,109,12,0,120,1,300,179,55,65
32,"SATU MARE","ŞCOALA DE GIMNAZIALĂ BEM JOZSEF CĂRĂŞEU",189,CULCIU,137540,1,PART,PRCNCT,PRSD,PRSD_SV,"2025-05-18 21:46:59",902,422,368,34,20,419,3,1000,578,88,331
32,"SATU MARE","CĂMIN CULTURAL COROD",190,CULCIU,137540,1,PART,PRCNCT,PRSD,PRSD_SV,"2025-05-18 21:36:18",414,221,193,24,4,219,2,500,279,76,143
32,"SATU MARE","ŞCOALA PRIMARĂ CULCIU-MIC",191,CULCIU,137540,1,PART,PRCNCT,PRSD,PRSD_SV,"2025-05-18 21:49:12",604,286,232,42,12,284,2,700,414,80,204
32,"SATU MARE","ŞCOALA PRIMARĂ LIPĂU",192,CULCIU,137540,1,PART,PRCNCT,PRSD,PRSD_SV,"2025-05-18 21:19:42",423,228,173,51,4,225,3,500,272,114,111
32,"SATU MARE","PRIMARIA COMUNEI DOBA",193,DOBA,137611,1,PART,PRCNCT,PRSD,PRSD_SV,"2025-05-18 21:31:04",1014,430,388,42,0,426,4,1100,670,204,222
32,"SATU MARE","ŞCOALA GENERALĂ BOGHIŞ",194,DOBA,137611,1,PART,PRCNCT,PRSD,PRSD_SV,"2025-05-18 21:24:23",671,218,186,32,0,216,2,700,482,90,126
32,"SATU MARE","CASĂ DE LOCUIT",195,DOBA,137611,1,PART,PRCNCT,PRSD,PRSD_SV,"2025-05-18 21:25:28",139,94,67,27,0,93,1,200,106,41,52
32,"SATU MARE","CAMINUL CULTURAL",196,DOBA,137611,1,PART,PRCNCT,PRSD,PRSD_SV,"2025-05-18 21:24:53",422,245,193,51,1,244,1,501,256,161,83
32,"SATU MARE","CĂMIN CULTURAL TRAIAN",197,DOBA,137611,1,PART,PRCNCT,PRSD,PRSD_SV,"2025-05-18 21:20:54",163,90,65,24,1,90,0,200,110,42,48
32,"SATU MARE","PRIMARIA COMUNEI DOROLT",198,DOROLŢ,137675,1,PART,PRCNCT,PRSD,PRSD_SV,"2025-05-18 21:35:57",1529,783,681,94,8,777,6,1600,817,155,622
32,"SATU MARE","CAMIN CULTURAL ATEA",199,DOROLŢ,137675,1,PART,PRCNCT,PRSD,PRSD_SV,"2025-05-18 21:18:32",315,192,171,13,8,183,9,400,208,30,153
32,"SATU MARE","SCOALA DARA",200,DOROLŢ,137675,1,PART,PRCNCT,PRSD,PRSD_SV,"2025-05-18 21:34:31",1010,637,594,23,20,631,6,1100,463,31,600
32,"SATU MARE","CAMIN CULTURAL PETEA",201,DOROLŢ,137675,1,PART,PRCNCT,PRSD,PRSD_SV,"2025-05-18 21:38:42",364,201,169,28,4,195,6,400,199,98,97
32,"SATU MARE","CONSILIUL LOCAL FOIENI",202,FOIENI,137728,1,PART,PRCNCT,PRSD,PRSD_SV,"2025-05-18 22:14:04",1603,810,770,40,0,806,4,1701,891,50,756
32,"SATU MARE","PRIMARIA COMUNEI",203,"GHERŢA MICĂ",137746,1,PART,PRCNCT,PRSD,PRSD_SV,"2025-05-18 21:46:48",1586,438,411,18,9,437,1,1700,1262,314,123
32,"SATU MARE","CĂMIN CULTURAL GHERȚA MICĂ",204,"GHERŢA MICĂ",137746,1,PART,PRCNCT,PRSD,PRSD_SV,"2025-05-18 21:37:06",1355,400,361,29,10,399,1,1400,1000,279,120
32,"SATU MARE","ŞCOALA CU CLS.I-VIII HALMEU",205,HALMEU,137764,1,PART,PRCNCT,PRSD,PRSD_SV,"2025-05-18 22:26:35",1656,608,534,70,4,596,12,1801,1193,299,297
32,"SATU MARE","ŞCOALA CU CLS.I-VIII HALMEU",206,HALMEU,137764,2,PART,PRCNCT,PRSD,PRSD_SV,"2025-05-19 00:27:51",1367,555,479,76,0,549,6,1500,945,293,256
32,"SATU MARE","GRĂDINIŢA BĂBEŞTI",207,HALMEU,137764,1,PART,PRCNCT,PRSD,PRSD_SV,"2025-05-18 21:35:42",352,192,165,25,2,185,7,400,208,39,146
32,"SATU MARE","GRĂDINIŢA DABOLŢ",208,HALMEU,137764,1,PART,PRCNCT,PRSD,PRSD_SV,"2025-05-18 21:17:24",335,139,117,22,0,138,1,400,261,53,85
32,"SATU MARE","GRĂDINIŢA MESTEACĂN",209,HALMEU,137764,1,PART,PRCNCT,PRSD,PRSD_SV,"2025-05-18 21:33:45",378,139,113,26,0,139,0,400,261,98,41
32,"SATU MARE","SEDIUL PRIMARIEI COMUNEI HODOD",210,HODOD,137844,1,PART,PRCNCT,PRSD,PRSD_SV,"2025-05-18 21:38:36",687,334,295,25,14,333,1,800,466,56,277
32,"SATU MARE","SCOALA GIMNAZIALA GIURTELECU HODODULUI",211,HODOD,137844,1,PART,PRCNCT,PRSD,PRSD_SV,"2025-05-18 21:19:36",423,238,175,63,0,235,3,500,262,129,106
32,"SATU MARE","SCOALA PRIMARA LELEI",212,HODOD,137844,1,PART,PRCNCT,PRSD,PRSD_SV,"2025-05-18 21:19:35",477,251,216,20,15,244,7,500,249,16,228
32,"SATU MARE","CENTRU SOCIAL NADISU HODODULUI",213,HODOD,137844,1,PART,PRCNCT,PRSD,PRSD_SV,"2025-05-18 21:27:26",665,352,298,24,30,349,3,700,348,38,311
32,"SATU MARE","SCOALA CLS. I-VIII HOMORODU DE MIJLOC",214,HOMOROADE,137899,1,PART,PRCNCT,PRSD,PRSD_SV,"2025-05-18 21:21:14",517,287,222,65,0,286,1,600,313,161,125
32,"SATU MARE","CĂMIN CULTURAL CHILIA",215,HOMOROADE,137899,1,PART,PRCNCT,PRSD,PRSD_SV,"2025-05-18 21:15:44",181,122,67,55,0,122,0,199,77,63,59
32,"SATU MARE","CĂMIN CULTURAL HOMORODU DE JOS",216,HOMOROADE,137899,1,PART,PRCNCT,PRSD,PRSD_SV,"2025-05-18 21:10:43",293,151,115,36,0,151,0,400,249,79,72
32,"SATU MARE","CĂMIN CULTURAL NECOPOI",217,HOMOROADE,137899,1,PART,PRCNCT,PRSD,PRSD_SV,"2025-05-18 21:18:19",176,106,67,39,0,104,2,200,94,38,66
32,"SATU MARE","CĂMIN CULTURAL SOLDUBA",218,HOMOROADE,137899,1,PART,PRCNCT,PRSD,PRSD_SV,"2025-05-18 21:25:21",202,129,95,33,1,128,1,302,173,62,66
32,"SATU MARE","CAMIN CULTURAL NOU",219,LAZURI,137960,1,PART,PRCNCT,PRSD,PRSD_SV,"2025-05-18 21:48:57",1488,817,728,79,10,806,11,1600,783,170,636
32,"SATU MARE","ȘCOALA GIMNAZIALĂ ”PETŐFI SÁNDOR” LAZURI",220,LAZURI,137960,1,PART,PRCNCT,PRSD,PRSD_SV,"2025-05-18 21:35:17",1214,601,563,31,7,601,0,1300,699,111,490
32,"SATU MARE","CĂMIN CULTURAL BERCU",221,LAZURI,137960,1,PART,PRCNCT,PRSD,PRSD_SV,"2025-05-18 21:17:22",502,304,262,19,23,303,1,600,296,34,269
32,"SATU MARE","SCOALA CU CLASELE I-VIII NISIPENI",222,LAZURI,137960,1,PART,PRCNCT,PRSD,PRSD_SV,"2025-05-18 21:15:07",719,349,303,33,13,343,6,800,451,71,272
32,"SATU MARE","CĂMIN CULTURAL NOROIENI",223,LAZURI,137960,1,PART,PRCNCT,PRSD,PRSD_SV,"2025-05-18 21:16:40",337,153,137,16,0,153,0,400,247,63,90
32,"SATU MARE","SCOALA CU CLASELE I-VIII PELES",224,LAZURI,137960,1,PART,PRCNCT,PRSD,PRSD_SV,"2025-05-18 21:24:22",749,356,327,26,3,351,5,800,444,71,280
32,"SATU MARE","SCOALA CU CLASELE I-IV PELISOR",225,LAZURI,137960,1,PART,PRCNCT,PRSD,PRSD_SV,"2025-05-18 21:19:05",244,145,126,16,3,142,3,300,155,23,119
32,"SATU MARE","PRIMARIA MEDIESU AURIT",226,"MEDIEŞU AURIT",138084,1,PART,PRCNCT,PRSD,PRSD_SV,"2025-05-18 21:27:47",914,479,432,44,3,478,1,1000,521,235,243
32,"SATU MARE","SCOALA MEDIESU AURIT",227,"MEDIEŞU AURIT",138084,1,PART,PRCNCT,PRSD,PRSD_SV,"2025-05-18 21:31:51",1316,582,510,68,4,576,6,1400,818,367,209
32,"SATU MARE","CĂMINUL CULTURAL BĂBĂȘEȘTI",228,"MEDIEŞU AURIT",138084,1,PART,PRCNCT,PRSD,PRSD_SV,"2025-05-18 21:19:39",505,299,239,60,0,295,4,600,301,169,126
32,"SATU MARE","SCOALA GENERALA",229,"MEDIEŞU AURIT",138084,1,PART,PRCNCT,PRSD,PRSD_SV,"2025-05-18 21:17:42",957,354,321,33,0,348,6,1000,646,137,211
32,"SATU MARE","CLĂDIRE ADMINISTRATIVĂ",230,"MEDIEŞU AURIT",138084,1,PART,PRCNCT,PRSD,PRSD_SV,"2025-05-18 21:14:57",242,127,107,20,0,127,0,302,175,94,33
32,"SATU MARE","CLĂDIRE ADMINISTRATIVĂ",231,"MEDIEŞU AURIT",138084,1,PART,PRCNCT,PRSD,PRSD_SV,"2025-05-18 21:12:33",157,100,70,30,0,100,0,200,100,70,30
32,"SATU MARE","SCOALA GENERALA",232,"MEDIEŞU AURIT",138084,1,PART,PRCNCT,PRSD,PRSD_SV,"2025-05-18 21:23:05",790,357,320,35,2,354,3,900,543,158,196
32,"SATU MARE","SCOALA GENERALA",233,"MEDIEŞU AURIT",138084,1,PART,PRCNCT,PRSD,PRSD_SV,"2025-05-18 21:13:29",572,247,22,224,1,246,1,600,353,114,132
32,"SATU MARE","CENTRU CULTURAL TURISTIC",234,MICULA,138164,1,PART,PRCNCT,PRSD,PRSD_SV,"2025-05-18 21:46:20",1206,614,552,55,7,605,9,1300,686,173,432
32,"SATU MARE","GRADINITA NR. II MICULA",235,MICULA,138164,1,PART,PRCNCT,PRSD,PRSD_SV,"2025-05-18 22:06:21",1493,571,538,31,2,566,5,1600,1029,380,186
32,"SATU MARE","CASĂ DE LOCUIT MICULA NOUA",236,MICULA,138164,1,PART,PRCNCT,PRSD,PRSD_SV,"2025-05-18 21:29:12",622,233,218,15,0,231,2,700,467,152,79
32,"SATU MARE","CAMINUL CULTURAL",237,MOFTIN,138208,1,PART,PRCNCT,PRSD,PRSD_SV,"2025-05-18 21:29:43",1052,466,423,43,0,461,5,1200,734,232,229
32,"SATU MARE","SCOALA GENERALA CL I-VIIII",238,MOFTIN,138208,1,PART,PRCNCT,PRSD,PRSD_SV,"2025-05-18 21:33:20",899,332,311,21,0,329,3,1001,669,188,141
32,"SATU MARE","ȘCOALA GENERALĂ ȘI GRADINIȚA GARA GHILVACI",239,MOFTIN,138208,1,PART,PRCNCT,PRSD,PRSD_SV,"2025-05-18 21:24:23",178,111,81,30,0,109,2,200,89,75,34
32,"SATU MARE","SCOALA GENERALA",240,MOFTIN,138208,1,PART,PRCNCT,PRSD,PRSD_SV,"2025-05-18 21:49:45",1012,335,275,60,0,333,2,1100,765,154,179
32,"SATU MARE","GRADINITA DE COPII",241,MOFTIN,138208,1,PART,PRCNCT,PRSD,PRSD_SV,"2025-05-18 22:00:05",408,167,142,25,0,164,3,500,333,98,66
32,"SATU MARE","GRĂDINIȚA CU PROGRAM NORMAL ODOREU",242,ODOREU,138280,1,PART,PRCNCT,PRSD,PRSD_SV,"2025-05-18 21:40:56",1571,677,632,44,1,669,8,1700,1023,338,331
32,"SATU MARE","SCOALA GIMNAZIALA ODOREU",243,ODOREU,138280,1,PART,PRCNCT,PRSD,PRSD_SV,"2025-05-18 21:26:00",1324,547,506,41,0,540,7,1400,853,234,306
32,"SATU MARE","SCOALA GIMNAZIALA ODOREU",244,ODOREU,138280,1,PART,PRCNCT,PRSD,PRSD_SV,"2025-05-18 21:28:21",1300,601,561,37,3,597,4,1400,799,232,365
32,"SATU MARE","CASA DE TIP FAMILIAL” IRIS”",245,ODOREU,138280,1,PART,PRCNCT,PRSD,PRSD_SV,"2025-05-18 21:13:03",126,73,46,27,0,73,0,200,127,27,46
32,"SATU MARE","AFTER SCHOOL, MARTINESTI NR. 51",246,ODOREU,138280,1,PART,PRCNCT,PRSD,PRSD_SV,"2025-05-18 21:38:38",1114,741,658,83,0,737,4,1200,459,203,534
32,"SATU MARE","SCOALA GIMNAZIALA ORASU NOU SALA DE CLASĂ 1",247,"ORAŞU NOU",138351,1,PART,PRCNCT,PRSD,PRSD_SV,"2025-05-18 21:23:45",690,399,334,28,37,394,5,800,401,75,319
32,"SATU MARE","SCOALA GIMNAZIALA ORASU NOU SALA DE CLASĂ 2",248,"ORAŞU NOU",138351,1,PART,PRCNCT,PRSD,PRSD_SV,"2025-05-18 21:29:22",876,459,396,18,45,452,7,1000,541,52,400
32,"SATU MARE","GRĂDINIȚĂ CU PROGRAM NORMAL",249,"ORAŞU NOU",138351,1,PART,PRCNCT,PRSD,PRSD_SV,"2025-05-18 21:18:59",327,168,138,30,0,166,2,400,232,102,64
32,"SATU MARE","GRĂDINIȚĂ CU PROGRAM NORMAL",250,"ORAŞU NOU",138351,1,PART,PRCNCT,PRSD,PRSD_SV,"2025-05-18 21:24:50",478,204,182,22,0,204,0,500,296,113,91
32,"SATU MARE","ŞCOALA CU CLASELE I-IV",251,"ORAŞU NOU",138351,1,PART,PRCNCT,PRSD,PRSD_SV,"2025-05-18 21:17:09",142,78,62,16,0,78,0,200,122,43,35
32,"SATU MARE","CLĂDIREA SCOLII",252,"ORAŞU NOU",138351,1,PART,PRCNCT,PRSD,PRSD_SV,"2025-05-18 21:10:41",98,60,35,25,0,60,0,200,140,31,29
32,"SATU MARE","SCOALĂ PRIMARĂ REMETEA OAȘ",253,"ORAŞU NOU",138351,1,PART,PRCNCT,PRSD,PRSD_SV,"2025-05-18 21:27:29",435,235,194,27,14,235,0,500,265,52,183
32,"SATU MARE","CĂMIN CULTURAL PĂULEȘTI",254,PĂULEŞTI,138431,1,PART,PRCNCT,PRSD,PRSD_SV,"2025-05-18 22:03:39",1806,1148,1018,129,1,1140,8,1900,752,355,785
32,"SATU MARE","CĂMINUL CULTURAL AMAȚI",255,PĂULEŞTI,138431,1,PART,PRCNCT,PRSD,PRSD_SV,"2025-05-18 21:33:50",950,435,387,45,3,431,4,1000,565,214,217
32,"SATU MARE","ȘCOALA SOLTESZ JANOS AMBUD",256,PĂULEŞTI,138431,1,PART,PRCNCT,PRSD,PRSD_SV,"2025-05-18 21:25:01",964,471,437,34,0,466,5,1100,629,144,322
32,"SATU MARE","GRĂDINIȚA CU PROGRAM NORMAL HRIP",257,PĂULEŞTI,138431,1,PART,PRCNCT,PRSD,PRSD_SV,"2025-05-18 21:30:01",595,239,206,33,0,237,2,701,462,98,139
32,"SATU MARE","GRĂDINIȚA ”GEORGE TOPÂRCEANU”",258,PĂULEŞTI,138431,1,PART,PRCNCT,PRSD,PRSD_SV,"2025-05-18 21:15:54",623,253,234,19,0,248,5,700,447,72,176
32,"SATU MARE","MAGAZIN TIP P",259,PĂULEŞTI,138431,1,PART,PRCNCT,PRSD,PRSD_SV,"2025-05-18 21:30:20",181,146,98,48,0,146,0,301,155,77,69
32,"SATU MARE","ŞCOALA GIMNAZIALĂ DR. STEFAN VONHÁZ",260,PETREŞTI,138501,1,PART,PRCNCT,PRSD,PRSD_SV,"2025-05-18 21:37:40",1284,436,387,34,15,433,3,1400,964,83,350
32,"SATU MARE","CLĂDIRE MULTIFUNCȚIONALĂ",261,PETREŞTI,138501,1,PART,PRCNCT,PRSD,PRSD_SV,"2025-05-18 21:26:41",318,122,95,22,5,122,0,400,278,37,85
32,"SATU MARE","ȘCOALA GIMNAZIALĂ PIR",262,PIR,138538,2,PART,PRCNCT,PRSD,PRSD_SV,"2025-05-19 01:45:21",1129,489,469,19,1,483,6,1200,711,95,388
32,"SATU MARE","SCOALA PRIMARA",263,PIR,138538,1,PART,PRCNCT,PRSD,PRSD_SV,"2025-05-18 21:20:15",98,43,29,14,0,39,4,200,157,21,18
32,"SATU MARE","PRIMARIA COMUNEI PISCOLT",264,PIŞCOLT,138574,1,PART,PRCNCT,PRSD,PRSD_SV,"2025-05-18 21:53:31",904,403,376,27,0,397,6,1000,597,160,237
32,"SATU MARE","PRIMARIA COMUNEI PISCOLT",265,PIŞCOLT,138574,1,PART,PRCNCT,PRSD,PRSD_SV,"2025-05-18 21:53:52",895,355,338,17,0,351,4,1000,645,126,225
32,"SATU MARE","CĂMIN CULTURAL RESIGHEA",266,PIŞCOLT,138574,1,PART,PRCNCT,PRSD,PRSD_SV,"2025-05-18 21:32:07",357,191,159,32,0,190,1,400,209,104,86
32,"SATU MARE","CĂMIN CULTURAL SCĂRIȘOARA NOUĂ",267,PIŞCOLT,138574,1,PART,PRCNCT,PRSD,PRSD_SV,"2025-05-18 22:00:04",312,189,134,54,1,186,3,400,211,99,87
32,"SATU MARE","CĂMIN CULTURAL POMI",268,POMI,138618,2,PART,PRCNCT,PRSD,PRSD_SV,"2025-05-19 00:20:46",716,446,327,107,12,440,6,800,354,254,186
32,"SATU MARE","CAMIN CULTURAL",269,POMI,138618,1,PART,PRCNCT,PRSD,PRSD_SV,"2025-05-18 21:16:44",69,114,35,79,0,114,0,200,86,39,75
32,"SATU MARE","CAMIN CULTURAL",270,POMI,138618,1,PART,PRCNCT,PRSD,PRSD_SV,"2025-05-18 21:13:43",113,86,57,25,4,86,0,199,113,37,49
32,"SATU MARE","CĂMIN CULTURAL BORLEŞTI",271,POMI,138618,1,PART,PRCNCT,PRSD,PRSD_SV,"2025-05-18 21:57:34",639,400,296,103,1,399,1,700,300,234,165
32,"SATU MARE","ŞCOALA GIMNAZIALĂ PORUMBEŞTI",272,PORUMBEŞTI,180028,1,PART,PRCNCT,PRSD,PRSD_SV,"2025-05-18 21:31:38",1209,551,495,47,9,546,5,1299,748,73,473
32,"SATU MARE","ŞCOALA GIMNAZIALĂ CIDREAG",273,PORUMBEŞTI,180028,1,PART,PRCNCT,PRSD,PRSD_SV,"2025-05-18 21:20:35",857,387,361,24,2,380,7,901,514,63,317
32,"SATU MARE","ȘCOALA GENERALĂ",274,RACŞA,180091,1,PART,PRCNCT,PRSD,PRSD_SV,"2025-05-18 21:27:18",1096,317,298,19,0,314,3,1200,883,199,115
32,"SATU MARE","ȘCOALA GIMNAZIALĂ",275,RACŞA,180091,1,PART,PRCNCT,PRSD,PRSD_SV,"2025-05-18 21:17:37",1124,345,322,23,0,341,4,1200,855,230,111
32,"SATU MARE","ŞCOALA PRIMARĂ",276,RACŞA,180091,1,PART,PRCNCT,PRSD,PRSD_SV,"2025-05-18 21:16:51",220,143,116,24,3,143,0,300,157,108,35
32,"SATU MARE","GRĂDINIŢA SANISLĂU",277,SANISLĂU,138663,1,PART,PRCNCT,PRSD,PRSD_SV,"2025-05-18 21:43:15",1304,547,506,39,2,543,4,1400,853,109,434
32,"SATU MARE","ŞCOALA CU CL. I-VIII GH. BULGĂR-SANISLĂU",278,SANISLĂU,138663,1,PART,PRCNCT,PRSD,PRSD_SV,"2025-05-18 21:59:20",1290,583,535,48,0,571,12,1400,817,240,331
32,"SATU MARE","CĂMIN CULTURAL SAT HOREA",279,SANISLĂU,138663,1,PART,PRCNCT,PRSD,PRSD_SV,"2025-05-18 21:12:23",107,93,51,42,0,93,0,201,108,55,38
32,"SATU MARE","CĂMIN CULTURAL SAT MARNA NOUĂ",280,SANISLĂU,138663,1,PART,PRCNCT,PRSD,PRSD_SV,"2025-05-18 21:55:44",281,168,142,26,0,166,2,300,132,107,59
32,"SATU MARE","SCOALA GIMNAZIALA SANTAU",281,SANTĂU,138734,1,PART,PRCNCT,PRSD,PRSD_SV,"2025-05-18 21:30:43",1375,708,620,62,26,703,5,1500,792,231,472
32,"SATU MARE","SC. PRIM. CHEREUŞA",282,SANTĂU,138734,1,PART,PRCNCT,PRSD,PRSD_SV,"2025-05-18 21:30:10",442,266,228,29,9,263,3,500,234,96,167
32,"SATU MARE","GRĂDINIŢA SUDURĂU",283,SANTĂU,138734,1,PART,PRCNCT,PRSD,PRSD_SV,"2025-05-18 21:19:27",151,81,62,18,1,80,1,198,117,32,48
32,"SATU MARE","PRIMARIA SACASENI",284,SĂCĂŞENI,138770,1,PART,PRCNCT,PRSD,PRSD_SV,"2025-05-18 21:38:36",810,318,267,26,25,313,5,900,582,144,169
32,"SATU MARE","CLĂDIRE ADMINISTRATIVĂ",285,SĂCĂŞENI,138770,1,PART,PRCNCT,PRSD,PRSD_SV,"2025-05-18 21:22:15",104,99,58,38,3,96,3,200,101,56,40
32,"SATU MARE","SCOALA CU CLASELE I-VIII SAUCA",286,SĂUCA,138805,1,PART,PRCNCT,PRSD,PRSD_SV,"2025-05-18 21:19:58",322,144,121,23,0,140,4,400,256,74,66
32,"SATU MARE","SCALA CU CLS.I-VIII BECHENI",287,SĂUCA,138805,1,PART,PRCNCT,PRSD,PRSD_SV,"2025-05-18 21:26:38",432,213,190,23,0,203,10,500,287,77,126
32,"SATU MARE","SCOALA CU CLS.I-IV CEAN",288,SĂUCA,138805,1,PART,PRCNCT,PRSD,PRSD_SV,"2025-05-18 21:21:41",230,132,111,21,0,128,4,300,168,62,66
32,"SATU MARE","SCOALA SILVAS",289,SĂUCA,138805,1,PART,PRCNCT,PRSD,PRSD_SV,"2025-05-18 21:22:15",126,75,52,23,0,73,2,200,125,33,40
32,"SATU MARE","SCOALA GIMNAZIALA SOCOND",290,SOCOND,138869,1,PART,PRCNCT,PRSD,PRSD_SV,"2025-05-18 21:19:55",558,236,214,19,3,233,3,600,364,124,109
32,"SATU MARE","CAMINUL CULTURAL CUTA",291,SOCOND,138869,1,PART,PRCNCT,PRSD,PRSD_SV,"2025-05-18 21:16:39",236,136,98,26,12,135,1,300,164,50,85
32,"SATU MARE","CAMINUL CULTURAL HODISA",292,SOCOND,138869,1,PART,PRCNCT,PRSD,PRSD_SV,"2025-05-18 21:20:15",160,121,86,26,9,121,0,200,79,55,66
32,"SATU MARE","CAMIN CULTURAL SOCONZEL",293,SOCOND,138869,1,PART,PRCNCT,PRSD,PRSD_SV,"2025-05-18 21:26:15",231,171,118,32,21,170,1,300,129,71,99
32,"SATU MARE","SCOALA GIMNAZIALA STANA",294,SOCOND,138869,1,PART,PRCNCT,PRSD,PRSD_SV,"2025-05-18 21:26:22",856,345,321,20,4,345,0,900,555,119,226
32,"SATU MARE","PRIMARIA COMUNEI SUPUR",295,SUPUR,138921,1,PART,PRCNCT,PRSD,PRSD_SV,"2025-05-18 21:14:41",972,474,386,88,0,470,4,1100,626,271,199
32,"SATU MARE","ȘCOALA GIMNAZIALĂ DOBRA",296,SUPUR,138921,1,PART,PRCNCT,PRSD,PRSD_SV,"2025-05-18 21:22:49",753,354,309,42,3,347,7,800,446,38,309
32,"SATU MARE","ȘCOALA GIMNAZIALĂ GIOROCUTA",297,SUPUR,138921,1,PART,PRCNCT,PRSD,PRSD_SV,"2025-05-18 21:15:20",620,244,203,41,0,244,0,700,456,184,60
32,"SATU MARE","ȘCOALA GIMNAZIALĂ ”MOISE SORA NOVAC” HUREZU MARE",298,SUPUR,138921,1,PART,PRCNCT,PRSD,PRSD_SV,"2025-05-18 21:13:27",266,154,113,41,0,152,2,300,146,55,97
32,"SATU MARE","GRĂDINIȚĂ CU PROGRAM NORMAL",299,SUPUR,138921,1,PART,PRCNCT,PRSD,PRSD_SV,"2025-05-18 21:07:21",151,86,67,19,0,86,0,200,114,52,34
32,"SATU MARE","CĂMIN CULTURAL SECHEREȘA",300,SUPUR,138921,1,PART,PRCNCT,PRSD,PRSD_SV,"2025-05-18 21:06:40",44,34,20,14,0,33,1,100,66,14,19
32,"SATU MARE","ȘCOALA PRIMARĂ ” IOAN GALU” SUPURU DE SUS",301,SUPUR,138921,1,PART,PRCNCT,PRSD,PRSD_SV,"2025-05-18 21:11:54",400,190,149,40,1,189,1,500,310,139,50
32,"SATU MARE","PRIMARIA TARNA MARE",302,"TARNA MARE",139009,1,PART,PRCNCT,PRSD,PRSD_SV,"2025-05-18 21:26:05",1683,641,601,33,7,633,8,1800,1159,413,220
32,"SATU MARE","CĂMINUL CULTURAL BOCICĂU",303,"TARNA MARE",139009,1,PART,PRCNCT,PRSD,PRSD_SV,"2025-05-18 21:20:58",496,162,144,14,4,160,2,600,438,105,55
32,"SATU MARE","ȘCOALA GIMNAZIALĂ VALEA SEACĂ",304,"TARNA MARE",139009,1,PART,PRCNCT,PRSD,PRSD_SV,"2025-05-18 21:30:12",928,292,269,23,0,289,3,1000,708,218,71
32,"SATU MARE","SCOALA GIMNAZIALA TARSOLT",305,TÂRŞOLŢ,139143,1,PART,PRCNCT,PRSD,PRSD_SV,"2025-05-18 21:28:05",1355,264,248,8,8,262,2,1500,1236,188,74
32,"SATU MARE","SCOALA GIMNAZIALA TARSOLT",306,TÂRŞOLŢ,139143,1,PART,PRCNCT,PRSD,PRSD_SV,"2025-05-18 21:23:51",846,154,131,21,2,153,1,900,746,98,55
32,"SATU MARE","SCOALA GIMNAZIALA ALICENI",307,TÂRŞOLŢ,139143,1,PART,PRCNCT,PRSD,PRSD_SV,"2025-05-18 21:13:31",351,89,74,12,3,89,0,400,311,48,41
32,"SATU MARE","PRIMARIA TEREBESTI",308,TEREBEŞTI,139054,1,PART,PRCNCT,PRSD,PRSD_SV,"2025-05-18 21:35:49",685,221,182,35,4,215,6,800,579,132,83
32,"SATU MARE","CENTRU DE ZI INGRIJIRE BATRANI",309,TEREBEŞTI,139054,1,PART,PRCNCT,PRSD,PRSD_SV,"2025-05-18 21:20:05",459,272,219,46,7,271,1,500,228,128,143
32,"SATU MARE","GRĂDINIȚA CU PROGRAM NORMAL PIȘCARI",310,TEREBEŞTI,139054,1,PART,PRCNCT,PRSD,PRSD_SV,"2025-05-18 21:24:39",396,157,122,35,0,154,3,500,343,106,48
32,"SATU MARE","PRIMARIA COMUNEI TIREAM",311,TIREAM,139107,1,PART,PRCNCT,PRSD,PRSD_SV,"2025-05-18 22:01:39",1410,548,506,42,0,545,3,1500,952,166,379
32,"SATU MARE","GRADINITA CU PROGRAM NORMAL",312,TIREAM,139107,1,PART,PRCNCT,PRSD,PRSD_SV,"2025-05-18 21:19:52",152,71,51,20,0,70,1,200,129,37,33
32,"SATU MARE","CĂMINUL CULTURAL VEZENDIU",313,TIREAM,139107,1,PART,PRCNCT,PRSD,PRSD_SV,"2025-05-18 21:26:56",347,164,132,30,2,163,1,400,236,86,77
32,"SATU MARE","LICEUL TEHNOLOGIC ANGHEL SALIGNY TURT, CORPUL A",314,TURŢ,139170,1,PART,PRCNCT,PRSD,PRSD_SV,"2025-05-18 21:45:30",1520,456,441,13,2,453,3,1608,1152,241,212
32,"SATU MARE","LICEUL TEHNOLOGIC ANGHEL SALIGNY TURT, CORPUL B",315,TURŢ,139170,1,PART,PRCNCT,PRSD,PRSD_SV,"2025-05-18 21:42:37",1298,394,376,18,0,387,7,1400,1006,265,122
32,"SATU MARE","SCOALA CU CLASELE I-VIII NR. 2",316,TURŢ,139170,1,PART,PRCNCT,PRSD,PRSD_SV,"2025-05-18 21:37:48",1411,470,442,28,0,464,6,1600,1130,332,132
32,"SATU MARE","GRADINITA CU PROGRAM NORMAL SUSANI",317,TURŢ,139170,1,PART,PRCNCT,PRSD,PRSD_SV,"2025-05-18 21:21:33",902,259,243,16,0,257,2,1000,741,183,74
32,"SATU MARE","CĂMIN CULTURAL GHERȚA MARE",318,TURŢ,139170,1,PART,PRCNCT,PRSD,PRSD_SV,"2025-05-18 21:35:34",1402,414,405,9,0,410,4,1500,1086,256,154
32,"SATU MARE",PRIMĂRIA,319,TURULUNG,139214,1,PART,PRCNCT,PRSD,PRSD_SV,"2025-05-18 21:28:40",911,384,342,42,0,382,2,1000,616,37,345
32,"SATU MARE","SCOALA GIMNAZIALA TURULUNG",320,TURULUNG,139214,1,PART,PRCNCT,PRSD,PRSD_SV,"2025-05-18 22:04:57",1234,534,509,25,0,528,6,1299,765,91,437
32,"SATU MARE","SCOALA GIMNAZIALA DRAGUSENI",321,TURULUNG,139214,1,PART,PRCNCT,PRSD,PRSD_SV,"2025-05-18 21:25:39",1137,339,306,31,2,338,1,1200,861,264,74
32,"SATU MARE",GRADINITA,322,TURULUNG,139214,1,PART,PRCNCT,PRSD,PRSD_SV,"2025-05-18 21:13:00",150,78,67,11,0,78,0,200,122,15,63
32,"SATU MARE","CAMIN CULTURAL URZICENI",323,URZICENI,139250,1,PART,PRCNCT,PRSD,PRSD_SV,"2025-05-18 21:44:44",1088,573,481,84,8,571,2,1199,626,62,509
32,"SATU MARE","CĂMIN CULTURAL URZICENI PĂDURE",324,URZICENI,139250,1,PART,PRCNCT,PRSD,PRSD_SV,"2025-05-18 21:20:26",150,73,56,17,0,73,0,200,127,31,42
32,"SATU MARE","CAMINUL CULTURAL VALEA VINULUI",325,"VALEA VINULUI",139287,1,PART,PRCNCT,PRSD,PRSD_SV,"2025-05-18 22:03:50",617,324,266,53,5,324,0,697,373,161,163
32,"SATU MARE","SCOALA CU CLASELE I-IV MARIUS",326,"VALEA VINULUI",139287,1,PART,PRCNCT,PRSD,PRSD_SV,"2025-05-18 21:23:17",170,127,74,53,0,127,0,199,72,56,71
32,"SATU MARE","SCOALA CU CLASELE I-IV ROSIORI",327,"VALEA VINULUI",139287,1,PART,PRCNCT,PRSD,PRSD_SV,"2025-05-18 21:40:15",316,199,142,55,2,196,3,400,201,100,96
32,"SATU MARE","SCOALA CU CLASELE I-IV SII",328,"VALEA VINULUI",139287,1,PART,PRCNCT,PRSD,PRSD_SV,"2025-05-18 21:25:08",444,185,141,44,0,182,3,500,315,108,74
32,"SATU MARE","ȘCOALA GIMNAZIALĂ VAMA",329,VAMA,139330,1,PART,PRCNCT,PRSD,PRSD_SV,"2025-05-18 21:50:16",1788,678,631,47,0,678,0,1900,1222,293,385
32,"SATU MARE","SCOALA GIMNAZIALA VAMA",330,VAMA,139330,1,PART,PRCNCT,PRSD,PRSD_SV,"2025-05-18 21:55:33",1624,644,584,60,0,642,2,1700,1056,281,361
32,"SATU MARE","PRIMĂRIA COMUNEI VETIŞ",331,VETIŞ,139358,1,PART,PRCNCT,PRSD,PRSD_SV,"2025-05-18 21:53:32",1278,562,513,48,1,560,2,1400,838,173,387
32,"SATU MARE","PRIMĂRIA COMUNEI VETIȘ",332,VETIŞ,139358,1,PART,PRCNCT,PRSD,PRSD_SV,"2025-05-18 21:40:52",967,483,440,43,0,481,2,1100,617,184,297
32,"SATU MARE","CAMINUL CULTURAL DIN DECEBAL",333,VETIŞ,139358,1,PART,PRCNCT,PRSD,PRSD_SV,"2025-05-18 21:48:52",1181,536,492,44,0,534,2,1300,764,320,214
32,"SATU MARE","CĂMINUL CULTURAL OAR",334,VETIŞ,139358,1,PART,PRCNCT,PRSD,PRSD_SV,"2025-05-18 21:54:20",1397,649,609,40,0,646,3,1499,850,116,530
32,"SATU MARE","ȘCOALA LIPA",335,"VIILE SATU MARE",139394,1,PART,PRCNCT,PRSD,PRSD_SV,"2025-05-18 21:19:45",691,467,381,85,1,466,1,800,333,108,358
32,"SATU MARE","PRIMĂRIA VIILE SATU MARE",336,"VIILE SATU MARE",139394,2,PART,PRCNCT,PRSD,PRSD_SV,"2025-05-19 01:45:30",928,528,450,78,0,521,7,1000,472,113,408
32,"SATU MARE","ŞCOALA PRIMARĂ DEALU MARE",337,"VIILE SATU MARE",139394,1,PART,PRCNCT,PRSD,PRSD_SV,"2025-05-18 21:27:51",540,287,235,46,6,285,2,600,313,181,104
32,"SATU MARE","CĂMIN CULTURAL CIONCHEŞTI",338,"VIILE SATU MARE",139394,1,PART,PRCNCT,PRSD,PRSD_SV,"2025-05-18 21:15:25",321,214,178,35,1,209,5,400,186,107,102
32,"SATU MARE","ŞCOALA PRIMARĂ MEDIŞA",339,"VIILE SATU MARE",139394,1,PART,PRCNCT,PRSD,PRSD_SV,"2025-05-18 21:09:40",181,87,64,22,1,87,0,200,113,55,32
32,"SATU MARE","ŞCOALA PRIMARĂ TĂTĂREŞTI",340,"VIILE SATU MARE",139394,1,PART,PRCNCT,PRSD,PRSD_SV,"2025-05-18 21:19:52",550,287,229,54,4,284,3,600,313,179,105
33,SĂLAJ,"COLEGIUL NAŢIONAL ”SILVANIA”",1,"MUNICIPIUL ZALĂU",139704,1,PART,PRCNCT,PRSD,PRSD_SV,"2025-05-18 22:21:52",1897,1252,1116,133,3,1240,12,1913,661,240,1000
33,SĂLAJ,"CASA MUNICIPALĂ DE CULTURĂ",2,"MUNICIPIUL ZALĂU",139704,1,PART,PRCNCT,PRSD,PRSD_SV,"2025-05-18 23:07:25",1891,1195,1096,99,0,1190,5,1900,705,233,957
33,SĂLAJ,"GRĂDINIŢA CU PROGRAM PRELUNGIT NR. 1",3,"MUNICIPIUL ZALĂU",139704,1,PART,PRCNCT,PRSD,PRSD_SV,"2025-05-18 22:25:54",1817,960,918,41,1,951,9,1900,940,200,751
33,SĂLAJ,"PRIMĂRIA MUNICIPIULUI ZALĂU",4,"MUNICIPIUL ZALĂU",139704,1,PART,PRCNCT,PRSD,PRSD_SV,"2025-05-18 22:56:08",1157,604,553,51,0,598,6,1200,596,177,421
33,SĂLAJ,"STADIONUL MUNICIPAL SEDIUL CLUBULUI SPORTIV MUNICIPAL",5,"MUNICIPIUL ZALĂU",139704,1,PART,PRCNCT,PRSD,PRSD_SV,"2025-05-18 21:59:29",1356,808,692,64,52,801,7,1400,592,272,529
33,SĂLAJ,"LICEUL CU PROGRAM SPORTIV ”AVRAM IANCU”",6,"MUNICIPIUL ZALĂU",139704,1,PART,PRCNCT,PRSD,PRSD_SV,"2025-05-18 22:51:12",1973,1318,1216,100,2,1306,12,2000,682,291,1015
33,SĂLAJ,"LICEUL CU PROGRAM SPORTIV ”AVRAM IANCU”",7,"MUNICIPIUL ZALĂU",139704,1,PART,PRCNCT,PRSD,PRSD_SV,"2025-05-18 22:19:17",1713,895,810,84,1,887,8,1800,905,261,626
33,SĂLAJ,"LICEUL CU PROGRAM SPORTIV ”AVRAM IANCU”",8,"MUNICIPIUL ZALĂU",139704,2,PART,PRCNCT,PRSD,PRSD_SV,"2025-05-18 23:50:29",1632,905,824,60,21,894,11,1700,795,230,664
33,SĂLAJ,"DIRECŢIA DE SĂNĂTATE PUBLICĂ SĂLAJ",9,"MUNICIPIUL ZALĂU",139704,1,PART,PRCNCT,PRSD,PRSD_SV,"2025-05-18 22:00:38",1067,649,578,69,2,642,7,1100,451,170,472
33,SĂLAJ,"CLĂDIREA TRANSILVANIA",10,"MUNICIPIUL ZALĂU",139704,1,PART,PRCNCT,PRSD,PRSD_SV,"2025-05-18 23:08:19",1348,863,766,94,3,850,13,1400,537,217,633
33,SĂLAJ,"ȘCOALA GIMNAZIALĂ ”SIMION BĂRNUȚIU”",11,"MUNICIPIUL ZALĂU",139704,1,PART,PRCNCT,PRSD,PRSD_SV,"2025-05-18 21:43:32",1389,785,707,76,2,774,11,1450,665,188,586
33,SĂLAJ,"ŞCOALA GIMNAZIALĂ ”GHEORGHE LAZĂR”",12,"MUNICIPIUL ZALĂU",139704,1,PART,PRCNCT,PRSD,PRSD_SV,"2025-05-18 22:02:33",1688,951,859,91,1,945,6,1750,799,248,697
33,SĂLAJ,"LICEUL TEHNOLOGIC ”MIHAI VITEAZU”",13,"MUNICIPIUL ZALĂU",139704,1,PART,PRCNCT,PRSD,PRSD_SV,"2025-05-18 21:36:11",865,466,417,48,1,461,5,950,484,128,333
33,SĂLAJ,"LICEUL TEHNOLOGIC ”MIHAI VITEAZU”",14,"MUNICIPIUL ZALĂU",139704,1,PART,PRCNCT,PRSD,PRSD_SV,"2025-05-18 22:19:18",1172,609,544,65,0,602,7,1192,583,239,363
33,SĂLAJ,"ŞCOALA GIMNAZIALĂ ”POROLISSUM”",15,"MUNICIPIUL ZALĂU",139704,1,PART,PRCNCT,PRSD,PRSD_SV,"2025-05-18 21:57:49",1718,981,869,89,23,975,6,1750,769,321,654
33,SĂLAJ,"ŞCOALA GIMNAZIALĂ ”POROLISSUM”",16,"MUNICIPIUL ZALĂU",139704,1,PART,PRCNCT,PRSD,PRSD_SV,"2025-05-18 21:43:43",1832,1071,980,91,0,1063,8,1900,829,371,692
33,SĂLAJ,"ŞCOALA GIMNAZIALĂ ”IULIU MANIU”",17,"MUNICIPIUL ZALĂU",139704,1,PART,PRCNCT,PRSD,PRSD_SV,"2025-05-18 21:56:19",1581,799,692,107,0,789,10,1650,851,334,455
33,SĂLAJ,"GRĂDINIŢA CU PROGRAM PRELUNGIT ”VOINICEL”",18,"MUNICIPIUL ZALĂU",139704,1,PART,PRCNCT,PRSD,PRSD_SV,"2025-05-18 21:42:28",895,448,418,30,0,441,7,1000,552,178,263
33,SĂLAJ,"GRĂDINIŢA CU PROGRAM PRELUNGIT ”VOINICEL”",19,"MUNICIPIUL ZALĂU",139704,1,PART,PRCNCT,PRSD,PRSD_SV,"2025-05-18 22:11:41",1055,489,460,29,0,489,0,1100,611,170,319
33,SĂLAJ,"SALA SPORTURILOR",20,"MUNICIPIUL ZALĂU",139704,1,PART,PRCNCT,PRSD,PRSD_SV,"2025-05-18 22:07:01",1614,821,708,113,0,810,11,1700,879,341,469
33,SĂLAJ,"SALA SPORTURILOR",21,"MUNICIPIUL ZALĂU",139704,1,PART,PRCNCT,PRSD,PRSD_SV,"2025-05-18 22:09:56",1462,783,695,88,0,771,12,1550,767,245,526
33,SĂLAJ,"ȘCOALA GIMNAZIALĂ ”CORNELIU COPOSU”",22,"MUNICIPIUL ZALĂU",139704,1,PART,PRCNCT,PRSD,PRSD_SV,"2025-05-18 21:58:47",1213,578,553,25,0,573,5,1300,722,234,339
33,SĂLAJ,"ŞCOALA GIMNAZIALĂ ”CORNELIU COPOSU”",23,"MUNICIPIUL ZALĂU",139704,1,PART,PRCNCT,PRSD,PRSD_SV,"2025-05-18 21:41:16",1402,777,678,99,0,771,6,1500,723,301,470
33,SĂLAJ,"ŞCOALA GIMNAZIALĂ ”CORNELIU COPOSU”",24,"MUNICIPIUL ZALĂU",139704,1,PART,PRCNCT,PRSD,PRSD_SV,"2025-05-18 21:33:39",1263,650,579,71,0,646,4,1300,650,229,417
33,SĂLAJ,"ŞCOALA GIMNAZIALĂ ”CORNELIU COPOSU”",25,"MUNICIPIUL ZALĂU",139704,1,PART,PRCNCT,PRSD,PRSD_SV,"2025-05-18 21:50:47",1280,748,701,47,0,738,10,1300,552,242,496
33,SĂLAJ,"LICEUL TEHNOLOGIC ”VOIEVOD GELU”",26,"MUNICIPIUL ZALĂU",139704,1,PART,PRCNCT,PRSD,PRSD_SV,"2025-05-18 21:58:29",1299,719,630,39,50,717,2,1400,681,230,487
33,SĂLAJ,"LICEUL TEHNOLOGIC ”VOIEVOD GELU”",27,"MUNICIPIUL ZALĂU",139704,1,PART,PRCNCT,PRSD,PRSD_SV,"2025-05-18 21:50:50",1844,974,927,47,0,967,7,1900,926,367,600
33,SĂLAJ,"LICEUL TEHNOLOGIC ”VOIEVOD GELU”",28,"MUNICIPIUL ZALĂU",139704,1,PART,PRCNCT,PRSD,PRSD_SV,"2025-05-18 22:12:43",1327,809,659,103,47,806,3,1450,641,337,469
33,SĂLAJ,"GRĂDINIŢA CU PROGRAM PRELUNGIT ”LICURICI”",29,"MUNICIPIUL ZALĂU",139704,1,PART,PRCNCT,PRSD,PRSD_SV,"2025-05-18 22:05:17",1650,817,713,81,23,812,5,1750,933,293,519
33,SĂLAJ,"LICEUL DE ARTĂ ”IOAN SIMA”",30,"MUNICIPIUL ZALĂU",139704,1,PART,PRCNCT,PRSD,PRSD_SV,"2025-05-18 21:59:23",1583,837,784,53,0,831,6,1650,813,305,526
33,SĂLAJ,"ŞCOALA POSTLICEALĂ SANITARĂ",31,"MUNICIPIUL ZALĂU",139704,1,PART,PRCNCT,PRSD,PRSD_SV,"2025-05-18 22:53:08",1236,625,574,49,2,619,6,1350,725,224,395
33,SĂLAJ,"GRĂDINIŢA CU PROGRAM PRELUNGIT ”PITICII ISTEȚI”",32,"MUNICIPIUL ZALĂU",139704,1,PART,PRCNCT,PRSD,PRSD_SV,"2025-05-18 22:03:03",1468,770,696,73,1,766,4,1550,780,294,472
33,SĂLAJ,"COLEGIUL TEHNIC ”ALESANDRU PAPIU ILARIAN”",33,"MUNICIPIUL ZALĂU",139704,1,PART,PRCNCT,PRSD,PRSD_SV,"2025-05-18 21:39:54",1034,504,446,58,0,497,7,1100,596,170,327
33,SĂLAJ,"COLEGIUL TEHNIC ”ALESANDRU PAPIU ILARIAN”",34,"MUNICIPIUL ZALĂU",139704,1,PART,PRCNCT,PRSD,PRSD_SV,"2025-05-18 22:29:02",864,455,416,39,0,451,4,950,495,127,324
33,SĂLAJ,"LICEUL TEORETIC ”GHEORGHE ŞINCAI”",35,"MUNICIPIUL ZALĂU",139704,1,PART,PRCNCT,PRSD,PRSD_SV,"2025-05-18 21:54:35",1496,932,870,61,1,928,4,1550,618,209,719
33,SĂLAJ,"ŞCOALA GIMNAZIALĂ ”MIHAI EMINESCU”",36,"MUNICIPIUL ZALĂU",139704,1,PART,PRCNCT,PRSD,PRSD_SV,"2025-05-18 21:53:31",1493,803,724,79,0,797,6,1550,747,230,567
33,SĂLAJ,"CLUB S.C. COMPANIA DE APĂ SOMEŞ S.A. SUCURSALA MUNICIPIULUI ZALĂU",37,"MUNICIPIUL ZALĂU",139704,1,PART,PRCNCT,PRSD,PRSD_SV,"2025-05-18 22:05:35",1172,627,560,66,1,621,6,1260,633,158,463
33,SĂLAJ,"ŞCOALA GENERALĂ ”GEORGE COŞBUC”, CARTIER ORTELEC",38,"MUNICIPIUL ZALĂU",139704,1,PART,PRCNCT,PRSD,PRSD_SV,"2025-05-18 22:30:22",1763,1041,979,60,2,1035,6,1850,809,513,522
33,SĂLAJ,"ŞCOALA PRIMARĂ STÎNA",39,"MUNICIPIUL ZALĂU",139704,1,PART,PRCNCT,PRSD,PRSD_SV,"2025-05-18 21:28:23",234,134,114,20,0,134,0,300,166,64,70
33,SĂLAJ,"LICEUL TEHNOLOGIC ”GHEORGHE POP DE BĂSEȘTI”",40,"ORAŞ CEHU SILVANIEI",139740,1,PART,PRCNCT,PRSD,PRSD_SV,"2025-05-18 21:53:42",1382,690,629,47,14,686,4,1450,760,125,561
33,SĂLAJ,"ȘCOALA GIMNAZIALĂ ”ANDREI MUREȘANU”",41,"ORAŞ CEHU SILVANIEI",139740,1,PART,PRCNCT,PRSD,PRSD_SV,"2025-05-18 22:08:20",1441,762,685,48,29,757,5,1500,738,164,593
33,SĂLAJ,"PIAȚA TRANDAFIRILOR NR. 29 CLUBUL COPIILOR",42,"ORAŞ CEHU SILVANIEI",139740,1,PART,PRCNCT,PRSD,PRSD_SV,"2025-05-18 21:46:26",1381,700,656,35,9,690,10,1450,750,131,559
33,SĂLAJ,"HOROATU CEHULUI NR. 23 ȘCOALA PRIMARĂ",43,"ORAŞ CEHU SILVANIEI",139740,1,PART,PRCNCT,PRSD,PRSD_SV,"2025-05-18 21:25:12",139,91,73,18,0,90,1,200,109,59,31
33,SĂLAJ,"SAT MOTIȘ NR. 228 ȘCOALA GIMNAZIALĂ ”GHEORGHE ȘINCAI”",44,"ORAŞ CEHU SILVANIEI",139740,1,PART,PRCNCT,PRSD,PRSD_SV,"2025-05-18 21:17:02",586,286,265,20,1,286,0,650,364,184,102
33,SĂLAJ,"SAT NADIȘ NR.127 ȘCOALA PRIMARĂ",45,"ORAŞ CEHU SILVANIEI",139740,1,PART,PRCNCT,PRSD,PRSD_SV,"2025-05-18 21:26:33",406,287,242,45,0,286,1,450,163,117,169
33,SĂLAJ,"SAT ULCIUG NR.86 CĂMINUL CULTURAL",46,"ORAŞ CEHU SILVANIEI",139740,1,PART,PRCNCT,PRSD,PRSD_SV,"2025-05-18 21:53:57",717,379,343,26,10,378,1,800,421,114,264
33,SĂLAJ,"CASA DE CULTURĂ",47,"ORAŞ JIBOU",139811,1,PART,PRCNCT,PRSD,PRSD_SV,"2025-05-18 22:01:07",1676,834,744,89,1,829,5,1750,916,366,463
33,SĂLAJ,"LICEUL TEHNOLOGIC ”OCTAVIAN GOGA”",48,"ORAŞ JIBOU",139811,1,PART,PRCNCT,PRSD,PRSD_SV,"2025-05-18 22:11:00",1401,680,602,50,28,677,3,1450,770,277,400
33,SĂLAJ,"LICEUL TEHNOLOGIC ”OCTAVIASN GOGA”PARTER,SALA DE CLASA NR.2",49,"ORAŞ JIBOU",139811,1,PART,PRCNCT,PRSD,PRSD_SV,"2025-05-18 21:32:47",1289,638,595,37,6,632,6,1350,712,233,399
33,SĂLAJ,"ȘCOALĂ GIMNAZIALĂ ”LUCIAN BLAGA” PARTER SALĂ DE CLASĂ NR.1,STR.GAROAFELOR NR.7",50,"ORAŞ JIBOU",139811,1,PART,PRCNCT,PRSD,PRSD_SV,"2025-05-18 22:44:34",1609,866,809,56,1,858,8,1700,834,335,523
33,SĂLAJ,"LICEUL TEORETIC ”ION AGÂRBICEANU”",51,"ORAŞ JIBOU",139811,1,PART,PRCNCT,PRSD,PRSD_SV,"2025-05-18 22:22:48",1662,770,676,58,36,750,20,1750,980,389,361
33,SĂLAJ,GRĂDINIȚĂ,52,"ORAŞ JIBOU",139811,1,PART,PRCNCT,PRSD,PRSD_SV,"2025-05-18 21:21:42",393,192,166,26,0,188,4,450,258,128,60
33,SĂLAJ,"ȘCOALA CU CLASELE I-IV",53,"ORAŞ JIBOU",139811,1,PART,PRCNCT,PRSD,PRSD_SV,"2025-05-18 21:25:48",201,113,99,14,0,113,0,250,137,60,53
33,SĂLAJ,"ȘCOALA CU CLASELE I-IV",54,"ORAŞ JIBOU",139811,1,PART,PRCNCT,PRSD,PRSD_SV,"2025-05-18 21:22:53",309,198,180,18,0,197,1,350,152,106,91
33,SĂLAJ,"CAMIN CULTURAL VAR",55,"ORAŞ JIBOU",139811,1,PART,PRCNCT,PRSD,PRSD_SV,"2025-05-18 21:33:20",390,250,210,39,1,247,3,450,200,93,154
33,SĂLAJ,"ȘCOALA GIMNAZIALĂ ”HOREA”",56,"ORAŞ ŞIMLEU SILVANIEI",139884,1,PART,PRCNCT,PRSD,PRSD_SV,"2025-05-18 21:47:19",1649,900,842,57,1,880,20,1700,800,371,509
33,SĂLAJ,"LICEUL TEHNOLOGIC ”IOAN OSSIAN”",57,"ORAŞ ŞIMLEU SILVANIEI",139884,1,PART,PRCNCT,PRSD,PRSD_SV,"2025-05-18 21:45:51",1510,772,721,51,0,761,11,1600,828,225,536
33,SĂLAJ,"CENTRUL CULTURAL",58,"ORAŞ ŞIMLEU SILVANIEI",139884,1,PART,PRCNCT,PRSD,PRSD_SV,"2025-05-18 22:27:21",1309,654,611,43,0,646,8,1400,746,143,503
33,SĂLAJ,"COLEGIUL TEHNIC ”IULIU MANIU”",59,"ORAŞ ŞIMLEU SILVANIEI",139884,1,PART,PRCNCT,PRSD,PRSD_SV,"2025-05-18 22:21:47",1530,892,798,71,23,883,9,1600,708,239,644
33,SĂLAJ,"CENTRUL ȘCOLAR PENTRU EDUCAȚIE INCLUZIVĂ",60,"ORAŞ ŞIMLEU SILVANIEI",139884,1,PART,PRCNCT,PRSD,PRSD_SV,"2025-05-18 21:55:33",1793,744,687,53,4,737,7,1870,1126,339,398
33,SĂLAJ,"GRĂDINIŢA CU PROGRAM PRELUNGIT NR. 2",61,"ORAŞ ŞIMLEU SILVANIEI",139884,1,PART,PRCNCT,PRSD,PRSD_SV,"2025-05-18 21:27:32",1593,798,732,66,0,791,7,1650,852,257,534
33,SĂLAJ,"GRĂDINIŢA CU PROGRAM PRELUNGIT NR. 3",62,"ORAŞ ŞIMLEU SILVANIEI",139884,1,PART,PRCNCT,PRSD,PRSD_SV,"2025-05-18 22:01:49",1407,646,620,26,0,641,5,1550,904,235,406
33,SĂLAJ,"BAZA SPORTIVĂ",63,"ORAŞ ŞIMLEU SILVANIEI",139884,1,PART,PRCNCT,PRSD,PRSD_SV,"2025-05-18 21:37:15",752,421,386,35,0,417,4,800,379,232,185
33,SĂLAJ,"ŞCOALA GIMNAZIALĂ NR.1",64,"ORAŞ ŞIMLEU SILVANIEI",139884,1,PART,PRCNCT,PRSD,PRSD_SV,"2025-05-18 21:40:01",1533,447,429,18,0,429,18,1600,1153,348,81
33,SĂLAJ,"ȘCOALA GIMNAZIALĂ NR.1 AGRIJ",65,AGRIJ,139937,1,PART,PRCNCT,PRSD,PRSD_SV,"2025-05-18 22:05:45",837,446,348,86,12,443,3,900,454,243,200
33,SĂLAJ,"ŞCOALA CU CLASELE I-IV",66,AGRIJ,139937,1,PART,PRCNCT,PRSD,PRSD_SV,"2025-05-18 21:18:19",270,191,138,42,11,191,0,350,159,94,97
33,SĂLAJ,"PRIMĂRIA COMUNEI ALMAŞU",67,ALMAŞU,139982,1,PART,PRCNCT,PRSD,PRSD_SV,"2025-05-18 21:40:03",777,422,332,77,13,419,3,850,428,202,217
33,SĂLAJ,"CĂMINUL CULTURAL JEBUCU",68,ALMAŞU,139982,1,PART,PRCNCT,PRSD,PRSD_SV,"2025-05-18 21:19:16",273,316,196,91,29,314,2,350,34,42,272
33,SĂLAJ,"SCOALA PRIMARA MESTEACANU",69,ALMAŞU,139982,1,PART,PRCNCT,PRSD,PRSD_SV,"2025-05-18 21:28:04",253,165,115,50,0,163,2,300,135,88,75
33,SĂLAJ,"CĂMINUL CULTURAL PETRINZEL",70,ALMAŞU,139982,1,PART,PRCNCT,PRSD,PRSD_SV,"2025-05-18 21:18:49",81,108,46,60,2,108,0,150,42,30,78
33,SĂLAJ,"CĂMINUL CULTURAL STANA",71,ALMAŞU,139982,1,PART,PRCNCT,PRSD,PRSD_SV,"2025-05-18 21:15:39",87,118,47,67,4,117,1,150,32,24,93
33,SĂLAJ,"ŞCOALA CU CLASELE I-IV ŢĂUDU",72,ALMAŞU,139982,1,PART,PRCNCT,PRSD,PRSD_SV,"2025-05-18 21:21:06",87,83,45,38,0,83,0,150,67,41,42
33,SĂLAJ,"CORP B , BIBLIOTECA COMUNALĂ",73,BĂBENI,140084,1,PART,PRCNCT,PRSD,PRSD_SV,"2025-05-18 21:53:25",416,279,198,76,5,278,1,500,221,130,148
33,SĂLAJ,"ŞCOALA VECHE CIOCMANI",74,BĂBENI,140084,1,PART,PRCNCT,PRSD,PRSD_SV,"2025-05-18 21:29:13",488,315,246,64,5,313,2,550,235,172,141
33,SĂLAJ,"ŞCOALA CLIŢ",75,BĂBENI,140084,1,PART,PRCNCT,PRSD,PRSD_SV,"2025-05-18 21:28:29",173,115,76,34,5,114,1,201,86,38,76
33,SĂLAJ,"CLĂDIRE MULTIFUNCŢIONALĂ",76,BĂBENI,140084,1,PART,PRCNCT,PRSD,PRSD_SV,"2025-05-18 21:25:15",70,58,37,20,1,58,0,100,42,21,37
33,SĂLAJ,"ŞCOALA POIENIŢA",77,BĂBENI,140084,1,PART,PRCNCT,PRSD,PRSD_SV,"2025-05-18 21:18:06",155,108,61,38,9,107,1,199,91,51,56
33,SĂLAJ,"ŞCOALA GIMNAZIALĂ BĂLAN",78,BĂLAN,140146,1,PART,PRCNCT,PRSD,PRSD_SV,"2025-05-18 21:37:01",745,441,335,95,11,438,3,800,359,247,191
33,SĂLAJ,"AFTER SCHOOL CHECHIŞ",79,BĂLAN,140146,1,PART,PRCNCT,PRSD,PRSD_SV,"2025-05-18 22:04:01",508,358,232,126,0,353,5,558,200,153,200
33,SĂLAJ,"CENTRUL CULTURAL CHENDREA",80,BĂLAN,140146,1,PART,PRCNCT,PRSD,PRSD_SV,"2025-05-18 21:23:00",616,347,277,54,16,345,2,700,353,167,178
33,SĂLAJ,"ŞCOALA PRIMARĂ GĂLPÎIA",81,BĂLAN,140146,1,PART,PRCNCT,PRSD,PRSD_SV,"2025-05-18 21:39:42",313,186,125,60,1,185,1,350,164,108,77
33,SĂLAJ,"ŞCOALA GIMNAZIALĂ GÎLGĂU ALMAŞULUI",82,BĂLAN,140146,1,PART,PRCNCT,PRSD,PRSD_SV,"2025-05-18 21:50:24",852,455,375,80,0,448,7,900,445,244,204
33,SĂLAJ,"CĂMIN CULTURAL",83,BĂNIŞOR,140208,1,PART,PRCNCT,PRSD,PRSD_SV,"2025-05-18 21:22:16",478,297,231,65,1,295,2,550,253,163,132
33,SĂLAJ,"CAMIN CULTURAL BAN, NR. 55",84,BĂNIŞOR,140208,1,PART,PRCNCT,PRSD,PRSD_SV,"2025-05-18 21:35:53",339,222,156,66,0,221,1,400,178,150,71
33,SĂLAJ,"ŞCOALA PECEIU, NR. 137",85,BĂNIŞOR,140208,1,PART,PRCNCT,PRSD,PRSD_SV,"2025-05-18 21:50:31",711,448,353,93,2,443,5,800,352,189,254
33,SĂLAJ,"ŞCOALA PRIMARĂ BENESAT",86,BENESAT,140244,1,PART,PRCNCT,PRSD,PRSD_SV,"2025-05-18 21:20:15",336,174,146,26,2,173,1,400,226,86,87
33,SĂLAJ,"ŞCOALA GIMNAZIALĂ ”AVRAM IANCU”",87,BENESAT,140244,1,PART,PRCNCT,PRSD,PRSD_SV,"2025-05-18 21:50:24",452,274,220,54,0,272,2,550,276,123,149
33,SĂLAJ,"ŞCOALA PRIMARĂ BIUŞA",88,BENESAT,140244,1,PART,PRCNCT,PRSD,PRSD_SV,"2025-05-18 21:22:22",370,233,188,28,17,233,0,450,217,59,174
33,SĂLAJ,"CĂMIN CULTURAL BOBOTA",89,BOBOTA,140280,1,PART,PRCNCT,PRSD,PRSD_SV,"2025-05-18 22:42:02",1150,608,529,72,7,602,6,1200,592,279,323
33,SĂLAJ,"CĂMIN CULTURAL",90,BOBOTA,140280,2,PART,PRCNCT,PRSD,PRSD_SV,"2025-05-19 01:19:08",1424,595,527,67,1,588,7,1500,905,374,214
33,SĂLAJ,"ȘCOALA ZALNOC",91,BOBOTA,140280,1,PART,PRCNCT,PRSD,PRSD_SV,"2025-05-18 21:36:48",363,157,119,38,0,154,3,450,293,96,58
33,SĂLAJ,"CENTRUL DE CONSULTANȚĂ AGRICOLĂ BOCȘA",92,BOCŞA,140324,1,PART,PRCNCT,PRSD,PRSD_SV,"2025-05-18 21:32:09",779,419,336,72,11,417,2,850,431,182,235
33,SĂLAJ,"ȘCOALA GIMNAZIALĂ NR.1 BORLA",93,BOCŞA,140324,1,PART,PRCNCT,PRSD,PRSD_SV,"2025-05-18 21:23:32",1280,790,692,37,61,790,0,1350,560,76,714
33,SĂLAJ,"ȘCOALA CU CLASELE I-IV CÎMPIA",94,BOCŞA,140324,1,PART,PRCNCT,PRSD,PRSD_SV,"2025-05-18 21:22:04",202,154,115,38,1,154,0,250,96,61,93
33,SĂLAJ,"ȘCOALA CU CLASELE I-IV SĂLĂJENI",95,BOCŞA,140324,1,PART,PRCNCT,PRSD,PRSD_SV,"2025-05-18 21:29:21",449,252,197,55,0,251,1,550,298,134,117
33,SĂLAJ,"PRIMĂRIA COMUNEI BOGHIŞ",96,BOGHIŞ,180037,1,PART,PRCNCT,PRSD,PRSD_SV,"2025-05-18 22:49:31",1308,713,673,26,14,703,10,1350,637,117,586
33,SĂLAJ,"CĂMINUL CULTURAL BOZIEŞ",97,BOGHIŞ,180037,1,PART,PRCNCT,PRSD,PRSD_SV,"2025-05-18 21:17:30",203,130,115,15,0,130,0,250,120,15,115
33,SĂLAJ,"PRIMĂRIA BUCIUMI",98,BUCIUMI,140379,1,PART,PRCNCT,PRSD,PRSD_SV,"2025-05-18 21:47:54",966,506,412,93,1,501,5,1000,494,277,224
33,SĂLAJ,"ŞCOALA CU CLASELE I-IV",99,BUCIUMI,140379,1,PART,PRCNCT,PRSD,PRSD_SV,"2025-05-18 21:15:18",218,132,107,25,0,132,0,300,168,92,40
33,SĂLAJ,"CAMIN CULTURAL BOGDANA",100,BUCIUMI,140379,1,PART,PRCNCT,PRSD,PRSD_SV,"2025-05-18 21:28:07",388,231,146,85,0,224,7,450,219,100,124
33,SĂLAJ,"ŞCOALA CU CLASELE I-IV",101,BUCIUMI,140379,1,PART,PRCNCT,PRSD,PRSD_SV,"2025-05-18 21:09:40",150,132,76,56,0,129,3,200,68,55,74
33,SĂLAJ,"CAMIN CULTURAL SANGEORGIU DE MESES",102,BUCIUMI,140379,1,PART,PRCNCT,PRSD,PRSD_SV,"2025-05-18 21:44:06",204,154,98,56,0,153,1,250,96,87,66
33,SĂLAJ,"PRIMĂRIA COMUNEI CAMĂR",103,CAMĂR,140440,1,PART,PRCNCT,PRSD,PRSD_SV,"2025-05-18 21:34:49",1283,842,757,39,46,833,9,1400,558,109,724
33,SĂLAJ,"CENTRUL LOCAL DE INFORMARE TURISTICĂ",104,CARASTELEC,140477,1,PART,PRCNCT,PRSD,PRSD_SV,"2025-05-18 21:55:35",805,461,390,45,26,459,2,850,389,71,388
33,SĂLAJ,"ŞCOALA PRIMARĂ",105,CARASTELEC,140477,1,PART,PRCNCT,PRSD,PRSD_SV,"2025-05-18 21:16:29",26,29,12,17,0,28,1,50,21,14,14
33,SĂLAJ,"SALA DE SPORT CHIEȘD",106,CHIEŞD,140501,1,PART,PRCNCT,PRSD,PRSD_SV,"2025-05-18 21:40:06",1548,603,566,37,0,596,7,1650,1047,374,222
33,SĂLAJ,"ȘCOALA PRIMARĂ SIGHETU SILVANIEI",107,CHIEŞD,140501,1,PART,PRCNCT,PRSD,PRSD_SV,"2025-05-18 21:24:52",397,201,153,48,0,201,0,450,249,114,87
33,SĂLAJ,"GRĂDINIŢA CU PROGRAM NORMAL NR. 1 CIZER",108,CIZER,140547,1,PART,PRCNCT,PRSD,PRSD_SV,"2025-05-18 22:00:59",1299,649,540,107,2,641,8,1350,701,358,283
33,SĂLAJ,"ŞCOALA GIMNAZIALĂ PLESCA",109,CIZER,140547,1,PART,PRCNCT,PRSD,PRSD_SV,"2025-05-18 21:16:53",160,111,74,37,0,106,5,200,89,54,52
33,SĂLAJ,"CAMIN CULTURAL PRIA",110,CIZER,140547,2,PART,PRCNCT,PRSD,PRSD_SV,"2025-05-19 00:11:33",326,213,134,78,1,208,5,400,187,96,112
33,SĂLAJ,"SCOALA GIMNAZIALA NR. 1 COSEIU",111,COŞEIU,140583,1,PART,PRCNCT,PRSD,PRSD_SV,"2025-05-18 22:09:21",363,244,182,56,6,244,0,400,156,66,178
33,SĂLAJ,"ŞCOALA GIMNAZIALĂ ARCHID",112,COŞEIU,140583,1,PART,PRCNCT,PRSD,PRSD_SV,"2025-05-18 21:29:30",365,196,172,15,9,195,1,450,254,18,177
33,SĂLAJ,"ŞCOALA CU CLASELE I-IV CHILIOARA",113,COŞEIU,140583,1,PART,PRCNCT,PRSD,PRSD_SV,"2025-05-18 21:18:42",232,148,82,64,2,147,1,300,152,56,91
33,SĂLAJ,"CĂMINUL CULTURAL ”PETŐFI SÁNDOR”",114,CRASNA,140627,1,PART,PRCNCT,PRSD,PRSD_SV,"2025-05-18 22:01:24",1890,1304,1139,78,87,1292,12,2000,696,126,1166
33,SĂLAJ,"CENTRU MULTIFUNCTIONAL",115,CRASNA,140627,1,PART,PRCNCT,PRSD,PRSD_SV,"2025-05-18 22:07:39",1841,1253,1150,70,33,1240,13,1950,697,193,1047
33,SĂLAJ,"CENTRUL DE ZI PENTRU COPII",116,CRASNA,140627,1,PART,PRCNCT,PRSD,PRSD_SV,"2025-05-18 21:19:20",419,223,194,29,0,215,8,500,277,125,90
33,SĂLAJ,"CAMIN CULTURAL MARIN",117,CRASNA,140627,1,PART,PRCNCT,PRSD,PRSD_SV,"2025-05-18 21:37:14",703,391,307,84,0,386,5,750,359,238,148
33,SĂLAJ,"CENTRUL DE ZI PENTRU COPII",118,CRASNA,140627,1,PART,PRCNCT,PRSD,PRSD_SV,"2025-05-18 21:19:34",395,139,125,14,0,138,1,450,311,60,78
33,SĂLAJ,"ȘCOALA GIMNAZIALĂ MARCUS AURELIUS CREACA",119,CREACA,140672,1,PART,PRCNCT,PRSD,PRSD_SV,"2025-05-18 21:16:31",381,203,150,53,0,200,3,450,247,102,98
33,SĂLAJ,"ȘCOALA GENERALĂ BORZA",120,CREACA,140672,1,PART,PRCNCT,PRSD,PRSD_SV,"2025-05-18 21:12:19",168,104,66,38,0,103,1,200,96,42,61
33,SĂLAJ,"ȘCOALA GENERALĂ BREBI",121,CREACA,140672,1,PART,PRCNCT,PRSD,PRSD_SV,"2025-05-18 21:22:16",449,238,186,52,0,235,3,550,312,116,119
33,SĂLAJ,"ȘCOALA GENERALĂ BRUSTURI",122,CREACA,140672,1,PART,PRCNCT,PRSD,PRSD_SV,"2025-05-18 21:10:40",153,134,89,45,0,131,3,200,66,60,71
33,SĂLAJ,"ȘCOALA GENERALĂ CIGLEAN",123,CREACA,140672,1,PART,PRCNCT,PRSD,PRSD_SV,"2025-05-18 21:10:04",113,67,52,15,0,67,0,150,83,35,32
33,SĂLAJ,"ȘCOALA GIMNAZIALĂ JAC",124,CREACA,140672,1,PART,PRCNCT,PRSD,PRSD_SV,"2025-05-18 21:23:26",561,351,278,72,1,342,9,600,249,167,175
33,SĂLAJ,"ȘCOALA GENERALĂ LUPOAIA",125,CREACA,140672,2,PART,PRCNCT,PRSD,PRSD_SV,"2025-05-18 22:40:59",264,143,108,35,0,141,2,299,156,89,52
33,SĂLAJ,"ȘCOALA GENERALĂ PRODĂNEȘTI",126,CREACA,140672,2,PART,PRCNCT,PRSD,PRSD_SV,"2025-05-18 22:11:32",197,131,89,42,0,130,1,250,119,56,74
33,SĂLAJ,"CĂMINUL CULTURAL CRISTOLȚ",127,CRISTOLŢ,140770,1,PART,PRCNCT,PRSD,PRSD_SV,"2025-05-18 21:19:35",440,247,204,43,0,246,1,550,303,102,144
33,SĂLAJ,"ŞCOALA PRIMARĂ MUNCEL",128,CRISTOLŢ,140770,1,PART,PRCNCT,PRSD,PRSD_SV,"2025-05-18 21:14:33",130,86,61,25,0,86,0,150,64,44,42
33,SĂLAJ,"ŞCOALA PRIMARĂ POIANA ONŢII",129,CRISTOLŢ,140770,1,PART,PRCNCT,PRSD,PRSD_SV,"2025-05-18 21:19:05",56,46,25,21,0,46,0,100,54,31,15
33,SĂLAJ,"ŞCOALA PRIMARĂ VĂLENI",130,CRISTOLŢ,140770,1,PART,PRCNCT,PRSD,PRSD_SV,"2025-05-18 21:18:03",283,136,102,34,0,135,1,350,214,49,86
33,SĂLAJ,"CĂMIN CULTURAL",131,CRIŞENI,140823,1,PART,PRCNCT,PRSD,PRSD_SV,"2025-05-18 22:16:20",1652,1155,1003,135,17,1147,8,1700,545,450,697
33,SĂLAJ,"CAMINUL CULTURAL CRISTUR-CRISENI",132,CRIŞENI,140823,1,PART,PRCNCT,PRSD,PRSD_SV,"2025-05-18 21:27:04",423,294,247,27,20,293,1,500,206,60,233
33,SĂLAJ,"CĂMIN CULTURAL",133,CRIŞENI,140823,1,PART,PRCNCT,PRSD,PRSD_SV,"2025-05-18 21:30:41",700,422,345,72,5,418,4,750,328,213,205
33,SĂLAJ,"ȘCOALA GIMNAZIALĂ CUZĂPLAC, NR.242",134,CUZĂPLAC,140869,1,PART,PRCNCT,PRSD,PRSD_SV,"2025-05-18 21:40:31",389,241,180,57,4,241,0,450,209,89,152
33,SĂLAJ,"CĂMINUL CULTURAL GĂLĂȘENI, NR.50",135,CUZĂPLAC,140869,1,PART,PRCNCT,PRSD,PRSD_SV,"2025-05-18 21:17:50",77,74,30,44,0,72,2,100,26,23,49
33,SĂLAJ,"ŞCOALA CU CLASELE I-IV MIERȚA, NR.97",136,CUZĂPLAC,140869,1,PART,PRCNCT,PRSD,PRSD_SV,"2025-05-18 21:16:05",102,74,49,25,0,74,0,150,76,29,45
33,SĂLAJ,"CENTRUL DE ZI PETRINDU, NR.78",137,CUZĂPLAC,140869,1,PART,PRCNCT,PRSD,PRSD_SV,"2025-05-18 21:48:25",318,222,152,70,0,219,3,400,178,104,115
33,SĂLAJ,"CĂMINUL CULTURAL RUGINOASA, NR.22",138,CUZĂPLAC,140869,1,PART,PRCNCT,PRSD,PRSD_SV,"2025-05-18 21:19:50",52,71,22,49,0,71,0,100,29,31,40
33,SĂLAJ,"ȘCOALA CU CLASELE I-IV TĂMAȘA, NR.219",139,CUZĂPLAC,140869,1,PART,PRCNCT,PRSD,PRSD_SV,"2025-05-18 21:21:42",250,189,152,37,0,187,2,300,111,83,104
33,SĂLAJ,"CĂMINUL CULTURAL",140,DOBRIN,140958,1,PART,PRCNCT,PRSD,PRSD_SV,"2025-05-18 21:24:45",361,205,157,37,11,200,5,450,245,83,117
33,SĂLAJ,"CĂMINUL CULTURAL DOBA",141,DOBRIN,140958,1,PART,PRCNCT,PRSD,PRSD_SV,"2025-05-18 21:25:47",279,168,146,15,7,168,0,350,182,21,147
33,SĂLAJ,"CENTRUL DE ZI DOBA",142,DOBRIN,140958,1,PART,PRCNCT,PRSD,PRSD_SV,"2025-05-18 21:36:20",220,145,112,24,9,144,1,300,155,18,126
33,SĂLAJ,"CASĂ PAROHIALĂ REFORMATĂ NAIMON",143,DOBRIN,140958,1,PART,PRCNCT,PRSD,PRSD_SV,"2025-05-18 21:07:57",111,61,36,25,0,61,0,150,89,36,25
33,SĂLAJ,"ȘCOALA ELEMENTARĂ VERVEGHIU",144,DOBRIN,140958,1,PART,PRCNCT,PRSD,PRSD_SV,"2025-05-18 21:19:51",369,239,193,31,15,236,3,450,211,44,192
33,SĂLAJ,"ŞCOALA GIMNAZIALA NR.1 DRAGU",145,DRAGU,141027,1,PART,PRCNCT,PRSD,PRSD_SV,"2025-05-18 21:55:59",532,287,208,66,13,284,3,580,293,168,116
33,SĂLAJ,"ȘCOALA CU CLASELE I-IV, NR.100",146,DRAGU,141027,1,PART,PRCNCT,PRSD,PRSD_SV,"2025-05-18 21:40:35",113,102,45,57,0,101,1,150,48,43,58
33,SĂLAJ,"CĂMINUL CULTURAL, NR.20",147,DRAGU,141027,1,PART,PRCNCT,PRSD,PRSD_SV,"2025-05-18 21:24:32",14,50,5,44,1,50,0,70,20,20,30
33,SĂLAJ,"ȘCOALA CU CLASELE I-IV, NR.117",148,DRAGU,141027,1,PART,PRCNCT,PRSD,PRSD_SV,"2025-05-18 21:39:22",223,199,101,98,0,194,5,300,101,107,87
33,SĂLAJ,"ŞCOALA PRIMARĂ FILDU DE JOS",149,"FILDU DE JOS",141081,1,PART,PRCNCT,PRSD,PRSD_SV,"2025-05-18 21:36:08",187,149,106,43,0,146,3,250,101,82,64
33,SĂLAJ,"DISPENSAR UMAN",150,"FILDU DE JOS",141081,1,PART,PRCNCT,PRSD,PRSD_SV,"2025-05-18 21:39:06",315,198,141,57,0,194,4,350,152,117,77
33,SĂLAJ,"SCOALA PRIMARA CU CLASELE I-IV",151,"FILDU DE JOS",141081,1,PART,PRCNCT,PRSD,PRSD_SV,"2025-05-18 21:35:50",301,172,141,30,1,170,2,350,178,93,77
33,SĂLAJ,"ŞCOALA PRIMARĂ TETIŞU",152,"FILDU DE JOS",141081,1,PART,PRCNCT,PRSD,PRSD_SV,"2025-05-18 21:30:27",216,170,132,31,7,169,1,250,80,15,154
33,SĂLAJ,"LICEUL TEHNOLOGIC",153,GÂLGĂU,141134,1,PART,PRCNCT,PRSD,PRSD_SV,"2025-05-18 21:53:40",475,355,273,81,1,352,3,550,195,171,181
33,SĂLAJ,"ȘCOALA CU CLASELE I-IV",154,GÂLGĂU,141134,1,PART,PRCNCT,PRSD,PRSD_SV,"2025-05-18 21:26:51",183,143,91,52,0,142,1,250,107,75,67
33,SĂLAJ,"ȘCOALA CU CLASELE I-IV",155,GÂLGĂU,141134,1,PART,PRCNCT,PRSD,PRSD_SV,"2025-05-18 21:31:08",239,201,139,62,0,200,1,292,91,90,110
33,SĂLAJ,"ȘCOALA CU CLASELE I-IV",156,GÂLGĂU,141134,1,PART,PRCNCT,PRSD,PRSD_SV,"2025-05-18 21:22:35",78,58,37,21,0,58,0,100,42,32,26
33,SĂLAJ,"CAMIN CULTURAL",157,GÂLGĂU,141134,1,PART,PRCNCT,PRSD,PRSD_SV,"2025-05-18 21:26:23",146,111,79,32,0,111,0,200,89,42,69
33,SĂLAJ,"IMOBIL TIP CONTAINER",158,GÂLGĂU,141134,1,PART,PRCNCT,PRSD,PRSD_SV,"2025-05-18 21:26:12",316,199,134,65,0,192,7,400,201,114,78
33,SĂLAJ,"CAMIN CULTURAL",159,GÂLGĂU,141134,1,PART,PRCNCT,PRSD,PRSD_SV,"2025-05-18 21:35:22",368,242,168,74,0,242,0,450,208,126,116
33,SĂLAJ,"PRIMĂRIA GÎRBOU",160,GÂRBOU,141232,1,PART,PRCNCT,PRSD,PRSD_SV,"2025-05-18 21:27:57",454,230,156,74,0,230,0,540,310,116,114
33,SĂLAJ,"CĂMINUL CULTURAL",161,GÂRBOU,141232,1,PART,PRCNCT,PRSD,PRSD_SV,"2025-05-18 21:30:47",87,94,45,46,3,92,2,150,56,29,63
33,SĂLAJ,"ȘCOALA PRIMARĂ",162,GÂRBOU,141232,2,PART,PRCNCT,PRSD,PRSD_SV,"2025-05-19 01:31:07",183,139,75,64,0,138,1,250,111,69,69
33,SĂLAJ,"CĂMINUL CULTURAL CERNUC",163,GÂRBOU,141232,1,PART,PRCNCT,PRSD,PRSD_SV,"2025-05-18 21:22:38",134,92,52,40,0,92,0,200,108,42,50
33,SĂLAJ,"ȘCOALA PRIMARĂ",164,GÂRBOU,141232,1,PART,PRCNCT,PRSD,PRSD_SV,"2025-05-18 21:20:21",77,67,49,18,0,67,0,100,33,34,33
33,SĂLAJ,"ȘCOALA PRIMARĂ",165,GÂRBOU,141232,1,PART,PRCNCT,PRSD,PRSD_SV,"2025-05-18 21:22:30",248,101,72,29,0,101,0,300,199,59,42
33,SĂLAJ,"CĂMINUL CULTURAL",166,GÂRBOU,141232,1,PART,PRCNCT,PRSD,PRSD_SV,"2025-05-18 21:31:03",263,154,121,32,1,154,0,300,146,95,59
33,SĂLAJ,"CAMIN CULTURAL HALMASD",167,HALMĂŞD,141312,1,PART,PRCNCT,PRSD,PRSD_SV,"2025-05-18 21:42:52",825,382,346,35,1,381,1,900,518,184,197
33,SĂLAJ,"CAMIN CULTURAL ALEUS",168,HALMĂŞD,141312,1,PART,PRCNCT,PRSD,PRSD_SV,"2025-05-18 21:17:26",220,119,100,18,1,118,1,250,131,53,65
33,SĂLAJ,"ȘCOALA VECHE",169,HALMĂŞD,141312,1,PART,PRCNCT,PRSD,PRSD_SV,"2025-05-18 21:29:32",437,210,183,27,0,205,5,500,290,126,79
33,SĂLAJ,"ȘCOALA NOUĂ DRIGHIU",170,HALMĂŞD,141312,1,PART,PRCNCT,PRSD,PRSD_SV,"2025-05-18 21:27:16",285,173,129,44,0,171,2,350,177,84,87
33,SĂLAJ,"CĂMINUL CULTURAL HERECLEAN",171,HERECLEAN,141376,1,PART,PRCNCT,PRSD,PRSD_SV,"2025-05-18 21:22:22",525,361,298,62,1,359,2,600,239,101,258
33,SĂLAJ,"ŞCOALA PRIMARĂ BADON",172,HERECLEAN,141376,1,PART,PRCNCT,PRSD,PRSD_SV,"2025-05-18 21:26:50",652,443,358,79,6,441,2,700,257,173,268
33,SĂLAJ,"CĂMINUL CULTURAL BOCȘIȚA",173,HERECLEAN,141376,1,PART,PRCNCT,PRSD,PRSD_SV,"2025-05-18 21:15:35",61,72,25,42,5,70,2,100,28,21,49
33,SĂLAJ,"ȘCOALA PRIMARĂ DIOȘOD",174,HERECLEAN,141376,1,PART,PRCNCT,PRSD,PRSD_SV,"2025-05-18 21:23:16",674,478,374,71,33,477,1,750,272,41,436
33,SĂLAJ,"ŞCOALA GIMNAZIALĂ GURUSLĂU",175,HERECLEAN,141376,1,PART,PRCNCT,PRSD,PRSD_SV,"2025-05-18 21:20:35",526,319,272,25,22,316,3,550,231,32,284
33,SĂLAJ,"CĂMINUL CULTURAL PANIC",176,HERECLEAN,141376,1,PART,PRCNCT,PRSD,PRSD_SV,"2025-05-18 21:30:16",882,548,483,45,20,540,8,930,382,93,447
33,SĂLAJ,PRIMĂRIA,177,HIDA,141447,1,PART,PRCNCT,PRSD,PRSD_SV,"2025-05-18 21:30:31",850,437,366,69,2,430,7,900,463,173,257
33,SĂLAJ,"CĂMINUL CULTURAL",178,HIDA,141447,1,PART,PRCNCT,PRSD,PRSD_SV,"2025-05-18 21:33:22",102,70,43,27,0,69,1,150,80,21,48
33,SĂLAJ,"CĂMINUL CULTURAL",179,HIDA,141447,1,PART,PRCNCT,PRSD,PRSD_SV,"2025-05-18 21:13:10",14,70,6,64,0,69,1,90,20,26,43
33,SĂLAJ,"ŞCOALA GENERALĂ",180,HIDA,141447,1,PART,PRCNCT,PRSD,PRSD_SV,"2025-05-18 21:10:47",14,38,6,32,0,38,0,60,22,18,20
33,SĂLAJ,"ŞCOALA GENERALĂ",181,HIDA,141447,1,PART,PRCNCT,PRSD,PRSD_SV,"2025-05-18 21:23:17",421,255,173,82,0,252,3,500,245,107,145
33,SĂLAJ,"CĂMINUL CULTURAL",182,HIDA,141447,2,PART,PRCNCT,PRSD,PRSD_SV,"2025-05-18 23:31:59",305,224,128,96,0,221,3,350,126,85,136
33,SĂLAJ,"CĂMINUL CULTURAL",183,HIDA,141447,1,PART,PRCNCT,PRSD,PRSD_SV,"2025-05-18 21:22:22",89,89,37,52,0,88,1,150,61,43,45
33,SĂLAJ,"CAMINUL CULTURAL",184,HIDA,141447,1,PART,PRCNCT,PRSD,PRSD_SV,"2025-05-18 21:39:29",223,161,112,49,0,160,1,298,137,109,51
33,SĂLAJ,"CAMIN CULTURAL HOROATU CRASNEI",185,"HOROATU CRASNEI",141535,1,PART,PRCNCT,PRSD,PRSD_SV,"2025-05-18 21:44:55",785,428,358,65,5,428,0,850,422,143,285
33,SĂLAJ,"ȘCOALA HUREZ",186,"HOROATU CRASNEI",141535,2,PART,PRCNCT,PRSD,PRSD_SV,"2025-05-19 00:07:57",266,159,114,44,1,158,1,350,191,83,75
33,SĂLAJ,"SCOALA GENERALA",187,"HOROATU CRASNEI",141535,1,PART,PRCNCT,PRSD,PRSD_SV,"2025-05-18 21:53:16",807,389,301,87,1,385,4,850,461,241,144
33,SĂLAJ,"CĂMINUL CULTURAL",188,"HOROATU CRASNEI",141535,1,PART,PRCNCT,PRSD,PRSD_SV,"2025-05-18 21:18:04",190,167,85,82,0,165,2,250,83,72,93
33,SĂLAJ,"PIATA AGROALIMENTARA ILEANDA",189,ILEANDA,141580,1,PART,PRCNCT,PRSD,PRSD_SV,"2025-05-18 21:38:28",989,620,473,137,10,615,5,1050,430,340,275
33,SĂLAJ,"ŞCOALA GENERALĂ",190,ILEANDA,141580,1,PART,PRCNCT,PRSD,PRSD_SV,"2025-05-18 21:14:08",146,112,87,25,0,111,1,200,88,77,34
33,SĂLAJ,"ŞCOALA GENERALĂ DOLHENI",191,ILEANDA,141580,1,PART,PRCNCT,PRSD,PRSD_SV,"2025-05-18 21:16:32",71,59,38,21,0,58,1,100,41,38,20
33,SĂLAJ,"ŞCOALA GENERALĂ LUMINIŞU",192,ILEANDA,141580,1,PART,PRCNCT,PRSD,PRSD_SV,"2025-05-18 21:19:38",72,67,41,24,2,67,0,100,33,23,44
33,SĂLAJ,"ŞCOALA GENERALĂ",193,ILEANDA,141580,1,PART,PRCNCT,PRSD,PRSD_SV,"2025-05-18 21:20:17",89,56,36,20,0,55,1,100,44,41,14
33,SĂLAJ,"ŞCOALA GENERALĂ",194,ILEANDA,141580,1,PART,PRCNCT,PRSD,PRSD_SV,"2025-05-18 21:15:38",84,66,35,31,0,65,1,100,34,26,39
33,SĂLAJ,"ŞCOALA GENERALĂ",195,ILEANDA,141580,1,PART,PRCNCT,PRSD,PRSD_SV,"2025-05-18 21:17:34",100,80,50,30,0,80,0,150,70,47,33
33,SĂLAJ,"ŞCOALA GENERALĂ",196,ILEANDA,141580,3,PART,PRCNCT,PRSD,PRSD_SV,"2025-05-18 23:53:12",104,74,52,22,0,74,0,150,76,42,32
33,SĂLAJ,"ŞCOALA GENERALĂ",197,ILEANDA,141580,1,PART,PRCNCT,PRSD,PRSD_SV,"2025-05-18 21:15:57",72,43,26,16,1,43,0,100,57,18,25
33,SĂLAJ,"ŞCOALA GENERALĂ",198,ILEANDA,141580,1,PART,PRCNCT,PRSD,PRSD_SV,"2025-05-18 21:28:08",41,34,17,17,0,34,0,100,66,16,18
33,SĂLAJ,"CERCUL GOSPODARILOR",199,IP,141722,1,PART,PRCNCT,PRSD,PRSD_SV,"2025-05-18 22:08:19",1366,707,649,51,7,703,4,1450,743,210,493
33,SĂLAJ,"CĂMIN CULTURAL COSNICIU DE JOS",200,IP,141722,1,PART,PRCNCT,PRSD,PRSD_SV,"2025-05-18 21:21:36",503,257,239,18,0,253,4,550,293,139,114
33,SĂLAJ,"CĂMINUL CULTURAL",201,IP,141722,1,PART,PRCNCT,PRSD,PRSD_SV,"2025-05-18 21:22:45",196,110,87,23,0,109,1,250,140,54,55
33,SĂLAJ,"CĂMINUL CULTURAL ZĂUAN",202,IP,141722,1,PART,PRCNCT,PRSD,PRSD_SV,"2025-05-18 21:19:18",781,363,328,35,0,363,0,850,487,50,313
33,SĂLAJ,"PRIMĂRIA COMUNEI LETCA",203,LETCA,141786,1,PART,PRCNCT,PRSD,PRSD_SV,"2025-05-18 21:28:42",406,279,207,70,2,274,5,500,221,127,147
33,SĂLAJ,"CLĂDIREA FOSTULUI CONSILIU CIULA",204,LETCA,141786,1,PART,PRCNCT,PRSD,PRSD_SV,"2025-05-18 21:19:46",71,51,36,15,0,50,1,100,49,22,28
33,SĂLAJ,"CĂMIN CULTURAL COZLA",205,LETCA,141786,1,PART,PRCNCT,PRSD,PRSD_SV,"2025-05-18 21:15:04",167,111,74,37,0,111,0,200,89,62,49
33,SĂLAJ,"CĂMIN CULTURAL CUCIULAT",206,LETCA,141786,1,PART,PRCNCT,PRSD,PRSD_SV,"2025-05-18 21:12:02",130,107,67,40,0,106,1,150,43,57,49
33,SĂLAJ,"ŞCOALA LEMNIU",207,LETCA,141786,1,PART,PRCNCT,PRSD,PRSD_SV,"2025-05-18 21:34:25",319,231,162,69,0,228,3,400,169,98,130
33,SĂLAJ,"ŞCOALA PURCĂREŢ",208,LETCA,141786,1,PART,PRCNCT,PRSD,PRSD_SV,"2025-05-18 21:11:01",89,74,33,39,2,74,0,150,76,33,41
33,SĂLAJ,"ŞCOALA ŞOIMUŞENI",209,LETCA,141786,1,PART,PRCNCT,PRSD,PRSD_SV,"2025-05-18 21:13:58",52,52,28,24,0,52,0,100,48,34,18
33,SĂLAJ,"ŞCOALA TOPLIŢA",210,LETCA,141786,1,PART,PRCNCT,PRSD,PRSD_SV,"2025-05-18 21:12:27",88,77,56,21,0,77,0,100,23,32,45
33,SĂLAJ,"PRIMĂRIA COMUNEI LOZNA",211,LOZNA,141884,1,PART,PRCNCT,PRSD,PRSD_SV,"2025-05-18 21:36:04",312,227,137,89,1,224,3,350,123,110,114
33,SĂLAJ,"ȘCOALA CU CLASELE I-IV CORMENIȘ",212,LOZNA,141884,1,PART,PRCNCT,PRSD,PRSD_SV,"2025-05-18 21:29:43",147,123,80,43,0,120,3,200,77,59,61
33,SĂLAJ,"ȘCOALA CU CLASELE I-IV -SALA DE EVENIMENTE",213,LOZNA,141884,1,PART,PRCNCT,PRSD,PRSD_SV,"2025-05-18 21:21:44",120,112,77,35,0,111,1,150,38,51,60
33,SĂLAJ,"CĂMIN CULTURAL VALEA LOZNEI",214,LOZNA,141884,1,PART,PRCNCT,PRSD,PRSD_SV,"2025-05-18 21:14:13",130,107,54,52,1,103,4,150,43,59,44
33,SĂLAJ,"SEDIUL PRIMĂRIEI MARCA",215,MARCA,141946,1,PART,PRCNCT,PRSD,PRSD_SV,"2025-05-18 21:57:21",1070,526,464,58,4,517,9,1150,624,262,255
33,SĂLAJ,"ŞCOALA PRIMARĂ LEŞMIR",216,MARCA,141946,1,PART,PRCNCT,PRSD,PRSD_SV,"2025-05-18 21:22:03",296,147,129,18,0,146,1,350,203,32,114
33,SĂLAJ,"ŞCOALA PRIMARĂ PORŢ",217,MARCA,141946,1,PART,PRCNCT,PRSD,PRSD_SV,"2025-05-18 21:14:20",204,136,116,19,1,135,1,250,114,54,81
33,SĂLAJ,"CĂMINUL CULTURAL ŞUMAL",218,MARCA,141946,1,PART,PRCNCT,PRSD,PRSD_SV,"2025-05-18 21:28:25",397,216,197,19,0,215,1,450,234,120,95
33,SĂLAJ,"ŞCOALA GIMNAZIALĂ MĂERIȘTE",219,MĂERIŞTE,142006,1,PART,PRCNCT,PRSD,PRSD_SV,"2025-05-18 21:32:36",604,310,274,36,0,309,1,650,340,153,156
33,SĂLAJ,"ŞCOALA CU CLASELE I-IV CRIȘTELEC",220,MĂERIŞTE,142006,1,PART,PRCNCT,PRSD,PRSD_SV,"2025-05-18 21:20:40",440,269,230,39,0,267,2,500,231,152,115
33,SĂLAJ,"ŞCOALA CU CLASELE I-IV DOH",221,MĂERIŞTE,142006,1,PART,PRCNCT,PRSD,PRSD_SV,"2025-05-18 21:21:33",153,78,60,18,0,76,2,200,122,42,34
33,SĂLAJ,"ŞCOALA GIMNAZIALĂ GIURTELECU ȘIMLEULUI",222,MĂERIŞTE,142006,1,PART,PRCNCT,PRSD,PRSD_SV,"2025-05-18 21:34:29",685,401,338,58,5,400,1,750,349,213,187
33,SĂLAJ,"CĂMIN CULTURAL MĂLĂDIA",223,MĂERIŞTE,142006,1,PART,PRCNCT,PRSD,PRSD_SV,"2025-05-18 21:18:12",130,77,52,25,0,77,0,200,123,37,40
33,SĂLAJ,"CĂMIN CULTURAL UILEACU ȘIMLEULUI",224,MĂERIŞTE,142006,1,PART,PRCNCT,PRSD,PRSD_SV,"2025-05-18 21:28:18",372,195,168,27,0,195,0,450,255,55,140
33,SĂLAJ,"CĂMINUL CULTURAL DIN MESEŞENII DE JOS",225,"MESEŞENII DE JOS",142079,1,PART,PRCNCT,PRSD,PRSD_SV,"2025-05-18 21:45:01",551,344,273,64,7,343,1,600,256,85,258
33,SĂLAJ,"ȘCOALA GIMNAZIALĂ NR.1 AGHIREȘ",226,"MESEŞENII DE JOS",142079,1,PART,PRCNCT,PRSD,PRSD_SV,"2025-05-18 21:40:07",1275,760,677,81,2,757,3,1350,590,246,511
33,SĂLAJ,"ŞCOALA GIMNAZIALĂ FETINDIA",227,"MESEŞENII DE JOS",142079,1,PART,PRCNCT,PRSD,PRSD_SV,"2025-05-18 21:14:25",165,138,93,45,0,136,2,200,62,72,64
33,SĂLAJ,"CENTRUL DE ZI",228,"MESEŞENII DE JOS",142079,1,PART,PRCNCT,PRSD,PRSD_SV,"2025-05-18 21:27:10",694,415,306,109,0,410,5,750,335,245,165
33,SĂLAJ,"CĂMINUL CULTURAL MIRŞID",229,MIRŞID,142122,1,PART,PRCNCT,PRSD,PRSD_SV,"2025-05-18 21:36:34",573,334,285,48,1,327,7,600,266,196,131
33,SĂLAJ,"CĂMINUL CULTURAL FIRMINIŞ",230,MIRŞID,142122,1,PART,PRCNCT,PRSD,PRSD_SV,"2025-05-18 21:20:21",137,116,65,50,1,114,2,150,34,42,72
33,SĂLAJ,"ŞCOALA CU CLASE I-IV",231,MIRŞID,142122,1,PART,PRCNCT,PRSD,PRSD_SV,"2025-05-18 21:22:06",452,262,219,43,0,260,2,550,288,104,156
33,SĂLAJ,"CĂMINUL CULTURAL POPENI",232,MIRŞID,142122,1,PART,PRCNCT,PRSD,PRSD_SV,"2025-05-18 21:43:34",759,315,283,30,2,313,2,792,477,203,110
33,SĂLAJ,"PRIMĂRIA NĂPRADEA",233,NĂPRADEA,142177,1,PART,PRCNCT,PRSD,PRSD_SV,"2025-05-18 21:38:56",623,324,257,64,3,321,3,692,368,156,165
33,SĂLAJ,"ŞCOALA GIMNAZIALĂ ”PETRE HOSSU”",234,NĂPRADEA,142177,1,PART,PRCNCT,PRSD,PRSD_SV,"2025-05-18 21:31:14",719,332,281,50,1,329,3,750,418,226,103
33,SĂLAJ,"ŞCOALA SOMEŞ GURUSLĂU",235,NĂPRADEA,142177,1,PART,PRCNCT,PRSD,PRSD_SV,"2025-05-18 21:26:56",343,229,165,64,0,229,0,400,171,121,108
33,SĂLAJ,"ŞCOALA TRANIŞ",236,NĂPRADEA,142177,1,PART,PRCNCT,PRSD,PRSD_SV,"2025-05-18 21:17:55",270,136,117,19,0,135,1,300,164,75,60
33,SĂLAJ,"ŞCOALA VĂDURELE",237,NĂPRADEA,142177,1,PART,PRCNCT,PRSD,PRSD_SV,"2025-05-18 21:11:29",157,101,78,23,0,101,0,200,99,65,36
33,SĂLAJ,"CENTRUL DE INFORMARE TURISTICĂ",238,NUŞFALĂU,142239,1,PART,PRCNCT,PRSD,PRSD_SV,"2025-05-18 21:54:42",1357,710,635,64,11,701,9,1450,740,259,442
33,SĂLAJ,"PRIMĂRIA NUȘFALĂU - SALA DE ȘEDINȚE",239,NUŞFALĂU,142239,1,PART,PRCNCT,PRSD,PRSD_SV,"2025-05-18 22:06:56",1388,873,813,43,17,871,2,1500,627,89,782
33,SĂLAJ,"CĂMINUL CULTURAL",240,NUŞFALĂU,142239,1,PART,PRCNCT,PRSD,PRSD_SV,"2025-05-18 21:21:58",310,189,167,18,4,189,0,350,161,20,169
33,SĂLAJ,"GRĂDINIȚA CU PROGRAM PRELUNGIT NR.1 PERICEI",241,PERICEI,142284,1,PART,PRCNCT,PRSD,PRSD_SV,"2025-05-18 21:34:10",1086,614,574,33,7,613,1,1150,536,86,527
33,SĂLAJ,"PRIMĂRIA COMUNEI PERICEI",242,PERICEI,142284,1,PART,PRCNCT,PRSD,PRSD_SV,"2025-05-18 21:39:47",1217,820,755,53,12,817,3,1300,480,77,740
33,SĂLAJ,"CĂMIN CULTURAL",243,PERICEI,142284,1,PART,PRCNCT,PRSD,PRSD_SV,"2025-05-18 21:27:46",536,310,266,44,0,309,1,600,290,116,193
33,SĂLAJ,"CENTRU DE INFORMARE ȘI MARKETING TURISTIC",244,PERICEI,142284,1,PART,PRCNCT,PRSD,PRSD_SV,"2025-05-18 21:15:30",128,77,49,28,0,77,0,150,73,46,31
33,SĂLAJ,"CĂMINUL CULTURAL PLOPIȘ",245,PLOPIŞ,142337,1,PART,PRCNCT,PRSD,PRSD_SV,"2025-05-18 21:58:38",792,429,361,67,1,426,3,850,421,244,182
33,SĂLAJ,"CĂMINUL CULTURAL FĂGETU",246,PLOPIŞ,142337,1,PART,PRCNCT,PRSD,PRSD_SV,"2025-05-18 21:20:38",492,208,179,29,0,206,2,550,342,149,57
33,SĂLAJ,"CENTRUL CULTURAL IAZ",247,PLOPIŞ,142337,1,PART,PRCNCT,PRSD,PRSD_SV,"2025-05-18 21:33:13",603,261,228,30,3,259,2,650,389,132,127
33,SĂLAJ,"ŞCOALA GIMNAZIALĂ POIANA BLENCHII",248,"POIANA BLENCHII",142373,1,PART,PRCNCT,PRSD,PRSD_SV,"2025-05-18 21:50:57",584,317,263,53,1,316,1,650,333,149,167
33,SĂLAJ,"ŞCOALA CU CLASELE I-IV GOSTILA",249,"POIANA BLENCHII",142373,1,PART,PRCNCT,PRSD,PRSD_SV,"2025-05-18 21:31:52",282,200,149,51,0,199,1,350,150,100,99
33,SĂLAJ,"CENTRUL DE INFORMARE ȘI MARKETING TURISTIC",250,ROMÂNAŞI,142426,1,PART,PRCNCT,PRSD,PRSD_SV,"2025-05-18 21:22:08",809,462,371,91,0,460,2,850,388,276,184
33,SĂLAJ,"ȘCOALA CU CLASELE I-IV CHICHIȘA",251,ROMÂNAŞI,142426,1,PART,PRCNCT,PRSD,PRSD_SV,"2025-05-18 21:15:30",199,147,97,49,1,146,1,250,103,67,79
33,SĂLAJ,"ȘCOALA CU CLASELE I-IV CIUMĂRNA",252,ROMÂNAŞI,142426,1,PART,PRCNCT,PRSD,PRSD_SV,"2025-05-18 21:36:43",365,240,174,65,1,238,2,450,210,131,107
33,SĂLAJ,"ȘCOALA CU CLASELE I-IV PĂUȘA",253,ROMÂNAŞI,142426,1,PART,PRCNCT,PRSD,PRSD_SV,"2025-05-18 21:15:23",442,214,164,50,0,213,1,500,286,109,104
33,SĂLAJ,"ȘCOALA CU CLASELE I-IV POARTA SĂLAJULUI",254,ROMÂNAŞI,142426,1,PART,PRCNCT,PRSD,PRSD_SV,"2025-05-18 21:28:25",395,265,181,63,21,264,1,450,185,141,123
33,SĂLAJ,"CĂMIN CULTURAL ROMITA",255,ROMÂNAŞI,142426,1,PART,PRCNCT,PRSD,PRSD_SV,"2025-05-18 21:22:57",242,121,80,41,0,121,0,300,179,72,49
33,SĂLAJ,"CĂMIN CULTURAL RUS",256,RUS,142499,1,PART,PRCNCT,PRSD,PRSD_SV,"2025-05-18 21:23:27",563,340,263,77,0,337,3,600,260,187,150
33,SĂLAJ,"ŞCOALA PRIMARĂ BUZAŞ",257,RUS,142499,1,PART,PRCNCT,PRSD,PRSD_SV,"2025-05-18 21:18:19",104,99,58,41,0,97,2,150,51,32,65
33,SĂLAJ,"ŞCOALA PRIMARĂ FÎNTÎNELE-RUS",258,RUS,142499,1,PART,PRCNCT,PRSD,PRSD_SV,"2025-05-18 21:27:30",136,111,71,40,0,109,2,200,89,74,35
33,SĂLAJ,"ȘCOALA GIMNAZIALĂ ”PETRE DULFU” SĂLĂȚIG",259,SĂLĂŢIG,142550,1,PART,PRCNCT,PRSD,PRSD_SV,"2025-05-18 21:21:31",388,226,205,17,4,225,1,430,204,100,125
33,SĂLAJ,"CAMIN CULTURAL BULGARI",260,SĂLĂŢIG,142550,1,PART,PRCNCT,PRSD,PRSD_SV,"2025-05-18 21:19:59",166,123,90,33,0,120,3,190,67,69,51
33,SĂLAJ,"ȘCOALA GIMNAZIALĂ DEJA",261,SĂLĂŢIG,142550,1,PART,PRCNCT,PRSD,PRSD_SV,"2025-05-18 21:27:27",949,608,566,24,18,604,4,1040,432,20,584
33,SĂLAJ,"CAMIN CULTURAL MINEU",262,SĂLĂŢIG,142550,1,PART,PRCNCT,PRSD,PRSD_SV,"2025-05-18 21:17:43",256,134,105,29,0,132,2,280,146,42,90
33,SĂLAJ,"ȘCOALA PRIMARĂ NOȚIG",263,SĂLĂŢIG,142550,1,PART,PRCNCT,PRSD,PRSD_SV,"2025-05-18 21:17:48",334,240,162,52,26,240,0,370,130,96,144
33,SĂLAJ,"PRIMĂRIA SÎG",264,SÂG,142612,1,PART,PRCNCT,PRSD,PRSD_SV,"2025-05-18 21:14:51",546,275,238,37,0,275,0,600,325,110,165
33,SĂLAJ,"CĂMINUL CULTURAL FIZEȘ",265,SÂG,142612,1,PART,PRCNCT,PRSD,PRSD_SV,"2025-05-18 21:29:33",249,144,112,32,0,142,2,300,156,71,71
33,SĂLAJ,"GRADINIȚA CU PROGRAM NORMAL NR.1 MAL",266,SÂG,142612,1,PART,PRCNCT,PRSD,PRSD_SV,"2025-05-18 21:25:09",1010,304,265,39,0,297,7,1050,746,222,75
33,SĂLAJ,"ȘCOALA PRIMARĂ SÎRBI",267,SÂG,142612,1,PART,PRCNCT,PRSD,PRSD_SV,"2025-05-18 21:09:46",206,94,76,18,0,94,0,250,156,38,56
33,SĂLAJ,"CĂMINUL CULTURAL TUSA",268,SÂG,142612,1,PART,PRCNCT,PRSD,PRSD_SV,"2025-05-18 21:18:03",529,267,239,28,0,265,2,600,333,172,93
33,SĂLAJ,"SEDIUL CONSILIU LOCAL SÎNMIHAIU ALMAŞULUI",269,"SÂNMIHAIU ALMAŞULUI",142676,1,PART,PRCNCT,PRSD,PRSD_SV,"2025-05-18 21:43:56",811,503,355,147,1,501,2,900,397,324,177
33,SĂLAJ,"SCOALA PRIMARĂ BERCEA",270,"SÂNMIHAIU ALMAŞULUI",142676,1,PART,PRCNCT,PRSD,PRSD_SV,"2025-05-18 21:32:01",138,74,52,22,0,72,2,150,76,52,20
33,SĂLAJ,"ŞCOALA CU CLASELE I - IV SÎNTĂ MĂRIA",271,"SÂNMIHAIU ALMAŞULUI",142676,1,PART,PRCNCT,PRSD,PRSD_SV,"2025-05-18 21:33:13",318,202,166,36,0,199,3,350,148,149,50
33,SĂLAJ,"CĂMINUL CULTURAL SOMEȘ-ODORHEI",272,SOMEŞ-ODORHEI,142710,1,PART,PRCNCT,PRSD,PRSD_SV,"2025-05-18 21:42:42",1141,582,490,88,4,577,5,1200,618,340,237
33,SĂLAJ,"ȘCOALA PRIMARĂ BÎRSA",273,SOMEŞ-ODORHEI,142710,1,PART,PRCNCT,PRSD,PRSD_SV,"2025-05-18 21:09:22",72,43,24,15,4,42,1,100,57,24,18
33,SĂLAJ,"ȘCOALA PRIMARĂ DOMNIN",274,SOMEŞ-ODORHEI,142710,1,PART,PRCNCT,PRSD,PRSD_SV,"2025-05-18 21:16:15",245,143,93,50,0,140,3,300,157,72,68
33,SĂLAJ,"CĂMINUL CULTURAL INĂU",275,SOMEŞ-ODORHEI,142710,1,PART,PRCNCT,PRSD,PRSD_SV,"2025-05-18 21:27:53",475,273,222,45,6,273,0,550,277,127,146
33,SĂLAJ,"CĂMINUL CULTURAL ȘOIMUȘ",276,SOMEŞ-ODORHEI,142710,1,PART,PRCNCT,PRSD,PRSD_SV,"2025-05-18 21:24:36",284,147,105,42,0,147,0,350,203,89,58
33,SĂLAJ,"CĂMINUL CULTURAL SURDUC",277,SURDUC,142774,1,PART,PRCNCT,PRSD,PRSD_SV,"2025-05-18 21:49:49",1068,623,543,79,1,612,11,1150,527,342,270
33,SĂLAJ,"CĂMINUL CULTURAL BRÎGLEZ",278,SURDUC,142774,1,PART,PRCNCT,PRSD,PRSD_SV,"2025-05-18 21:37:42",210,151,114,36,1,149,2,300,149,63,86
33,SĂLAJ,"ȘCOALA PRIMARĂ CLASELE I-IV CRISTOLȚEL",279,SURDUC,142774,1,PART,PRCNCT,PRSD,PRSD_SV,"2025-05-18 21:15:21",332,178,142,36,0,177,1,400,222,101,76
33,SĂLAJ,"CĂMINUL CULTURAL SOLONA",280,SURDUC,142774,1,PART,PRCNCT,PRSD,PRSD_SV,"2025-05-18 21:22:08",179,101,69,32,0,101,0,250,149,33,68
33,SĂLAJ,"CĂMINUL CULTURAL TEȘTIOARA",281,SURDUC,142774,1,PART,PRCNCT,PRSD,PRSD_SV,"2025-05-18 21:17:29",63,49,24,25,0,49,0,101,52,22,27
33,SĂLAJ,"CĂMINUL CULTURAL TIHĂU",282,SURDUC,142774,1,PART,PRCNCT,PRSD,PRSD_SV,"2025-05-18 22:28:03",840,536,435,85,16,534,2,900,364,269,265
33,SĂLAJ,"ȘCOALA PRIMARĂ CLASELE I-IV TURBUȚA",283,SURDUC,142774,1,PART,PRCNCT,PRSD,PRSD_SV,"2025-05-18 21:28:00",223,108,79,29,0,108,0,300,192,56,52
33,SĂLAJ,"CĂMIN CULTURAL",284,ŞAMŞUD,142854,1,PART,PRCNCT,PRSD,PRSD_SV,"2025-05-18 21:24:03",900,570,512,25,33,568,2,950,380,24,544
33,SĂLAJ,"CENTRUL DE INFORMARE ŞI PROMOVARE TURISTICĂ VALEA POMILOR",285,ŞAMŞUD,142854,1,PART,PRCNCT,PRSD,PRSD_SV,"2025-05-18 21:29:22",493,266,230,20,16,262,4,600,334,46,216
33,SĂLAJ,"CĂMIN CULTURAL ȘĂRMĂȘAG",286,ŞĂRMĂŞAG,142881,1,PART,PRCNCT,PRSD,PRSD_SV,"2025-05-18 21:41:50",939,627,561,41,25,623,4,1000,373,55,568
33,SĂLAJ,"AFTER SCHOOL ȘĂRMĂȘAG",287,ŞĂRMĂŞAG,142881,1,PART,PRCNCT,PRSD,PRSD_SV,"2025-05-18 21:57:44",833,513,452,45,16,508,5,900,387,73,435
33,SĂLAJ,"GRĂDINIȚA DE COPII NR.3 ȘĂRMĂȘAG",288,ŞĂRMĂŞAG,142881,1,PART,PRCNCT,PRSD,PRSD_SV,"2025-05-18 21:34:12",882,562,513,31,18,559,3,950,388,28,531
33,SĂLAJ,"ȘCOALA GENERALĂ NR.2 ȘĂRMĂȘAG",289,ŞĂRMĂŞAG,142881,2,PART,PRCNCT,PRSD,PRSD_SV,"2025-05-18 23:45:00",1166,481,451,29,1,477,4,1250,769,174,303
33,SĂLAJ,"ȘCOALA GENERALĂ ”SELYMES PETER” ILIȘUA",290,ŞĂRMĂŞAG,142881,1,PART,PRCNCT,PRSD,PRSD_SV,"2025-05-18 21:24:57",542,350,269,42,39,349,1,600,250,50,299
33,SĂLAJ,"ȘCOALA GENERALĂ ”ADY ENDRE” LOMPIRT",291,ŞĂRMĂŞAG,142881,1,PART,PRCNCT,PRSD,PRSD_SV,"2025-05-18 21:34:53",696,396,329,41,26,392,4,750,354,73,319
33,SĂLAJ,"CĂMINUL CULTURAL MOIAD",292,ŞĂRMĂŞAG,142881,1,PART,PRCNCT,PRSD,PRSD_SV,"2025-05-18 21:37:51",166,119,90,29,0,118,1,200,81,53,65
33,SĂLAJ,"ȘCOALA GIMNAZIALĂ ȘIMIȘNA",293,ŞIMIŞNA,179695,2,PART,PRCNCT,PRSD,PRSD_SV,"2025-05-19 01:15:48",670,277,218,59,0,276,1,700,423,137,139
33,SĂLAJ,"CĂMINUL CULTURAL HĂȘMAȘ",294,ŞIMIŞNA,179695,1,PART,PRCNCT,PRSD,PRSD_SV,"2025-05-18 21:28:50",178,130,88,42,0,126,4,250,120,57,69
33,SĂLAJ,"ȘCOALA GIMNAZIALĂ TREZNEA",295,TREZNEA,179631,1,PART,PRCNCT,PRSD,PRSD_SV,"2025-05-18 21:42:44",673,423,345,78,0,418,5,700,277,208,210
33,SĂLAJ,"ȘCOALA GENERALĂ BOZNA",296,TREZNEA,179631,1,PART,PRCNCT,PRSD,PRSD_SV,"2025-05-18 21:10:31",181,137,99,38,0,137,0,250,113,65,72
33,SĂLAJ,"ȘCOALA GIMNAZIALĂ CU CLASELE I-VIII",297,"VALCĂU DE JOS",142952,1,PART,PRCNCT,PRSD,PRSD_SV,"2025-05-18 21:27:02",695,384,353,31,0,381,3,750,366,191,190
33,SĂLAJ,GRĂDINIȚA,298,"VALCĂU DE JOS",142952,1,PART,PRCNCT,PRSD,PRSD_SV,"2025-05-18 21:17:33",186,117,103,14,0,116,1,250,133,58,58
33,SĂLAJ,"ȘCOALA GIMNAZIALĂ",299,"VALCĂU DE JOS",142952,1,PART,PRCNCT,PRSD,PRSD_SV,"2025-05-18 21:42:38",504,323,296,24,3,322,1,550,227,182,140
33,SĂLAJ,"ȘCOALA CU CLASELE I-IV",300,"VALCĂU DE JOS",142952,1,PART,PRCNCT,PRSD,PRSD_SV,"2025-05-18 21:19:57",301,177,159,16,2,176,1,350,173,84,92
33,SĂLAJ,"CAMIN CULTURAL",301,"VALCĂU DE JOS",142952,1,PART,PRCNCT,PRSD,PRSD_SV,"2025-05-18 21:31:33",719,345,306,39,0,340,5,800,455,188,152
33,SĂLAJ,"PRIMĂRIA COMUNEI VÎRȘOLȚ",302,VÂRŞOLŢ,143021,1,PART,PRCNCT,PRSD,PRSD_SV,"2025-05-18 22:00:01",1393,785,719,59,7,776,9,1450,665,117,659
33,SĂLAJ,"CĂMINUL CULTURAL RECEA",303,VÂRŞOLŢ,143021,1,PART,PRCNCT,PRSD,PRSD_SV,"2025-05-18 21:42:13",456,289,222,62,5,289,0,550,261,140,149
33,SĂLAJ,"ȘCOALA GIMNAZIALĂ NR.1 ZALHA",304,ZALHA,143067,1,PART,PRCNCT,PRSD,PRSD_SV,"2025-05-18 21:14:34",210,130,78,52,0,129,1,250,120,62,67
33,SĂLAJ,"CENTRUL CULTURAL CEACA",305,ZALHA,143067,1,PART,PRCNCT,PRSD,PRSD_SV,"2025-05-18 21:20:13",152,106,60,44,2,106,0,200,94,58,48
33,SĂLAJ,"ȘCOALA CU CLASELE I-IV CIURENI",306,ZALHA,143067,1,PART,PRCNCT,PRSD,PRSD_SV,"2025-05-18 21:17:08",112,87,58,29,0,87,0,150,63,54,33
33,SĂLAJ,"ȘCOALA CU CLASELE I-IV VALEA HRANEI",307,ZALHA,143067,1,PART,PRCNCT,PRSD,PRSD_SV,"2025-05-18 21:13:29",55,60,33,27,0,60,0,100,40,34,26
33,SĂLAJ,"ȘCOALA CU CLASELE I-IV VALEA LUNGĂ",308,ZALHA,143067,1,PART,PRCNCT,PRSD,PRSD_SV,"2025-05-18 21:13:06",117,69,56,13,0,69,0,150,81,49,20
33,SĂLAJ,"SCOALA GIMNAZIALA ZIMBOR",309,ZIMBOR,143147,1,PART,PRCNCT,PRSD,PRSD_SV,"2025-05-18 22:12:46",475,638,245,388,5,637,1,830,192,429,208
33,SĂLAJ,"CĂMINUL CULTURAL DOLU",310,ZIMBOR,143147,1,PART,PRCNCT,PRSD,PRSD_SV,"2025-05-18 21:22:54",36,67,24,43,0,67,0,90,23,30,37
33,SĂLAJ,"CĂMINUL CULTURAL SÂNCRAIU ALMAȘULUI",311,ZIMBOR,143147,1,PART,PRCNCT,PRSD,PRSD_SV,"2025-05-18 21:30:20",132,148,62,86,0,146,2,200,52,79,67
33,SĂLAJ,"CĂMINUL CULTURAL SUTORU",312,ZIMBOR,143147,1,PART,PRCNCT,PRSD,PRSD_SV,"2025-05-18 21:25:55",99,227,46,180,1,226,1,250,23,160,66
34,SIBIU,"ŞCOALA GIMNAZIALĂ NR. 10 CU STRUCTURA GRADINIŢA CU PROGRAM PRELUNGIT NR. 20",1,"MUNICIPIUL SIBIU",143450,1,PART,PRCNCT,PRSD,PRSD_SV,"2025-05-18 22:11:21",1952,1049,930,119,0,1039,10,2000,951,372,667
34,SIBIU,"ŞCOALA GIMNAZIALĂ NR. 10 CU STRUCTURA GRADINIŢA CU PROGRAM PRELUNGIT NR. 20",2,"MUNICIPIUL SIBIU",143450,1,PART,PRCNCT,PRSD,PRSD_SV,"2025-05-18 22:11:11",1820,1001,945,55,1,997,4,1950,949,346,651
34,SIBIU,"ŞCOALA GIMNAZIALĂ NR.10",3,"MUNICIPIUL SIBIU",143450,1,PART,PRCNCT,PRSD,PRSD_SV,"2025-05-18 23:05:17",1729,1221,972,249,0,1208,13,1900,679,369,839
34,SIBIU,"ŞCOALA GIMNAZIALĂ NR.10",4,"MUNICIPIUL SIBIU",143450,1,PART,PRCNCT,PRSD,PRSD_SV,"2025-05-18 22:24:16",1610,1231,939,290,2,1218,13,1800,569,392,826
34,SIBIU,"ŞCOALA GIMNAZIALĂ NR.10",5,"MUNICIPIUL SIBIU",143450,1,PART,PRCNCT,PRSD,PRSD_SV,"2025-05-18 22:17:33",1724,1107,944,162,1,1096,11,1900,793,299,797
34,SIBIU,"ȘCOALA GIMNAZIALĂ NR.10",6,"MUNICIPIUL SIBIU",143450,1,PART,PRCNCT,PRSD,PRSD_SV,"2025-05-18 22:09:08",1252,810,728,82,0,798,12,1400,590,196,602
34,SIBIU,"ŞCOALA GIMNAZIALĂ NR. 13 CU STRUCTURA ŞCOALA GIMNAZIALĂ NR. 12",7,"MUNICIPIUL SIBIU",143450,1,PART,PRCNCT,PRSD,PRSD_SV,"2025-05-18 21:46:56",1611,1091,937,154,0,1080,11,1800,709,248,832
34,SIBIU,"ŞCOALA GIMNAZIALĂ NR. 13 CU STRUCTURA ŞCOALA GIMNAZIALĂ NR. 12",8,"MUNICIPIUL SIBIU",143450,1,PART,PRCNCT,PRSD,PRSD_SV,"2025-05-18 21:46:15",1617,1061,959,100,2,1049,12,1800,739,284,765
34,SIBIU,"ŞCOALA GIMNAZIALĂ NR. 13 CU STRUCTURA ŞCOALA GIMNAZIALĂ NR. 12",9,"MUNICIPIUL SIBIU",143450,1,PART,PRCNCT,PRSD,PRSD_SV,"2025-05-18 21:57:03",1455,949,873,74,2,934,15,1600,651,260,674
34,SIBIU,"LICEUL TEHNOLOGIC CONSTRUCȚII ŞI ARHITECTURĂ CAROL I SIBIU",10,"MUNICIPIUL SIBIU",143450,1,PART,PRCNCT,PRSD,PRSD_SV,"2025-05-18 23:34:11",916,794,495,261,38,785,9,1020,226,216,569
34,SIBIU,"LICEUL TEHNOLOGIC CONSTRUCȚII ȘI ARHITECTURĂ CAROL I SIBIU",11,"MUNICIPIUL SIBIU",143450,1,PART,PRCNCT,PRSD,PRSD_SV,"2025-05-18 22:14:00",1714,1091,948,143,0,1077,14,1900,809,394,683
34,SIBIU,"ŞCOALA GIMNAZIALĂ NR.13",12,"MUNICIPIUL SIBIU",143450,1,PART,PRCNCT,PRSD,PRSD_SV,"2025-05-18 21:43:57",1003,742,586,155,1,739,3,1100,358,195,544
34,SIBIU,"ŞCOALA GIMNAZIALĂ NR.13",13,"MUNICIPIUL SIBIU",143450,1,PART,PRCNCT,PRSD,PRSD_SV,"2025-05-18 21:37:46",1157,725,629,96,0,715,10,1270,545,277,438
34,SIBIU,"ŞCOALA GIMNAZIALĂ NR.13",14,"MUNICIPIUL SIBIU",143450,1,PART,PRCNCT,PRSD,PRSD_SV,"2025-05-18 21:41:24",1162,739,651,88,0,727,12,1300,561,213,514
34,SIBIU,"ŞCOALA GIMNAZIALĂ NR.23",15,"MUNICIPIUL SIBIU",143450,1,PART,PRCNCT,PRSD,PRSD_SV,"2025-05-18 22:54:56",1920,1349,1244,105,0,1332,17,2100,751,382,950
34,SIBIU,"ŞCOALA GIMNAZIALĂ NR.23",16,"MUNICIPIUL SIBIU",143450,1,PART,PRCNCT,PRSD,PRSD_SV,"2025-05-18 21:53:48",1817,1111,1010,101,0,1091,20,2000,889,448,643
34,SIBIU,"ŞCOALA GIMNAZIALĂ NR.23",17,"MUNICIPIUL SIBIU",143450,1,PART,PRCNCT,PRSD,PRSD_SV,"2025-05-18 22:06:46",1559,860,782,76,2,850,10,1720,860,313,537
34,SIBIU,"COLEGIUL TEHNIC INDEPENDENŢA",18,"MUNICIPIUL SIBIU",143450,1,PART,PRCNCT,PRSD,PRSD_SV,"2025-05-18 22:05:54",1207,815,636,179,0,800,15,1400,585,284,516
34,SIBIU,"COLEGIUL TEHNIC DE INDUSTRIE ALIMENTARĂ TEREZIANUM SIBIU",19,"MUNICIPIUL SIBIU",143450,1,PART,PRCNCT,PRSD,PRSD_SV,"2025-05-18 22:06:20",1403,851,792,59,0,841,10,1600,749,277,564
34,SIBIU,"COLEGIUL TEHNIC DE INDUSTRIE ALIMENTARĂ TEREZIANUM SIBIU",20,"MUNICIPIUL SIBIU",143450,2,PART,PRCNCT,PRSD,PRSD_SV,"2025-05-19 01:33:15",1313,866,767,99,0,855,11,1450,584,225,630
34,SIBIU,"ŞCOALA GIMNAZIALĂ NR.18",21,"MUNICIPIUL SIBIU",143450,1,PART,PRCNCT,PRSD,PRSD_SV,"2025-05-18 22:29:45",1775,1296,1072,191,33,1283,13,2000,704,415,868
34,SIBIU,"ŞCOALA GIMNAZIALĂ NR.18",22,"MUNICIPIUL SIBIU",143450,1,PART,PRCNCT,PRSD,PRSD_SV,"2025-05-18 22:23:45",1671,1175,1006,116,53,1160,15,1840,665,365,795
34,SIBIU,"ŞCOALA GIMNAZIALĂ IOAN SLAVICI CU STRUCTURA ŞCOALA GIMNAZIALĂ NR. 11",23,"MUNICIPIUL SIBIU",143450,1,PART,PRCNCT,PRSD,PRSD_SV,"2025-05-18 22:08:56",1554,858,756,63,39,846,12,1600,742,385,461
34,SIBIU,"ŞCOALA GIMNAZIALĂ IOAN SLAVICI CU STRUCTURA ŞCOALA GIMNAZIALĂ NR. 11",24,"MUNICIPIUL SIBIU",143450,1,PART,PRCNCT,PRSD,PRSD_SV,"2025-05-18 22:24:32",1726,1016,951,65,0,1006,10,1900,884,396,610
34,SIBIU,"ŞCOALA GIMNAZIALĂ IOAN SLAVICI",25,"MUNICIPIUL SIBIU",143450,1,PART,PRCNCT,PRSD,PRSD_SV,"2025-05-18 21:41:35",1647,1252,1050,201,1,1236,16,1810,558,330,906
34,SIBIU,"ŞCOALA GIMNAZIALĂ IOAN SLAVICI",26,"MUNICIPIUL SIBIU",143450,1,PART,PRCNCT,PRSD,PRSD_SV,"2025-05-18 21:53:44",1483,1128,890,236,2,1111,17,1630,502,272,839
34,SIBIU,"LICEUL TEHNOLOGIC HENRI COANDĂ",27,"MUNICIPIUL SIBIU",143450,3,PART,PRCNCT,PRSD,PRSD_SV,"2025-05-19 01:39:48",963,592,505,87,0,586,6,1060,468,269,317
34,SIBIU,"LICEUL TEHNOLOGIC HENRI COANDĂ",28,"MUNICIPIUL SIBIU",143450,1,PART,PRCNCT,PRSD,PRSD_SV,"2025-05-18 21:54:24",963,673,579,93,1,657,16,1060,387,246,411
34,SIBIU,"LICEUL TEHNOLOGIC HENRI COANDĂ",29,"MUNICIPIUL SIBIU",143450,1,PART,PRCNCT,PRSD,PRSD_SV,"2025-05-18 21:48:05",1592,871,795,76,0,856,15,1750,879,390,466
34,SIBIU,"ŞCOALA GIMNAZIALĂ NR. 8",30,"MUNICIPIUL SIBIU",143450,1,PART,PRCNCT,PRSD,PRSD_SV,"2025-05-18 21:47:03",1159,769,697,71,1,765,4,1270,501,236,529
34,SIBIU,"ŞCOALA GIMNAZIALĂ NR. 8",31,"MUNICIPIUL SIBIU",143450,1,PART,PRCNCT,PRSD,PRSD_SV,"2025-05-18 21:42:09",1347,898,784,114,0,885,13,1480,582,302,583
34,SIBIU,"ŞCOALA GIMNAZIALĂ NR. 8",32,"MUNICIPIUL SIBIU",143450,1,PART,PRCNCT,PRSD,PRSD_SV,"2025-05-18 21:53:56",1296,828,788,40,0,816,12,1410,582,245,571
34,SIBIU,"ŞCOALA GIMNAZIALĂ NR. 8",33,"MUNICIPIUL SIBIU",143450,1,PART,PRCNCT,PRSD,PRSD_SV,"2025-05-18 22:02:43",1754,1111,1050,58,3,1098,13,1930,819,328,770
34,SIBIU,"GRĂDINIŢA CU PROGRAM PRELUNGIT NR. 17",34,"MUNICIPIUL SIBIU",143450,1,PART,PRCNCT,PRSD,PRSD_SV,"2025-05-18 21:43:42",913,518,436,82,0,516,2,1010,492,199,317
34,SIBIU,"GRĂDINIŢA CU PROGRAM PRELUNGIT NR. 37",35,"MUNICIPIUL SIBIU",143450,1,PART,PRCNCT,PRSD,PRSD_SV,"2025-05-18 22:01:43",1188,746,593,153,0,733,13,1310,564,228,505
34,SIBIU,"ȘCOALA GIMNAZIALĂ NR.2 SIBIU",36,"MUNICIPIUL SIBIU",143450,1,PART,PRCNCT,PRSD,PRSD_SV,"2025-05-18 21:53:58",1195,799,580,142,77,789,10,1310,511,213,576
34,SIBIU,"ȘCOALA GIMNAZIALĂ NR.2 SIBIU",37,"MUNICIPIUL SIBIU",143450,1,PART,PRCNCT,PRSD,PRSD_SV,"2025-05-18 21:35:23",926,649,532,75,42,644,5,1020,371,146,498
34,SIBIU,"ŞCOALA GIMNAZIALĂ NR.2",38,"MUNICIPIUL SIBIU",143450,1,PART,PRCNCT,PRSD,PRSD_SV,"2025-05-18 21:49:35",967,638,418,177,43,634,4,1070,432,207,427
34,SIBIU,"COLEGIUL NAŢIONAL GHEORGHE LAZĂR SIBIU",39,"MUNICIPIUL SIBIU",143450,1,PART,PRCNCT,PRSD,PRSD_SV,"2025-05-18 22:38:50",1065,1253,519,701,33,1242,11,1430,177,286,956
34,SIBIU,"LICEUL DE ARTĂ SIBIU",40,"MUNICIPIUL SIBIU",143450,1,PART,PRCNCT,PRSD,PRSD_SV,"2025-05-18 21:58:46",681,688,322,343,23,679,9,850,162,198,481
34,SIBIU,"LICEUL DE ARTĂ SIBIU",41,"MUNICIPIUL SIBIU",143450,1,PART,PRCNCT,PRSD,PRSD_SV,"2025-05-18 21:47:54",826,614,391,180,43,603,11,900,286,169,434
34,SIBIU,"COLEGIUL TEHNIC INDEPENDENŢA SIBIU",42,"MUNICIPIUL SIBIU",143450,1,PART,PRCNCT,PRSD,PRSD_SV,"2025-05-18 22:07:06",1010,627,470,157,0,615,12,1120,493,172,443
34,SIBIU,"COLEGIUL NAŢIONAL OCTAVIAN GOGA SIBIU",43,"MUNICIPIUL SIBIU",143450,1,PART,PRCNCT,PRSD,PRSD_SV,"2025-05-18 22:24:56",868,707,417,288,2,696,11,950,243,193,503
34,SIBIU,"COLEGIUL NAŢIONAL OCTAVIAN GOGA CU STRUCTURĂ ŞCOALA CU CLASELE I-VIII NR. 15",44,"MUNICIPIUL SIBIU",143450,2,PART,PRCNCT,PRSD,PRSD_SV,"2025-05-18 23:50:30",1064,666,546,120,0,656,10,1170,504,173,483
34,SIBIU,"ŞCOALA GIMNAZIALĂ REGINA MARIA",45,"MUNICIPIUL SIBIU",143450,1,PART,PRCNCT,PRSD,PRSD_SV,"2025-05-18 22:06:03",1113,1046,673,373,0,1027,19,1330,284,221,806
34,SIBIU,"ŞCOALA GIMNAZIALĂ REGINA MARIA",46,"MUNICIPIUL SIBIU",143450,1,PART,PRCNCT,PRSD,PRSD_SV,"2025-05-18 22:03:10",959,888,537,350,1,876,12,1150,262,190,686
34,SIBIU,"COLEGIUL AGRICOL DANIIL POPOVICI BARCIANU SIBIU",47,"MUNICIPIUL SIBIU",143450,1,PART,PRCNCT,PRSD,PRSD_SV,"2025-05-18 22:03:04",963,791,481,246,64,778,13,1060,269,223,555
34,SIBIU,"CASA CORPULUI DIDACTIC",48,"MUNICIPIUL SIBIU",143450,1,PART,PRCNCT,PRSD,PRSD_SV,"2025-05-18 22:28:55",1367,908,812,96,0,896,12,1510,602,220,676
34,SIBIU,"LICEUL TEORETIC ONISIFOR GHIBU",49,"MUNICIPIUL SIBIU",143450,1,PART,PRCNCT,PRSD,PRSD_SV,"2025-05-18 22:22:34",1120,1000,669,331,0,981,19,1230,230,273,708
34,SIBIU,"ŞCOALA GIMNAZIALĂ NR. 1",50,"MUNICIPIUL SIBIU",143450,1,PART,PRCNCT,PRSD,PRSD_SV,"2025-05-18 22:06:02",1371,953,792,161,0,942,11,1500,547,222,720
34,SIBIU,"ŞCOALA GIMNAZIALĂ NR. 1",51,"MUNICIPIUL SIBIU",143450,1,PART,PRCNCT,PRSD,PRSD_SV,"2025-05-18 22:27:07",1375,978,805,171,2,964,14,1500,522,205,759
34,SIBIU,"ŞCOALA GIMNAZIALĂ NR. 1",52,"MUNICIPIUL SIBIU",143450,1,PART,PRCNCT,PRSD,PRSD_SV,"2025-05-18 22:33:03",1450,933,837,95,1,919,14,1590,657,272,647
34,SIBIU,"ŞCOALA GIMNAZIALĂ NR. 1",53,"MUNICIPIUL SIBIU",143450,1,PART,PRCNCT,PRSD,PRSD_SV,"2025-05-18 22:41:10",1648,1091,992,99,0,1076,15,1800,709,257,819
34,SIBIU,"GRĂDINIŢA CU PROGRAM PRELUNGIT NR. 22",54,"MUNICIPIUL SIBIU",143450,1,PART,PRCNCT,PRSD,PRSD_SV,"2025-05-18 22:31:25",1462,1097,933,160,4,1088,9,1600,503,200,888
34,SIBIU,"GRĂDINIŢA CU PROGRAM PRELUNGIT NR. 22",55,"MUNICIPIUL SIBIU",143450,1,PART,PRCNCT,PRSD,PRSD_SV,"2025-05-18 21:57:30",1365,916,824,90,2,906,10,1500,584,204,702
34,SIBIU,"GRĂDINIŢA CU PROGRAM PRELUNGIT NR. 22",56,"MUNICIPIUL SIBIU",143450,1,PART,PRCNCT,PRSD,PRSD_SV,"2025-05-18 21:53:04",1723,1190,1083,106,1,1174,16,1900,710,291,883
34,SIBIU,"GRĂDINIŢA CU PROGRAM PRELUNGIT NR. 22",57,"MUNICIPIUL SIBIU",143450,1,PART,PRCNCT,PRSD,PRSD_SV,"2025-05-18 21:49:17",986,586,536,49,1,579,7,1080,494,173,406
34,SIBIU,"ŞCOALA GIMNAZIALĂ NR. 25",58,"MUNICIPIUL SIBIU",143450,1,PART,PRCNCT,PRSD,PRSD_SV,"2025-05-18 21:59:36",1195,869,675,194,0,861,8,1310,441,248,613
34,SIBIU,"ŞCOALA GIMNAZIALĂ NR. 25",59,"MUNICIPIUL SIBIU",143450,2,PART,PRCNCT,PRSD,PRSD_SV,"2025-05-18 23:43:22",1220,732,663,69,0,722,10,1330,598,241,481
34,SIBIU,"ŞCOALA GIMNAZIALĂ NR. 25",60,"MUNICIPIUL SIBIU",143450,1,PART,PRCNCT,PRSD,PRSD_SV,"2025-05-18 21:40:19",1165,776,689,87,0,773,3,1280,504,226,547
34,SIBIU,"ŞCOALA GIMNAZIALĂ NR. 25",61,"MUNICIPIUL SIBIU",143450,1,PART,PRCNCT,PRSD,PRSD_SV,"2025-05-18 21:51:37",1579,964,897,67,0,958,6,1740,776,267,691
34,SIBIU,"ŞCOALA GIMNAZIALĂ ION LUCA CARAGIALE",62,"MUNICIPIUL SIBIU",143450,1,PART,PRCNCT,PRSD,PRSD_SV,"2025-05-18 21:51:06",1370,964,879,76,9,951,13,1500,536,158,793
34,SIBIU,"ŞCOALA GIMNAZIALĂ ION LUCA CARAGIALE",63,"MUNICIPIUL SIBIU",143450,1,PART,PRCNCT,PRSD,PRSD_SV,"2025-05-18 22:26:03",1151,853,726,124,3,845,8,1270,417,161,684
34,SIBIU,"ŞCOALA GIMNAZIALĂ ION LUCA CARAGIALE",64,"MUNICIPIUL SIBIU",143450,1,PART,PRCNCT,PRSD,PRSD_SV,"2025-05-18 22:23:48",1139,805,722,78,5,796,9,1250,445,148,648
34,SIBIU,"FACULTATEA DE INGINERIE",65,"MUNICIPIUL SIBIU",143450,1,PART,PRCNCT,PRSD,PRSD_SV,"2025-05-18 22:05:30",1105,873,589,284,0,861,12,1220,347,191,670
34,SIBIU,"COLEGIU ECONOMIC GEORGE BARIŢIU",66,"MUNICIPIUL SIBIU",143450,1,PART,PRCNCT,PRSD,PRSD_SV,"2025-05-18 22:24:34",1106,821,595,226,0,813,8,1200,379,217,596
34,SIBIU,"COLEGIU ECONOMIC GEORGE BARIŢIU",67,"MUNICIPIUL SIBIU",143450,1,PART,PRCNCT,PRSD,PRSD_SV,"2025-05-18 22:52:47",1223,924,674,250,0,906,18,1350,426,259,647
34,SIBIU,"COLEGIUL ECONOMIC GEORGE BARIŢIU, SIBIU",68,"MUNICIPIUL SIBIU",143450,1,PART,PRCNCT,PRSD,PRSD_SV,"2025-05-18 22:19:35",1171,849,664,183,2,843,6,1290,441,181,662
34,SIBIU,"ȘCOALA GIMNAZIALĂ NR.4 SIBIU",69,"MUNICIPIUL SIBIU",143450,1,PART,PRCNCT,PRSD,PRSD_SV,"2025-05-18 22:22:38",1260,856,704,136,16,846,10,1390,534,201,645
34,SIBIU,"ŞCOALA GIMNAZIALĂ NR.4",70,"MUNICIPIUL SIBIU",143450,1,PART,PRCNCT,PRSD,PRSD_SV,"2025-05-18 22:06:29",1285,824,721,103,0,818,6,1400,576,198,620
34,SIBIU,"ŞCOALA GIMNAZIALĂ NR.4",71,"MUNICIPIUL SIBIU",143450,1,PART,PRCNCT,PRSD,PRSD_SV,"2025-05-18 21:46:00",1104,723,623,100,0,718,5,1220,497,183,535
34,SIBIU,"ŞCOALA GIMNAZIALĂ NR.4",72,"MUNICIPIUL SIBIU",143450,1,PART,PRCNCT,PRSD,PRSD_SV,"2025-05-18 22:00:59",1364,975,822,148,5,967,8,1500,525,212,755
34,SIBIU,"COLEGIUL TEHNIC ENERGETIC",73,"MUNICIPIUL SIBIU",143450,1,PART,PRCNCT,PRSD,PRSD_SV,"2025-05-18 21:40:36",1489,1072,908,164,0,1063,9,1630,558,254,809
34,SIBIU,"COLEGIUL TEHNIC ENERGETIC",74,"MUNICIPIUL SIBIU",143450,1,PART,PRCNCT,PRSD,PRSD_SV,"2025-05-18 22:10:20",1155,701,557,143,1,689,12,1270,569,242,447
34,SIBIU,"COLEGIUL TEHNIC ENERGETIC",75,"MUNICIPIUL SIBIU",143450,1,PART,PRCNCT,PRSD,PRSD_SV,"2025-05-18 21:38:52",1397,917,766,151,0,909,8,1530,613,307,602
34,SIBIU,"COLEGIUL TEHNIC ENERGETIC",76,"MUNICIPIUL SIBIU",143450,1,PART,PRCNCT,PRSD,PRSD_SV,"2025-05-18 22:55:00",1297,806,686,120,0,795,11,1430,624,274,521
34,SIBIU,"ŞCOALA GIMNAZIALĂ REGELE FERDINAND",77,"MUNICIPIUL SIBIU",143450,1,PART,PRCNCT,PRSD,PRSD_SV,"2025-05-18 22:23:03",1112,628,549,79,0,622,6,1230,602,274,348
34,SIBIU,"ŞCOALA GIMNAZIALĂ REGELE FERDINAND",78,"MUNICIPIUL SIBIU",143450,1,PART,PRCNCT,PRSD,PRSD_SV,"2025-05-18 21:33:19",1256,647,587,60,0,638,9,1380,733,273,365
34,SIBIU,"ŞCOALA GIMNAZIALĂ REGELE FERDINAND",79,"MUNICIPIUL SIBIU",143450,1,PART,PRCNCT,PRSD,PRSD_SV,"2025-05-18 21:55:09",1235,776,687,89,0,764,12,1360,584,242,522
34,SIBIU,"ŞCOALA GIMNAZIALĂ REGELE FERDINAND",80,"MUNICIPIUL SIBIU",143450,1,PART,PRCNCT,PRSD,PRSD_SV,"2025-05-18 21:46:49",1179,817,652,165,0,803,14,1300,483,296,507
34,SIBIU,"ŞCOALA GIMNAZIALĂ REGELE FERDINAND",81,"MUNICIPIUL SIBIU",143450,1,PART,PRCNCT,PRSD,PRSD_SV,"2025-05-18 21:44:48",957,607,517,90,0,601,6,1050,443,196,405
34,SIBIU,"ŞCOALA GIMNAZIALĂ REGELE FERDINAND",82,"MUNICIPIUL SIBIU",143450,1,PART,PRCNCT,PRSD,PRSD_SV,"2025-05-18 21:38:44",1125,652,616,36,0,643,9,1230,578,225,418
34,SIBIU,"ŞCOALA GIMNAZIALĂ REGELE FERDINAND",83,"MUNICIPIUL SIBIU",143450,1,PART,PRCNCT,PRSD,PRSD_SV,"2025-05-18 21:53:42",1119,554,529,25,0,550,4,1230,676,237,313
34,SIBIU,"GRĂDINIŢA CU PROGRAM PRELUNGIT NR.29",84,"MUNICIPIUL SIBIU",143450,1,PART,PRCNCT,PRSD,PRSD_SV,"2025-05-18 22:24:41",1056,928,635,292,1,911,17,1160,232,330,581
34,SIBIU,"ŞCOALA GIMNAZIALĂ RADU SELEJAN",85,"MUNICIPIUL SIBIU",143450,1,PART,PRCNCT,PRSD,PRSD_SV,"2025-05-18 21:56:54",911,627,486,141,0,622,5,1000,373,172,450
34,SIBIU,"ŞCOALA GIMNAZIALĂ RADU SELEJAN",86,"MUNICIPIUL SIBIU",143450,1,PART,PRCNCT,PRSD,PRSD_SV,"2025-05-18 21:55:55",1067,770,563,206,1,762,8,1150,380,321,441
34,SIBIU,"GRĂDINIŢA CU PROGRAM PRELUNGIT NR.33",87,"MUNICIPIUL SIBIU",143450,1,PART,PRCNCT,PRSD,PRSD_SV,"2025-05-18 21:24:27",1101,717,549,168,0,704,13,1210,493,217,487
34,SIBIU,"ŞCOALA GIMNAZIALĂ NR. 21",88,"MUNICIPIUL SIBIU",143450,1,PART,PRCNCT,PRSD,PRSD_SV,"2025-05-18 21:48:44",1181,783,678,102,3,775,8,1300,517,234,541
34,SIBIU,"ŞCOALA GIMNAZIALĂ NR. 21",89,"MUNICIPIUL SIBIU",143450,1,PART,PRCNCT,PRSD,PRSD_SV,"2025-05-18 21:48:11",858,672,456,216,0,667,5,940,268,223,444
34,SIBIU,"ŞCOALA GIMNAZIALĂ NR. 21",90,"MUNICIPIUL SIBIU",143450,1,PART,PRCNCT,PRSD,PRSD_SV,"2025-05-18 21:42:12",879,613,487,125,1,603,10,960,347,148,455
34,SIBIU,"ŞCOALA GIMNAZIALĂ NR. 21",91,"MUNICIPIUL SIBIU",143450,1,PART,PRCNCT,PRSD,PRSD_SV,"2025-05-18 22:14:11",1083,694,586,106,2,688,6,1190,496,207,481
34,SIBIU,"ŞCOALA GIMNAZIALĂ NICOLAE IORGA - CORP NOU",92,"MUNICIPIUL SIBIU",143450,1,PART,PRCNCT,PRSD,PRSD_SV,"2025-05-18 22:29:49",1273,911,714,196,1,898,13,1400,489,223,675
34,SIBIU,"ŞCOALA GIMNAZIALĂ NICOLAE IORGA - CORP NOU",93,"MUNICIPIUL SIBIU",143450,1,PART,PRCNCT,PRSD,PRSD_SV,"2025-05-18 21:58:58",1270,866,696,169,1,854,12,1390,524,250,604
34,SIBIU,"ŞCOALA GIMNAZIALĂ NICOLAE IORGA - CORP NOU",94,"MUNICIPIUL SIBIU",143450,1,PART,PRCNCT,PRSD,PRSD_SV,"2025-05-18 21:54:30",1231,851,672,178,1,841,10,1350,499,217,624
34,SIBIU,"ŞCOALA GIMNAZIALĂ NICOLAE IORGA - CORP NOU",95,"MUNICIPIUL SIBIU",143450,1,PART,PRCNCT,PRSD,PRSD_SV,"2025-05-18 21:44:28",940,587,451,134,2,578,9,1030,443,174,404
34,SIBIU,"LICEUL TEORETIC CONSTANTIN NOICA",96,"MUNICIPIUL SIBIU",143450,1,PART,PRCNCT,PRSD,PRSD_SV,"2025-05-18 21:54:04",1161,779,647,131,1,772,7,1280,501,211,561
34,SIBIU,"LICEUL TEORETIC CONSTANTIN NOICA",97,"MUNICIPIUL SIBIU",143450,1,PART,PRCNCT,PRSD,PRSD_SV,"2025-05-18 21:48:52",1189,767,618,149,0,751,16,1310,543,188,563
34,SIBIU,"LICEUL TEORETIC CONSTANTIN NOICA",98,"MUNICIPIUL SIBIU",143450,1,PART,PRCNCT,PRSD,PRSD_SV,"2025-05-18 22:15:15",1304,935,688,247,0,924,11,1430,495,251,673
34,SIBIU,"GRĂDINIŢA CU PROGRAM PRELUNGIT ELEFĂNŢELUL CURIOS",99,"MUNICIPIUL SIBIU",143450,1,PART,PRCNCT,PRSD,PRSD_SV,"2025-05-18 21:35:31",1272,837,654,183,0,824,13,1400,563,285,539
34,SIBIU,"COLEGIUL NAŢIONAL PEDAGOGIC ANDREI ŞAGUNA",100,"MUNICIPIUL SIBIU",143450,1,PART,PRCNCT,PRSD,PRSD_SV,"2025-05-18 22:10:50",1201,909,653,256,0,901,8,1320,411,247,654
34,SIBIU,"COLEGIUL NAŢIONAL PEDAGOGIC ANDREI ŞAGUNA",101,"MUNICIPIUL SIBIU",143450,1,PART,PRCNCT,PRSD,PRSD_SV,"2025-05-18 22:12:31",1071,776,650,124,2,770,6,1180,404,187,583
34,SIBIU,"GRĂDINIŢA CU PROGRAM PRELUNGIT NR. 42",102,"MUNICIPIUL SIBIU",143450,1,PART,PRCNCT,PRSD,PRSD_SV,"2025-05-18 21:58:29",1191,883,704,175,4,871,12,1310,427,203,668
34,SIBIU,"GRĂDINIŢA CU PROGRAM PRELUNGIT NR. 43",103,"MUNICIPIUL SIBIU",143450,1,PART,PRCNCT,PRSD,PRSD_SV,"2025-05-18 22:43:45",1507,1173,860,312,1,1162,11,1650,477,399,763
34,SIBIU,"GRĂDINIŢA CU PROGRAM PRELUNGIT NR. 43",104,"MUNICIPIUL SIBIU",143450,2,PART,PRCNCT,PRSD,PRSD_SV,"2025-05-19 01:05:27",1315,1079,698,381,0,1063,16,1450,371,389,674
34,SIBIU,"GRĂDINIŢA CU PROGRAM PRELUNGIT NR. 5",105,"MUNICIPIUL SIBIU",143450,1,PART,PRCNCT,PRSD,PRSD_SV,"2025-05-18 22:54:02",1558,1033,846,187,0,1017,16,1710,677,339,678
34,SIBIU,"GRĂDINIŢA CU PROGRAM PRELUNGIT NR. 5",106,"MUNICIPIUL SIBIU",143450,1,PART,PRCNCT,PRSD,PRSD_SV,"2025-05-18 22:14:29",1524,1027,859,167,1,1012,15,1600,573,266,746
34,SIBIU,PĂLTINIŞ,107,"MUNICIPIUL SIBIU",143450,1,PART,PRCNCT,PRSD,PRSD_SV,"2025-05-18 21:08:05",19,61,3,58,0,61,0,161,100,25,36
34,SIBIU,"LICEUL TEORETIC ”ROTH - OBERTH”",108,"MUNICIPIUL MEDIAŞ",143619,1,PART,PRCNCT,PRSD,PRSD_SV,"2025-05-18 22:20:30",1035,491,364,52,75,482,9,1140,649,215,267
34,SIBIU,"GRĂDINIŢA CU PROGRAM PRELUNGIT NR.12",109,"MUNICIPIUL MEDIAŞ",143619,1,PART,PRCNCT,PRSD,PRSD_SV,"2025-05-18 21:23:09",980,469,390,48,31,463,6,1080,611,188,275
34,SIBIU,"ŞCOALA GIMNAZIALĂ MIHAI EMINESCU",110,"MUNICIPIUL MEDIAŞ",143619,1,PART,PRCNCT,PRSD,PRSD_SV,"2025-05-18 21:47:14",1215,574,520,54,0,569,5,1340,766,214,355
34,SIBIU,"GRĂDINIŢA CU PROGRAM PRELUNGIT BUCURIA COPIILOR",111,"MUNICIPIUL MEDIAŞ",143619,1,PART,PRCNCT,PRSD,PRSD_SV,"2025-05-18 21:57:22",1096,552,526,26,0,544,8,1200,648,175,369
34,SIBIU,"VESTIAR SPARTA",112,"MUNICIPIUL MEDIAŞ",143619,1,PART,PRCNCT,PRSD,PRSD_SV,"2025-05-18 21:27:04",716,398,366,30,2,391,7,790,392,124,267
34,SIBIU,"STADIONUL MUNICIPAL GAZ METAN",113,"MUNICIPIUL MEDIAŞ",143619,1,PART,PRCNCT,PRSD,PRSD_SV,"2025-05-18 21:45:15",834,461,431,30,0,456,5,920,459,162,294
34,SIBIU,"SC HULA VECHE SRL",114,"MUNICIPIUL MEDIAŞ",143619,1,PART,PRCNCT,PRSD,PRSD_SV,"2025-05-18 22:25:00",1210,617,581,36,0,611,6,1320,703,264,347
34,SIBIU,"CLUBUL COPIILOR",115,"MUNICIPIUL MEDIAŞ",143619,1,PART,PRCNCT,PRSD,PRSD_SV,"2025-05-18 22:08:22",983,495,461,34,0,482,13,1080,585,172,310
34,SIBIU,"CENTRU ŞCOLAR DE EDUCAŢIE INCLUZIVĂ MEDIAŞ",116,"MUNICIPIUL MEDIAŞ",143619,1,PART,PRCNCT,PRSD,PRSD_SV,"2025-05-18 21:46:22",1113,575,524,49,2,570,5,1220,645,201,369
34,SIBIU,"ŞCOALA GIMNAZIALĂ NR.7",117,"MUNICIPIUL MEDIAŞ",143619,1,PART,PRCNCT,PRSD,PRSD_SV,"2025-05-18 21:42:26",1235,576,540,36,0,574,2,1350,774,234,340
34,SIBIU,"ŞCOALA GIMNAZIALĂ NR.7",118,"MUNICIPIUL MEDIAŞ",143619,1,PART,PRCNCT,PRSD,PRSD_SV,"2025-05-18 21:36:17",889,352,330,21,1,347,5,980,628,171,176
34,SIBIU,"ŞCOALA GIMNAZIALĂ NR.7",119,"MUNICIPIUL MEDIAŞ",143619,1,PART,PRCNCT,PRSD,PRSD_SV,"2025-05-18 21:25:42",1068,501,490,11,0,496,5,1170,669,188,308
34,SIBIU,"ŞCOALA GIMNAZIALĂ NR.7",120,"MUNICIPIUL MEDIAŞ",143619,1,PART,PRCNCT,PRSD,PRSD_SV,"2025-05-18 21:25:07",913,360,335,25,0,356,4,1000,640,172,184
34,SIBIU,"GRĂDINIŢA CU PROGRAM PRELUNGIT RAZĂ DE SOARE",121,"MUNICIPIUL MEDIAŞ",143619,1,PART,PRCNCT,PRSD,PRSD_SV,"2025-05-18 22:08:04",1139,526,481,44,1,515,11,1240,714,197,318
34,SIBIU,"ŞCOALA GIMNAZIALĂ NR.7 CORP A",122,"MUNICIPIUL MEDIAŞ",143619,1,PART,PRCNCT,PRSD,PRSD_SV,"2025-05-18 21:41:53",918,431,388,42,1,426,5,1000,569,145,281
34,SIBIU,"ŞCOALA GIMNAZIALĂ NR.7 CORP A",123,"MUNICIPIUL MEDIAŞ",143619,1,PART,PRCNCT,PRSD,PRSD_SV,"2025-05-18 22:02:04",1059,385,363,21,1,378,7,1150,765,205,173
34,SIBIU,"ŞCOALA GIMNAZIALĂ NR.7 CORP A",124,"MUNICIPIUL MEDIAŞ",143619,1,PART,PRCNCT,PRSD,PRSD_SV,"2025-05-18 21:34:44",1032,391,365,26,0,387,4,1130,739,167,220
34,SIBIU,"GRĂDINIŢA CU PROGRAM PRELUNGIT PITICOT",125,"MUNICIPIUL MEDIAŞ",143619,1,PART,PRCNCT,PRSD,PRSD_SV,"2025-05-18 21:56:34",1272,619,551,61,7,598,21,1370,751,369,229
34,SIBIU,"AUTOGARA MEDIAŞ",126,"MUNICIPIUL MEDIAŞ",143619,1,PART,PRCNCT,PRSD,PRSD_SV,"2025-05-18 21:21:10",1134,561,484,77,0,556,5,1250,689,234,322
34,SIBIU,"ŞCOALA GIMNAZIALĂ NR.4",127,"MUNICIPIUL MEDIAŞ",143619,1,PART,PRCNCT,PRSD,PRSD_SV,"2025-05-18 21:33:32",1022,575,528,46,1,565,10,1110,535,193,372
34,SIBIU,"ŞCOALA GIMNAZIALĂ NR.4",128,"MUNICIPIUL MEDIAŞ",143619,1,PART,PRCNCT,PRSD,PRSD_SV,"2025-05-18 21:50:09",1020,508,459,48,1,504,4,1120,612,167,337
34,SIBIU,"CREŞA NR.3",129,"MUNICIPIUL MEDIAŞ",143619,1,PART,PRCNCT,PRSD,PRSD_SV,"2025-05-18 21:56:20",1121,546,512,34,0,541,5,1230,684,184,357
34,SIBIU,"SC AUTOMECANICA SA",130,"MUNICIPIUL MEDIAŞ",143619,1,PART,PRCNCT,PRSD,PRSD_SV,"2025-05-18 21:53:00",555,307,273,34,0,299,8,610,303,138,161
34,SIBIU,"ŞCOALA GIMNAZIALĂ GEORGE POPA",131,"MUNICIPIUL MEDIAŞ",143619,1,PART,PRCNCT,PRSD,PRSD_SV,"2025-05-18 22:05:12",1273,684,623,60,1,672,12,1380,696,271,401
34,SIBIU,"ŞCOALA GIMNAZIALĂ GEORGE POPA",132,"MUNICIPIUL MEDIAŞ",143619,1,PART,PRCNCT,PRSD,PRSD_SV,"2025-05-18 22:10:29",931,487,459,27,1,482,5,1010,523,193,289
34,SIBIU,"ŞCOALA GIMNAZIALĂ GEORGE POPA",133,"MUNICIPIUL MEDIAŞ",143619,1,PART,PRCNCT,PRSD,PRSD_SV,"2025-05-18 21:52:18",1356,552,539,13,0,549,3,1460,908,292,257
34,SIBIU,"COMPLEX COMERCIAL",134,"MUNICIPIUL MEDIAŞ",143619,1,PART,PRCNCT,PRSD,PRSD_SV,"2025-05-18 21:42:35",1235,650,615,35,0,646,4,1340,690,227,419
34,SIBIU,"LICEUL TEORECTIC ”AXENTE SEVER”",135,"MUNICIPIUL MEDIAŞ",143619,1,PART,PRCNCT,PRSD,PRSD_SV,"2025-05-18 21:52:20",1138,570,517,50,3,562,8,1240,670,222,340
34,SIBIU,"COLEGIUL ”ŞCOALA NAŢIONALĂ DE GAZ”",136,"MUNICIPIUL MEDIAŞ",143619,1,PART,PRCNCT,PRSD,PRSD_SV,"2025-05-18 21:35:25",1053,534,487,47,0,526,8,1140,606,207,319
34,SIBIU,"CASA DE OASPETI",137,"MUNICIPIUL MEDIAŞ",143619,1,PART,PRCNCT,PRSD,PRSD_SV,"2025-05-18 22:09:24",738,364,344,19,1,359,5,810,446,119,240
34,SIBIU,"LICEUL TEHNOLOGIC ”MEDIENSIS”",138,"MUNICIPIUL MEDIAŞ",143619,1,PART,PRCNCT,PRSD,PRSD_SV,"2025-05-18 21:51:14",1334,684,637,47,0,675,9,1470,786,271,404
34,SIBIU,"ŞCOALA GIMNAZIALĂ CIREŞARII",139,"MUNICIPIUL MEDIAŞ",143619,1,PART,PRCNCT,PRSD,PRSD_SV,"2025-05-18 21:54:23",1285,650,616,33,1,638,12,1400,750,232,406
34,SIBIU,"GRĂDINIŢA CU PROGRAM PRELUNGIT PINOCCHIO",140,"MUNICIPIUL MEDIAŞ",143619,1,PART,PRCNCT,PRSD,PRSD_SV,"2025-05-18 21:49:15",1190,554,516,38,0,552,2,1300,746,231,321
34,SIBIU,"ŞCOALA GIMNAZIALĂ CONSTANTIN IOAN MOTAŞ",141,"MUNICIPIUL MEDIAŞ",143619,1,PART,PRCNCT,PRSD,PRSD_SV,"2025-05-18 21:53:43",1137,550,478,72,0,542,8,1250,700,231,311
34,SIBIU,"ŞCOALA GIMNAZIALĂ CONSTANTIN IOAN MOTAŞ",142,"MUNICIPIUL MEDIAŞ",143619,1,PART,PRCNCT,PRSD,PRSD_SV,"2025-05-18 21:48:42",1256,538,505,33,0,527,11,1360,822,200,327
34,SIBIU,"ŞCOALA GIMNAZIALĂ CONSTANTIN IOAN MOTAŞ",143,"MUNICIPIUL MEDIAŞ",143619,1,PART,PRCNCT,PRSD,PRSD_SV,"2025-05-18 21:54:55",1258,537,513,22,2,536,1,1360,823,219,317
34,SIBIU,"ŞCOALA GIMNAZIALĂ CONSTANTIN IOAN MOTAŞ",144,"MUNICIPIUL MEDIAŞ",143619,1,PART,PRCNCT,PRSD,PRSD_SV,"2025-05-18 21:50:56",1094,482,466,16,0,476,6,1200,718,242,234
34,SIBIU,"ŞCOALA GIMNAZIALĂ CONSTANTIN IOAN MOTAŞ",145,"MUNICIPIUL MEDIAŞ",143619,1,PART,PRCNCT,PRSD,PRSD_SV,"2025-05-18 21:37:00",1249,552,522,29,1,547,5,1370,818,205,342
34,SIBIU,"ŞCOALA GIMNAZIALĂ CONSTANTIN IOAN MOTAŞ",146,"MUNICIPIUL MEDIAŞ",143619,1,PART,PRCNCT,PRSD,PRSD_SV,"2025-05-18 21:31:04",1006,449,433,15,1,443,6,1110,661,184,259
34,SIBIU,"UNIVERSITATEA LUCIAN BLAGA",147,"MUNICIPIUL MEDIAŞ",143619,1,PART,PRCNCT,PRSD,PRSD_SV,"2025-05-18 21:40:03",1073,516,474,42,0,504,12,1180,664,203,301
34,SIBIU,"UNIVERSITATEA LUCIAN BLAGA",148,"MUNICIPIUL MEDIAŞ",143619,1,PART,PRCNCT,PRSD,PRSD_SV,"2025-05-18 21:38:08",1360,653,610,42,1,640,13,1490,837,239,401
34,SIBIU,"ŞCOALA GIMNAZIALĂ",149,"MUNICIPIUL MEDIAŞ",143619,1,PART,PRCNCT,PRSD,PRSD_SV,"2025-05-18 21:39:03",1321,507,470,35,2,496,11,1450,943,382,114
34,SIBIU,"ŞCOALA GIMNAZIALĂ G.D.TEUTSCH",150,"ORAŞ AGNITA",143682,1,PART,PRCNCT,PRSD,PRSD_SV,"2025-05-18 21:29:21",1152,456,397,46,13,446,10,1270,814,205,241
34,SIBIU,"ŞCOALA GIMNAZIALĂ G.D.TEUTSCH",151,"ORAŞ AGNITA",143682,1,PART,PRCNCT,PRSD,PRSD_SV,"2025-05-18 21:43:33",1036,480,449,29,2,477,3,1140,660,192,285
34,SIBIU,"ȘCOALA GIMNAZIALĂ G.D. TEUTSCH",152,"ORAŞ AGNITA",143682,1,PART,PRCNCT,PRSD,PRSD_SV,"2025-05-18 21:30:35",972,359,343,16,0,351,8,1070,711,161,190
34,SIBIU,"PRIMĂRIA ORAȘULUI AGNITA",153,"ORAŞ AGNITA",143682,1,PART,PRCNCT,PRSD,PRSD_SV,"2025-05-18 21:32:51",1337,500,432,42,26,493,7,1470,970,205,288
34,SIBIU,"COLEGIUL TEHNIC A.T. LAUREAN",154,"ORAŞ AGNITA",143682,1,PART,PRCNCT,PRSD,PRSD_SV,"2025-05-18 21:32:17",1014,402,381,21,0,399,3,1110,708,240,159
34,SIBIU,"CASA DE CULTURĂ ”ILARION COCIȘIU”",155,"ORAŞ AGNITA",143682,1,PART,PRCNCT,PRSD,PRSD_SV,"2025-05-18 21:59:24",1184,454,416,37,1,451,3,1300,846,233,218
34,SIBIU,"GRĂDINIŢA CU PROGRAM PRELUNGIT NR.2",156,"ORAŞ AGNITA",143682,1,PART,PRCNCT,PRSD,PRSD_SV,"2025-05-18 21:45:26",1134,507,477,30,0,502,5,1250,743,187,315
34,SIBIU,"SPAȚIU COMERCIAL",157,"ORAŞ AGNITA",143682,1,PART,PRCNCT,PRSD,PRSD_SV,"2025-05-18 21:37:06",525,258,233,25,0,257,1,600,342,159,98
34,SIBIU,"ŞCOALA GIMNAZIALĂ RUJA",158,"ORAŞ AGNITA",143682,1,PART,PRCNCT,PRSD,PRSD_SV,"2025-05-18 21:31:36",971,444,405,39,0,441,3,1070,626,337,104
34,SIBIU,"GRADINITA NR.3 PROGRAM PRELUNGIT",159,"ORAŞ AVRIG",144054,1,PART,PRCNCT,PRSD,PRSD_SV,"2025-05-18 22:22:12",1447,792,639,153,0,785,7,1590,798,474,311
34,SIBIU,"SCOALA GIMNAZIALA AVRIG",160,"ORAŞ AVRIG",144054,1,PART,PRCNCT,PRSD,PRSD_SV,"2025-05-18 21:30:19",1468,807,704,102,1,797,10,1620,813,395,402
34,SIBIU,"ŞCOALA GIMNAZIALA AVRIG",161,"ORAŞ AVRIG",144054,1,PART,PRCNCT,PRSD,PRSD_SV,"2025-05-18 21:24:53",1183,733,649,79,5,726,7,1300,567,313,413
34,SIBIU,"GRADINITA NR,1 PROGRAM NORMAL",162,"ORAŞ AVRIG",144054,1,PART,PRCNCT,PRSD,PRSD_SV,"2025-05-18 21:57:57",1584,874,807,64,3,859,15,1740,866,443,416
34,SIBIU,"LICEUL ”GHEORGHE LAZĂR”, AVRIG",163,"ORAŞ AVRIG",144054,1,PART,PRCNCT,PRSD,PRSD_SV,"2025-05-18 21:44:19",1229,677,576,99,2,670,7,1350,673,329,341
34,SIBIU,"LICEUL ”GHEORGHE LAZĂR”, AVRIG",164,"ORAŞ AVRIG",144054,1,PART,PRCNCT,PRSD,PRSD_SV,"2025-05-18 21:57:26",1352,756,727,29,0,748,8,1480,724,335,413
34,SIBIU,"ŞCOLA GIMNAZIALĂ BRADU",165,"ORAŞ AVRIG",144054,1,PART,PRCNCT,PRSD,PRSD_SV,"2025-05-18 21:29:51",897,494,419,75,0,486,8,980,486,289,197
34,SIBIU,"ŞCOALA PRIMARĂ GLÎMBOACA",166,"ORAŞ AVRIG",144054,1,PART,PRCNCT,PRSD,PRSD_SV,"2025-05-18 21:18:44",203,133,109,24,0,133,0,220,87,83,50
34,SIBIU,"LICEUL ”TEHNOLOGIC MÂRŞA",167,"ORAŞ AVRIG",144054,1,PART,PRCNCT,PRSD,PRSD_SV,"2025-05-18 21:28:32",1253,619,570,49,0,617,2,1370,751,377,240
34,SIBIU,"LICEUL ”TEHNOLOGIC MÂRŞA",168,"ORAŞ AVRIG",144054,2,PART,PRCNCT,PRSD,PRSD_SV,"2025-05-18 23:55:57",1261,639,602,37,0,629,10,1380,741,355,274
34,SIBIU,"ŞCOLA PRIMARĂ SĂCĂDATE",169,"ORAŞ AVRIG",144054,1,PART,PRCNCT,PRSD,PRSD_SV,"2025-05-18 21:16:04",490,285,236,49,0,284,1,540,255,151,133
34,SIBIU,"GRĂDINIȚA CU PROGRAM NORMAL NR. 1",170,"ORAŞ CISNĂDIE",143735,1,PART,PRCNCT,PRSD,PRSD_SV,"2025-05-18 21:37:35",1713,1004,851,153,0,987,17,1890,886,415,572
34,SIBIU,"GRĂDINIŢA CU PROGRAM PRELUNGIT NR.7",171,"ORAŞ CISNĂDIE",143735,1,PART,PRCNCT,PRSD,PRSD_SV,"2025-05-18 21:56:00",1644,814,739,75,0,808,6,1810,996,327,481
34,SIBIU,"ȘCOALA GIMNAZIALĂ NR. 3",172,"ORAŞ CISNĂDIE",143735,1,PART,PRCNCT,PRSD,PRSD_SV,"2025-05-18 21:30:03",1417,698,632,66,0,693,5,1560,862,270,423
34,SIBIU,"ŞCOALA GIMNAZIALĂ NR.3 CISNĂDIE",173,"ORAŞ CISNĂDIE",143735,1,PART,PRCNCT,PRSD,PRSD_SV,"2025-05-18 21:40:55",1585,784,715,41,28,778,6,1730,946,275,503
34,SIBIU,"GRĂDINIŢA CU PROGRAM PRELUNGIT NR.6",174,"ORAŞ CISNĂDIE",143735,1,PART,PRCNCT,PRSD,PRSD_SV,"2025-05-18 21:38:18",1328,644,587,57,0,637,7,1460,816,273,364
34,SIBIU,"LICEUL TEORETIC ”GUSTAV GUNDISCH” CISNĂDIE",175,"ORAŞ CISNĂDIE",143735,1,PART,PRCNCT,PRSD,PRSD_SV,"2025-05-18 22:04:24",1779,823,749,72,2,811,12,1960,1137,389,422
34,SIBIU,"ŞCOALA GIMNAZIALĂ NR. 2 CISNĂDIE",176,"ORAŞ CISNĂDIE",143735,1,PART,PRCNCT,PRSD,PRSD_SV,"2025-05-18 22:08:08",1829,975,896,77,2,970,3,2010,1037,379,591
34,SIBIU,"LICEUL TEHNOLOGIC",177,"ORAŞ CISNĂDIE",143735,1,PART,PRCNCT,PRSD,PRSD_SV,"2025-05-18 21:47:27",1552,745,693,52,0,730,15,1710,965,300,430
34,SIBIU,"LICEUL TEHNOLOGIC CISNĂDIE",178,"ORAŞ CISNĂDIE",143735,1,PART,PRCNCT,PRSD,PRSD_SV,"2025-05-18 22:06:01",1089,543,508,35,0,535,8,1200,657,231,304
34,SIBIU,"LICEUL TEHNOLOGIC CISNĂDIE",179,"ORAŞ CISNĂDIE",143735,1,PART,PRCNCT,PRSD,PRSD_SV,"2025-05-18 21:54:24",1072,497,464,33,0,495,2,1180,683,277,218
34,SIBIU,"GRĂDINIȚA CU PROGRAM PRELUNGIT „SF. NICOLAE”",180,"ORAŞ CISNĂDIE",143735,1,PART,PRCNCT,PRSD,PRSD_SV,"2025-05-18 22:10:56",1702,1152,830,322,0,1143,9,1870,718,360,783
34,SIBIU,"KEMO S.R.L.",181,"ORAŞ CISNĂDIE",143735,1,PART,PRCNCT,PRSD,PRSD_SV,"2025-05-18 23:03:48",1576,1172,823,349,0,1165,7,1730,558,355,810
34,SIBIU,"GRĂDINIŢA CU PROGRAM NORMAL „ERI”",182,"ORAŞ CISNĂDIE",143735,1,PART,PRCNCT,PRSD,PRSD_SV,"2025-05-18 22:26:01",1570,1158,980,177,1,1151,7,1720,562,234,917
34,SIBIU,"GRĂDINIȚA CU PROGRAM NORMAL „ERI”",183,"ORAŞ CISNĂDIE",143735,1,PART,PRCNCT,PRSD,PRSD_SV,"2025-05-18 22:23:01",1503,1126,935,191,0,1119,7,1624,498,286,833
34,SIBIU,"GRĂDINIŢA CU PROGRAM NORMAL CISNĂDIOARA",184,"ORAŞ CISNĂDIE",143735,1,PART,PRCNCT,PRSD,PRSD_SV,"2025-05-18 21:39:22",802,485,315,170,0,483,2,880,395,129,354
34,SIBIU,"ŞCOALA GIMNAZIALĂ COPŞA MICĂ, STRADA COLONIA LABORATOR, NR.45",185,"ORAŞ COPŞA MICĂ",143771,1,PART,PRCNCT,PRSD,PRSD_SV,"2025-05-18 21:37:38",1448,551,500,51,0,549,2,1590,1039,438,111
34,SIBIU,"LICEUL TEHNOLOGIC ”NICOLAE TECLU” COPŞA MICĂ, STRADA ŞOSEAUA SIBIULUI, NR.61",186,"ORAŞ COPŞA MICĂ",143771,1,PART,PRCNCT,PRSD,PRSD_SV,"2025-05-18 22:10:10",1407,578,509,68,1,572,6,1550,972,345,227
34,SIBIU,"ŞCOALA GIMNAZIALĂ NR.1 COPŞA MICĂ,STRADA ŞOSEAUA MEDIAŞULUI, NR.93",187,"ORAŞ COPŞA MICĂ",143771,1,PART,PRCNCT,PRSD,PRSD_SV,"2025-05-18 21:43:25",1211,426,381,45,0,423,3,1330,904,259,164
34,SIBIU,"ŞCOALA PRIMARĂ NR. 2 COPŞA MICĂ, STRADA TÂRNĂVIOARA, NR.76",188,"ORAŞ COPŞA MICĂ",143771,1,PART,PRCNCT,PRSD,PRSD_SV,"2025-05-18 21:44:04",445,176,152,23,1,174,2,480,304,133,41
34,SIBIU,"LICEUL ”TIMOTEI CIPARIU” DUMBRĂVENI",189,"ORAŞ DUMBRĂVENI",143806,1,PART,PRCNCT,PRSD,PRSD_SV,"2025-05-18 22:13:07",1098,557,512,45,0,551,6,1200,643,292,259
34,SIBIU,"LICEUL ”TIMOTEI CIPARIU” DUMBRĂVENI",190,"ORAŞ DUMBRĂVENI",143806,1,PART,PRCNCT,PRSD,PRSD_SV,"2025-05-18 21:47:42",1150,399,377,22,0,396,3,1260,861,284,112
34,SIBIU,"CENTRUL ŞCOLAR PENTRU EDUCAŢIE INCLUZIVĂ DUMBRĂVENI",191,"ORAŞ DUMBRĂVENI",143806,1,PART,PRCNCT,PRSD,PRSD_SV,"2025-05-18 21:44:30",1175,486,433,48,5,476,10,1290,804,228,248
34,SIBIU,"CASA DE CULTURĂ DUMBRĂVENI",192,"ORAŞ DUMBRĂVENI",143806,1,PART,PRCNCT,PRSD,PRSD_SV,"2025-05-18 21:55:24",1173,558,502,56,0,555,3,1290,732,241,314
34,SIBIU,"CĂMINUL CULTURAL ERNEA",193,"ORAŞ DUMBRĂVENI",143806,1,PART,PRCNCT,PRSD,PRSD_SV,"2025-05-18 21:38:48",404,170,151,19,0,167,3,440,270,144,23
34,SIBIU,"GRADINITȚA CU PROGRAM NORMAL ȘAROȘ PE TARNAVE",194,"ORAŞ DUMBRĂVENI",143806,1,PART,PRCNCT,PRSD,PRSD_SV,"2025-05-18 22:01:17",1408,510,477,30,3,498,12,1540,1030,354,144
34,SIBIU,"PRIMĂRIA ORAŞULUI MIERCUREA SIBIULUI",195,"ORAŞ MIERCUREA SIBIULUI",144928,1,PART,PRCNCT,PRSD,PRSD_SV,"2025-05-18 21:35:52",792,444,383,61,0,441,3,870,426,300,141
34,SIBIU,"PRIMĂRIA ORAŞULUI MIERCUREA SIBIULUI",196,"ORAŞ MIERCUREA SIBIULUI",144928,1,PART,PRCNCT,PRSD,PRSD_SV,"2025-05-18 21:41:42",938,388,357,30,1,385,3,1030,642,243,142
34,SIBIU,"CAMIN CULTURAL",197,"ORAŞ MIERCUREA SIBIULUI",144928,1,PART,PRCNCT,PRSD,PRSD_SV,"2025-05-18 21:26:58",1478,405,337,67,1,403,2,1620,1215,239,164
34,SIBIU,"CAMIN CULTURAL",198,"ORAŞ MIERCUREA SIBIULUI",144928,1,PART,PRCNCT,PRSD,PRSD_SV,"2025-05-18 21:26:40",657,241,199,42,0,238,3,720,479,177,61
34,SIBIU,"ŞCOALA GIMNAZIALA OCNA SIBIULUI",199,"ORAŞ OCNA SIBIULUI",143851,1,PART,PRCNCT,PRSD,PRSD_SV,"2025-05-18 21:51:44",975,567,507,60,0,559,8,1070,503,251,308
34,SIBIU,"ŞCOALA GIMNAZIALĂ OCNA SIBIULUI",200,"ORAŞ OCNA SIBIULUI",143851,1,PART,PRCNCT,PRSD,PRSD_SV,"2025-05-18 21:32:58",945,490,437,52,1,489,1,1030,540,194,295
34,SIBIU,"CLĂDIREA PAROHIALĂ ORTODOXĂ NR.1 OCNA SIBIULUI",201,"ORAŞ OCNA SIBIULUI",143851,1,PART,PRCNCT,PRSD,PRSD_SV,"2025-05-18 22:22:19",1442,790,729,61,0,779,11,1580,790,481,298
34,SIBIU,"CLADIRE (FOST SEDIU PRIMARIE),TOPÎRCEA",202,"ORAŞ OCNA SIBIULUI",143851,1,PART,PRCNCT,PRSD,PRSD_SV,"2025-05-18 21:27:20",120,112,56,56,0,109,3,130,18,50,59
34,SIBIU,"LICEUL TEHNOLOGIC ”IOAN LUPAȘ”",203,"ORAŞ SĂLIŞTE",145499,1,PART,PRCNCT,PRSD,PRSD_SV,"2025-05-18 22:16:47",1256,741,618,122,1,740,1,1380,639,423,317
34,SIBIU,"LICEUL TEHNOLOGIC ”IOAN LUPAȘ”",204,"ORAŞ SĂLIŞTE",145499,1,PART,PRCNCT,PRSD,PRSD_SV,"2025-05-18 22:01:06",1156,749,617,98,34,739,10,1270,521,390,349
34,SIBIU,"CĂMIN CULTURAL ACILIU",205,"ORAŞ SĂLIŞTE",145499,1,PART,PRCNCT,PRSD,PRSD_SV,"2025-05-18 21:28:14",179,116,73,42,1,115,1,200,84,67,48
34,SIBIU,"ŞCOALA PRIMARĂ AMNAŞ",206,"ORAŞ SĂLIŞTE",145499,1,PART,PRCNCT,PRSD,PRSD_SV,"2025-05-18 21:22:45",356,177,115,62,0,176,1,400,223,112,64
34,SIBIU,"CĂMIN CULTURAL FÂNTÂNELE",207,"ORAŞ SĂLIŞTE",145499,1,PART,PRCNCT,PRSD,PRSD_SV,"2025-05-18 21:13:10",178,153,82,71,0,151,2,200,47,55,96
34,SIBIU,"MUZEUL ETNOGRAFIC ”MARIA COSTACHESCU",208,"ORAŞ SĂLIŞTE",145499,1,PART,PRCNCT,PRSD,PRSD_SV,"2025-05-18 21:20:36",273,175,145,30,0,175,0,300,125,80,95
34,SIBIU,"ŞCOALA PRIMARĂ MAG",209,"ORAŞ SĂLIŞTE",145499,1,PART,PRCNCT,PRSD,PRSD_SV,"2025-05-18 21:24:00",426,265,211,54,0,263,2,460,195,161,102
34,SIBIU,"ŞCOALA GENERALĂ SĂCEL",210,"ORAŞ SĂLIŞTE",145499,1,PART,PRCNCT,PRSD,PRSD_SV,"2025-05-18 21:43:12",464,314,256,58,0,312,2,500,186,164,148
34,SIBIU,"CENTRU DE DOCUMENTARE ȘI INFORMARE SIBIEL",211,"ORAŞ SĂLIŞTE",145499,1,PART,PRCNCT,PRSD,PRSD_SV,"2025-05-18 21:29:46",367,347,194,151,2,345,2,400,53,96,249
34,SIBIU,"CLĂDIREA FOSTEI PRIMĂRII",212,"ORAŞ SĂLIŞTE",145499,1,PART,PRCNCT,PRSD,PRSD_SV,"2025-05-18 21:24:49",328,235,170,65,0,235,0,360,125,95,140
34,SIBIU,"LICEUL TEHOLOGIC ” JOHANNES LEBEL” TĂLMACIU/ȘCOALA GIMNAZIALĂ TĂLMACIU",213,"ORAŞ TĂLMACIU",145827,1,PART,PRCNCT,PRSD,PRSD_SV,"2025-05-18 22:18:30",1527,704,661,43,0,698,6,1680,976,377,321
34,SIBIU,"LICEUL TEHNOLOGIC ”JOHANNES LEBEL” TĂLMACIU/ȘCOALA GIMNAZIALĂ TĂLMACIU",214,"ORAŞ TĂLMACIU",145827,1,PART,PRCNCT,PRSD,PRSD_SV,"2025-05-18 22:09:12",1147,673,597,74,2,660,13,1260,587,297,363
34,SIBIU,"LICEUL TEHNOLOGIC ”JOHANNES LEBEL” TĂLMACIU CORP A",215,"ORAŞ TĂLMACIU",145827,1,PART,PRCNCT,PRSD,PRSD_SV,"2025-05-18 21:38:08",1138,669,604,65,0,662,7,1250,581,316,346
34,SIBIU,"LICEUL TEHNOLOGIC ”JOHANNES LEBEL” TĂLMACIU CORP B",216,"ORAŞ TĂLMACIU",145827,1,PART,PRCNCT,PRSD,PRSD_SV,"2025-05-18 22:10:11",1605,888,818,68,2,873,15,1770,882,356,517
34,SIBIU,"IMOBIL APARȚINÂND PRIMĂRIEI ORAȘULUI TĂLMACIU (FOSTA ȘCOALĂ COLONIA TĂLMACIU II)",217,"ORAŞ TĂLMACIU",145827,1,PART,PRCNCT,PRSD,PRSD_SV,"2025-05-18 21:29:02",220,113,92,21,0,110,3,240,127,78,32
34,SIBIU,"LICEUL TEHNOLOGIC ”JOHANNES LEBEL” TĂLMACIU/ȘCOALA GIMNAZIALĂ TĂLMĂCEL",218,"ORAŞ TĂLMACIU",145827,1,PART,PRCNCT,PRSD,PRSD_SV,"2025-05-18 21:46:05",952,572,514,58,0,567,5,1040,468,352,215
34,SIBIU,"CĂMINUL CULTURAL ALMA",219,ALMA,146012,1,PART,PRCNCT,PRSD,PRSD_SV,"2025-05-18 21:45:26",643,384,327,48,9,376,8,700,316,174,202
34,SIBIU,"CĂMINUL CULTURAL GIACĂŞ",220,ALMA,146012,1,PART,PRCNCT,PRSD,PRSD_SV,"2025-05-18 21:28:49",170,111,86,25,0,109,2,190,79,76,33
34,SIBIU,"CĂMINUL CULTURAL ŞMIG",221,ALMA,146012,1,PART,PRCNCT,PRSD,PRSD_SV,"2025-05-18 21:46:15",714,456,416,38,2,453,3,780,324,242,211
34,SIBIU,"SEDIU PRIMARIA",222,ALŢINA,143888,1,PART,PRCNCT,PRSD,PRSD_SV,"2025-05-18 22:01:45",1073,495,444,51,0,494,1,1180,685,265,229
34,SIBIU,"FOST SEDIU CAP",223,ALŢINA,143888,1,PART,PRCNCT,PRSD,PRSD_SV,"2025-05-18 21:28:27",239,117,88,29,0,107,10,260,143,74,33
34,SIBIU,"FOST SEDIU CAP",224,ALŢINA,143888,1,PART,PRCNCT,PRSD,PRSD_SV,"2025-05-18 21:15:50",115,87,51,35,1,87,0,120,33,44,43
34,SIBIU,"CĂMINUL CULTURAL APOLDU DE JOS",225,"APOLDU DE JOS",143922,1,PART,PRCNCT,PRSD,PRSD_SV,"2025-05-18 21:35:50",811,493,398,92,3,486,7,890,397,252,234
34,SIBIU,"CĂMINUL CULTURAL SÂNGĂTIN",226,"APOLDU DE JOS",143922,1,PART,PRCNCT,PRSD,PRSD_SV,"2025-05-18 21:15:24",221,160,119,41,0,159,1,240,80,82,77
34,SIBIU,"CĂMIN CULTURAL ARPAȘU DE JOS",227,"ARPAŞU DE JOS",143959,1,PART,PRCNCT,PRSD,PRSD_SV,"2025-05-18 21:42:04",920,509,417,92,0,505,4,1010,501,326,179
34,SIBIU,"CLĂDIREA ȘCOLII GIMNAZIALE AUREL POPA- ARPAȘU DE SUS",228,"ARPAŞU DE JOS",143959,1,PART,PRCNCT,PRSD,PRSD_SV,"2025-05-18 21:47:29",1039,650,566,82,2,647,3,1130,480,364,283
34,SIBIU,"CĂMINUL CULTURAL NOU ROMÂN",229,"ARPAŞU DE JOS",143959,1,PART,PRCNCT,PRSD,PRSD_SV,"2025-05-18 21:27:47",293,194,129,63,2,190,4,320,126,79,111
34,SIBIU,"PRIMARIA ATEL",230,AŢEL,143995,1,PART,PRCNCT,PRSD,PRSD_SV,"2025-05-18 22:06:33",1163,479,428,51,0,477,2,1280,801,307,170
34,SIBIU,"CLADIREA PRIMARIEI (FOSTA SCOALA), DUPUS NR. 107.",231,AŢEL,143995,1,PART,PRCNCT,PRSD,PRSD_SV,"2025-05-18 21:45:00",191,73,52,21,0,73,0,210,137,41,32
34,SIBIU,"ȘCOALA GIMNAZIALĂ AXENTE SEVER",232,"AXENTE SEVER",144116,3,PART,PRCNCT,PRSD,PRSD_SV,"2025-05-19 01:38:13",1011,449,399,47,3,444,5,1110,661,194,250
34,SIBIU,"SALA DE FESTIVITĂȚI",233,"AXENTE SEVER",144116,1,PART,PRCNCT,PRSD,PRSD_SV,"2025-05-18 21:37:10",1022,420,384,36,0,417,3,1120,700,306,111
34,SIBIU,"CĂMIN CULTURAL",234,"AXENTE SEVER",144116,1,PART,PRCNCT,PRSD,PRSD_SV,"2025-05-18 21:46:58",1144,550,486,62,2,544,6,1250,700,362,182
34,SIBIU,"CĂMIN CULTURAL",235,"AXENTE SEVER",144116,1,PART,PRCNCT,PRSD,PRSD_SV,"2025-05-18 21:36:34",270,125,96,29,0,124,1,300,175,72,52
34,SIBIU,"PRIMARIA BAZNA",236,BAZNA,144152,1,PART,PRCNCT,PRSD,PRSD_SV,"2025-05-18 22:03:32",1385,570,470,100,0,564,6,1520,950,307,257
34,SIBIU,"SCOALA GIMNAZIALA BOIAN",237,BAZNA,144152,1,PART,PRCNCT,PRSD,PRSD_SV,"2025-05-18 21:49:57",1148,432,395,37,0,427,5,1260,828,314,113
34,SIBIU,"SCOALA PRIMARĂ VELȚ",238,BAZNA,144152,1,PART,PRCNCT,PRSD,PRSD_SV,"2025-05-18 21:41:54",481,182,152,30,0,177,5,520,338,118,59
34,SIBIU,"GRĂDINIȚA CU PROGRAM NORMAL BÎRGHIȘ",239,BÂRGHIŞ,144232,1,PART,PRCNCT,PRSD,PRSD_SV,"2025-05-18 21:25:44",617,280,246,34,0,276,4,670,390,138,138
34,SIBIU,"ŞCOALA PRIMARĂ APOȘ",240,BÂRGHIŞ,144232,1,PART,PRCNCT,PRSD,PRSD_SV,"2025-05-18 21:26:45",280,126,110,16,0,123,3,300,174,105,18
34,SIBIU,"CĂMIN CULTURAL IGHIŞU VECHI",241,BÂRGHIŞ,144232,1,PART,PRCNCT,PRSD,PRSD_SV,"2025-05-18 21:17:16",188,113,79,34,0,111,2,200,87,72,39
34,SIBIU,"ŞCOALA PRIMARĂ PELIȘOR",242,BÂRGHIŞ,144232,1,PART,PRCNCT,PRSD,PRSD_SV,"2025-05-18 21:27:07",401,159,130,29,0,158,1,440,281,113,45
34,SIBIU,"DISPENSAR UMAN VECERD",243,BÂRGHIŞ,144232,1,PART,PRCNCT,PRSD,PRSD_SV,"2025-05-18 21:16:57",88,65,29,36,0,63,2,100,35,40,23
34,SIBIU,"ŞCOALA PRIMARĂ ZLAGNA",244,BÂRGHIŞ,144232,1,PART,PRCNCT,PRSD,PRSD_SV,"2025-05-18 21:19:26",140,79,52,27,0,79,0,150,71,49,30
34,SIBIU,"PRIMARIA COMUNEI BIERTAN",245,BIERTAN,144198,1,PART,PRCNCT,PRSD,PRSD_SV,"2025-05-18 21:46:51",1343,499,423,63,13,489,10,1500,1001,286,203
34,SIBIU,"SCOALA PRIMARA COPSA MARE",246,BIERTAN,144198,1,PART,PRCNCT,PRSD,PRSD_SV,"2025-05-18 21:33:18",406,153,128,23,2,149,4,440,287,98,51
34,SIBIU,"SCOALA PRIMARA RICHIS",247,BIERTAN,144198,1,PART,PRCNCT,PRSD,PRSD_SV,"2025-05-18 22:02:20",631,257,215,42,0,256,1,700,443,165,91
34,SIBIU,"CĂMIN CULTURAL",248,BLĂJEL,144303,1,PART,PRCNCT,PRSD,PRSD_SV,"2025-05-18 21:44:09",1425,635,587,47,1,622,13,1600,965,329,293
34,SIBIU,"ŞCOALA GIMNAZIALĂ",249,BLĂJEL,144303,1,PART,PRCNCT,PRSD,PRSD_SV,"2025-05-18 21:36:08",355,202,176,26,0,201,1,408,206,92,109
34,SIBIU,"FOSTA ŞCOALĂ GENERALĂ",250,BLĂJEL,144303,1,PART,PRCNCT,PRSD,PRSD_SV,"2025-05-18 21:07:22",58,47,29,18,0,47,0,100,53,24,23
34,SIBIU,"PRIMĂRIA COMUNEI BOIŢA",251,BOIŢA,146021,1,PART,PRCNCT,PRSD,PRSD_SV,"2025-05-18 23:07:26",1189,764,656,108,0,757,7,1300,536,445,312
34,SIBIU,"CĂMINUL CULTURAL BRATEIU",252,BRATEIU,144349,1,PART,PRCNCT,PRSD,PRSD_SV,"2025-05-18 21:37:37",1178,468,438,29,1,462,6,1300,832,345,117
34,SIBIU,"ŞCOALA GIMNAZIALĂ BRATEIU",253,BRATEIU,144349,1,PART,PRCNCT,PRSD,PRSD_SV,"2025-05-18 21:39:25",854,327,302,23,2,325,2,1000,673,253,72
34,SIBIU,"ŞCOALA GIMNAZIALĂ BUZD",254,BRATEIU,144349,1,PART,PRCNCT,PRSD,PRSD_SV,"2025-05-18 21:49:47",1022,323,307,16,0,322,1,1120,797,281,41
34,SIBIU,"SALA MARE-PRIMĂRIE",255,BRĂDENI,144376,1,PART,PRCNCT,PRSD,PRSD_SV,"2025-05-18 21:26:04",777,298,256,41,1,298,0,850,552,221,77
34,SIBIU,"SALA MARE FOSTĂ PRIMĂRIE",256,BRĂDENI,144376,1,PART,PRCNCT,PRSD,PRSD_SV,"2025-05-18 21:36:42",385,177,132,45,0,177,0,420,243,113,64
34,SIBIU,"FOSTA ŞCOALĂ ŢELINE",257,BRĂDENI,144376,2,PART,PRCNCT,PRSD,PRSD_SV,"2025-05-19 01:35:31",94,47,31,16,0,45,2,100,53,21,24
34,SIBIU,"PRIMĂRIA BRUIU",258,BRUIU,144410,1,PART,PRCNCT,PRSD,PRSD_SV,"2025-05-18 21:29:43",417,156,133,22,1,153,3,460,304,87,66
34,SIBIU,"ȘCOALA PRIMARĂ ȘOMARTIN",259,BRUIU,144410,1,PART,PRCNCT,PRSD,PRSD_SV,"2025-05-18 21:29:53",324,112,92,20,0,110,2,360,248,69,41
34,SIBIU,"PRIMARIA CIRTA",260,CÂRŢA,144508,1,PART,PRCNCT,PRSD,PRSD_SV,"2025-05-18 21:31:11",991,450,359,89,2,446,4,1100,650,256,190
34,SIBIU,"PRIMĂRIA COMUNEI CÎRȚIȘOARA",261,CÂRŢIŞOARA,144535,1,PART,PRCNCT,PRSD,PRSD_SV,"2025-05-18 21:39:12",1146,755,592,160,3,749,6,1300,545,483,266
34,SIBIU,"ŞCOALA GIMNAZIALĂ CHIRPĂR",262,CHIRPĂR,144456,1,PART,PRCNCT,PRSD,PRSD_SV,"2025-05-18 21:50:23",989,265,242,23,0,264,1,1090,825,165,99
34,SIBIU,"CĂMINUL CULTURAL SĂSĂUŞ",263,CHIRPĂR,144456,1,PART,PRCNCT,PRSD,PRSD_SV,"2025-05-18 21:16:01",110,71,43,28,0,70,1,120,49,45,25
34,SIBIU,"CĂMINUL CULTURAL VĂRD",264,CHIRPĂR,144456,1,PART,PRCNCT,PRSD,PRSD_SV,"2025-05-18 21:30:08",291,140,107,32,1,140,0,320,180,105,35
34,SIBIU,"ŞCOALA PRIMARĂ VESEUD",265,CHIRPĂR,144456,1,PART,PRCNCT,PRSD,PRSD_SV,"2025-05-18 21:20:54",157,81,42,39,0,80,1,170,89,41,39
34,SIBIU,"PRIMARIA COMUNEI CRISTIAN",266,CRISTIAN,143487,1,PART,PRCNCT,PRSD,PRSD_SV,"2025-05-18 21:34:20",1314,676,544,131,1,672,4,1440,764,448,224
34,SIBIU,"ȘCOALA GIMNAZIALĂ CRISTIAN-CORP IV, ȘCOALA ROMÂNEASCĂ",267,CRISTIAN,143487,1,PART,PRCNCT,PRSD,PRSD_SV,"2025-05-18 22:06:46",1233,752,642,109,1,750,2,1350,598,307,443
34,SIBIU,"SCOALA GIMNAZIALA , CRISTIAN",268,CRISTIAN,143487,1,PART,PRCNCT,PRSD,PRSD_SV,"2025-05-18 21:57:07",1314,823,702,120,1,809,14,1450,627,327,482
34,SIBIU,"CĂMINUL CULTURAL DÂRLOS",269,DÂRLOS,144553,1,PART,PRCNCT,PRSD,PRSD_SV,"2025-05-18 21:26:07",884,423,383,40,0,420,3,970,547,217,203
34,SIBIU,"ŞCOALA GIMNAZIALĂ ”IOAN MORARU” DÎRLOS",270,DÂRLOS,144553,1,PART,PRCNCT,PRSD,PRSD_SV,"2025-05-18 21:38:51",1054,427,388,39,0,425,2,1160,733,305,120
34,SIBIU,"ŞCOALA GIMNAZIALĂ CURCIU",271,DÂRLOS,144553,1,PART,PRCNCT,PRSD,PRSD_SV,"2025-05-18 21:23:29",777,304,272,32,0,304,0,850,546,209,95
34,SIBIU,"CĂMIN CULTURAL VALEA LUNGĂ",272,DÂRLOS,144553,1,PART,PRCNCT,PRSD,PRSD_SV,"2025-05-18 21:22:16",211,121,100,21,0,121,0,230,109,67,54
34,SIBIU,"ŞCOALA GIMNAZIALĂ ”AUREL DECEI” GURA RÂULUI",273,"GURA RÂULUI",144599,1,PART,PRCNCT,PRSD,PRSD_SV,"2025-05-18 21:53:24",1457,948,817,128,3,938,10,1600,652,547,391
34,SIBIU,"GRĂDINIŢA CU PROGRAM NORMAL NR.2 GURA RÂULUI",274,"GURA RÂULUI",144599,1,PART,PRCNCT,PRSD,PRSD_SV,"2025-05-18 21:46:49",1555,825,767,57,1,814,11,1700,875,535,279
34,SIBIU,"PRIMĂRIA HOGHILAG",275,HOGHILAG,144615,1,PART,PRCNCT,PRSD,PRSD_SV,"2025-05-18 21:35:50",1027,351,323,27,1,349,2,1120,769,259,90
34,SIBIU,"SCOALA PRIMARĂ PROD",276,HOGHILAG,144615,1,PART,PRCNCT,PRSD,PRSD_SV,"2025-05-18 21:30:16",195,153,101,52,0,152,1,220,67,105,47
34,SIBIU,"FOSTA PRIMĂRIE VALCHID",277,HOGHILAG,144615,1,PART,PRCNCT,PRSD,PRSD_SV,"2025-05-18 21:22:59",665,239,217,21,1,236,3,720,481,174,62
34,SIBIU,"LICEUL TEHNOLOGIC IACOBENI",278,IACOBENI,144651,1,PART,PRCNCT,PRSD,PRSD_SV,"2025-05-18 21:37:06",936,359,346,13,0,354,5,1030,671,299,55
34,SIBIU,"ȘCOALA PRIMARĂ MOVILE",279,IACOBENI,144651,1,PART,PRCNCT,PRSD,PRSD_SV,"2025-05-18 21:24:14",273,117,104,13,0,117,0,300,183,85,32
34,SIBIU,"ȘCOALA PRIMARĂ NETUȘ",280,IACOBENI,144651,1,PART,PRCNCT,PRSD,PRSD_SV,"2025-05-18 21:33:46",414,191,168,23,0,191,0,450,259,151,40
34,SIBIU,"ȘCOALA GIMNAZIALĂ NOIȘTAT",281,IACOBENI,144651,1,PART,PRCNCT,PRSD,PRSD_SV,"2025-05-18 21:21:38",464,151,135,16,0,149,2,510,359,99,50
34,SIBIU,"ȘCOALA PRIMARĂ STEJĂRIȘU",282,IACOBENI,144651,1,PART,PRCNCT,PRSD,PRSD_SV,"2025-05-18 21:40:56",413,150,134,16,0,149,1,450,300,122,27
34,SIBIU,"PRIMĂRIA COMUNEI JINA",283,JINA,144713,1,PART,PRCNCT,PRSD,PRSD_SV,"2025-05-18 21:46:28",1431,617,561,56,0,617,0,1560,943,508,109
34,SIBIU,"ŞCOALA GIMNAZIALĂ JINA BĂIEŞI",284,JINA,144713,1,PART,PRCNCT,PRSD,PRSD_SV,"2025-05-18 21:50:35",1208,388,318,70,0,379,9,1330,942,346,33
34,SIBIU,"CĂMIN CULTURAL LASLEA",285,LASLEA,144731,1,PART,PRCNCT,PRSD,PRSD_SV,"2025-05-18 21:46:18",1352,524,472,51,1,518,6,1480,956,339,179
34,SIBIU,"CĂMIN CULTURAL FLOREŞTI",286,LASLEA,144731,1,PART,PRCNCT,PRSD,PRSD_SV,"2025-05-18 21:16:28",111,85,58,27,0,85,0,120,35,31,54
34,SIBIU,"CĂMIN CULTURAL MĂLÎNCRAV",287,LASLEA,144731,1,PART,PRCNCT,PRSD,PRSD_SV,"2025-05-18 21:40:59",1059,421,383,38,0,418,3,1150,729,277,141
34,SIBIU,"ȘCOALA PRIMARĂ NOU SĂSESC",288,LASLEA,144731,1,PART,PRCNCT,PRSD,PRSD_SV,"2025-05-18 21:30:48",597,123,104,19,0,123,0,650,527,62,61
34,SIBIU,"ȘCOALA PRIMARĂ ROANDOLA",289,LASLEA,144731,1,PART,PRCNCT,PRSD,PRSD_SV,"2025-05-18 21:17:55",265,73,59,14,0,73,0,290,217,53,20
34,SIBIU,"CĂMIN CULTURAL LOAMNEŞ",290,LOAMNEŞ,144795,1,PART,PRCNCT,PRSD,PRSD_SV,"2025-05-18 21:15:58",493,307,243,64,0,305,2,550,243,169,136
34,SIBIU,"CĂMIN CULTURAL ALĂMOR",291,LOAMNEŞ,144795,1,PART,PRCNCT,PRSD,PRSD_SV,"2025-05-18 21:32:01",591,330,67,263,0,325,5,650,320,155,170
34,SIBIU,"ŞCOALA PRIMARĂ ARMENI",292,LOAMNEŞ,144795,1,PART,PRCNCT,PRSD,PRSD_SV,"2025-05-18 21:21:06",427,214,160,54,0,213,1,470,256,122,91
34,SIBIU,"ŞCOALA PRIMARĂ HAŞAG",293,LOAMNEŞ,144795,1,PART,PRCNCT,PRSD,PRSD_SV,"2025-05-18 21:38:41",514,309,256,53,0,306,3,560,251,190,116
34,SIBIU,"CĂMIN CULTURAL MÎNDRA",294,LOAMNEŞ,144795,1,PART,PRCNCT,PRSD,PRSD_SV,"2025-05-18 21:43:41",279,194,155,39,0,192,2,300,106,82,110
34,SIBIU,"PRIMĂRIA COMUNEI LUDOȘ",295,LUDOŞ,144866,1,PART,PRCNCT,PRSD,PRSD_SV,"2025-05-18 21:23:19",528,267,194,63,10,264,3,580,313,147,117
34,SIBIU,"PRIMĂRIA MARPOD",296,MARPOD,144893,1,PART,PRCNCT,PRSD,PRSD_SV,"2025-05-18 21:51:31",599,320,258,54,8,314,6,660,340,145,169
34,SIBIU,"FOSTĂ ŞCOALĂ GENERALĂ ILIMBAV",297,MARPOD,144893,1,PART,PRCNCT,PRSD,PRSD_SV,"2025-05-18 21:35:13",172,119,87,32,0,119,0,190,71,61,58
34,SIBIU,"ȘCOALA PRIMARĂ CLASELE I-IV MERGHINDEAL",298,MERGHINDEAL,144964,1,PART,PRCNCT,PRSD,PRSD_SV,"2025-05-18 21:49:05",696,296,265,18,13,294,2,760,464,224,70
34,SIBIU,"ȘCOALA PRIMARĂ DEALU FRUMOS",299,MERGHINDEAL,144964,1,PART,PRCNCT,PRSD,PRSD_SV,"2025-05-18 21:36:36",569,239,201,34,4,238,1,620,381,156,82
34,SIBIU,"ȘCOALA GIMNAZIALĂ ”CORNELIU PĂCURARIU” MICĂSASA",300,MICĂSASA,144991,1,PART,PRCNCT,PRSD,PRSD_SV,"2025-05-18 21:38:31",1070,533,491,35,7,527,6,1170,637,275,252
34,SIBIU,"DISPENSARUL MEDICAL CHESLER",301,MICĂSASA,144991,1,PART,PRCNCT,PRSD,PRSD_SV,"2025-05-18 21:32:14",45,36,22,14,0,36,0,50,14,20,16
34,SIBIU,"ȘCOALA PRIMARĂ ŢAPU",302,MICĂSASA,144991,1,PART,PRCNCT,PRSD,PRSD_SV,"2025-05-18 21:36:13",555,265,232,31,2,260,5,610,345,180,80
34,SIBIU,"PRIMĂRIA COMUNEI MIHĂILENI",303,MIHĂILENI,145042,2,PART,PRCNCT,PRSD,PRSD_SV,"2025-05-18 23:48:15",241,138,98,40,0,138,0,260,122,85,53
34,SIBIU,"ȘCOALA PRIMARĂ METIȘ - CORP NOU",304,MIHĂILENI,145042,1,PART,PRCNCT,PRSD,PRSD_SV,"2025-05-18 21:14:21",253,79,62,17,0,78,1,280,201,45,33
34,SIBIU,"ȘCOALA PRIMARĂ RĂVĂȘEL",305,MIHĂILENI,145042,1,PART,PRCNCT,PRSD,PRSD_SV,"2025-05-18 21:17:59",269,79,58,21,0,77,2,300,221,50,27
34,SIBIU,"CĂMINUL CULTURAL AL COMUNEI MOȘNA",306,MOŞNA,145104,1,PART,PRCNCT,PRSD,PRSD_SV,"2025-05-18 21:25:46",1064,328,318,10,0,323,5,1160,832,270,53
34,SIBIU,"CĂMINUL CULTURAL AL COMUNEI MOȘNA",307,MOŞNA,145104,1,PART,PRCNCT,PRSD,PRSD_SV,"2025-05-18 21:32:18",990,520,465,55,0,511,9,1090,570,292,219
34,SIBIU,"PUNCT DE LUCRU PRIMĂRIE (FOSTA GRĂDINIȚĂ CU PROGRAM NORMAL ALMA VII)",308,MOŞNA,145104,1,PART,PRCNCT,PRSD,PRSD_SV,"2025-05-18 21:22:47",316,149,113,36,0,148,1,350,201,84,64
34,SIBIU,"ȘCOALA GIMNAZIALĂ NEMȘA",309,MOŞNA,145104,1,PART,PRCNCT,PRSD,PRSD_SV,"2025-05-18 21:20:49",485,186,160,26,0,185,1,530,344,138,47
34,SIBIU,"CAMINUL CULTURAL NOCRICH",310,NOCRICH,145140,1,PART,PRCNCT,PRSD,PRSD_SV,"2025-05-18 21:27:40",1191,570,534,36,0,564,6,1300,730,424,140
34,SIBIU,"SCOALA PRIMARA FOFELDEA",311,NOCRICH,145140,1,PART,PRCNCT,PRSD,PRSD_SV,"2025-05-18 21:38:00",366,199,166,32,1,197,2,400,201,146,51
34,SIBIU,"FOSTA SCOALA GHIJASA DE JOS",312,NOCRICH,145140,1,PART,PRCNCT,PRSD,PRSD_SV,"2025-05-18 21:10:44",72,50,29,21,0,50,0,80,30,33,17
34,SIBIU,"SCOALA GIMNAZIALA HOSMAN",313,NOCRICH,145140,1,PART,PRCNCT,PRSD,PRSD_SV,"2025-05-18 21:23:37",762,304,252,52,0,301,3,830,526,163,138
34,SIBIU,"SCOALA PRIMARA ŢICHINDEAL",314,NOCRICH,145140,1,PART,PRCNCT,PRSD,PRSD_SV,"2025-05-18 21:14:38",142,90,64,25,1,87,3,160,70,67,20
34,SIBIU,"GRĂDINIŢA CU PROGRAM NORMAL ORLAT",315,ORLAT,145202,1,PART,PRCNCT,PRSD,PRSD_SV,"2025-05-18 21:59:37",1288,709,610,98,1,703,6,1400,691,440,263
34,SIBIU,"GRĂDINIŢA CU PROGRAM NORMAL ORLAT",316,ORLAT,145202,1,PART,PRCNCT,PRSD,PRSD_SV,"2025-05-18 21:54:46",1400,832,741,88,3,827,5,1540,708,437,390
34,SIBIU,"PRIMARIA COMUNEI PĂUCA",317,PĂUCA,145220,1,PART,PRCNCT,PRSD,PRSD_SV,"2025-05-18 21:28:29",627,229,189,38,2,223,6,700,471,109,114
34,SIBIU,"ŞCOALA GIMNAZIALA BOGATU-ROMÂN",318,PĂUCA,145220,1,PART,PRCNCT,PRSD,PRSD_SV,"2025-05-18 21:14:51",360,192,153,39,0,189,3,400,208,108,81
34,SIBIU,"ŞCOALA PRIMARA BROŞTENI",319,PĂUCA,145220,1,PART,PRCNCT,PRSD,PRSD_SV,"2025-05-18 21:16:53",256,167,139,28,0,166,1,280,113,91,75
34,SIBIU,"ŞCOALA PRIMARA PRESACA",320,PĂUCA,145220,1,PART,PRCNCT,PRSD,PRSD_SV,"2025-05-18 21:15:26",289,186,169,17,0,186,0,320,134,99,87
34,SIBIU,"GRĂDINIȚA CU PROGRAM NORMAL POIANA SIBIULUI",321,"POIANA SIBIULUI",145275,1,PART,PRCNCT,PRSD,PRSD_SV,"2025-05-18 21:25:29",827,312,251,61,0,309,3,910,598,179,130
34,SIBIU,"ȘCOALA GIMNAZIALĂ ”IOAN BAN - DASCĂLU”, POIANA SIBIULUI, NR. 1332",322,"POIANA SIBIULUI",145275,1,PART,PRCNCT,PRSD,PRSD_SV,"2025-05-18 21:30:57",970,272,243,29,0,268,4,1060,788,151,117
34,SIBIU,"CĂMINUL CULTURAL POPLACA",323,POPLACA,143502,1,PART,PRCNCT,PRSD,PRSD_SV,"2025-05-18 21:50:43",1507,924,811,113,0,914,10,1660,736,435,479
34,SIBIU,"SALA DE SPORT A ȘCOLII GIMNAZIALE PORUMBACU DE JOS",324,"PORUMBACU DE JOS",145293,1,PART,PRCNCT,PRSD,PRSD_SV,"2025-05-18 21:50:32",903,485,386,98,1,480,5,1000,515,270,210
34,SIBIU,"CĂMINUL CULTURAL COLUN",325,"PORUMBACU DE JOS",145293,1,PART,PRCNCT,PRSD,PRSD_SV,"2025-05-18 21:31:06",146,101,69,32,0,100,1,160,59,66,34
34,SIBIU,"CĂMINUL CULTURAL PORUMBACU DE SUS",326,"PORUMBACU DE JOS",145293,1,PART,PRCNCT,PRSD,PRSD_SV,"2025-05-18 21:34:18",721,544,369,175,0,543,1,790,246,300,243
34,SIBIU,"CĂMINUL CULTURAL SARATA",327,"PORUMBACU DE JOS",145293,1,PART,PRCNCT,PRSD,PRSD_SV,"2025-05-18 21:17:46",277,170,127,43,0,169,1,300,130,117,52
34,SIBIU,"CĂMINUL CULTURAL SCOREIU",328,"PORUMBACU DE JOS",145293,1,PART,PRCNCT,PRSD,PRSD_SV,"2025-05-18 21:23:48",548,316,210,106,0,314,2,600,284,185,129
34,SIBIU,"CĂMINUL CULTURAL RACOVIŢA",329,RACOVIŢA,145355,1,PART,PRCNCT,PRSD,PRSD_SV,"2025-05-18 21:46:28",1785,1060,978,82,0,1048,12,1970,910,546,502
34,SIBIU,"CĂMINUL CULTURAL SEBEȘU DE SUS",330,RACOVIŢA,145355,1,PART,PRCNCT,PRSD,PRSD_SV,"2025-05-18 21:40:25",593,379,297,80,2,378,1,650,271,217,161
34,SIBIU,"ŞCOALA GIMNAZIALĂ OCTAVIAN GOGA RĂŞINARI",331,RĂŞINARI,143520,1,PART,PRCNCT,PRSD,PRSD_SV,"2025-05-18 21:39:41",1538,751,680,71,0,744,7,1680,929,509,235
34,SIBIU,"ŞCOALA GIMNAZIALĂ SAVA POPOVICI BARCIANU RĂŞINARI",332,RĂŞINARI,143520,1,PART,PRCNCT,PRSD,PRSD_SV,"2025-05-18 21:57:51",1461,780,698,79,3,774,6,1600,820,461,313
34,SIBIU,"CĂMINUL CULTURAL RĂȘINARI",333,RĂŞINARI,143520,1,PART,PRCNCT,PRSD,PRSD_SV,"2025-05-18 21:56:07",1403,916,783,133,0,911,5,1540,624,465,446
34,SIBIU,PRIMĂRIA,334,"RÂU SADULUI",145382,1,PART,PRCNCT,PRSD,PRSD_SV,"2025-05-18 21:35:42",474,289,231,57,1,285,4,520,231,172,113
34,SIBIU,"PRIMARIA ROSIA",335,ROŞIA,145408,1,PART,PRCNCT,PRSD,PRSD_SV,"2025-05-18 21:26:27",1264,559,521,37,1,556,3,1400,841,475,81
34,SIBIU,"SCOALA GIMNAZIALA CAŞOLŢ",336,ROŞIA,145408,1,PART,PRCNCT,PRSD,PRSD_SV,"2025-05-18 21:53:05",757,418,349,69,0,414,4,830,412,241,173
34,SIBIU,"SEDIUL ADMINISTRATIV DISPENSAR",337,ROŞIA,145408,1,PART,PRCNCT,PRSD,PRSD_SV,"2025-05-18 21:24:09",437,300,213,87,0,299,1,480,180,179,120
34,SIBIU,"SCOALA GIMAZIALA DAIA",338,ROŞIA,145408,1,PART,PRCNCT,PRSD,PRSD_SV,"2025-05-18 21:38:31",843,490,404,86,0,488,2,930,440,271,217
34,SIBIU,"SCOALA GIMNAZIALA NOU",339,ROŞIA,145408,1,PART,PRCNCT,PRSD,PRSD_SV,"2025-05-18 21:33:03",1437,625,579,45,1,623,2,1580,955,543,80
34,SIBIU,"CĂMINUL CULTURAL AL COMUNEI SADU",340,SADU,145471,1,PART,PRCNCT,PRSD,PRSD_SV,"2025-05-18 22:01:24",904,590,532,56,2,588,2,1000,410,271,317
34,SIBIU,"CĂMINUL CULTURAL AL COMUNEI SADU",341,SADU,145471,1,PART,PRCNCT,PRSD,PRSD_SV,"2025-05-18 22:27:59",1347,880,775,105,0,873,7,1480,600,367,506
34,SIBIU,"ŞCOALA GIMNAZIALĂ SLIMNIC",342,SLIMNIC,145603,1,PART,PRCNCT,PRSD,PRSD_SV,"2025-05-18 21:49:07",1278,620,563,53,4,615,5,1410,790,393,222
34,SIBIU,"ŞCOALA GIMNAZIALĂ SLIMNIC",343,SLIMNIC,145603,1,PART,PRCNCT,PRSD,PRSD_SV,"2025-05-18 21:31:18",1092,569,514,54,1,565,4,1200,631,341,224
34,SIBIU,"ŞCOALA GIMNAZIALĂ RUŞI (CORP C2)",344,SLIMNIC,145603,1,PART,PRCNCT,PRSD,PRSD_SV,"2025-05-18 21:40:09",711,344,305,39,0,342,2,790,446,174,168
34,SIBIU,"ŞCOALA GIMNAZIALA VESEUD",345,SLIMNIC,145603,1,PART,PRCNCT,PRSD,PRSD_SV,"2025-05-18 21:12:16",164,96,57,39,0,96,0,180,84,31,65
34,SIBIU,"SCOALA GIMNAZIALA SEICA MARE",346,"ŞEICA MARE",145667,1,PART,PRCNCT,PRSD,PRSD_SV,"2025-05-18 21:28:28",945,438,376,59,3,436,2,1040,602,262,174
34,SIBIU,"SCOALA GIMNAZIALA SEICA MARE",347,"ŞEICA MARE",145667,1,PART,PRCNCT,PRSD,PRSD_SV,"2025-05-18 21:37:28",848,371,339,31,1,365,6,940,569,205,160
34,SIBIU,"SCOALA PRIMARA SEICA MARE",348,"ŞEICA MARE",145667,1,PART,PRCNCT,PRSD,PRSD_SV,"2025-05-18 21:38:49",862,498,411,84,3,495,3,950,452,227,268
34,SIBIU,"SCOALA PRIMARA BOARTA",349,"ŞEICA MARE",145667,1,PART,PRCNCT,PRSD,PRSD_SV,"2025-05-18 21:19:06",321,161,137,23,1,161,0,350,189,63,98
34,SIBIU,"SCOALA PRIMARA BUIA",350,"ŞEICA MARE",145667,1,PART,PRCNCT,PRSD,PRSD_SV,"2025-05-18 21:29:07",474,198,160,38,0,197,1,520,322,126,71
34,SIBIU,"CASA PAROHIALA CULT ORTODOX",351,"ŞEICA MARE",145667,1,PART,PRCNCT,PRSD,PRSD_SV,"2025-05-18 21:17:18",48,43,16,27,0,43,0,60,17,12,31
34,SIBIU,"ŞCOALA PRIMARA ŞTENEA",352,"ŞEICA MARE",145667,1,PART,PRCNCT,PRSD,PRSD_SV,"2025-05-18 21:33:47",121,82,52,30,0,81,1,130,48,49,32
34,SIBIU,PRIMARIA,353,"ŞEICA MICĂ",145738,1,PART,PRCNCT,PRSD,PRSD_SV,"2025-05-18 21:55:08",1003,406,352,52,2,403,3,1100,694,238,165
34,SIBIU,"FOSTUL SEDIU CAP SOROŞTIN",354,"ŞEICA MICĂ",145738,1,PART,PRCNCT,PRSD,PRSD_SV,"2025-05-18 21:51:00",438,235,196,39,0,234,1,480,245,91,143
34,SIBIU,"GRĂDINIȚA CU PROGRAM PRELUNGIT ”DOAMNA STANCA”ȘELIMBĂR",355,ŞELIMBĂR,143557,1,PART,PRCNCT,PRSD,PRSD_SV,"2025-05-18 22:01:43",1408,1172,783,388,1,1158,14,1530,358,355,803
34,SIBIU,"GRĂDINIȚA CU PROGRAM PRELUNGIT ”DOAMNA STANCA”ȘELIMBĂR",356,ŞELIMBĂR,143557,1,PART,PRCNCT,PRSD,PRSD_SV,"2025-05-18 21:51:08",1405,1026,785,241,0,1016,10,1540,514,354,662
34,SIBIU,"GRĂDINITA CU PROGRAM PRELUNGIT”DOAMNA STANCA” ȘELIMBĂR",357,ŞELIMBĂR,143557,1,PART,PRCNCT,PRSD,PRSD_SV,"2025-05-18 21:46:21",794,789,468,321,0,782,7,870,81,252,530
34,SIBIU,"ȘCOALA GENERALĂ”MIHAI VITEAZU”ȘELIMBĂR, CORP B",358,ŞELIMBĂR,143557,1,PART,PRCNCT,PRSD,PRSD_SV,"2025-05-18 22:51:39",1923,1373,1118,255,0,1354,19,2100,727,430,924
34,SIBIU,"ŞCOALA GIMNAZIALĂ `MIHAI VITEAZU~ ŞELIMBĂR",359,ŞELIMBĂR,143557,1,PART,PRCNCT,PRSD,PRSD_SV,"2025-05-18 22:45:20",1963,1453,1198,255,0,1435,18,2160,707,422,1013
34,SIBIU,"ȘCOALA GIMNAZIALĂ ”MIHAI VITEAZU” ȘELIMBĂR",360,ŞELIMBĂR,143557,1,PART,PRCNCT,PRSD,PRSD_SV,"2025-05-18 22:25:53",1562,1152,971,153,28,1141,11,1700,548,308,833
34,SIBIU,"GRĂDINIȚA CU PROGRAM PRELUNGIT",361,ŞELIMBĂR,143557,1,PART,PRCNCT,PRSD,PRSD_SV,"2025-05-18 23:44:46",1941,1546,1297,248,1,1531,15,2100,554,345,1186
34,SIBIU,"GRĂDINIȚA CU PROGRAM PRELUNGIT ȘELIMBĂR, CORP NOU, PARTER",362,ŞELIMBĂR,143557,1,PART,PRCNCT,PRSD,PRSD_SV,"2025-05-18 22:31:04",1720,1297,1096,201,0,1287,10,1890,593,316,971
34,SIBIU,"CĂMIN CULTURAL BUNGRAD",363,ŞELIMBĂR,143557,3,PART,PRCNCT,PRSD,PRSD_SV,"2025-05-19 01:41:37",506,281,238,43,0,278,3,560,279,145,133
34,SIBIU,"CĂMIN CULTURAL MOHU",364,ŞELIMBĂR,143557,1,PART,PRCNCT,PRSD,PRSD_SV,"2025-05-18 21:35:19",603,336,289,47,0,331,5,670,334,150,181
34,SIBIU,"CĂMIN CULTURAL VEȘTEM",365,ŞELIMBĂR,143557,1,PART,PRCNCT,PRSD,PRSD_SV,"2025-05-18 22:01:34",1442,829,749,79,1,823,6,1590,761,472,351
34,SIBIU,"SALĂ SPORT",366,"ŞURA MARE",145765,1,PART,PRCNCT,PRSD,PRSD_SV,"2025-05-18 22:05:07",1832,1249,1034,215,0,1236,13,2010,761,517,719
34,SIBIU,"SALĂ SPORT",367,"ŞURA MARE",145765,1,PART,PRCNCT,PRSD,PRSD_SV,"2025-05-18 22:20:05",1785,979,876,102,1,969,10,1960,981,490,479
34,SIBIU,"CĂMIN CULTURAL",368,"ŞURA MARE",145765,1,PART,PRCNCT,PRSD,PRSD_SV,"2025-05-18 21:45:39",796,446,380,65,1,442,4,900,454,235,207
34,SIBIU,"SCOALA GIMNAZIALA SURA MICA",369,"ŞURA MICĂ",145792,1,PART,PRCNCT,PRSD,PRSD_SV,"2025-05-18 21:49:43",1299,672,567,102,3,666,6,1420,748,305,361
34,SIBIU,"ȘCOALA GIMNAZIALĂ CLASELE I-IV ȘURA MICĂ",370,"ŞURA MICĂ",145792,1,PART,PRCNCT,PRSD,PRSD_SV,"2025-05-18 21:48:17",1019,761,595,139,27,757,4,1100,339,295,462
34,SIBIU,"SCOALA PRIMARA RUSCIORI",371,"ŞURA MICĂ",145792,1,PART,PRCNCT,PRSD,PRSD_SV,"2025-05-18 21:29:18",674,297,246,51,0,289,8,750,453,183,106
34,SIBIU,"GRĂDINIŢA CU ORAR NORMAL TÎRNAVA",372,TÂRNAVA,143646,1,PART,PRCNCT,PRSD,PRSD_SV,"2025-05-18 21:52:13",1315,487,455,32,0,483,4,1450,963,325,158
34,SIBIU,"GRĂDINIŢA CU ORAR NORMAL TÎRNAVA",373,TÂRNAVA,143646,1,PART,PRCNCT,PRSD,PRSD_SV,"2025-05-18 21:50:17",1178,499,470,29,0,493,6,1300,801,255,238
34,SIBIU,"PRIMĂRIA TILIŞCA",374,TILIŞCA,145907,1,PART,PRCNCT,PRSD,PRSD_SV,"2025-05-18 21:56:17",788,500,435,65,0,496,4,900,400,203,293
34,SIBIU,"ŞCOALA PRIMARĂ ROD",375,TILIŞCA,145907,1,PART,PRCNCT,PRSD,PRSD_SV,"2025-05-18 21:38:23",315,234,166,68,0,229,5,400,166,144,85
34,SIBIU,"CĂMINUL CULTURAL ”REGELE MIHAI I”",376,"TURNU ROŞU",145934,1,PART,PRCNCT,PRSD,PRSD_SV,"2025-05-18 21:52:21",1542,922,798,124,0,908,14,1700,778,444,464
34,SIBIU,"CĂMINUL CULTURAL",377,"TURNU ROŞU",145934,1,PART,PRCNCT,PRSD,PRSD_SV,"2025-05-18 22:02:09",445,328,229,99,0,325,3,500,172,135,190
34,SIBIU,"CĂMIN VALEA VIILOR",378,"VALEA VIILOR",145961,1,PART,PRCNCT,PRSD,PRSD_SV,"2025-05-18 22:13:32",1251,571,482,60,29,569,2,1400,829,326,243
34,SIBIU,"CĂMIN MOTIȘ",379,"VALEA VIILOR",145961,1,PART,PRCNCT,PRSD,PRSD_SV,"2025-05-18 21:38:11",544,225,192,31,2,224,1,600,375,162,62
34,SIBIU,"GRADINITA 80 LOCURI",380,VURPĂR,145998,1,PART,PRCNCT,PRSD,PRSD_SV,"2025-05-18 21:42:03",1312,438,410,28,0,436,2,1460,1022,363,73
34,SIBIU,"CAMINUL CULTURAL VURPAR",381,VURPĂR,145998,1,PART,PRCNCT,PRSD,PRSD_SV,"2025-05-18 21:43:02",894,316,284,32,0,314,2,1000,684,218,96
35,SUCEAVA,"PRIMĂRIA MUNICIPIULUI SUCEAVA",1,"MUNICIPIUL SUCEAVA",146263,1,PART,PRCNCT,PRSD,PRSD_SV,"2025-05-18 22:17:09",1745,1129,901,217,11,1106,23,1900,771,306,800
35,SUCEAVA,"COLEGIUL NAŢIONAL ”PETRU RAREŞ” SALA A",2,"MUNICIPIUL SUCEAVA",146263,1,PART,PRCNCT,PRSD,PRSD_SV,"2025-05-18 21:50:58",1469,905,731,174,0,890,15,1600,695,237,653
35,SUCEAVA,"COLEGIUL NAŢIONAL ”PETRU RAREŞ” SALA B",3,"MUNICIPIUL SUCEAVA",146263,1,PART,PRCNCT,PRSD,PRSD_SV,"2025-05-18 21:37:54",1475,720,656,64,0,707,13,1600,880,190,517
35,SUCEAVA,"COLEGIUL NAŢIONAL ”ŞTEFAN CEL MARE”",4,"MUNICIPIUL SUCEAVA",146263,1,PART,PRCNCT,PRSD,PRSD_SV,"2025-05-18 21:50:37",1556,803,731,72,0,791,12,1700,897,233,558
35,SUCEAVA,"COLEGIUL NAȚIONAL ”ȘTEFAN CEL MARE”",5,"MUNICIPIUL SUCEAVA",146263,1,PART,PRCNCT,PRSD,PRSD_SV,"2025-05-18 21:47:51",794,467,297,169,1,458,9,900,433,139,319
35,SUCEAVA,"CENTRUL CULTURAL BUCOVINA",6,"MUNICIPIUL SUCEAVA",146263,1,PART,PRCNCT,PRSD,PRSD_SV,"2025-05-18 21:53:16",1523,860,701,154,5,851,9,1700,840,255,596
35,SUCEAVA,"ŞCOALA GIMNAZIALĂ NR .1",7,"MUNICIPIUL SUCEAVA",146263,1,PART,PRCNCT,PRSD,PRSD_SV,"2025-05-18 22:08:11",1351,795,665,129,1,783,12,1500,705,204,579
35,SUCEAVA,"COLEGIUL TEHNIC ”SAMUIL ISOPESCU”",8,"MUNICIPIUL SUCEAVA",146263,1,PART,PRCNCT,PRSD,PRSD_SV,"2025-05-18 21:44:00",1198,796,667,128,1,782,14,1300,504,268,514
35,SUCEAVA,"COLEGIUL DE ARTĂ „CIPRIAN PORUMBESCU” SALA A",9,"MUNICIPIUL SUCEAVA",146263,1,PART,PRCNCT,PRSD,PRSD_SV,"2025-05-18 21:37:11",1157,433,316,117,0,429,4,1200,767,135,294
35,SUCEAVA,"COLEGIUL DE ARTĂ „CIPRIAN PORUMBESCU” SALA B",10,"MUNICIPIUL SUCEAVA",146263,1,PART,PRCNCT,PRSD,PRSD_SV,"2025-05-18 21:54:42",1206,635,569,63,3,624,11,1300,665,204,420
35,SUCEAVA,"ŞCOALA GIMNAZIALĂ NR.3 SALA A",11,"MUNICIPIUL SUCEAVA",146263,1,PART,PRCNCT,PRSD,PRSD_SV,"2025-05-18 21:47:30",949,633,468,161,4,620,13,1000,367,173,447
35,SUCEAVA,"ŞCOALA GIMNAZIALĂ NR.3 SALA B",12,"MUNICIPIUL SUCEAVA",146263,1,PART,PRCNCT,PRSD,PRSD_SV,"2025-05-18 22:04:00",1085,635,578,55,2,622,13,1200,565,180,442
35,SUCEAVA,"COLEGIUL ECONOMIC ” DIMITRIE CANTEMIR”",13,"MUNICIPIUL SUCEAVA",146263,1,PART,PRCNCT,PRSD,PRSD_SV,"2025-05-18 22:01:03",1007,601,499,101,1,600,1,1100,499,154,446
35,SUCEAVA,"CENTRUL PENTRU SUSŢINEREA TRADIŢIILOR BUCOVINENE",14,"MUNICIPIUL SUCEAVA",146263,1,PART,PRCNCT,PRSD,PRSD_SV,"2025-05-18 21:55:52",1281,691,584,107,0,678,13,1400,709,238,440
35,SUCEAVA,"UNIVERSITATEA ”ŞTEFAN CEL MARE”",15,"MUNICIPIUL SUCEAVA",146263,1,PART,PRCNCT,PRSD,PRSD_SV,"2025-05-18 21:51:20",737,987,320,667,0,977,10,1300,313,255,722
35,SUCEAVA,"DIRECŢIA SILVICĂ SUCEAVA",16,"MUNICIPIUL SUCEAVA",146263,1,PART,PRCNCT,PRSD,PRSD_SV,"2025-05-18 21:26:29",1006,569,468,100,1,562,7,1100,531,179,383
35,SUCEAVA,"COLEGIUL NAŢIONAL DE INFORMATICĂ ”SPIRU HARET”, SALA A",17,"MUNICIPIUL SUCEAVA",146263,2,PART,PRCNCT,PRSD,PRSD_SV,"2025-05-18 23:22:31",1036,805,515,11,279,794,11,1600,795,351,443
35,SUCEAVA,"COLEGIUL NAŢIONAL DE INFORMATICĂ ” SPIRU HARET”, SALA B",18,"MUNICIPIUL SUCEAVA",146263,1,PART,PRCNCT,PRSD,PRSD_SV,"2025-05-18 22:01:00",898,704,468,236,0,690,14,1000,296,227,463
35,SUCEAVA,"GRĂDINIŢA CU PROGRAM PRELUNGIT NR.7 ”ABC ”",19,"MUNICIPIUL SUCEAVA",146263,1,PART,PRCNCT,PRSD,PRSD_SV,"2025-05-18 21:38:21",1446,669,591,78,0,661,8,1600,931,211,450
35,SUCEAVA,"ŞCOALA GIMNAZIALĂ NR. 4 SALA A",20,"MUNICIPIUL SUCEAVA",146263,1,PART,PRCNCT,PRSD,PRSD_SV,"2025-05-18 22:08:06",1333,699,638,61,0,683,16,1400,701,265,418
35,SUCEAVA,"ŞCOALA GIMNAZIALĂ NR. 4, SALA B",21,"MUNICIPIUL SUCEAVA",146263,1,PART,PRCNCT,PRSD,PRSD_SV,"2025-05-18 21:33:06",1177,676,614,62,0,660,16,1300,624,213,447
35,SUCEAVA,"ŞCOALA GIMNAZIALĂ NR. 8",22,"MUNICIPIUL SUCEAVA",146263,1,PART,PRCNCT,PRSD,PRSD_SV,"2025-05-18 22:20:22",1919,1066,919,147,0,1045,21,2000,934,380,665
35,SUCEAVA,"GRADINIŢA CU PROGRAM NORMAL NR. 5",23,"MUNICIPIUL SUCEAVA",146263,1,PART,PRCNCT,PRSD,PRSD_SV,"2025-05-18 21:47:00",1618,775,739,36,0,758,17,1700,925,253,505
35,SUCEAVA,"GRADINIŢA CU PROGRAM PRELUNGIT NR.1 ”GULIVER”",24,"MUNICIPIUL SUCEAVA",146263,1,PART,PRCNCT,PRSD,PRSD_SV,"2025-05-18 21:46:35",1137,680,572,108,0,667,13,1200,520,207,460
35,SUCEAVA,"LICEUL CU PROGRAM SPORTIV SALA A",25,"MUNICIPIUL SUCEAVA",146263,1,PART,PRCNCT,PRSD,PRSD_SV,"2025-05-18 21:52:57",1433,842,680,159,3,828,14,1500,658,263,565
35,SUCEAVA,"LICEUL CU PROGRAM SPORTIV SALA B",26,"MUNICIPIUL SUCEAVA",146263,1,PART,PRCNCT,PRSD,PRSD_SV,"2025-05-18 21:34:25",1641,846,726,119,1,830,16,1700,854,305,525
35,SUCEAVA,"COLEGIUL NAŢIONAL ”MIHAI EMINESCU”",27,"MUNICIPIUL SUCEAVA",146263,1,PART,PRCNCT,PRSD,PRSD_SV,"2025-05-18 21:34:00",1716,481,315,166,0,470,11,1800,1319,222,248
35,SUCEAVA,"COLEGIUL NAŢIONAL ”MIHAI EMINESCU”",28,"MUNICIPIUL SUCEAVA",146263,2,PART,PRCNCT,PRSD,PRSD_SV,"2025-05-19 00:12:27",1621,892,839,53,0,875,17,1700,808,302,573
35,SUCEAVA,"COLEGIUL NAŢIONAL ”MIHAI EMINESCU”",29,"MUNICIPIUL SUCEAVA",146263,1,PART,PRCNCT,PRSD,PRSD_SV,"2025-05-18 21:49:57",1739,841,748,91,2,825,16,1800,959,313,512
35,SUCEAVA,"COLEGIUL NAȚIONAL ”MIHAI EMINESCU”",30,"MUNICIPIUL SUCEAVA",146263,1,PART,PRCNCT,PRSD,PRSD_SV,"2025-05-18 21:50:52",1467,747,681,65,1,737,10,1600,853,251,486
35,SUCEAVA,"COLEGIUL TEHNIC DE INDUSTRIE ALIMENTARĂ, SALA A",31,"MUNICIPIUL SUCEAVA",146263,1,PART,PRCNCT,PRSD,PRSD_SV,"2025-05-18 22:16:09",1705,916,822,93,1,896,20,1800,884,315,581
35,SUCEAVA,"COLEGIUL TEHNIC DE INDUSTRIE ALIMENTARĂ, SALA B",32,"MUNICIPIUL SUCEAVA",146263,1,PART,PRCNCT,PRSD,PRSD_SV,"2025-05-18 21:53:55",1792,960,844,114,2,943,17,1900,940,290,653
35,SUCEAVA,"COLEGIUL TEHNIC „PETRU MUŞAT”",33,"MUNICIPIUL SUCEAVA",146263,1,PART,PRCNCT,PRSD,PRSD_SV,"2025-05-18 21:32:18",1045,391,306,85,0,385,6,1100,709,194,191
35,SUCEAVA,"AGENTIA PENTRU PROTECTIA MEDIULUI",34,"MUNICIPIUL SUCEAVA",146263,1,PART,PRCNCT,PRSD,PRSD_SV,"2025-05-18 22:11:15",1893,1218,1065,152,1,1196,22,2000,782,461,735
35,SUCEAVA,"ŞCOALA GIMNAZIALĂ NR. 9 ”ION CREANGĂ”, SALA E",35,"MUNICIPIUL SUCEAVA",146263,1,PART,PRCNCT,PRSD,PRSD_SV,"2025-05-18 22:31:24",1808,915,832,83,0,899,16,1900,985,326,573
35,SUCEAVA,"ŞCOALA GIMNAZIALĂ NR. 9 ”ION CREANGĂ”, SALA F",36,"MUNICIPIUL SUCEAVA",146263,1,PART,PRCNCT,PRSD,PRSD_SV,"2025-05-18 21:46:42",1755,873,788,84,1,856,17,1900,1027,278,578
35,SUCEAVA,"ŞCOALA GIMNAZIALĂ NR. 9 ”ION CREANGĂ”, SALA A",37,"MUNICIPIUL SUCEAVA",146263,1,PART,PRCNCT,PRSD,PRSD_SV,"2025-05-18 22:18:56",1646,994,801,188,5,982,12,1700,706,345,637
35,SUCEAVA,"ŞCOALA GIMNAZIALĂ NR. 9 ”ION CREANGĂ”, SALA B",38,"MUNICIPIUL SUCEAVA",146263,1,PART,PRCNCT,PRSD,PRSD_SV,"2025-05-18 21:54:47",1752,1087,939,148,0,1065,22,1800,713,393,672
35,SUCEAVA,"ŞCOALA GIMNAZIALĂ NR. 9 ”ION CREANGĂ”, SALA C",39,"MUNICIPIUL SUCEAVA",146263,1,PART,PRCNCT,PRSD,PRSD_SV,"2025-05-18 21:48:33",1728,960,882,78,0,943,17,1800,840,323,620
35,SUCEAVA,"ŞCOALA GIMNAZIALĂ NR. 9 ”ION CREANGĂ”, SALA D",40,"MUNICIPIUL SUCEAVA",146263,1,PART,PRCNCT,PRSD,PRSD_SV,"2025-05-18 22:22:58",1739,959,887,72,0,945,14,1800,841,304,641
35,SUCEAVA,"GRĂDINIŢA CU PROGRAM NORMAL NR. 9 ”NOROCEL” SALA A",41,"MUNICIPIUL SUCEAVA",146263,1,PART,PRCNCT,PRSD,PRSD_SV,"2025-05-18 21:40:22",1921,674,584,90,0,660,14,2000,1326,330,330
35,SUCEAVA,"GRĂDINIŢA CU PROGRAM NORMAL NR.9 ”NOROCEL” SALA B",42,"MUNICIPIUL SUCEAVA",146263,1,PART,PRCNCT,PRSD,PRSD_SV,"2025-05-18 21:58:51",1997,978,917,61,0,954,24,2100,1122,498,456
35,SUCEAVA,"SNTFM C.F.R. MARFĂ- ZONA DE REPARAȚII SUCEAVA",43,"MUNICIPIUL SUCEAVA",146263,1,PART,PRCNCT,PRSD,PRSD_SV,"2025-05-18 21:43:09",1523,529,490,39,0,517,12,1700,1171,297,220
35,SUCEAVA,"GARA BURDUJENI",44,"MUNICIPIUL SUCEAVA",146263,1,PART,PRCNCT,PRSD,PRSD_SV,"2025-05-18 21:41:54",1601,537,278,259,0,528,9,2100,1563,304,224
35,SUCEAVA,"GARA BURDUJENI",45,"MUNICIPIUL SUCEAVA",146263,1,PART,PRCNCT,PRSD,PRSD_SV,"2025-05-18 21:58:21",1974,916,722,194,0,902,14,2200,1284,487,415
35,SUCEAVA,"ŞCOALA GIMNAZIALĂ NR. 10, SALA A",46,"MUNICIPIUL SUCEAVA",146263,1,PART,PRCNCT,PRSD,PRSD_SV,"2025-05-18 21:46:58",1955,1009,932,77,0,998,11,2100,1091,499,499
35,SUCEAVA,"ŞCOALA GIMNAZIALĂ NR. 10, SALA B",47,"MUNICIPIUL SUCEAVA",146263,1,PART,PRCNCT,PRSD,PRSD_SV,"2025-05-18 22:03:14",2007,1021,964,57,0,995,26,2100,1079,496,499
35,SUCEAVA,"COLEGIUL TEHNIC ”A.I.CUZA” SALA A, CALEA UNIRII, NR.49",48,"MUNICIPIUL SUCEAVA",146263,1,PART,PRCNCT,PRSD,PRSD_SV,"2025-05-18 22:08:45",1707,741,688,53,0,719,22,1800,1059,298,421
35,SUCEAVA,"COLEGIUL TEHNIC ”A.I.CUZA” SALA B, CALEA UNIRII, NR.49",49,"MUNICIPIUL SUCEAVA",146263,1,PART,PRCNCT,PRSD,PRSD_SV,"2025-05-18 21:52:44",1420,729,671,58,0,717,12,1500,771,355,362
35,SUCEAVA,"COLEGIUL TEHNIC ”AL. I. CUZA” SALA C",50,"MUNICIPIUL SUCEAVA",146263,1,PART,PRCNCT,PRSD,PRSD_SV,"2025-05-18 21:38:14",1153,610,555,55,0,600,10,1300,690,254,346
35,SUCEAVA,"ŞCOALA GIMNAZIALĂ NR. 5 ”JEAN BART”",51,"MUNICIPIUL SUCEAVA",146263,1,PART,PRCNCT,PRSD,PRSD_SV,"2025-05-18 21:51:36",1449,744,665,78,1,727,17,1600,856,334,393
35,SUCEAVA,"CENTRUL ŞCOLAR PENTRU EDUCAŢIE INCLUZIVĂ SUCEAVA, CORP A",52,"MUNICIPIUL SUCEAVA",146263,1,PART,PRCNCT,PRSD,PRSD_SV,"2025-05-18 21:52:43",1772,827,789,38,0,815,12,1900,1073,389,426
35,SUCEAVA,"CENTRUL ŞCOLAR PENTRU EDUCAŢIE INCLUZIVĂ SUCEAVA- CORP B",53,"MUNICIPIUL SUCEAVA",146263,1,PART,PRCNCT,PRSD,PRSD_SV,"2025-05-18 21:50:04",1616,687,655,32,0,678,9,1700,1013,315,363
35,SUCEAVA,"GRĂDINIŢA CU PROGRAM NORMAL NR. 12 ”ŢĂNDĂRICĂ”",54,"MUNICIPIUL SUCEAVA",146263,1,PART,PRCNCT,PRSD,PRSD_SV,"2025-05-18 21:52:41",1630,881,761,120,0,868,13,1700,819,440,428
35,SUCEAVA,"ŞCOALA GIMNAZIALĂ NR.11, ”MIRON COSTIN”, SALA A",55,"MUNICIPIUL SUCEAVA",146263,1,PART,PRCNCT,PRSD,PRSD_SV,"2025-05-18 21:47:13",2015,1025,948,77,0,1013,12,2200,1175,515,498
35,SUCEAVA,"ŞCOALA GIMNAZIALĂ NR.11, ”MIRON COSTIN”, SALA B",56,"MUNICIPIUL SUCEAVA",146263,1,PART,PRCNCT,PRSD,PRSD_SV,"2025-05-18 22:07:10",1634,738,671,67,0,724,14,1800,1062,365,359
35,SUCEAVA,"ŞCOALA GIMNAZIALĂ NR.11, ”MIRON COSTIN”, SALA C",57,"MUNICIPIUL SUCEAVA",146263,1,PART,PRCNCT,PRSD,PRSD_SV,"2025-05-18 21:29:16",1601,806,692,114,0,790,16,1800,994,365,425
35,SUCEAVA,"ŞCOALA GIMNAZIALĂ NR.11, ”MIRON COSTIN”, SALA D",58,"MUNICIPIUL SUCEAVA",146263,1,PART,PRCNCT,PRSD,PRSD_SV,"2025-05-18 21:35:37",1847,905,855,49,1,892,13,2000,1095,408,484
35,SUCEAVA,"SCOALA GIMNAZIALA NR.11 ”MIRON COSTIN”, SALA E",59,"MUNICIPIUL SUCEAVA",146263,1,PART,PRCNCT,PRSD,PRSD_SV,"2025-05-18 22:07:06",1505,659,599,60,0,646,13,1700,1041,316,330
35,SUCEAVA,"PRIMĂRIA BURDUJENI",60,"MUNICIPIUL SUCEAVA",146263,1,PART,PRCNCT,PRSD,PRSD_SV,"2025-05-18 21:53:19",1348,741,671,61,9,731,10,1500,759,403,328
35,SUCEAVA,"ŞCOALA GIMNAZIALĂ NR. 6, SALA A",61,"MUNICIPIUL SUCEAVA",146263,1,PART,PRCNCT,PRSD,PRSD_SV,"2025-05-18 21:50:18",1445,667,634,33,0,651,16,1600,933,378,273
35,SUCEAVA,"SCOALA GIMNAZIALA NR.6 SALA B",62,"MUNICIPIUL SUCEAVA",146263,1,PART,PRCNCT,PRSD,PRSD_SV,"2025-05-18 21:52:04",1757,552,531,21,0,540,12,1900,1348,289,251
35,SUCEAVA,"GRĂDINIŢA CU PROGRAM NORMAL NR.7",63,"MUNICIPIUL SUCEAVA",146263,1,PART,PRCNCT,PRSD,PRSD_SV,"2025-05-18 21:47:34",1313,673,572,101,0,657,16,1500,827,314,343
35,SUCEAVA,"GRĂDINIŢA CU PROGRAM NORMAL NR.8",64,"MUNICIPIUL SUCEAVA",146263,1,PART,PRCNCT,PRSD,PRSD_SV,"2025-05-18 21:45:35",1689,755,713,42,0,742,13,1900,1145,401,341
35,SUCEAVA,"ŞCOALA GIMNAZIALĂ ”GRIGORE GHICA VOIEVOD”",65,"MUNICIPIUL SUCEAVA",146263,1,PART,PRCNCT,PRSD,PRSD_SV,"2025-05-18 22:04:31",1871,1002,944,57,1,981,21,2100,1098,578,403
35,SUCEAVA,"ŞCOALA GIMNAZIALĂ „THEODOR DARIE”",66,"MUNICIPIUL CÂMPULUNG MOLDOVENESC",146502,1,PART,PRCNCT,PRSD,PRSD_SV,"2025-05-18 21:53:47",1594,823,767,56,0,809,14,1800,977,382,427
35,SUCEAVA,"LICEUL TEHNOLOGIC NR. 1",67,"MUNICIPIUL CÂMPULUNG MOLDOVENESC",146502,1,PART,PRCNCT,PRSD,PRSD_SV,"2025-05-18 21:31:41",831,454,359,47,48,447,7,900,446,170,277
35,SUCEAVA,"CENTRALA TERMICĂ CU COGENERARE",68,"MUNICIPIUL CÂMPULUNG MOLDOVENESC",146502,1,PART,PRCNCT,PRSD,PRSD_SV,"2025-05-18 21:39:01",1373,715,662,53,0,707,8,1500,785,316,391
35,SUCEAVA,"ŞCOALA GIMNAZIALĂ „TEODOR ŞTEFANELLI”",69,"MUNICIPIUL CÂMPULUNG MOLDOVENESC",146502,1,PART,PRCNCT,PRSD,PRSD_SV,"2025-05-18 21:33:27",1709,416,363,53,0,411,5,1900,1484,185,226
35,SUCEAVA,"COLEGIUL NAŢIONAL ”DRAGOŞ VODĂ”",70,"MUNICIPIUL CÂMPULUNG MOLDOVENESC",146502,1,PART,PRCNCT,PRSD,PRSD_SV,"2025-05-18 21:44:42",1081,506,423,82,1,499,7,1200,694,191,308
35,SUCEAVA,"CLUBUL COPIILOR ŞI ELEVILOR",71,"MUNICIPIUL CÂMPULUNG MOLDOVENESC",146502,1,PART,PRCNCT,PRSD,PRSD_SV,"2025-05-18 21:33:24",1406,630,545,85,0,624,6,1500,870,226,398
35,SUCEAVA,"ŞCOALA GIMNAZIALĂ ”BOGDAN VODĂ”",72,"MUNICIPIUL CÂMPULUNG MOLDOVENESC",146502,1,PART,PRCNCT,PRSD,PRSD_SV,"2025-05-18 21:47:25",1503,810,644,144,22,800,10,1700,890,275,525
35,SUCEAVA,"CLUBUL COPIILOR ŞI ELEVILOR – SATUL DE VACANŢĂ",73,"MUNICIPIUL CÂMPULUNG MOLDOVENESC",146502,1,PART,PRCNCT,PRSD,PRSD_SV,"2025-05-18 21:29:25",1594,314,293,21,0,310,4,1800,1486,141,169
35,SUCEAVA,"COLEGIUL SILVIC ”BUCOVINA” (CORP A)",74,"MUNICIPIUL CÂMPULUNG MOLDOVENESC",146502,1,PART,PRCNCT,PRSD,PRSD_SV,"2025-05-18 21:50:16",1435,657,584,71,2,639,18,1600,943,237,402
35,SUCEAVA,"COLEGIUL SILVIC ”BUCOVINA” (CORP B)",75,"MUNICIPIUL CÂMPULUNG MOLDOVENESC",146502,1,PART,PRCNCT,PRSD,PRSD_SV,"2025-05-18 21:35:39",1393,655,603,52,0,643,12,1500,845,259,384
35,SUCEAVA,"COLEGIUL SILVIC ”BUCOVINA” (CORP C)",76,"MUNICIPIUL CÂMPULUNG MOLDOVENESC",146502,1,PART,PRCNCT,PRSD,PRSD_SV,"2025-05-18 22:00:16",1443,715,665,49,1,706,9,1600,885,268,438
35,SUCEAVA,"GRĂDINIŢA NR. 4 „VALEA SEACĂ”",77,"MUNICIPIUL CÂMPULUNG MOLDOVENESC",146502,1,PART,PRCNCT,PRSD,PRSD_SV,"2025-05-18 21:37:56",1288,743,684,57,2,731,12,1400,657,294,437
35,SUCEAVA,"ŞCOALA GIMNAZIALĂ „GEORGE VOEVIDCA” - CORP A",78,"MUNICIPIUL CÂMPULUNG MOLDOVENESC",146502,1,PART,PRCNCT,PRSD,PRSD_SV,"2025-05-18 21:39:07",1018,572,496,75,1,566,6,1100,528,280,286
35,SUCEAVA,"ŞCOALA GIMNAZIALĂ „GEORGE VOEVIDCA” - CORP B",79,"MUNICIPIUL CÂMPULUNG MOLDOVENESC",146502,1,PART,PRCNCT,PRSD,PRSD_SV,"2025-05-18 21:43:45",1123,637,568,69,0,625,12,1200,563,276,349
35,SUCEAVA,"COLEGIUL TEHNIC ”MIHAI BĂCESCU”",80,"MUNICIPIUL FĂLTICENI",146539,1,PART,PRCNCT,PRSD,PRSD_SV,"2025-05-18 21:53:00",1340,812,671,85,56,798,14,1500,688,321,477
35,SUCEAVA,"ŞCOALA GIMNAZIALĂ ”ALEXANDRU IOAN CUZA”",81,"MUNICIPIUL FĂLTICENI",146539,1,PART,PRCNCT,PRSD,PRSD_SV,"2025-05-18 21:53:56",1424,722,656,65,1,706,16,1600,878,302,404
35,SUCEAVA,"COLEGIUL NAŢIONAL ”NICU GANE”",82,"MUNICIPIUL FĂLTICENI",146539,1,PART,PRCNCT,PRSD,PRSD_SV,"2025-05-18 21:43:29",1415,757,695,60,2,748,9,1600,843,339,409
35,SUCEAVA,"COLEGIUL NAŢIONAL ”NICU GANE”",83,"MUNICIPIUL FĂLTICENI",146539,1,PART,PRCNCT,PRSD,PRSD_SV,"2025-05-18 21:37:54",1512,727,664,63,0,708,19,1700,973,342,366
35,SUCEAVA,"ŞCOALA GIMNAZIALĂ ”IOAN CIUREA”",84,"MUNICIPIUL FĂLTICENI",146539,2,PART,PRCNCT,PRSD,PRSD_SV,"2025-05-18 23:37:53",1306,588,526,62,0,581,7,1400,812,304,277
35,SUCEAVA,"ŞCOALA GIMNAZIALĂ ”IOAN CIUREA”",85,"MUNICIPIUL FĂLTICENI",146539,1,PART,PRCNCT,PRSD,PRSD_SV,"2025-05-18 21:49:57",779,440,405,35,0,428,12,900,460,220,208
35,SUCEAVA,"ŞCOALA GIMNAZIALĂ ”IOAN CIUREA”",86,"MUNICIPIUL FĂLTICENI",146539,1,PART,PRCNCT,PRSD,PRSD_SV,"2025-05-18 21:36:05",1048,527,498,29,0,518,9,1200,673,271,247
35,SUCEAVA,"ŞCOALA GIMNAZIALĂ ”MIHAIL SADOVEANU”",87,"MUNICIPIUL FĂLTICENI",146539,1,PART,PRCNCT,PRSD,PRSD_SV,"2025-05-18 21:57:10",1607,788,735,52,1,781,7,1800,1012,380,401
35,SUCEAVA,"ŞCOALA GIMNAZIALĂ ”MIHAIL SADOVEANU”",88,"MUNICIPIUL FĂLTICENI",146539,1,PART,PRCNCT,PRSD,PRSD_SV,"2025-05-18 22:15:27",1118,589,503,86,0,575,14,1200,611,271,304
35,SUCEAVA,"ŞCOALA GIMNAZIALĂ ”MIHAIL SADOVEANU”",89,"MUNICIPIUL FĂLTICENI",146539,1,PART,PRCNCT,PRSD,PRSD_SV,"2025-05-18 21:52:06",1206,665,619,46,0,656,9,1300,635,291,365
35,SUCEAVA,"ŞCOALA GIMNAZIALĂ ”ION IRIMIESCU”",90,"MUNICIPIUL FĂLTICENI",146539,1,PART,PRCNCT,PRSD,PRSD_SV,"2025-05-18 21:40:23",1092,588,503,84,1,571,17,1200,612,258,313
35,SUCEAVA,"ŞCOALA GIMNAZIALĂ ”ION IRIMIESCU”",91,"MUNICIPIUL FĂLTICENI",146539,1,PART,PRCNCT,PRSD,PRSD_SV,"2025-05-18 21:46:26",1127,568,506,62,0,557,11,1200,632,272,285
35,SUCEAVA,"GRĂDINIŢA CU PROGRAM PRELUNGIT ”DUMBRAVA MINUNATĂ”",92,"MUNICIPIUL FĂLTICENI",146539,1,PART,PRCNCT,PRSD,PRSD_SV,"2025-05-18 21:53:44",1004,444,403,41,0,433,11,1100,656,209,224
35,SUCEAVA,"GRĂDINIŢA CU PROGRAM PRELUNGIT ”DUMBRAVA MINUNATĂ”",93,"MUNICIPIUL FĂLTICENI",146539,1,PART,PRCNCT,PRSD,PRSD_SV,"2025-05-18 21:45:06",1014,445,413,31,1,439,6,1100,655,228,211
35,SUCEAVA,"GRĂDINIŢA CU PROGRAM PRELUNGIT ”DUMBRAVA MINUNATĂ”",94,"MUNICIPIUL FĂLTICENI",146539,1,PART,PRCNCT,PRSD,PRSD_SV,"2025-05-18 21:39:34",903,471,446,16,9,460,11,1000,529,277,183
35,SUCEAVA,"COLEGIUL ”VASILE LOVINESCU”",95,"MUNICIPIUL FĂLTICENI",146539,1,PART,PRCNCT,PRSD,PRSD_SV,"2025-05-18 21:49:07",1257,571,524,45,2,563,8,1400,829,256,307
35,SUCEAVA,"COLEGIUL ”VASILE LOVINESCU”",96,"MUNICIPIUL FĂLTICENI",146539,1,PART,PRCNCT,PRSD,PRSD_SV,"2025-05-18 21:52:42",1358,684,642,42,0,676,8,1500,816,299,377
35,SUCEAVA,"COLEGIUL ”VASILE LOVINESCU”",97,"MUNICIPIUL FĂLTICENI",146539,1,PART,PRCNCT,PRSD,PRSD_SV,"2025-05-18 21:58:11",1733,1008,937,41,30,986,22,1900,892,430,556
35,SUCEAVA,"ŞCOALA GIMNAZIALĂ ”IOAN CIUREA”- CLĂDIRE GHEORGHE GAFENCU",98,"MUNICIPIUL FĂLTICENI",146539,1,PART,PRCNCT,PRSD,PRSD_SV,"2025-05-18 21:51:56",1563,741,712,29,0,732,9,1700,959,400,332
35,SUCEAVA,"CASA SOCIALĂ ”ARHIM. ZENOVIE GHIDESCU”",99,"MUNICIPIUL FĂLTICENI",146539,1,PART,PRCNCT,PRSD,PRSD_SV,"2025-05-18 21:35:34",834,422,407,15,0,416,6,900,478,254,162
35,SUCEAVA,"PRIMARIA RADAUTI",100,"MUNICIPIUL RĂDĂUŢI",146628,1,PART,PRCNCT,PRSD,PRSD_SV,"2025-05-18 22:24:27",1867,862,696,166,0,840,22,2000,1138,372,468
35,SUCEAVA,"CASA DE CULTURA",101,"MUNICIPIUL RĂDĂUŢI",146628,1,PART,PRCNCT,PRSD,PRSD_SV,"2025-05-18 22:06:40",1745,779,698,79,2,764,15,1900,1121,296,468
35,SUCEAVA,"GALERIILE DE ARTA",102,"MUNICIPIUL RĂDĂUŢI",146628,1,PART,PRCNCT,PRSD,PRSD_SV,"2025-05-18 22:30:21",1684,785,664,119,2,765,20,1800,1015,354,411
35,SUCEAVA,"SCOALA GIMNAZIALA REGINA ELISABETA NR.4",103,"MUNICIPIUL RĂDĂUŢI",146628,1,PART,PRCNCT,PRSD,PRSD_SV,"2025-05-18 22:13:44",1864,856,804,51,1,844,12,2000,1144,445,399
35,SUCEAVA,"COLEGIUL TEHNIC",104,"MUNICIPIUL RĂDĂUŢI",146628,1,PART,PRCNCT,PRSD,PRSD_SV,"2025-05-18 22:51:24",1883,882,782,68,32,872,10,2000,1118,384,488
35,SUCEAVA,"COLEGIUL EUDOXIU HURMUZACHI",105,"MUNICIPIUL RĂDĂUŢI",146628,1,PART,PRCNCT,PRSD,PRSD_SV,"2025-05-18 22:21:58",1785,867,751,69,47,854,13,1900,1033,419,435
35,SUCEAVA,"COLEGIUL EUDOXIU HURMUZACHI",106,"MUNICIPIUL RĂDĂUŢI",146628,1,PART,PRCNCT,PRSD,PRSD_SV,"2025-05-18 22:38:50",1879,882,766,70,46,874,8,2000,1118,417,457
35,SUCEAVA,"SCOALA GIMNAZIALA NR.5 BOGDAN VODA",107,"MUNICIPIUL RĂDĂUŢI",146628,1,PART,PRCNCT,PRSD,PRSD_SV,"2025-05-18 22:38:33",1603,692,622,70,0,682,10,1800,1108,277,405
35,SUCEAVA,"COLEGIUL TEHNIC RĂDĂUȚI-CLĂDIRE ÎNVĂȚĂMÂNT LICEAL",108,"MUNICIPIUL RĂDĂUŢI",146628,1,PART,PRCNCT,PRSD,PRSD_SV,"2025-05-18 21:57:58",1820,768,743,25,0,759,9,2000,1232,354,405
35,SUCEAVA,"COLEGIUL TEHNIC RĂDĂUȚI-CLĂDIRE ÎNVĂȚĂMÂNT LICEAL",109,"MUNICIPIUL RĂDĂUŢI",146628,1,PART,PRCNCT,PRSD,PRSD_SV,"2025-05-18 22:03:08",1775,734,671,63,0,722,12,1900,1166,263,459
35,SUCEAVA,"SCOALA GIMNAZIALA NR.3 MIHAI EMINESCU",110,"MUNICIPIUL RĂDĂUŢI",146628,1,PART,PRCNCT,PRSD,PRSD_SV,"2025-05-18 21:59:05",1990,843,766,77,0,822,21,2100,1257,364,458
35,SUCEAVA,"CRESA HIPODROM",111,"MUNICIPIUL RĂDĂUŢI",146628,1,PART,PRCNCT,PRSD,PRSD_SV,"2025-05-18 22:00:32",1736,745,695,50,0,730,15,1900,1155,301,429
35,SUCEAVA,"SCOALA GIMNAZIALA NR.2",112,"MUNICIPIUL RĂDĂUŢI",146628,1,PART,PRCNCT,PRSD,PRSD_SV,"2025-05-18 21:50:17",1626,714,648,65,1,695,19,1800,1086,349,346
35,SUCEAVA,"SCOALA GIMNAZIALA GHEORGHE POPADIUC NR.1",113,"MUNICIPIUL RĂDĂUŢI",146628,1,PART,PRCNCT,PRSD,PRSD_SV,"2025-05-18 22:18:10",2004,813,759,54,0,803,10,2200,1387,500,303
35,SUCEAVA,"GRADINITA CU PROGRAM PRELUNGIT PINOCHIO",114,"MUNICIPIUL RĂDĂUŢI",146628,1,PART,PRCNCT,PRSD,PRSD_SV,"2025-05-18 22:06:42",1742,764,736,27,1,743,21,1900,1136,362,381
35,SUCEAVA,"COLEGIUL ANDRONIC MOTRESCU",115,"MUNICIPIUL RĂDĂUŢI",146628,1,PART,PRCNCT,PRSD,PRSD_SV,"2025-05-18 22:19:36",1696,797,732,65,0,792,5,1800,1003,372,420
35,SUCEAVA,"CASA DE CULTURĂ ”PLATON PARDĂU”",116,"MUNICIPIUL VATRA DORNEI",146744,1,PART,PRCNCT,PRSD,PRSD_SV,"2025-05-18 21:26:28",1152,684,530,129,25,666,18,1300,616,347,319
35,SUCEAVA,"CASA DE CULTURĂ ”PLATON PARDĂU”",117,"MUNICIPIUL VATRA DORNEI",146744,1,PART,PRCNCT,PRSD,PRSD_SV,"2025-05-18 21:42:24",880,559,443,116,0,546,13,1000,441,230,316
35,SUCEAVA,"HOTEL BRADUL",118,"MUNICIPIUL VATRA DORNEI",146744,1,PART,PRCNCT,PRSD,PRSD_SV,"2025-05-18 21:43:15",778,870,352,518,0,854,16,1300,430,343,511
35,SUCEAVA,"ŞCOALA GIMNAZIALĂ NR.1",119,"MUNICIPIUL VATRA DORNEI",146744,1,PART,PRCNCT,PRSD,PRSD_SV,"2025-05-18 21:37:34",953,566,462,103,1,560,6,1000,434,200,360
35,SUCEAVA,"ŞCOALA GIMNAZIALĂ NR.1",120,"MUNICIPIUL VATRA DORNEI",146744,1,PART,PRCNCT,PRSD,PRSD_SV,"2025-05-18 21:54:02",1515,834,761,73,0,817,17,1700,866,353,464
35,SUCEAVA,"ŞCOALA GIMNAZIALĂ NR.2",121,"MUNICIPIUL VATRA DORNEI",146744,1,PART,PRCNCT,PRSD,PRSD_SV,"2025-05-18 21:47:03",801,428,397,31,0,421,7,900,472,190,231
35,SUCEAVA,"ȘCOALA GIMNAZIALĂ NR.2",122,"MUNICIPIUL VATRA DORNEI",146744,1,PART,PRCNCT,PRSD,PRSD_SV,"2025-05-18 22:07:10",1132,561,533,27,1,539,22,800,239,225,314
35,SUCEAVA,"CENTRUL SOCIAL DE PRIMIRE, ASISTARE ȘI ÎNGRIJIRE A PERSOANELOR VÂRSTNICE",123,"MUNICIPIUL VATRA DORNEI",146744,1,PART,PRCNCT,PRSD,PRSD_SV,"2025-05-18 21:21:33",503,302,266,36,0,295,7,600,298,166,129
35,SUCEAVA,"GRĂDINIȚA CU PROGRAM PRELUNGIT NR.3 ”SCUFIȚA ROȘIE”",124,"MUNICIPIUL VATRA DORNEI",146744,1,PART,PRCNCT,PRSD,PRSD_SV,"2025-05-18 21:35:26",1058,683,546,133,4,673,10,1200,517,296,377
35,SUCEAVA,"GRADINITA CU PROGRAM NORMAL NR.5",125,"MUNICIPIUL VATRA DORNEI",146744,1,PART,PRCNCT,PRSD,PRSD_SV,"2025-05-18 21:25:59",1049,583,505,78,0,578,5,1200,617,303,275
35,SUCEAVA,"ȘCOALA PRIMARĂ NR.3",126,"MUNICIPIUL VATRA DORNEI",146744,1,PART,PRCNCT,PRSD,PRSD_SV,"2025-05-18 21:44:00",970,523,472,50,1,517,6,1100,577,264,253
35,SUCEAVA,"ȘCOALA PRIMARĂ NR.3",127,"MUNICIPIUL VATRA DORNEI",146744,1,PART,PRCNCT,PRSD,PRSD_SV,"2025-05-18 21:35:22",767,393,368,25,0,388,5,800,407,189,199
35,SUCEAVA,"COMPLEX CFR GARA MARE",128,"MUNICIPIUL VATRA DORNEI",146744,2,PART,PRCNCT,PRSD,PRSD_SV,"2025-05-19 05:52:03",1074,526,482,40,4,521,5,1200,674,291,230
35,SUCEAVA,"SCOALA GENERALA ARGESTRU",129,"MUNICIPIUL VATRA DORNEI",146744,2,PART,PRCNCT,PRSD,PRSD_SV,"2025-05-19 06:04:23",481,271,242,29,0,268,3,500,229,152,116
35,SUCEAVA,"CLUBUL PENSIONARILOR",130,"ORAŞ BROŞTENI",147358,1,PART,PRCNCT,PRSD,PRSD_SV,"2025-05-18 21:55:02",799,394,371,23,0,384,10,900,506,206,178
35,SUCEAVA,"LICEUL TEHNOLOGIC ”NICOLAI NANU” BROŞTENI",131,"ORAŞ BROŞTENI",147358,1,PART,PRCNCT,PRSD,PRSD_SV,"2025-05-18 21:51:07",1370,548,504,44,0,534,14,1500,952,326,208
35,SUCEAVA,"SPITAL MEDICO SOCIAL CARMEN SYLVA",132,"ORAŞ BROŞTENI",147358,1,PART,PRCNCT,PRSD,PRSD_SV,"2025-05-18 21:33:06",420,193,164,19,10,188,5,500,307,112,76
35,SUCEAVA,"ŞCOALA COTÎRGAŞI NR.1",133,"ORAŞ BROŞTENI",147358,1,PART,PRCNCT,PRSD,PRSD_SV,"2025-05-18 22:01:17",1010,524,501,21,2,518,6,1100,576,379,139
35,SUCEAVA,"ŞCOALA GENERALĂ DÎRMOXA",134,"ORAŞ BROŞTENI",147358,1,PART,PRCNCT,PRSD,PRSD_SV,"2025-05-18 21:20:25",111,87,57,30,0,85,2,200,113,57,28
35,SUCEAVA,"CASĂ DE PRĂZNUIRE A PAROFIEI SFINŢII ÎMPĂRAŢI MIHAIL ŞI GAVRIL PE STIL VECHI",135,"ORAŞ BROŞTENI",147358,1,PART,PRCNCT,PRSD,PRSD_SV,"2025-05-18 21:43:03",399,226,201,25,0,220,6,500,274,159,61
35,SUCEAVA,"CĂMIN CULTURAL HOLDA",136,"ORAŞ BROŞTENI",147358,1,PART,PRCNCT,PRSD,PRSD_SV,"2025-05-18 22:05:09",1034,494,464,30,0,490,4,1100,606,348,142
35,SUCEAVA,"CĂMIN CULTURAL CAJVANA",137,"ORAŞ CAJVANA",147633,1,PART,PRCNCT,PRSD,PRSD_SV,"2025-05-18 21:37:39",1930,698,672,26,0,690,8,2100,1402,513,177
35,SUCEAVA,"LICEUL TEHNOLOGIC CAJVANA",138,"ORAŞ CAJVANA",147633,1,PART,PRCNCT,PRSD,PRSD_SV,"2025-05-18 21:48:13",1971,691,671,19,1,688,3,2100,1409,567,121
35,SUCEAVA,"LICEUL TEHNOLOGIC CAJVANA",139,"ORAŞ CAJVANA",147633,1,PART,PRCNCT,PRSD,PRSD_SV,"2025-05-18 21:35:09",1841,637,616,17,4,633,4,2000,1363,528,105
35,SUCEAVA,"GRADINITA CU PROGRAM NORMAL CAJVANA",140,"ORAŞ CAJVANA",147633,1,PART,PRCNCT,PRSD,PRSD_SV,"2025-05-18 21:47:59",1551,566,540,25,1,564,2,1700,1134,479,85
35,SUCEAVA,"LICEUL TEHNOLOGIC ”OLTEA DOAMNA”",141,"ORAŞ DOLHASCA",148006,1,PART,PRCNCT,PRSD,PRSD_SV,"2025-05-18 22:29:21",1171,514,472,40,2,509,5,1300,786,288,221
35,SUCEAVA,"LICEUL TEHNOLOGIC ”OLTEA DOAMNA” ȘCOALA PRIMARĂ - CORP C",142,"ORAŞ DOLHASCA",148006,1,PART,PRCNCT,PRSD,PRSD_SV,"2025-05-18 21:43:14",996,428,386,41,1,423,5,1100,672,224,199
35,SUCEAVA,"ŞCOALA PRIMARĂ SÂNDENI",143,"ORAŞ DOLHASCA",148006,1,PART,PRCNCT,PRSD,PRSD_SV,"2025-05-18 21:44:45",709,328,307,21,0,322,6,800,472,207,115
35,SUCEAVA,"ȘCOALA GIMNAZIALĂ BUDENI",144,"ORAŞ DOLHASCA",148006,1,PART,PRCNCT,PRSD,PRSD_SV,"2025-05-18 21:29:11",1117,439,402,37,0,434,5,1200,761,305,129
35,SUCEAVA,"ŞCOALA GIMNAZIALĂ GULIA",145,"ORAŞ DOLHASCA",148006,1,PART,PRCNCT,PRSD,PRSD_SV,"2025-05-18 22:04:02",1894,589,559,30,0,583,6,2000,1411,447,136
35,SUCEAVA,"ŞCOALA PRIMARĂ POIANA",146,"ORAŞ DOLHASCA",148006,1,PART,PRCNCT,PRSD,PRSD_SV,"2025-05-18 21:29:00",345,165,144,21,0,162,3,400,235,105,57
35,SUCEAVA,"ŞCOALA PRIMARĂ POIENARI",147,"ORAŞ DOLHASCA",148006,1,PART,PRCNCT,PRSD,PRSD_SV,"2025-05-18 21:33:36",226,103,88,15,0,102,1,300,197,73,29
35,SUCEAVA,"ŞCOALA GIMNAZIALĂ PROBOTA",148,"ORAŞ DOLHASCA",148006,1,PART,PRCNCT,PRSD,PRSD_SV,"2025-05-18 21:46:12",1446,674,592,81,1,666,8,1600,926,460,206
35,SUCEAVA,"ȘCOALA PRIMARĂ SILIȘTEA NOUĂ",149,"ORAŞ DOLHASCA",148006,1,PART,PRCNCT,PRSD,PRSD_SV,"2025-05-18 21:53:37",617,274,247,27,0,271,3,699,425,164,107
35,SUCEAVA,"ŞCOALA PRIMARĂ VALEA POIENII",150,"ORAŞ DOLHASCA",148006,1,PART,PRCNCT,PRSD,PRSD_SV,"2025-05-18 21:29:47",399,216,185,31,0,214,2,400,184,147,67
35,SUCEAVA,"PRIMĂRIA ORAŞULUI FRASIN",151,"ORAŞ FRASIN",148612,1,PART,PRCNCT,PRSD,PRSD_SV,"2025-05-18 21:48:03",1311,599,515,84,0,588,11,1400,801,339,249
35,SUCEAVA,"ŞCOALA GIMNAZIALĂ FRASIN",152,"ORAŞ FRASIN",148612,1,PART,PRCNCT,PRSD,PRSD_SV,"2025-05-18 22:13:52",1015,499,468,31,0,496,3,1100,601,367,129
35,SUCEAVA,"ŞCOALA GIMNAZIALĂ BUCŞOAIA",153,"ORAŞ FRASIN",148612,2,PART,PRCNCT,PRSD,PRSD_SV,"2025-05-19 03:32:59",1291,684,631,53,0,679,5,1400,716,439,240
35,SUCEAVA,"ŞCOALA GIMNAZIALĂ DOROTEIA",154,"ORAŞ FRASIN",148612,1,PART,PRCNCT,PRSD,PRSD_SV,"2025-05-18 21:23:00",683,358,327,31,0,357,1,800,442,285,72
35,SUCEAVA,"CĂMIN CULTURAL PLUTONIŢA",155,"ORAŞ FRASIN",148612,1,PART,PRCNCT,PRSD,PRSD_SV,"2025-05-18 21:17:06",944,451,407,44,0,447,4,1000,549,328,119
35,SUCEAVA,"CENTRUL CULTURAL- CASA DE CULTURĂ",156,"ORAŞ GURA HUMORULUI",146584,1,PART,PRCNCT,PRSD,PRSD_SV,"2025-05-18 22:16:27",1768,948,817,111,20,940,8,1900,952,455,485
35,SUCEAVA,"GRADINITA CU PROGRAM NORMAL ”PINOCHIO”",157,"ORAŞ GURA HUMORULUI",146584,2,PART,PRCNCT,PRSD,PRSD_SV,"2025-05-19 04:21:39",1538,729,622,105,2,721,8,1700,971,359,362
35,SUCEAVA,"COLEGIUL ”ALEXANDRU CEL BUN” CORPUL B",158,"ORAŞ GURA HUMORULUI",146584,1,PART,PRCNCT,PRSD,PRSD_SV,"2025-05-18 21:55:13",1992,948,876,70,2,941,7,2200,1252,448,493
35,SUCEAVA,"SCOALA GIMNAZIALA NR.1",159,"ORAŞ GURA HUMORULUI",146584,1,PART,PRCNCT,PRSD,PRSD_SV,"2025-05-18 22:10:00",1922,1019,862,157,0,1002,17,2100,1081,440,562
35,SUCEAVA,"SCOALA GIMNAZIALA ”PETRU COMARNESCU” CORP C",160,"ORAŞ GURA HUMORULUI",146584,1,PART,PRCNCT,PRSD,PRSD_SV,"2025-05-18 22:13:24",1665,816,705,109,2,797,19,1800,984,309,488
35,SUCEAVA,"COLEGIUL” ALEXANDRU CEL BUN” CORPUL A",161,"ORAŞ GURA HUMORULUI",146584,1,PART,PRCNCT,PRSD,PRSD_SV,"2025-05-18 23:02:43",1731,866,725,140,1,850,16,1900,1034,423,427
35,SUCEAVA,"SCOALA GIMNAZIALA ”TEODOR BALAN”",162,"ORAŞ GURA HUMORULUI",146584,1,PART,PRCNCT,PRSD,PRSD_SV,"2025-05-18 22:01:04",1728,916,803,106,7,902,14,1900,984,350,552
35,SUCEAVA,"GRĂDINIȚA CU PROGRAM PRELUNGIT ”CĂSUȚA PITICILOR”- CORP B",163,"ORAŞ GURA HUMORULUI",146584,1,PART,PRCNCT,PRSD,PRSD_SV,"2025-05-18 22:12:01",1080,461,437,24,0,456,5,1200,739,313,143
35,SUCEAVA,"GRADINITA CU PROGRAM NORMAL VORONET",164,"ORAŞ GURA HUMORULUI",146584,1,PART,PRCNCT,PRSD,PRSD_SV,"2025-05-18 21:42:12",716,527,352,175,0,522,5,800,273,276,246
35,SUCEAVA,"CASA DE CULTURĂ LITENI",165,"ORAŞ LITENI",149227,1,PART,PRCNCT,PRSD,PRSD_SV,"2025-05-18 21:34:24",1766,784,751,33,0,776,8,1900,1116,433,343
35,SUCEAVA,"CORPUL III LICEUL TEHNOLOGIC IORGU VÂRNAV LITEANU LITENI",166,"ORAŞ LITENI",149227,1,PART,PRCNCT,PRSD,PRSD_SV,"2025-05-18 21:37:32",1320,599,563,35,1,587,12,1500,901,342,245
35,SUCEAVA,"CORPUL A LICEUL TEHNOLOGIC IORGU VÂRNAV LITEANU LITENI",167,"ORAŞ LITENI",149227,1,PART,PRCNCT,PRSD,PRSD_SV,"2025-05-18 21:57:18",997,448,407,41,0,444,4,1100,652,275,169
35,SUCEAVA,"ŞCOALA GIMNAZIALĂ CORNI",168,"ORAŞ LITENI",149227,1,PART,PRCNCT,PRSD,PRSD_SV,"2025-05-18 21:35:36",588,310,274,36,0,308,2,600,290,192,116
35,SUCEAVA,"ŞCOALA GIMNAZIALĂ ROŞCANI",169,"ORAŞ LITENI",149227,1,PART,PRCNCT,PRSD,PRSD_SV,"2025-05-18 21:40:39",1008,453,401,52,0,446,7,1100,647,276,170
35,SUCEAVA,"ŞCOALA GIMNAZIALĂ NR. 1 ROTUNDA",170,"ORAŞ LITENI",149227,1,PART,PRCNCT,PRSD,PRSD_SV,"2025-05-18 21:42:49",1150,523,487,36,0,522,1,1300,777,367,155
35,SUCEAVA,"ŞCOALA PRIMARĂ NR. 2 ROTUNDA",171,"ORAŞ LITENI",149227,1,PART,PRCNCT,PRSD,PRSD_SV,"2025-05-18 21:34:06",739,282,268,14,0,280,2,800,518,232,48
35,SUCEAVA,"ŞCOALA GIMNAZIALĂ SILIŞTEA",172,"ORAŞ LITENI",149227,1,PART,PRCNCT,PRSD,PRSD_SV,"2025-05-18 21:24:33",630,270,233,37,0,267,3,700,430,191,76
35,SUCEAVA,"ȘCOALA GIMNAZIALĂ MILIȘĂUȚI",173,"ORAŞ MILIŞĂUŢI",146931,1,PART,PRCNCT,PRSD,PRSD_SV,"2025-05-18 22:04:08",1451,628,596,30,2,622,6,1600,972,356,266
35,SUCEAVA,"CĂMINUL CULTURAL MILIŞĂUŢI",174,"ORAŞ MILIŞĂUŢI",146931,1,PART,PRCNCT,PRSD,PRSD_SV,"2025-05-18 21:50:11",1682,735,691,44,0,727,8,1800,1065,441,286
35,SUCEAVA,"GRĂDINIȚA CU PROGRAM NORMAL BĂDEUȚI",175,"ORAŞ MILIŞĂUŢI",146931,1,PART,PRCNCT,PRSD,PRSD_SV,"2025-05-18 22:23:59",1285,613,569,43,1,603,10,1400,787,369,234
35,SUCEAVA,"CĂMINUL CULTURAL SALCEA",176,"ORAŞ SALCEA",146370,1,PART,PRCNCT,PRSD,PRSD_SV,"2025-05-18 21:44:56",1249,580,543,36,1,566,14,1400,820,362,204
35,SUCEAVA,"CĂMINUL CULTURAL SALCEA",177,"ORAŞ SALCEA",146370,1,PART,PRCNCT,PRSD,PRSD_SV,"2025-05-18 21:37:22",1417,669,649,20,0,648,21,1600,931,409,239
35,SUCEAVA,"ȘCOALA MERENI",178,"ORAŞ SALCEA",146370,1,PART,PRCNCT,PRSD,PRSD_SV,"2025-05-18 22:02:02",1434,713,657,56,0,696,17,1600,887,466,230
35,SUCEAVA,"ȘCOALA GIMNAZIALĂ ”CRISTOFOR SIMIONESCU”",179,"ORAŞ SALCEA",146370,1,PART,PRCNCT,PRSD,PRSD_SV,"2025-05-18 21:49:32",2007,1094,996,97,1,1076,18,2200,1106,647,429
35,SUCEAVA,"ȘCOALA GIMNAZIALĂ ”IACOB COSTACHE”",180,"ORAŞ SALCEA",146370,1,PART,PRCNCT,PRSD,PRSD_SV,"2025-05-18 21:53:00",1280,618,581,37,0,606,12,1401,783,453,153
35,SUCEAVA,"CĂMINUL CULTURAL - PRELIPCA",181,"ORAŞ SALCEA",146370,1,PART,PRCNCT,PRSD,PRSD_SV,"2025-05-18 21:25:18",1108,492,453,39,0,481,11,1200,708,338,143
35,SUCEAVA,"CENTRUL CULTURAL ”MIHAI TELIMAN”",182,"ORAŞ SIRET",146655,1,PART,PRCNCT,PRSD,PRSD_SV,"2025-05-18 22:04:54",1245,614,552,48,14,599,15,1400,786,275,324
35,SUCEAVA,"COLEGIUL LATCU VODA",183,"ORAŞ SIRET",146655,2,PART,PRCNCT,PRSD,PRSD_SV,"2025-05-19 02:12:01",1363,624,592,31,1,610,14,1500,876,269,341
35,SUCEAVA,"CENTRU DE TINERET",184,"ORAŞ SIRET",146655,1,PART,PRCNCT,PRSD,PRSD_SV,"2025-05-18 22:03:55",1215,474,438,34,2,458,16,1300,826,230,228
35,SUCEAVA,"COLEGIUL LAȚCU VODĂ ȘCOALA PROFESIONALĂ",185,"ORAŞ SIRET",146655,1,PART,PRCNCT,PRSD,PRSD_SV,"2025-05-18 22:12:50",707,307,266,41,0,302,5,800,493,161,141
35,SUCEAVA,"ȘCOALA GIMNAZIALĂ PETRU MUȘAT CORP C",186,"ORAŞ SIRET",146655,1,PART,PRCNCT,PRSD,PRSD_SV,"2025-05-18 22:19:18",1067,483,454,27,2,467,16,1200,717,211,256
35,SUCEAVA,"ȘCOALA GIMNAZIALĂ PETRU MUȘAT CORP I",187,"ORAŞ SIRET",146655,1,PART,PRCNCT,PRSD,PRSD_SV,"2025-05-18 21:59:13",1418,705,616,57,32,698,7,1600,895,390,308
35,SUCEAVA,"CENTRU RECREATIV, CARTIER PĂDURENI",188,"ORAŞ SIRET",146655,1,PART,PRCNCT,PRSD,PRSD_SV,"2025-05-18 21:31:19",430,216,194,22,0,212,4,500,284,117,95
35,SUCEAVA,"CENTRU DE SERVICII SOCIALE INTEGRATE MĂNĂSTIOARA",189,"ORAŞ SIRET",146655,1,PART,PRCNCT,PRSD,PRSD_SV,"2025-05-18 21:24:27",465,192,175,17,0,189,3,500,308,105,84
35,SUCEAVA,"PRIMĂRIA ORAŞULUI SOLCA",190,"ORAŞ SOLCA",146708,1,PART,PRCNCT,PRSD,PRSD_SV,"2025-05-18 22:00:06",982,457,391,43,23,446,11,1100,643,243,203
35,SUCEAVA,"LICEUL TEHNOLOGIC TOMŞA VODĂ SOLCA",191,"ORAŞ SOLCA",146708,1,PART,PRCNCT,PRSD,PRSD_SV,"2025-05-18 21:56:40",1055,474,438,36,0,469,5,1200,726,256,213
35,SUCEAVA,"GRĂDINIŢA CU PROGRAM NORMAL ”LUMEA COPIILOR”",192,"ORAŞ VICOVU DE SUS",151095,1,PART,PRCNCT,PRSD,PRSD_SV,"2025-05-18 21:48:43",1342,622,582,40,0,618,4,1500,878,504,114
35,SUCEAVA,"CĂMINUL CULTURAL VICOVU DE SUS-EST",193,"ORAŞ VICOVU DE SUS",151095,1,PART,PRCNCT,PRSD,PRSD_SV,"2025-05-18 21:30:31",1347,602,570,32,0,596,6,1500,898,458,138
35,SUCEAVA,"GRĂDINIŢA CU PROGRAM NORMAL NR. 1-EST",194,"ORAŞ VICOVU DE SUS",151095,1,PART,PRCNCT,PRSD,PRSD_SV,"2025-05-18 21:24:24",1410,548,530,18,0,544,4,1500,952,451,93
35,SUCEAVA,"LICEUL TEHHNOLOGIC ”ION NISTOR” VICOVU DE SUS-CORPUL 4",195,"ORAŞ VICOVU DE SUS",151095,1,PART,PRCNCT,PRSD,PRSD_SV,"2025-05-18 21:35:25",1100,483,444,36,3,478,5,1200,717,363,115
35,SUCEAVA,"ŞCOALA GIMNAZIALĂ NR. 3 VICOVU DE SUS",196,"ORAŞ VICOVU DE SUS",151095,1,PART,PRCNCT,PRSD,PRSD_SV,"2025-05-18 21:29:50",1601,558,535,23,0,549,9,1800,1242,407,142
35,SUCEAVA,"ŞCOALA GIMNAZIALĂ NR. 2 VICOVU DE SUS",197,"ORAŞ VICOVU DE SUS",151095,1,PART,PRCNCT,PRSD,PRSD_SV,"2025-05-18 21:53:42",1481,604,573,31,0,600,4,1600,996,413,187
35,SUCEAVA,"CASA DE CULTURĂ VICOVU DE SUS - LAURA",198,"ORAŞ VICOVU DE SUS",151095,1,PART,PRCNCT,PRSD,PRSD_SV,"2025-05-18 21:37:17",1748,723,699,24,0,717,6,1900,1177,540,177
35,SUCEAVA,"ŞCOALA GIMNAZIALĂ BIVOLĂRIA",199,"ORAŞ VICOVU DE SUS",151095,1,PART,PRCNCT,PRSD,PRSD_SV,"2025-05-18 21:53:20",1815,923,860,62,1,911,12,2000,1077,752,159
35,SUCEAVA,"GRĂDINIŢA NOUĂ BIVOLĂRIE",200,"ORAŞ VICOVU DE SUS",151095,1,PART,PRCNCT,PRSD,PRSD_SV,"2025-05-18 21:34:19",920,371,354,17,0,363,8,1000,629,282,81
35,SUCEAVA,"SCOALA GIMNAZIALĂ IOAN BĂNCESCU ADÂNCATA - CORPUL CU CLASELE I-IV",201,ADÂNCATA,146799,1,PART,PRCNCT,PRSD,PRSD_SV,"2025-05-18 21:44:47",1404,768,693,75,0,750,18,1500,732,411,339
35,SUCEAVA,"SCOALA GIMNAZIALĂ IOAN BĂNCESCU ADÂNCATA - CORPUL CU CLASELE V-VIII",202,ADÂNCATA,146799,1,PART,PRCNCT,PRSD,PRSD_SV,"2025-05-18 21:59:24",1005,639,555,84,0,635,4,1100,461,358,277
35,SUCEAVA,"ŞCOALA PRIMARĂ CĂLUGĂRENI",203,ADÂNCATA,146799,1,PART,PRCNCT,PRSD,PRSD_SV,"2025-05-18 21:34:01",651,378,303,75,0,375,3,700,322,230,145
35,SUCEAVA,"ŞCOALA PRIMARĂ FETEŞTI",204,ADÂNCATA,146799,1,PART,PRCNCT,PRSD,PRSD_SV,"2025-05-18 21:34:06",482,252,204,45,3,246,6,500,248,130,116
35,SUCEAVA,"SCOALA GIMNAZIALA NR. 1 ”LUCA ARBURE”, CORP B",205,ARBORE,146860,1,PART,PRCNCT,PRSD,PRSD_SV,"2025-05-18 21:53:43",1881,751,688,63,0,744,7,2000,1249,495,249
35,SUCEAVA,"SCOALA GIMNAZIALA NR.2 ARBORE",206,ARBORE,146860,1,PART,PRCNCT,PRSD,PRSD_SV,"2025-05-18 21:53:45",1773,627,589,38,0,606,21,1900,1273,360,246
35,SUCEAVA,"SCOALA GIMNAZIALA NR.3 ARBORE",207,ARBORE,146860,1,PART,PRCNCT,PRSD,PRSD_SV,"2025-05-18 21:32:18",1183,423,402,21,0,416,7,1300,877,276,140
35,SUCEAVA,"ŞCOALA PRIMARĂ BODNĂRENI",208,ARBORE,146860,1,PART,PRCNCT,PRSD,PRSD_SV,"2025-05-18 21:37:42",283,116,94,22,0,115,1,300,184,101,14
35,SUCEAVA,"SALĂ DE FESTIVITĂŢI CLIT",209,ARBORE,146860,1,PART,PRCNCT,PRSD,PRSD_SV,"2025-05-18 21:50:18",1100,508,469,39,0,499,9,1200,692,290,209
35,SUCEAVA,"SEDIUL PRIMARIEI BAIA",210,BAIA,146904,1,PART,PRCNCT,PRSD,PRSD_SV,"2025-05-18 22:06:36",1723,724,665,59,0,716,8,1900,1176,465,251
35,SUCEAVA,"ŞCOALA NR. 2 BAIA",211,BAIA,146904,1,PART,PRCNCT,PRSD,PRSD_SV,"2025-05-18 21:31:57",1267,597,565,32,0,588,9,1400,803,419,169
35,SUCEAVA,"ŞCOALA NR. 3 BAIA",212,BAIA,146904,1,PART,PRCNCT,PRSD,PRSD_SV,"2025-05-18 21:45:38",1820,715,683,32,0,700,15,2000,1285,529,171
35,SUCEAVA,"ŞCOALA GIMNAZIALĂ BOGATA",213,BAIA,146904,1,PART,PRCNCT,PRSD,PRSD_SV,"2025-05-18 21:31:23",1092,425,388,37,0,421,4,1200,775,298,123
35,SUCEAVA,"ŞCOALA GIMNAZIALĂ BĂLĂCEANA",214,BĂLĂCEANA,151530,1,PART,PRCNCT,PRSD,PRSD_SV,"2025-05-18 21:48:08",1174,576,474,102,0,569,7,1197,621,361,208
35,SUCEAVA,"SEDIUL PRIMĂRIEI COMUNEI BĂLCĂUŢI",215,BĂLCĂUŢI,146995,1,PART,PRCNCT,PRSD,PRSD_SV,"2025-05-18 21:27:48",1232,425,386,39,0,418,7,1400,975,275,143
35,SUCEAVA,"ŞCOALA PRIMARA GROPENI",216,BĂLCĂUŢI,146995,1,PART,PRCNCT,PRSD,PRSD_SV,"2025-05-18 21:31:31",297,106,85,21,0,104,2,300,194,51,53
35,SUCEAVA,"ŞCOALA GIMNAZIALA NEGOSTINA",217,BĂLCĂUŢI,146995,2,PART,PRCNCT,PRSD,PRSD_SV,"2025-05-18 23:12:40",1102,511,473,38,0,500,11,1200,689,251,249
35,SUCEAVA,"ȘCOALA GIMNAZIALĂ BERCHIȘEȘTI",218,BERCHIŞEŞTI,151576,1,PART,PRCNCT,PRSD,PRSD_SV,"2025-05-18 22:04:05",1066,576,494,82,0,571,5,1200,624,398,173
35,SUCEAVA,"ȘCOALA GIMNAZIALĂ BERCHIȘEȘTI",219,BERCHIŞEŞTI,151576,1,PART,PRCNCT,PRSD,PRSD_SV,"2025-05-18 22:09:28",1083,466,442,24,0,457,9,1200,734,321,136
35,SUCEAVA,"CENTRUL CULTURAL FLORIN PIERSIC CORLATA",220,BERCHIŞEŞTI,151576,1,PART,PRCNCT,PRSD,PRSD_SV,"2025-05-18 22:09:54",411,195,174,21,0,191,4,500,305,134,57
35,SUCEAVA,PRIMARIA,221,BILCA,147036,1,PART,PRCNCT,PRSD,PRSD_SV,"2025-05-18 21:42:33",1180,493,460,29,4,490,3,1300,807,280,210
35,SUCEAVA,"SCOALA GIMNAZIALA NR. 2",222,BILCA,147036,1,PART,PRCNCT,PRSD,PRSD_SV,"2025-05-18 21:46:01",983,475,439,29,7,473,2,1100,625,274,199
35,SUCEAVA,"SCOALA PRIMARA NR. 3",223,BILCA,147036,1,PART,PRCNCT,PRSD,PRSD_SV,"2025-05-18 21:40:17",1012,436,410,26,0,429,7,1100,664,295,134
35,SUCEAVA,"ȘCOALA GIMNAZIALĂ NUMĂRUL 1 BOGDĂNEȘTI, LOCAL VECHI",224,BOGDĂNEŞTI,147054,1,PART,PRCNCT,PRSD,PRSD_SV,"2025-05-18 22:02:47",1701,938,744,191,3,925,13,1900,962,622,303
35,SUCEAVA,"ȘCOALA GIMNAZIALĂ NR. 2 BOGDĂNEȘTI, LOCAL VECHI",225,BOGDĂNEŞTI,147054,1,PART,PRCNCT,PRSD,PRSD_SV,"2025-05-18 21:31:25",1541,738,668,69,1,728,10,1700,962,527,201
35,SUCEAVA,"CĂMIN CULTURAL MIHAI BOLEAC",226,BOROAIA,147072,1,PART,PRCNCT,PRSD,PRSD_SV,"2025-05-18 21:38:21",824,440,368,72,0,438,2,900,460,229,209
35,SUCEAVA,"ŞCOALA PRIMARĂ NR.2 BOROAIA",227,BOROAIA,147072,1,PART,PRCNCT,PRSD,PRSD_SV,"2025-05-18 21:31:33",716,304,278,26,0,301,3,800,496,187,114
35,SUCEAVA,"GRĂDINIŢA CU PROGRAM NORMAL BĂRĂŞTI",228,BOROAIA,147072,1,PART,PRCNCT,PRSD,PRSD_SV,"2025-05-18 21:54:04",841,411,370,41,0,400,11,900,489,231,169
35,SUCEAVA,"ȘCOALA PRIMARĂ",229,BOROAIA,147072,1,PART,PRCNCT,PRSD,PRSD_SV,"2025-05-18 21:27:40",463,227,197,30,0,226,1,500,273,133,93
35,SUCEAVA,"ŞCOALA GIMNAZIALĂ MOIŞA",230,BOROAIA,147072,1,PART,PRCNCT,PRSD,PRSD_SV,"2025-05-18 21:23:59",540,258,219,39,0,254,4,600,342,193,61
35,SUCEAVA,"ŞCOALA PRIMARĂ SĂCUŢA",231,BOROAIA,147072,1,PART,PRCNCT,PRSD,PRSD_SV,"2025-05-18 21:24:00",425,178,151,27,0,177,1,500,322,131,46
35,SUCEAVA,"CAMINUL CULTURAL BOSANCI",232,BOSANCI,147134,1,PART,PRCNCT,PRSD,PRSD_SV,"2025-05-18 21:50:52",1171,504,441,63,0,496,8,1300,796,354,142
35,SUCEAVA,"CĂMINUL CULTURAL BOSANCI",233,BOSANCI,147134,1,PART,PRCNCT,PRSD,PRSD_SV,"2025-05-18 21:43:32",1418,592,557,35,0,576,16,1500,908,382,194
35,SUCEAVA,"ŞCOALA GIMNAZIALĂ BOSANCI",234,BOSANCI,147134,1,PART,PRCNCT,PRSD,PRSD_SV,"2025-05-18 21:42:09",1267,510,480,30,0,501,9,1400,890,301,200
35,SUCEAVA,"ŞCOALA PRIMARĂ BOSANCI",235,BOSANCI,147134,1,PART,PRCNCT,PRSD,PRSD_SV,"2025-05-18 21:44:06",1770,685,644,41,0,675,10,1900,1215,423,252
35,SUCEAVA,"ŞCOALA PRIMARĂ CUMPĂRĂTURA",236,BOSANCI,147134,1,PART,PRCNCT,PRSD,PRSD_SV,"2025-05-18 21:33:31",357,152,129,23,0,146,6,400,248,92,54
35,SUCEAVA,"SCOALA GIMNAZIALA CU CLASELE I-VIII BOTOSANA",237,BOTOŞANA,147161,1,PART,PRCNCT,PRSD,PRSD_SV,"2025-05-18 21:35:04",1045,490,465,24,1,487,3,1200,710,348,139
35,SUCEAVA,"CĂMIN CULTURAL BOTOŞANA",238,BOTOŞANA,147161,1,PART,PRCNCT,PRSD,PRSD_SV,"2025-05-18 21:19:12",1043,517,473,40,4,510,7,1100,583,360,150
35,SUCEAVA,"CAMINUL CULTURAL SAT BREAZA",239,BREAZA,147205,1,PART,PRCNCT,PRSD,PRSD_SV,"2025-05-18 21:38:02",1213,546,499,47,0,541,5,1300,754,380,161
35,SUCEAVA,"SEDIUL NOU AL PRIMARIEI COMUNEI BRODINA",240,BRODINA,147241,1,PART,PRCNCT,PRSD,PRSD_SV,"2025-05-18 21:36:45",1353,581,534,47,0,574,7,1500,919,435,139
35,SUCEAVA,"CENTRU DE ASISTENTA DUPA PROGRAMUL SCOLAR TIP AFTER SCHOOL",241,BRODINA,147241,1,PART,PRCNCT,PRSD,PRSD_SV,"2025-05-18 21:29:49",606,228,198,30,0,228,0,700,472,182,46
35,SUCEAVA,"GRADINITA CU PROGRAM NORMAL FALCAU",242,BRODINA,147241,1,PART,PRCNCT,PRSD,PRSD_SV,"2025-05-18 21:51:16",1113,538,479,59,0,531,7,1200,662,390,141
35,SUCEAVA,"GRĂDINIȚA CU PROGRAM NORMAL BUNEȘTI",243,BUNEŞTI,147465,1,PART,PRCNCT,PRSD,PRSD_SV,"2025-05-18 21:32:45",585,311,291,20,0,299,12,600,289,166,133
35,SUCEAVA,"SCOALA GIMNAZIALA PETIA",244,BUNEŞTI,147465,1,PART,PRCNCT,PRSD,PRSD_SV,"2025-05-18 21:43:45",621,275,248,27,0,265,10,700,425,177,88
35,SUCEAVA,"GRADINITA CU PROGRAM NORMAL PODENI",245,BUNEŞTI,147465,1,PART,PRCNCT,PRSD,PRSD_SV,"2025-05-18 21:34:09",515,252,218,34,0,249,3,600,348,163,86
35,SUCEAVA,"SCOALA UNCESTI",246,BUNEŞTI,147465,1,PART,PRCNCT,PRSD,PRSD_SV,"2025-05-18 21:35:04",543,275,238,37,0,272,3,600,325,188,84
35,SUCEAVA,"CAMINUL CULTURAL BURLA - SALA MARE",247,BURLA,151521,1,PART,PRCNCT,PRSD,PRSD_SV,"2025-05-18 22:04:50",1751,675,632,43,0,671,4,1900,1225,458,213
35,SUCEAVA,"AȘEZĂMÂNT CULTURAL",248,CACICA,147526,1,PART,PRCNCT,PRSD,PRSD_SV,"2025-05-18 21:50:11",1519,818,746,69,3,807,11,1700,882,559,248
35,SUCEAVA,"ȘCOALA CACICA",249,CACICA,147526,1,PART,PRCNCT,PRSD,PRSD_SV,"2025-05-18 21:34:42",1081,511,426,84,1,506,5,1200,689,306,200
35,SUCEAVA,"ŞCOALA RUNCU",250,CACICA,147526,1,PART,PRCNCT,PRSD,PRSD_SV,"2025-05-18 21:21:32",170,105,45,60,0,104,1,200,95,65,39
35,SUCEAVA,"ŞCOALA SOLONEŢU NOU",251,CACICA,147526,1,PART,PRCNCT,PRSD,PRSD_SV,"2025-05-18 21:32:35",689,307,286,21,0,302,5,800,493,170,132
35,SUCEAVA,"SALA DE SPORT CALAFINDESTI SALA A",252,CALAFINDEŞTI,147580,1,PART,PRCNCT,PRSD,PRSD_SV,"2025-05-18 21:30:12",1028,491,463,28,0,483,8,1100,609,271,212
35,SUCEAVA,"SALA DE SPORT CALAFINDESTI- SALA B",253,CALAFINDEŞTI,147580,1,PART,PRCNCT,PRSD,PRSD_SV,"2025-05-18 21:27:16",1009,456,433,23,0,447,9,1100,644,270,177
35,SUCEAVA,"SCOALA PRIMARA BOTOŞANIŢA MARE",254,CALAFINDEŞTI,147580,1,PART,PRCNCT,PRSD,PRSD_SV,"2025-05-18 21:22:47",277,129,107,22,0,125,4,300,171,59,66
35,SUCEAVA,"GRĂDINIŢA CU PROGRAM NORMAL NR.1 CAPU CÂMPULUI",255,"CAPU CÂMPULUI",151503,1,PART,PRCNCT,PRSD,PRSD_SV,"2025-05-18 22:40:42",1912,1313,1101,142,70,1297,16,2100,787,668,629
35,SUCEAVA,"CĂMIN CULTURAL",256,CÂRLIBABA,147713,1,PART,PRCNCT,PRSD,PRSD_SV,"2025-05-18 22:02:24",1580,810,737,59,14,799,11,1700,890,550,249
35,SUCEAVA,"CASA DE CULTURĂ CIOCĂNEȘTI",257,CIOCĂNEŞTI,151451,1,PART,PRCNCT,PRSD,PRSD_SV,"2025-05-18 21:48:38",902,551,485,60,6,549,2,1000,449,321,228
35,SUCEAVA,"ȘCOALA BOTOȘ",258,CIOCĂNEŞTI,151451,1,PART,PRCNCT,PRSD,PRSD_SV,"2025-05-18 21:36:18",322,232,194,33,5,228,4,400,168,146,82
35,SUCEAVA,"PRIMARIA COMUNEI CIPRIAN PORUMBESCU",259,"CIPRIAN PORUMBESCU",151567,1,PART,PRCNCT,PRSD,PRSD_SV,"2025-05-18 21:21:45",1758,655,573,82,0,638,17,1900,1245,400,238
35,SUCEAVA,"SCOALA GIMNAZIALA CU CLASELE I-VIII COMANESTI",260,COMĂNEŞTI,151433,1,PART,PRCNCT,PRSD,PRSD_SV,"2025-05-18 21:39:18",955,513,455,54,4,508,5,1100,587,235,273
35,SUCEAVA,"SCOALA GIMNAZIALA CU CLASELE I-VIII HUMORENI",261,COMĂNEŞTI,151433,1,PART,PRCNCT,PRSD,PRSD_SV,"2025-05-18 21:23:51",937,427,378,48,1,423,4,1000,573,231,192
35,SUCEAVA,"SCOALA GIMNAZIALA CORNU LUNCII",262,"CORNU LUNCII",147786,1,PART,PRCNCT,PRSD,PRSD_SV,"2025-05-18 21:43:21",1038,505,433,71,1,494,11,1100,595,311,183
35,SUCEAVA,"SCOALA GIMNAZIALA BAISESTI",263,"CORNU LUNCII",147786,1,PART,PRCNCT,PRSD,PRSD_SV,"2025-05-18 21:51:34",1183,649,586,63,0,643,6,1300,651,454,189
35,SUCEAVA,"SCOALA GIMNAZIALA BRAIESTI",264,"CORNU LUNCII",147786,1,PART,PRCNCT,PRSD,PRSD_SV,"2025-05-18 21:36:30",960,537,476,59,2,533,4,1100,563,329,204
35,SUCEAVA,"SCOALA PRIMARA DUMBRAVA",265,"CORNU LUNCII",147786,1,PART,PRCNCT,PRSD,PRSD_SV,"2025-05-18 21:35:24",476,215,189,26,0,213,2,500,285,157,56
35,SUCEAVA,"SCOALA PAISENI",266,"CORNU LUNCII",147786,1,PART,PRCNCT,PRSD,PRSD_SV,"2025-05-18 21:29:04",635,353,325,27,1,348,5,700,347,278,70
35,SUCEAVA,"SCOALA SASCA MARE",267,"CORNU LUNCII",147786,1,PART,PRCNCT,PRSD,PRSD_SV,"2025-05-18 21:28:40",557,294,259,34,1,292,2,600,306,205,87
35,SUCEAVA,"CĂMINUL CULTURAL SASCA MICĂ",268,"CORNU LUNCII",147786,1,PART,PRCNCT,PRSD,PRSD_SV,"2025-05-18 21:32:54",593,288,248,39,1,275,13,700,412,176,99
35,SUCEAVA,"SCOALA SASCA NOUA",269,"CORNU LUNCII",147786,1,PART,PRCNCT,PRSD,PRSD_SV,"2025-05-18 21:22:32",186,132,99,33,0,131,1,200,68,81,50
35,SUCEAVA,"SCOALA SINCA",270,"CORNU LUNCII",147786,1,PART,PRCNCT,PRSD,PRSD_SV,"2025-05-18 21:22:05",137,88,66,18,4,87,1,200,112,59,28
35,SUCEAVA,"CĂMIN CULTURAL COȘNA",271,COŞNA,151497,1,PART,PRCNCT,PRSD,PRSD_SV,"2025-05-18 21:32:24",1213,725,656,68,1,723,2,1300,575,438,285
35,SUCEAVA,"PRIMĂRIA COMUNEI CRUCEA SALĂ FESTIVITĂȚI",272,CRUCEA,147884,1,PART,PRCNCT,PRSD,PRSD_SV,"2025-05-18 21:26:35",1164,591,537,54,0,583,8,1300,709,392,191
35,SUCEAVA,"CĂMINUL CULTURAL CHIRIL",273,CRUCEA,147884,1,PART,PRCNCT,PRSD,PRSD_SV,"2025-05-18 21:32:39",473,259,225,34,0,251,8,500,241,159,92
35,SUCEAVA,"ŞCOALA GIMNAZIALĂ MĂRIŢEI",274,DĂRMĂNEŞTI,147937,1,PART,PRCNCT,PRSD,PRSD_SV,"2025-05-18 21:48:21",1489,745,689,56,0,733,12,1600,855,465,268
35,SUCEAVA,"ŞCOALA GIMNAZIALĂ CĂLINEŞTI ENACHE",275,DĂRMĂNEŞTI,147937,1,PART,PRCNCT,PRSD,PRSD_SV,"2025-05-18 21:33:06",549,322,265,57,0,321,1,600,278,171,150
35,SUCEAVA,"ŞCOALA CĂLINEŞTI-VASILACHE",276,DĂRMĂNEŞTI,147937,1,PART,PRCNCT,PRSD,PRSD_SV,"2025-05-18 21:15:29",163,83,66,17,0,83,0,200,117,61,22
35,SUCEAVA,"ŞCOALA GIMNAZIALĂ DĂNILA",277,DĂRMĂNEŞTI,147937,1,PART,PRCNCT,PRSD,PRSD_SV,"2025-05-18 22:00:59",934,473,432,41,0,468,5,1000,527,300,168
35,SUCEAVA,"GRĂDINIŢA CU PROGRAM NORMAL NR.1 DĂRMĂNEŞTI",278,DĂRMĂNEŞTI,147937,1,PART,PRCNCT,PRSD,PRSD_SV,"2025-05-18 22:01:38",1014,523,464,56,3,520,3,1100,577,335,185
35,SUCEAVA,"ŞCOALA DĂRMĂNEŞTI NR.2",279,DĂRMĂNEŞTI,147937,1,PART,PRCNCT,PRSD,PRSD_SV,"2025-05-18 21:39:03",835,458,423,35,0,447,11,900,442,268,179
35,SUCEAVA,"PRIMĂRIA DOLHEŞTI",280,DOLHEŞTI,148097,1,PART,PRCNCT,PRSD,PRSD_SV,"2025-05-18 22:09:48",1388,684,599,78,7,674,10,1500,816,322,352
35,SUCEAVA,"ŞCOALA GIMNAZIALĂ DOLHEŞTII MICI",281,DOLHEŞTI,148097,1,PART,PRCNCT,PRSD,PRSD_SV,"2025-05-18 21:41:34",964,470,423,47,0,467,3,1100,630,258,209
35,SUCEAVA,"ŞCOALA PRIMARĂ VALEA BOUREI",282,DOLHEŞTI,148097,1,PART,PRCNCT,PRSD,PRSD_SV,"2025-05-18 21:29:57",619,320,272,46,2,317,3,700,380,200,117
35,SUCEAVA,"CĂMIN CULTURAL COZĂNEŞTI",283,DORNA-ARINI,148131,1,PART,PRCNCT,PRSD,PRSD_SV,"2025-05-18 21:50:11",1208,792,695,97,0,778,14,1300,508,470,308
35,SUCEAVA,"SEDIU ASOCIAŢIE ”OBŞTEA GURA NEGRII” DORNA ARINI",284,DORNA-ARINI,148131,1,PART,PRCNCT,PRSD,PRSD_SV,"2025-05-18 21:44:32",597,396,349,46,1,392,4,700,304,203,189
35,SUCEAVA,"GRĂDINIŢA CU PROGRAM NORMAL RUSCA, SAT RUSCA, NR. 59A",285,DORNA-ARINI,148131,1,PART,PRCNCT,PRSD,PRSD_SV,"2025-05-18 21:33:24",633,379,344,35,0,371,8,700,321,191,180
35,SUCEAVA,"PRIMĂRIA COMUNEI DORNA CANDRENILOR",286,"DORNA CANDRENILOR",148202,1,PART,PRCNCT,PRSD,PRSD_SV,"2025-05-18 22:13:37",1717,982,889,92,1,967,15,1900,918,546,421
35,SUCEAVA,"CĂMINUL CULTURAL POIANA NEGRII",287,"DORNA CANDRENILOR",148202,1,PART,PRCNCT,PRSD,PRSD_SV,"2025-05-18 21:51:45",774,481,444,37,0,474,7,900,419,362,112
35,SUCEAVA,"SCOALA GIMNAZIALA DORNESTI",288,DORNEŞTI,148293,1,PART,PRCNCT,PRSD,PRSD_SV,"2025-05-18 21:49:36",1771,630,593,35,2,624,6,1900,1270,411,213
35,SUCEAVA,"PRIMĂRIA COMUNEI DORNEȘTI",289,DORNEŞTI,148293,1,PART,PRCNCT,PRSD,PRSD_SV,"2025-05-18 21:41:42",1786,733,684,49,0,723,10,1900,1167,446,277
35,SUCEAVA,"SCOALA PRIMARA IAZ",290,DORNEŞTI,148293,1,PART,PRCNCT,PRSD,PRSD_SV,"2025-05-18 21:26:43",224,93,81,12,0,90,3,300,207,55,35
35,SUCEAVA,"PRIMARIA COMUNEI DRĂGOIEŞTI",291,DRĂGOIEŞTI,148328,1,PART,PRCNCT,PRSD,PRSD_SV,"2025-05-18 21:18:52",450,232,190,42,0,228,4,500,268,161,67
35,SUCEAVA,"ȘCOALA GIMNAZIALĂ DRĂGOIEȘTI",292,DRĂGOIEŞTI,148328,1,PART,PRCNCT,PRSD,PRSD_SV,"2025-05-18 21:33:52",1344,566,491,75,0,564,2,1500,934,372,192
35,SUCEAVA,"CĂMIN CULTURAL LUCĂCEȘTI",293,DRĂGOIEŞTI,148328,1,PART,PRCNCT,PRSD,PRSD_SV,"2025-05-18 21:24:57",214,135,104,31,0,134,1,300,165,84,50
35,SUCEAVA,"PRIMĂRIA COMUNEI DRĂGUŞENI",294,DRĂGUŞENI,148382,1,PART,PRCNCT,PRSD,PRSD_SV,"2025-05-18 21:49:28",1795,871,752,119,0,859,12,2008,1137,566,293
35,SUCEAVA,"GRĂDINIŢA CU PROGRAM NORMAL BROŞTENI",295,DRĂGUŞENI,148382,1,PART,PRCNCT,PRSD,PRSD_SV,"2025-05-18 21:28:53",268,141,103,38,0,139,2,300,159,89,50
35,SUCEAVA,"ATENEU DUMBRAVENI",296,DUMBRĂVENI,148426,1,PART,PRCNCT,PRSD,PRSD_SV,"2025-05-18 22:09:26",1889,862,784,75,3,848,14,2000,1138,602,246
35,SUCEAVA,"LICEUL TEHNOLOGIC MIHAI EMINESCU DUMBRAVENI",297,DUMBRĂVENI,148426,1,PART,PRCNCT,PRSD,PRSD_SV,"2025-05-18 21:49:39",1904,917,842,69,6,894,23,2100,1183,598,296
35,SUCEAVA,"SCOALA TOLOACA",298,DUMBRĂVENI,148426,1,PART,PRCNCT,PRSD,PRSD_SV,"2025-05-18 22:02:11",2002,922,864,49,9,909,13,2200,1278,665,244
35,SUCEAVA,"SCOALA DEAL",299,DUMBRĂVENI,148426,1,PART,PRCNCT,PRSD,PRSD_SV,"2025-05-18 21:41:13",1736,821,784,35,2,808,13,1900,1079,579,229
35,SUCEAVA,"SCOALA SALAGENI",300,DUMBRĂVENI,148426,1,PART,PRCNCT,PRSD,PRSD_SV,"2025-05-18 21:21:07",527,232,204,28,0,229,3,600,368,165,64
35,SUCEAVA,"SCOALA CU CLASELE I-IV FANTANA MARE",301,"FÂNTÂNA MARE",151488,1,PART,PRCNCT,PRSD,PRSD_SV,"2025-05-18 21:31:50",880,480,434,46,0,476,4,1000,520,286,190
35,SUCEAVA,"SCOALA CU CLASELE I-IV COTU BAII",302,"FÂNTÂNA MARE",151488,1,PART,PRCNCT,PRSD,PRSD_SV,"2025-05-18 21:35:50",772,353,308,45,0,351,2,900,547,225,126
35,SUCEAVA,"SCOALA CU CLASELE I-IV PRAXIA",303,"FÂNTÂNA MARE",151488,1,PART,PRCNCT,PRSD,PRSD_SV,"2025-05-18 21:16:39",127,104,64,39,1,103,1,200,96,73,30
35,SUCEAVA,"SCOALA CU CLASELE I-IV SPĂTĂREȘTI",304,"FÂNTÂNA MARE",151488,1,PART,PRCNCT,PRSD,PRSD_SV,"2025-05-18 21:12:17",386,204,168,36,0,204,0,400,196,124,80
35,SUCEAVA,"GRĂDINIȚA CU PROGRAM NORMAL CU 3 GRUPE NR.1 FÂNTÂNELE",305,FÂNTÂNELE,148453,1,PART,PRCNCT,PRSD,PRSD_SV,"2025-05-18 21:44:03",913,403,360,43,0,395,8,1000,597,297,98
35,SUCEAVA,"CĂMINUL CULTURAL BĂNEŞTI",306,FÂNTÂNELE,148453,1,PART,PRCNCT,PRSD,PRSD_SV,"2025-05-18 21:35:52",917,412,374,38,0,406,6,1000,588,275,131
35,SUCEAVA,"SCOALA DIN SATUL COTU DOBEI",307,FÂNTÂNELE,148453,1,PART,PRCNCT,PRSD,PRSD_SV,"2025-05-18 21:18:10",147,85,63,22,0,81,4,200,115,49,32
35,SUCEAVA,"CONTAINER MOBIL",308,FÂNTÂNELE,148453,1,PART,PRCNCT,PRSD,PRSD_SV,"2025-05-18 21:18:48",168,73,61,12,0,71,2,200,127,56,15
35,SUCEAVA,"ȘCOALA PRIMARĂ CU CLASELE I-IV STAMATE",309,FÂNTÂNELE,148453,1,PART,PRCNCT,PRSD,PRSD_SV,"2025-05-18 22:18:49",1534,724,665,59,0,719,5,1700,976,508,211
35,SUCEAVA,"SEDIUL PRIMARIEI FORASTI",310,FORĂŞTI,148514,1,PART,PRCNCT,PRSD,PRSD_SV,"2025-05-18 21:28:14",467,238,208,28,2,237,1,500,262,162,75
35,SUCEAVA,"SCOALA ANTOCENI",311,FORĂŞTI,148514,2,PART,PRCNCT,PRSD,PRSD_SV,"2025-05-19 03:57:24",261,139,111,28,0,139,0,300,161,72,67
35,SUCEAVA,"SCOALA PRIMARA BOURA",312,FORĂŞTI,148514,1,PART,PRCNCT,PRSD,PRSD_SV,"2025-05-18 21:30:24",471,227,216,11,0,225,2,500,273,173,52
35,SUCEAVA,"SEDIUL FOSTEI PRIMARII MANOLEA",313,FORĂŞTI,148514,1,PART,PRCNCT,PRSD,PRSD_SV,"2025-05-18 21:35:36",373,219,180,39,0,216,3,400,181,131,85
35,SUCEAVA,"SCOALA VIISOARA, CATUN VIISOARA",314,FORĂŞTI,148514,1,PART,PRCNCT,PRSD,PRSD_SV,"2025-05-18 21:30:56",161,98,82,16,0,97,1,200,102,72,25
35,SUCEAVA,"SCOALA GIMNAZIALA ONICENI",315,FORĂŞTI,148514,1,PART,PRCNCT,PRSD,PRSD_SV,"2025-05-18 21:32:09",755,358,307,51,0,355,3,800,442,217,138
35,SUCEAVA,"SCOALA ROSIORI",316,FORĂŞTI,148514,1,PART,PRCNCT,PRSD,PRSD_SV,"2025-05-18 21:34:44",279,184,132,52,0,184,0,300,116,128,56
35,SUCEAVA,"SCOALA PRIMARA RUSI",317,FORĂŞTI,148514,1,PART,PRCNCT,PRSD,PRSD_SV,"2025-05-18 21:41:33",316,194,166,28,0,191,3,400,206,132,59
35,SUCEAVA,"SCOALA TOLESTI",318,FORĂŞTI,148514,1,PART,PRCNCT,PRSD,PRSD_SV,"2025-05-18 21:27:07",304,136,122,14,0,135,1,400,264,102,33
35,SUCEAVA,"SCOALA PRIMARA UIDESTI",319,FORĂŞTI,148514,1,PART,PRCNCT,PRSD,PRSD_SV,"2025-05-18 21:17:12",130,82,66,16,0,82,0,200,118,45,37
35,SUCEAVA,"ȘCOALA GIMNAZIALĂ ”IRACLIE PORUMBESCU”, CORP A",320,"FRĂTĂUŢII NOI",148667,1,PART,PRCNCT,PRSD,PRSD_SV,"2025-05-18 21:48:29",1172,536,503,33,0,529,7,1300,764,245,284
35,SUCEAVA,"ȘCOALA GIMNAZIALĂ ”IRACLIE PORUMBESCU”, CORP B",321,"FRĂTĂUŢII NOI",148667,1,PART,PRCNCT,PRSD,PRSD_SV,"2025-05-18 21:26:50",399,204,179,25,0,201,3,400,196,105,96
35,SUCEAVA,"ŞCOALA GIMNAZIALĂ NR 2 FRĂTĂUŢII NOI",322,"FRĂTĂUŢII NOI",148667,1,PART,PRCNCT,PRSD,PRSD_SV,"2025-05-18 21:52:02",1685,431,409,22,0,423,8,1800,1369,309,114
35,SUCEAVA,"CĂMIN CULTURAL COSTIŞA",323,"FRĂTĂUŢII NOI",148667,1,PART,PRCNCT,PRSD,PRSD_SV,"2025-05-18 21:41:38",837,312,289,23,0,301,11,900,588,158,143
35,SUCEAVA,"GRĂDINIŢA CU PROGRAM NORMAL NR 2 COSTIŞA",324,"FRĂTĂUŢII NOI",148667,1,PART,PRCNCT,PRSD,PRSD_SV,"2025-05-18 21:23:28",482,195,178,17,0,189,6,500,305,89,100
35,SUCEAVA,"CAMIN CULTURAL FRATAUTII VECHI",325,"FRĂTĂUŢII VECHI",148694,1,PART,PRCNCT,PRSD,PRSD_SV,"2025-05-18 21:51:53",1611,601,576,25,0,596,5,1800,1199,385,211
35,SUCEAVA,"ŞCOALA PRIMARĂ LIVIU V. IONESI FRĂTĂUŢII-VECHI",326,"FRĂTĂUŢII VECHI",148694,1,PART,PRCNCT,PRSD,PRSD_SV,"2025-05-18 21:52:02",1191,403,373,30,0,401,2,1300,897,208,193
35,SUCEAVA,"ȘCOALA GIMNAZIALĂ ION PINTILIE MĂNEUȚI",327,"FRĂTĂUŢII VECHI",148694,1,PART,PRCNCT,PRSD,PRSD_SV,"2025-05-18 21:50:40",1776,637,611,26,0,623,14,1900,1263,396,227
35,SUCEAVA,"SALĂ DE FESTIVITĂȚI A PRIMĂRIEI FRUMOSU",328,FRUMOSU,148729,1,PART,PRCNCT,PRSD,PRSD_SV,"2025-05-18 21:59:25",1798,970,891,77,2,970,0,2000,1030,640,330
35,SUCEAVA,"GRĂDINIȚA CU PROGRAM NORMAL ”VOINICEL” DEIA",329,FRUMOSU,148729,1,PART,PRCNCT,PRSD,PRSD_SV,"2025-05-18 21:37:12",617,354,336,18,0,353,1,700,346,229,124
35,SUCEAVA,"CĂMIN CULTURAL DRAGOȘA",330,FRUMOSU,148729,1,PART,PRCNCT,PRSD,PRSD_SV,"2025-05-18 21:39:14",350,196,181,15,0,195,1,400,204,158,37
35,SUCEAVA,"CASA DE CULTURĂ",331,"FUNDU MOLDOVEI",148765,1,PART,PRCNCT,PRSD,PRSD_SV,"2025-05-18 21:58:56",1518,945,826,117,2,935,10,1700,755,503,432
35,SUCEAVA,"CĂMINUL CULTURAL BOTUȘ",332,"FUNDU MOLDOVEI",148765,1,PART,PRCNCT,PRSD,PRSD_SV,"2025-05-18 21:34:47",959,516,469,47,0,512,4,1100,584,299,213
35,SUCEAVA,"ȘCOALA GIMNAZIALĂ ”TRAIAN POPOVICI” COLACU",333,"FUNDU MOLDOVEI",148765,1,PART,PRCNCT,PRSD,PRSD_SV,"2025-05-18 21:42:05",776,458,432,26,0,450,8,900,442,239,211
35,SUCEAVA,"ŞCOALA PRIMARĂ DIN SATUL GĂLĂNEŞTI",334,GĂLĂNEŞTI,148872,1,PART,PRCNCT,PRSD,PRSD_SV,"2025-05-18 21:53:46",1632,593,558,35,0,588,5,1800,1207,302,286
35,SUCEAVA,"CĂMIN CULTURAL GĂLĂNEŞTI",335,GĂLĂNEŞTI,148872,1,PART,PRCNCT,PRSD,PRSD_SV,"2025-05-18 21:38:08",1020,339,322,17,0,335,4,1100,761,184,151
35,SUCEAVA,"ȘCOALA GIMNAZIALĂ ” PAHOMIE C. VASILIU”",336,GRĂMEŞTI,148916,1,PART,PRCNCT,PRSD,PRSD_SV,"2025-05-18 21:52:30",1620,737,669,65,3,734,3,1800,1063,431,303
35,SUCEAVA,"ŞCOALA PRIMARĂ BĂLINEŞTI",337,GRĂMEŞTI,148916,1,PART,PRCNCT,PRSD,PRSD_SV,"2025-05-18 21:56:58",583,216,178,37,1,212,4,600,384,129,83
35,SUCEAVA,"ŞCOALA CU CLASELE I-IV BOTOŞANIŢA MICĂ",338,GRĂMEŞTI,148916,1,PART,PRCNCT,PRSD,PRSD_SV,"2025-05-18 21:23:53",193,102,75,27,0,101,1,200,98,64,37
35,SUCEAVA,"ŞCOALA GIMNAZIALĂ ”MIHAIL SADOVEANU” GRĂNICEŞTI",339,GRĂNICEŞTI,148970,1,PART,PRCNCT,PRSD,PRSD_SV,"2025-05-18 21:45:33",1041,404,360,43,1,400,4,1100,696,305,95
35,SUCEAVA,"SCOALA GIMNAZIALA MIHAIL SADOVEANU GRANICESTI",340,GRĂNICEŞTI,148970,1,PART,PRCNCT,PRSD,PRSD_SV,"2025-05-18 21:30:38",935,325,315,9,1,315,10,1000,675,253,62
35,SUCEAVA,"ȘCOALA PRIMARĂ DUMBRAVA",341,GRĂNICEŞTI,148970,1,PART,PRCNCT,PRSD,PRSD_SV,"2025-05-18 21:29:57",363,167,144,23,0,165,2,400,233,130,35
35,SUCEAVA,"ŞCOALA GIMNAZIALĂ GURA SOLCII",342,GRĂNICEŞTI,148970,1,PART,PRCNCT,PRSD,PRSD_SV,"2025-05-18 21:37:58",626,205,178,27,0,204,1,700,495,178,26
35,SUCEAVA,"ŞCOALA PRIMARĂ IACOBEŞTI",343,GRĂNICEŞTI,148970,1,PART,PRCNCT,PRSD,PRSD_SV,"2025-05-18 21:38:57",454,183,168,15,0,181,2,500,317,133,48
35,SUCEAVA,"ŞCOALA GIMNAZIALĂ ROMÂNEŞTI",344,GRĂNICEŞTI,148970,1,PART,PRCNCT,PRSD,PRSD_SV,"2025-05-18 21:38:47",578,272,237,35,0,266,6,600,328,180,86
35,SUCEAVA,"ŞCOALA PRIMARĂ SLOBOZIA SUCEVEI",345,GRĂNICEŞTI,148970,1,PART,PRCNCT,PRSD,PRSD_SV,"2025-05-18 21:52:22",577,261,220,41,0,260,1,600,339,176,84
35,SUCEAVA,"CĂMINUL CULTURAL HĂNŢEŞTI",346,HĂNŢEŞTI,151512,1,PART,PRCNCT,PRSD,PRSD_SV,"2025-05-18 21:25:05",1518,744,687,57,0,729,15,1700,956,473,256
35,SUCEAVA,"ȘCOALA PRIMARĂ NR. 2 HĂNȚEȘTI VALE",347,HĂNŢEŞTI,151512,1,PART,PRCNCT,PRSD,PRSD_SV,"2025-05-18 21:37:05",1243,572,536,33,3,565,7,1400,828,384,181
35,SUCEAVA,"ȘCOALA PRIMARĂ BEREȘTI",348,HĂNŢEŞTI,151512,1,PART,PRCNCT,PRSD,PRSD_SV,"2025-05-18 21:24:13",518,243,211,30,2,242,1,600,357,172,70
35,SUCEAVA,"CENTRU DE ASISTENȚĂ DUPĂ PROGRAMUL ȘCOLAR TIP ”AFTERSCHOOL”",349,HÂRTOP,151549,1,PART,PRCNCT,PRSD,PRSD_SV,"2025-05-18 21:52:45",1045,536,503,33,0,529,7,1200,664,351,178
35,SUCEAVA,"CENTRU DE ASISTENȚĂ DUPĂ PROGRAMUL ȘCOLAR TIP ”AFTERSCHOOL”",350,HÂRTOP,151549,1,PART,PRCNCT,PRSD,PRSD_SV,"2025-05-18 21:44:00",1025,427,408,19,0,425,2,1100,673,336,89
35,SUCEAVA,"CĂMINUL CULTURAL HORODNIC DE JOS",351,"HORODNIC DE JOS",149101,1,PART,PRCNCT,PRSD,PRSD_SV,"2025-05-18 22:03:45",1371,668,624,44,0,661,7,1500,832,351,310
35,SUCEAVA,"SCOALA PRIMARĂ VASILE ŢIGĂNESCU",352,"HORODNIC DE JOS",149101,1,PART,PRCNCT,PRSD,PRSD_SV,"2025-05-18 21:49:49",624,309,290,19,0,305,4,700,391,198,107
35,SUCEAVA,"SCOALA GIMNAZIALA NR.2",353,"HORODNIC DE SUS",151479,1,PART,PRCNCT,PRSD,PRSD_SV,"2025-05-18 21:53:55",1287,590,554,36,0,578,12,1400,810,460,118
35,SUCEAVA,"CASA DE CULTURĂ",354,"HORODNIC DE SUS",151479,2,PART,PRCNCT,PRSD,PRSD_SV,"2025-05-19 05:45:55",1802,958,893,65,0,948,10,2000,1042,644,304
35,SUCEAVA,"SCOALA GIMNAZIALA NR.3",355,"HORODNIC DE SUS",151479,1,PART,PRCNCT,PRSD,PRSD_SV,"2025-05-18 21:30:24",1155,458,439,19,0,452,6,1300,842,351,101
35,SUCEAVA,"PRIMĂRIA COMUNEI HORODNICENI",356,HORODNICENI,149049,1,PART,PRCNCT,PRSD,PRSD_SV,"2025-05-18 21:47:47",865,503,422,53,28,498,5,900,397,277,221
35,SUCEAVA,"ȘCOALA GENERALĂ CU CLASELE I-IV BOTEȘTI",357,HORODNICENI,149049,1,PART,PRCNCT,PRSD,PRSD_SV,"2025-05-18 21:34:54",367,197,161,36,0,193,4,400,203,93,100
35,SUCEAVA,"ȘCOALA CU CL.I-IV BRĂDĂȚEL",358,HORODNICENI,149049,1,PART,PRCNCT,PRSD,PRSD_SV,"2025-05-18 21:44:17",478,290,245,45,0,285,5,500,210,216,69
35,SUCEAVA,"ȘCOALA CU CL.I-VIII MIHĂIEȘTI",359,HORODNICENI,149049,1,PART,PRCNCT,PRSD,PRSD_SV,"2025-05-18 21:40:42",663,415,338,49,28,409,6,700,285,212,197
35,SUCEAVA,"PUNCT DOCUMENTAR NICOALE ISTRATI",360,HORODNICENI,149049,1,PART,PRCNCT,PRSD,PRSD_SV,"2025-05-18 21:25:18",395,181,153,20,8,181,0,400,219,122,59
35,SUCEAVA,"CASA NAȚIONALĂ",361,IACOBENI,149138,1,PART,PRCNCT,PRSD,PRSD_SV,"2025-05-18 21:43:59",829,469,412,57,0,466,3,900,431,246,220
35,SUCEAVA,"LICEUL TEHNOLOGIC LIVIU SUHAR IACOBENI CORP A STR. MINELOR NR 17 COMUNA IACOBENI JUDETUL SUCEAVA",362,IACOBENI,149138,1,PART,PRCNCT,PRSD,PRSD_SV,"2025-05-18 21:39:34",533,267,249,18,0,260,7,600,333,139,121
35,SUCEAVA,"CLUBUL FERMIERILOR MESTECANIS STR FERMIERILOR NR 14 SAT MESTECANIS COMUNA IACOBENI JUDETUL SUCEAVA",363,IACOBENI,149138,1,PART,PRCNCT,PRSD,PRSD_SV,"2025-05-18 21:33:09",258,162,138,24,0,158,4,300,138,104,54
35,SUCEAVA,"SALA MICĂ A CĂMINULUI CULTURAL IASLOVĂŢ",364,IASLOVĂŢ,151442,1,PART,PRCNCT,PRSD,PRSD_SV,"2025-05-18 21:37:02",1768,689,660,29,0,675,14,1900,1211,522,153
35,SUCEAVA,"ŞCOALA GIMNAZIALA NR. 2 IASLOVAT",365,IASLOVĂŢ,151442,1,PART,PRCNCT,PRSD,PRSD_SV,"2025-05-18 21:51:05",1601,562,543,19,0,559,3,1800,1238,478,81
35,SUCEAVA,"PRIMARIA ILISESTI",366,ILIŞEŞTI,147660,1,PART,PRCNCT,PRSD,PRSD_SV,"2025-05-18 22:10:09",1999,982,866,101,15,973,9,2200,1218,635,338
35,SUCEAVA,"CAMIN CULTURAL BRASCA",367,ILIŞEŞTI,147660,1,PART,PRCNCT,PRSD,PRSD_SV,"2025-05-18 21:40:50",332,196,160,36,0,192,4,400,204,129,63
35,SUCEAVA,"ȘCOALA GIMNAZIALĂ IPOTEȘTI",368,IPOTEŞTI,146281,1,PART,PRCNCT,PRSD,PRSD_SV,"2025-05-18 22:00:52",1551,959,856,103,0,941,18,1700,741,553,388
35,SUCEAVA,"GRĂDINIȚA CU PROGRAM NORMAL IPOTEȘTI",369,IPOTEŞTI,146281,1,PART,PRCNCT,PRSD,PRSD_SV,"2025-05-18 21:43:11",595,311,266,44,1,310,1,700,389,176,134
35,SUCEAVA,"GRĂDINIȚA CU PROGRAM NORMAL NR. 2 IPOTEȘTI",370,IPOTEŞTI,146281,1,PART,PRCNCT,PRSD,PRSD_SV,"2025-05-18 22:11:58",1251,664,609,55,0,657,7,1400,736,480,177
35,SUCEAVA,"CĂMINUL CULTURAL IPOTEȘTI",371,IPOTEŞTI,146281,1,PART,PRCNCT,PRSD,PRSD_SV,"2025-05-18 21:44:27",1154,681,611,70,0,663,18,1300,619,296,367
35,SUCEAVA,"CĂMINUL CULTURAL IPOTEȘTI",372,IPOTEŞTI,146281,1,PART,PRCNCT,PRSD,PRSD_SV,"2025-05-18 21:54:35",978,602,538,64,0,590,12,1100,498,240,350
35,SUCEAVA,"ŞCOALA PRIMARĂ LISAURA",373,IPOTEŞTI,146281,1,PART,PRCNCT,PRSD,PRSD_SV,"2025-05-18 21:46:51",1574,1068,913,155,0,1050,18,1700,632,394,656
35,SUCEAVA,"ŞCOALA PRIMARĂ TIŞĂUŢI",374,IPOTEŞTI,146281,1,PART,PRCNCT,PRSD,PRSD_SV,"2025-05-18 22:02:00",1415,911,807,104,0,886,25,1600,689,396,490
35,SUCEAVA,"PRIMARIA IZVOARELE SUCEVEI",375,"IZVOARELE SUCEVEI",149183,1,PART,PRCNCT,PRSD,PRSD_SV,"2025-05-18 21:34:38",708,238,217,20,1,236,2,800,562,150,86
35,SUCEAVA,"CENTRUL SOCIAL DE ZI PENTRU PERSOANE VÂRSTNICE, SAT BOBEICA",376,"IZVOARELE SUCEVEI",149183,1,PART,PRCNCT,PRSD,PRSD_SV,"2025-05-18 21:21:28",337,145,128,17,0,144,1,400,255,99,45
35,SUCEAVA,"SCOALA GIMNAZIALĂ BRODINA - IZVOARELE SUCEVEI",377,"IZVOARELE SUCEVEI",149183,1,PART,PRCNCT,PRSD,PRSD_SV,"2025-05-18 21:49:18",576,238,192,46,0,237,1,600,362,195,42
35,SUCEAVA,"SCOALA CU CLASELE I-VIII NR. 2 MARGINEA",378,MARGINEA,149290,1,PART,PRCNCT,PRSD,PRSD_SV,"2025-05-18 21:39:00",1671,740,717,23,0,730,10,1800,1060,574,156
35,SUCEAVA,"LICEUL TEHNOLOGIC VASILE GHERASIM MARGINEA",379,MARGINEA,149290,1,PART,PRCNCT,PRSD,PRSD_SV,"2025-05-18 21:58:56",1688,740,699,41,0,720,20,1800,1060,514,206
35,SUCEAVA,"LICEUL TEHNOLOGIC VASILE GHERASIM MARGINEA",380,MARGINEA,149290,1,PART,PRCNCT,PRSD,PRSD_SV,"2025-05-18 22:06:00",1718,769,730,39,0,752,17,1900,1131,565,187
35,SUCEAVA,"LICEUL TEHNOLOGIC VASILE GHERASIM MARGINEA",381,MARGINEA,149290,1,PART,PRCNCT,PRSD,PRSD_SV,"2025-05-18 21:38:15",1755,770,728,41,1,761,9,1900,1130,551,210
35,SUCEAVA,"SCOALA CU CLASELE I-VIII NR. 3 MARGINEA",382,MARGINEA,149290,2,PART,PRCNCT,PRSD,PRSD_SV,"2025-05-19 05:37:39",1970,925,849,76,0,913,12,2100,1175,675,238
35,SUCEAVA,"PRIMARIA MALINI",383,MĂLINI,149316,1,PART,PRCNCT,PRSD,PRSD_SV,"2025-05-18 21:29:07",1287,711,634,77,0,695,16,1400,689,437,258
35,SUCEAVA,"SCOALA GIMNAZIALA SUHA",384,MĂLINI,149316,2,PART,PRCNCT,PRSD,PRSD_SV,"2025-05-19 05:30:41",1557,772,733,38,1,768,4,1700,928,552,216
35,SUCEAVA,"SCOALA GIMNAZIALA PIRAIE",385,MĂLINI,149316,1,PART,PRCNCT,PRSD,PRSD_SV,"2025-05-18 21:25:25",1591,822,781,41,0,814,8,1800,978,630,184
35,SUCEAVA,"SCOALA GIMNAZIALA POIANA MARULUI",386,MĂLINI,149316,1,PART,PRCNCT,PRSD,PRSD_SV,"2025-05-18 21:23:48",1045,576,525,51,0,568,8,1200,624,419,149
35,SUCEAVA,"SCOALA GIMNAZIALA VALENI-STANISOARA",387,MĂLINI,149316,1,PART,PRCNCT,PRSD,PRSD_SV,"2025-05-18 21:29:32",640,372,318,54,0,368,4,700,328,234,134
35,SUCEAVA,"ŞCOALA GIMNAZIALĂ MĂNĂSTIREA HUMORULUI",388,"MĂNĂSTIREA HUMORULUI",149370,1,PART,PRCNCT,PRSD,PRSD_SV,"2025-05-18 22:01:01",1021,589,515,73,1,583,6,1100,511,348,235
35,SUCEAVA,"ŞCOALA GIMNAZIALĂ MĂNĂSTIREA HUMORULUI",389,"MĂNĂSTIREA HUMORULUI",149370,1,PART,PRCNCT,PRSD,PRSD_SV,"2025-05-18 22:00:52",1080,565,458,107,0,555,10,1200,635,376,179
35,SUCEAVA,"CASA POLONĂ ”DOM POLSKI”",390,"MĂNĂSTIREA HUMORULUI",149370,1,PART,PRCNCT,PRSD,PRSD_SV,"2025-05-18 21:22:26",154,62,45,17,0,59,3,200,138,22,37
35,SUCEAVA,"ŞCOALA GIMNAZIALĂ ”KRYSTINA BOCHENEK” POIANA MICULUI",391,"MĂNĂSTIREA HUMORULUI",149370,1,PART,PRCNCT,PRSD,PRSD_SV,"2025-05-18 21:39:52",507,238,221,17,0,237,1,600,362,121,116
35,SUCEAVA,"CONTAINER MOBIL",392,"MĂNĂSTIREA HUMORULUI",149370,1,PART,PRCNCT,PRSD,PRSD_SV,"2025-05-18 21:18:40",329,184,153,31,0,184,0,400,216,115,69
35,SUCEAVA,"CAMINUL CULTURAL AL COMUNEI MITOCU DRAGOMIRNEI",393,"MITOCU DRAGOMIRNEI",146325,1,PART,PRCNCT,PRSD,PRSD_SV,"2025-05-18 22:41:33",1278,692,605,87,0,679,13,1400,708,490,189
35,SUCEAVA,"GRĂDINIŢA CU PROGRAM NORMAL NR. 1",394,"MITOCU DRAGOMIRNEI",146325,1,PART,PRCNCT,PRSD,PRSD_SV,"2025-05-18 21:53:56",1950,1003,910,93,0,992,11,2100,1097,777,215
35,SUCEAVA,"ŞCOALA PRIMARĂ LIPOVENI",395,"MITOCU DRAGOMIRNEI",146325,1,PART,PRCNCT,PRSD,PRSD_SV,"2025-05-18 21:41:49",386,185,157,28,0,184,1,400,215,120,64
35,SUCEAVA,"ŞCOALA PRIMARĂ ”ION CREANGĂ” MITOCAŞI",396,"MITOCU DRAGOMIRNEI",146325,1,PART,PRCNCT,PRSD,PRSD_SV,"2025-05-18 21:41:50",780,405,357,46,2,402,3,900,495,277,125
35,SUCEAVA,"GRĂDINIȚA CU PROGRAM PRELUNGIT, SAT MOARA NICA, COMUNA MOARA , JUDEȚUL SUCEAVA",397,MOARA,149414,1,PART,PRCNCT,PRSD,PRSD_SV,"2025-05-18 22:00:02",1813,978,900,78,0,969,9,2000,1022,525,444
35,SUCEAVA,"SCOALA GENERALA MOARA NICA",398,MOARA,149414,1,PART,PRCNCT,PRSD,PRSD_SV,"2025-05-18 21:58:15",1592,884,768,116,0,872,12,1700,816,421,451
35,SUCEAVA,"CONTAINER MOBIL",399,MOARA,149414,1,PART,PRCNCT,PRSD,PRSD_SV,"2025-05-18 21:17:04",225,135,103,32,0,132,3,300,165,89,43
35,SUCEAVA,"CĂMIN CULTURAL LITENI",400,MOARA,149414,1,PART,PRCNCT,PRSD,PRSD_SV,"2025-05-18 21:34:47",766,420,370,50,0,416,4,800,380,231,185
35,SUCEAVA,"SCOALA GENERALA MOARA CARP",401,MOARA,149414,1,PART,PRCNCT,PRSD,PRSD_SV,"2025-05-18 21:30:01",738,372,343,29,0,367,5,800,428,266,101
35,SUCEAVA,"CLĂDIRE CU DESTINAȚIE ADMINISTRATIVĂ ȘI SOCIAL CULTURALĂ",402,MOARA,149414,1,PART,PRCNCT,PRSD,PRSD_SV,"2025-05-18 21:20:11",204,123,86,37,0,120,3,300,177,69,51
35,SUCEAVA,"PRIMĂRIA COM MOLDOVA SULIȚA",403,MOLDOVA-SULIŢA,149502,1,PART,PRCNCT,PRSD,PRSD_SV,"2025-05-18 21:24:06",1018,348,330,18,0,346,2,1100,752,272,74
35,SUCEAVA,"ȘCOALA PRIMARĂ BENIA",404,MOLDOVA-SULIŢA,149502,1,PART,PRCNCT,PRSD,PRSD_SV,"2025-05-18 21:21:13",500,216,196,20,0,211,5,600,384,137,74
35,SUCEAVA,"SALA DE SPECTACOLE",405,MOLDOVIŢA,149539,1,PART,PRCNCT,PRSD,PRSD_SV,"2025-05-18 22:03:02",1823,905,807,98,0,899,6,2000,1095,590,309
35,SUCEAVA,"ŞCOALA GIMNAZIALĂ ARGEL",406,MOLDOVIŢA,149539,1,PART,PRCNCT,PRSD,PRSD_SV,"2025-05-18 21:33:26",803,314,294,20,0,313,1,900,586,261,52
35,SUCEAVA,"GRĂDINIŢA CU PROGRAM NORMAL DEMACUŞA",407,MOLDOVIŢA,149539,2,PART,PRCNCT,PRSD,PRSD_SV,"2025-05-19 06:09:44",797,400,392,8,0,399,1,900,500,304,95
35,SUCEAVA,"GRĂDINIŢA CU PROGRAM NORMAL RAŞCA",408,MOLDOVIŢA,149539,2,PART,PRCNCT,PRSD,PRSD_SV,"2025-05-19 06:02:14",672,351,332,17,2,347,4,700,349,253,94
35,SUCEAVA,"CĂMINUL CULTURAL BAINEŢ",409,MUŞENIŢA,149584,1,PART,PRCNCT,PRSD,PRSD_SV,"2025-05-18 21:27:15",242,124,91,31,2,123,1,300,176,60,63
35,SUCEAVA,"CĂMINUL CULTURAL CLIMĂUŢI",410,MUŞENIŢA,149584,1,PART,PRCNCT,PRSD,PRSD_SV,"2025-05-18 21:17:38",257,124,89,35,0,123,1,300,176,62,61
35,SUCEAVA,"ŞCOALA CU CL.I-IV MUŞENIŢA",411,MUŞENIŢA,149584,1,PART,PRCNCT,PRSD,PRSD_SV,"2025-05-18 21:30:00",296,150,128,22,0,149,1,300,150,82,67
35,SUCEAVA,"CĂMINUL CULTURAL VĂŞCĂUŢI",412,MUŞENIŢA,149584,1,PART,PRCNCT,PRSD,PRSD_SV,"2025-05-18 21:48:11",510,229,207,22,0,228,1,600,371,156,72
35,SUCEAVA,"CLĂDIREA ”DOM POLSKI” VICŞANI",413,MUŞENIŢA,149584,1,PART,PRCNCT,PRSD,PRSD_SV,"2025-05-18 21:25:24",181,98,80,18,0,96,2,200,102,56,40
35,SUCEAVA,"CĂMINUL CULTURAL NOU",414,OSTRA,149655,1,PART,PRCNCT,PRSD,PRSD_SV,"2025-05-18 21:51:41",1745,634,610,19,5,625,9,1900,1266,460,165
35,SUCEAVA,"CASA DE TIP FAMILIAL ”CIREŞARII”",415,OSTRA,149655,1,PART,PRCNCT,PRSD,PRSD_SV,"2025-05-18 22:05:19",1003,435,419,16,0,433,2,1100,665,342,91
35,SUCEAVA,"ȘCOALA GIMNAZIALĂ PANACI",416,PANACI,149682,1,PART,PRCNCT,PRSD,PRSD_SV,"2025-05-18 21:28:46",651,396,347,49,0,388,8,700,304,236,152
35,SUCEAVA,"SCOALA CU CLASELE I-IV COVERCA",417,PANACI,149682,1,PART,PRCNCT,PRSD,PRSD_SV,"2025-05-18 21:39:39",650,373,329,44,0,371,2,700,327,256,115
35,SUCEAVA,"CAMIN CULTURAL GLODU",418,PANACI,149682,1,PART,PRCNCT,PRSD,PRSD_SV,"2025-05-18 21:21:18",243,123,104,19,0,121,2,300,177,80,41
35,SUCEAVA,"CĂMINUL CULTURAL",419,PANACI,149682,2,PART,PRCNCT,PRSD,PRSD_SV,"2025-05-19 05:39:24",261,130,105,25,0,130,0,300,170,92,38
35,SUCEAVA,"CĂMINUL CULTURAL PĂLTINOASA",420,PĂLTINOASA,149753,1,PART,PRCNCT,PRSD,PRSD_SV,"2025-05-18 21:47:39",1243,657,615,42,0,650,7,1400,743,421,229
35,SUCEAVA,"ŞCOALA GIMNAZIALĂ PĂLTINOASA",421,PĂLTINOASA,149753,1,PART,PRCNCT,PRSD,PRSD_SV,"2025-05-18 21:31:36",1343,665,629,35,1,660,5,1500,835,424,236
35,SUCEAVA,"CĂMINUL CULTURAL CAPU CODRULUI",422,PĂLTINOASA,149753,1,PART,PRCNCT,PRSD,PRSD_SV,"2025-05-18 21:42:42",906,470,423,45,2,466,4,1000,530,293,173
35,SUCEAVA,"ŞCOALA GIMNAZIALĂ BOGDAN VODĂ CAPU CODRULUI",423,PĂLTINOASA,149753,1,PART,PRCNCT,PRSD,PRSD_SV,"2025-05-18 21:45:55",1270,577,535,42,0,569,8,1400,823,408,161
35,SUCEAVA,"CĂMINUL CULTURAL PĂTRĂUȚI",424,PĂTRĂUŢI,149833,1,PART,PRCNCT,PRSD,PRSD_SV,"2025-05-18 21:38:51",1575,695,647,48,0,687,8,1700,1005,451,236
35,SUCEAVA,"CAMINUL CULTURAL VECHI PATRAUTI",425,PĂTRĂUŢI,149833,1,PART,PRCNCT,PRSD,PRSD_SV,"2025-05-18 21:45:48",1282,564,515,47,2,560,4,1400,836,374,186
35,SUCEAVA,"ȘCOALA GIMNAZIALĂ ”CONSTANTIN MORARIU” PĂTRĂUȚI",426,PĂTRĂUŢI,149833,1,PART,PRCNCT,PRSD,PRSD_SV,"2025-05-18 21:27:26",1273,408,396,12,0,400,8,1400,992,360,40
35,SUCEAVA,"LICEUL TEHNOLOGIC ”NICANOR MOROȘAN” PÎRTEȘTII DE JOS",427,"PÂRTEŞTII DE JOS",149780,1,PART,PRCNCT,PRSD,PRSD_SV,"2025-05-18 21:52:19",1602,753,655,97,1,748,5,1800,1047,512,236
35,SUCEAVA,"GRĂDINIȚA DELENI",428,"PÂRTEŞTII DE JOS",149780,1,PART,PRCNCT,PRSD,PRSD_SV,"2025-05-18 21:51:42",545,244,210,34,0,242,2,600,356,188,54
35,SUCEAVA,"ŞCOALA VÂRFU DEALULUI",429,"PÂRTEŞTII DE JOS",149780,1,PART,PRCNCT,PRSD,PRSD_SV,"2025-05-18 21:39:42",155,128,82,46,0,125,3,200,72,68,57
35,SUCEAVA,"CASA DE CULTURĂ ”ELISEI TODAȘCĂ”",430,"POIANA STAMPEI",149851,1,PART,PRCNCT,PRSD,PRSD_SV,"2025-05-18 21:56:43",1624,999,883,91,25,990,9,1800,801,553,437
35,SUCEAVA,"CENTRUL CULTURAL EDUCAȚIONAL",431,"POIANA STAMPEI",149851,1,PART,PRCNCT,PRSD,PRSD_SV,"2025-05-18 21:15:15",242,135,117,18,0,132,3,300,165,77,55
35,SUCEAVA,"PRIMĂRIA POIENI-SOLCA",432,POIENI-SOLCA,151585,1,PART,PRCNCT,PRSD,PRSD_SV,"2025-05-18 21:46:30",1728,692,641,49,2,687,5,1900,1208,413,274
35,SUCEAVA,"ŞCOALA CU CLASELE I-IV POJORÎTA",433,POJORÂTA,149931,1,PART,PRCNCT,PRSD,PRSD_SV,"2025-05-18 21:22:34",773,498,409,89,0,491,7,900,402,291,200
35,SUCEAVA,"CĂMINUL CULTURAL POJORÂTA",434,POJORÂTA,149931,1,PART,PRCNCT,PRSD,PRSD_SV,"2025-05-18 21:56:05",1353,852,763,87,2,843,9,1500,648,497,346
35,SUCEAVA,"CĂMINUL CULTURAL VALEA PUTNEI",435,POJORÂTA,149931,1,PART,PRCNCT,PRSD,PRSD_SV,"2025-05-18 21:18:22",275,147,124,23,0,147,0,300,153,91,56
35,SUCEAVA,"CĂMINUL CULTURAL PREUTEŞTI",436,PREUTEŞTI,149968,1,PART,PRCNCT,PRSD,PRSD_SV,"2025-05-18 21:57:34",1510,765,715,50,0,755,10,1700,935,479,276
35,SUCEAVA,"ŞCOALA GIMNAZIALĂ ARGHIRA",437,PREUTEŞTI,149968,1,PART,PRCNCT,PRSD,PRSD_SV,"2025-05-18 22:04:41",979,457,418,39,0,451,6,1100,643,312,139
35,SUCEAVA,"ŞCOALA PRIMARĂ BAHNA ARIN",438,PREUTEŞTI,149968,1,PART,PRCNCT,PRSD,PRSD_SV,"2025-05-18 21:41:44",223,109,91,18,0,106,3,300,191,86,20
35,SUCEAVA,"AȘEZĂMÂNT CULTURAL BASARABI",439,PREUTEŞTI,149968,1,PART,PRCNCT,PRSD,PRSD_SV,"2025-05-18 21:58:43",1381,717,671,46,0,712,5,1500,783,483,229
35,SUCEAVA,"ŞCOALA PRIMARĂ HUŞI",440,PREUTEŞTI,149968,1,PART,PRCNCT,PRSD,PRSD_SV,"2025-05-18 21:41:47",532,279,249,30,0,275,4,600,321,211,64
35,SUCEAVA,"ŞCOALA GIMNAZIALĂ LEUCUŞEŞTI",441,PREUTEŞTI,149968,1,PART,PRCNCT,PRSD,PRSD_SV,"2025-05-18 21:42:25",964,469,439,30,0,468,1,1100,631,370,98
35,SUCEAVA,"ȘCOALA GIMNAZIALĂ ”MITROPOLIT IACOB PUTNEANUL”- CORP B",442,PUTNA,150043,1,PART,PRCNCT,PRSD,PRSD_SV,"2025-05-18 21:31:42",1162,617,547,68,2,609,8,1300,683,403,206
35,SUCEAVA,"ȘCOALA GIMNAZIALĂ ”MITROPOLIT IACOB PUTNEANUL”- CORP B",443,PUTNA,150043,1,PART,PRCNCT,PRSD,PRSD_SV,"2025-05-18 21:30:05",903,488,385,101,2,481,7,1000,512,287,194
35,SUCEAVA,"CĂMINUL CULTURAL GURA PUTNEI",444,PUTNA,150043,1,PART,PRCNCT,PRSD,PRSD_SV,"2025-05-18 21:35:50",1096,500,484,15,1,492,8,1200,700,383,109
35,SUCEAVA,"ȘCOALA GIMNAZIALĂ ”ION LOVINESCU” RĂDĂȘENI",445,RĂDĂŞENI,150070,1,PART,PRCNCT,PRSD,PRSD_SV,"2025-05-18 21:41:39",1001,555,480,72,3,549,6,1100,545,345,204
35,SUCEAVA,"ȘCOALA GIMNAZIALĂ ”ION LOVINESCU” RĂDĂȘENI",446,RĂDĂŞENI,150070,1,PART,PRCNCT,PRSD,PRSD_SV,"2025-05-18 21:56:26",1195,584,535,48,1,581,3,1300,716,327,254
35,SUCEAVA,"ȘCOALA MIHAI NICULĂIASA, SAT LĂMĂȘENI",447,RĂDĂŞENI,150070,1,PART,PRCNCT,PRSD,PRSD_SV,"2025-05-18 21:48:38",996,510,471,39,0,501,9,1100,590,306,195
35,SUCEAVA,"ȘCOALA POCOLENI",448,RĂDĂŞENI,150070,1,PART,PRCNCT,PRSD,PRSD_SV,"2025-05-18 21:21:22",140,81,59,22,0,81,0,200,119,46,35
35,SUCEAVA,"CĂMIN CULTURAL RÎŞCA",449,RÂŞCA,150114,1,PART,PRCNCT,PRSD,PRSD_SV,"2025-05-18 21:48:12",1509,751,671,80,0,741,10,1700,949,485,256
35,SUCEAVA,"ŞCOALA GENERALĂ RÎŞCA 3",450,RÂŞCA,150114,1,PART,PRCNCT,PRSD,PRSD_SV,"2025-05-18 21:44:56",722,366,330,36,0,363,3,800,434,270,93
35,SUCEAVA,"ȘCOALA PRIMARĂ NR. 2 RÎȘCA",451,RÂŞCA,150114,1,PART,PRCNCT,PRSD,PRSD_SV,"2025-05-18 21:29:17",616,295,277,18,0,290,5,700,405,182,108
35,SUCEAVA,"ȘCOALA DUMBRĂVENI",452,RÂŞCA,150114,1,PART,PRCNCT,PRSD,PRSD_SV,"2025-05-18 21:49:45",317,189,156,33,0,184,5,400,211,144,40
35,SUCEAVA,"CĂMIN CULTURAL JAHALIA",453,RÂŞCA,150114,1,PART,PRCNCT,PRSD,PRSD_SV,"2025-05-18 21:22:26",274,140,109,31,0,138,2,300,160,82,56
35,SUCEAVA,"ȘCOALA SLĂTIOARA",454,RÂŞCA,150114,1,PART,PRCNCT,PRSD,PRSD_SV,"2025-05-18 21:39:40",673,352,295,57,0,348,4,700,348,277,71
35,SUCEAVA,"CĂMINUL CULTURAL SADOVA",455,SADOVA,150178,1,PART,PRCNCT,PRSD,PRSD_SV,"2025-05-18 21:44:44",1170,722,659,62,1,710,12,1300,578,370,340
35,SUCEAVA,"ŞCOALA GENERALĂ FUNDU SADOVEI",456,SADOVA,150178,1,PART,PRCNCT,PRSD,PRSD_SV,"2025-05-18 21:29:25",947,589,559,30,0,584,5,1000,411,302,282
35,SUCEAVA,"CAMIN CULTURAL",457,"SATU MARE",150196,1,PART,PRCNCT,PRSD,PRSD_SV,"2025-05-18 21:48:26",1194,457,432,25,0,451,6,1300,843,330,121
35,SUCEAVA,"SCOALA GIMNAZIALA SATU MARE",458,"SATU MARE",150196,1,PART,PRCNCT,PRSD,PRSD_SV,"2025-05-18 21:44:07",1241,490,470,20,0,487,3,1400,910,315,172
35,SUCEAVA,"SCOALA GIMNAZIALA SAT TIBENI",459,"SATU MARE",150196,1,PART,PRCNCT,PRSD,PRSD_SV,"2025-05-18 22:04:01",1187,462,436,26,0,458,4,1300,838,303,155
35,SUCEAVA,"CĂMINUL CULTURAL SIMINICEA",460,SIMINICEA,150221,1,PART,PRCNCT,PRSD,PRSD_SV,"2025-05-18 22:07:20",1133,473,438,35,0,462,11,1200,727,287,175
35,SUCEAVA,"SCOALA GIMNAZIALA SIMINICEA",461,SIMINICEA,150221,1,PART,PRCNCT,PRSD,PRSD_SV,"2025-05-18 21:43:05",936,435,391,44,0,429,6,1000,565,260,169
35,SUCEAVA,"SCOALA PRIMARA GRIGORESTI",462,SIMINICEA,150221,1,PART,PRCNCT,PRSD,PRSD_SV,"2025-05-18 22:00:08",261,156,105,51,0,156,0,300,144,84,72
35,SUCEAVA,"ȘCOALA GIMNAZIALĂ ”ALEXANDRU LĂPUȘNEANU”- CORP B",463,SLATINA,150258,1,PART,PRCNCT,PRSD,PRSD_SV,"2025-05-18 22:37:53",1470,627,596,30,1,619,8,1600,973,486,133
35,SUCEAVA,"ȘCOALA GIMNAZIALĂ GĂINEȘTI",464,SLATINA,150258,1,PART,PRCNCT,PRSD,PRSD_SV,"2025-05-18 22:15:13",1644,888,796,92,0,874,14,1800,912,583,291
35,SUCEAVA,"CĂMINUL CULTURAL HERLA",465,SLATINA,150258,1,PART,PRCNCT,PRSD,PRSD_SV,"2025-05-18 22:03:08",1225,644,582,62,0,636,8,1300,656,533,103
35,SUCEAVA,"GRĂDINIŢA DE COPII NR. 1 STRAJA",466,STRAJA,150294,1,PART,PRCNCT,PRSD,PRSD_SV,"2025-05-18 21:39:48",1273,537,511,26,0,535,2,1400,863,401,134
35,SUCEAVA,"GRĂDINIŢA DE COPII NR. 3 STRAJA",467,STRAJA,150294,1,PART,PRCNCT,PRSD,PRSD_SV,"2025-05-18 21:28:08",1141,487,461,25,1,485,2,1300,813,364,121
35,SUCEAVA,"PRIMĂRIA COMUNEI STRAJA",468,STRAJA,150294,1,PART,PRCNCT,PRSD,PRSD_SV,"2025-05-18 21:44:14",1171,504,465,39,0,499,5,1300,796,357,142
35,SUCEAVA,"GRĂDINIŢA DE COPII NR. 2 STRAJA",469,STRAJA,150294,1,PART,PRCNCT,PRSD,PRSD_SV,"2025-05-18 22:02:40",993,456,429,26,1,450,6,1100,644,387,63
35,SUCEAVA,"ŞCOALA GIMNAZIALĂ STROIEŞTI, SALA DE SPORT",470,STROIEŞTI,150310,1,PART,PRCNCT,PRSD,PRSD_SV,"2025-05-18 21:46:26",1163,615,573,41,1,596,19,1300,685,371,225
35,SUCEAVA,"ŞCOALA GIMNAZIALĂ STROIEŞTI, SALA DE CLASĂ",471,STROIEŞTI,150310,1,PART,PRCNCT,PRSD,PRSD_SV,"2025-05-18 22:02:45",977,477,454,23,0,472,5,1100,623,298,174
35,SUCEAVA,"SCOALA CU CLASELE I - IV ” ILIE GRAMADA”",472,STROIEŞTI,150310,1,PART,PRCNCT,PRSD,PRSD_SV,"2025-05-18 21:35:09",585,338,290,48,0,333,5,600,262,216,117
35,SUCEAVA,"CASA TINERETULUI",473,STULPICANI,150356,1,PART,PRCNCT,PRSD,PRSD_SV,"2025-05-18 22:04:27",1211,560,537,23,0,554,6,1300,740,431,123
35,SUCEAVA,"GRĂDINIŢA CU PROGRAM NORMAL STULPICANI",474,STULPICANI,150356,1,PART,PRCNCT,PRSD,PRSD_SV,"2025-05-18 21:49:04",1071,527,500,26,1,524,3,1200,673,414,110
35,SUCEAVA,"CĂMINUL CULTURAL GEMENEA",475,STULPICANI,150356,1,PART,PRCNCT,PRSD,PRSD_SV,"2025-05-18 21:39:42",617,317,284,33,0,313,4,700,383,225,88
35,SUCEAVA,"GRĂDINIȚA CU PROGRAM NORMAL NEGRILEASA",476,STULPICANI,150356,1,PART,PRCNCT,PRSD,PRSD_SV,"2025-05-18 21:38:13",814,373,357,16,0,369,4,900,527,287,82
35,SUCEAVA,"ŞCOALA GIMNAZIALĂ SLĂTIOARA",477,STULPICANI,150356,1,PART,PRCNCT,PRSD,PRSD_SV,"2025-05-18 21:28:23",470,217,193,24,0,217,0,500,283,163,54
35,SUCEAVA,"ŞCOALA PRIMARĂ VADU NEGRILESEI",478,STULPICANI,150356,1,PART,PRCNCT,PRSD,PRSD_SV,"2025-05-18 21:41:27",470,259,231,28,0,259,0,500,241,228,31
35,SUCEAVA,"SCOALA GIMNAZIALĂ DIMITRIE VATAMANIUC",479,SUCEVIŢA,150418,1,PART,PRCNCT,PRSD,PRSD_SV,"2025-05-18 22:20:58",1483,770,626,143,1,757,13,1600,830,448,309
35,SUCEAVA,"CĂMINUL CULTURAL VOIEVODEASA",480,SUCEVIŢA,150418,1,PART,PRCNCT,PRSD,PRSD_SV,"2025-05-18 21:43:57",1118,502,474,28,0,493,9,1200,698,363,130
35,SUCEAVA,"CĂMINUL CULTURAL NEAGRA ȘARULUI",481,"ŞARU DORNEI",150445,1,PART,PRCNCT,PRSD,PRSD_SV,"2025-05-18 21:54:19",1559,922,807,109,6,913,9,1700,778,554,359
35,SUCEAVA,"SCOALA CU CLASELE I-IV GURA HAITII",482,"ŞARU DORNEI",150445,1,PART,PRCNCT,PRSD,PRSD_SV,"2025-05-18 21:41:14",457,279,247,32,0,278,1,500,221,167,111
35,SUCEAVA,"SCOALA CU CLASELE I-IV SARISORU MARE",483,"ŞARU DORNEI",150445,1,PART,PRCNCT,PRSD,PRSD_SV,"2025-05-18 21:32:10",426,255,237,18,0,253,2,500,245,168,85
35,SUCEAVA,"SCOALA CU CLASELE I-VIII SARU DORNEI",484,"ŞARU DORNEI",150445,1,PART,PRCNCT,PRSD,PRSD_SV,"2025-05-18 21:33:35",966,564,522,42,0,559,5,1100,536,341,218
35,SUCEAVA,"ȘCOALA GIMNAZIALĂ ”DIMITRIE PĂCURARIU” ȘCHEIA",485,ŞCHEIA,146432,1,PART,PRCNCT,PRSD,PRSD_SV,"2025-05-18 21:59:40",1967,1218,1097,121,0,1199,19,2100,882,533,666
35,SUCEAVA,"ȘCOALA GIMNAZIALĂ ”DIMITRIE PĂCURARIU” ȘCHEIA",486,ŞCHEIA,146432,1,PART,PRCNCT,PRSD,PRSD_SV,"2025-05-18 22:17:47",1916,1099,986,113,0,1082,17,2100,1001,534,548
35,SUCEAVA,"CAMIN CULTURAL",487,ŞCHEIA,146432,1,PART,PRCNCT,PRSD,PRSD_SV,"2025-05-18 21:33:01",187,126,90,36,0,126,0,200,74,80,46
35,SUCEAVA,"ŞCOALA GIMNAZIALĂ",488,ŞCHEIA,146432,1,PART,PRCNCT,PRSD,PRSD_SV,"2025-05-18 21:47:01",1828,1058,955,103,0,1048,10,2000,942,638,410
35,SUCEAVA,"CĂMIN CULTURAL",489,ŞCHEIA,146432,1,PART,PRCNCT,PRSD,PRSD_SV,"2025-05-18 21:48:04",1742,999,923,76,0,993,6,1900,901,426,567
35,SUCEAVA,"CĂMIN CULTURAL",490,ŞCHEIA,146432,1,PART,PRCNCT,PRSD,PRSD_SV,"2025-05-18 21:45:45",1799,1016,952,64,0,1008,8,2000,984,474,534
35,SUCEAVA,"CĂMIN CULTURAL",491,ŞCHEIA,146432,1,PART,PRCNCT,PRSD,PRSD_SV,"2025-05-18 21:46:14",1752,1051,981,69,1,1029,22,1900,849,423,606
35,SUCEAVA,"CAMIN CULTURAL SERBAUTI",492,ŞERBĂUŢI,151460,1,PART,PRCNCT,PRSD,PRSD_SV,"2025-05-18 21:56:25",1651,659,608,51,0,644,15,1800,1141,471,173
35,SUCEAVA,"ȘCOALA GIMNAZIALĂ CĂLINEȘTI",493,ŞERBĂUŢI,151460,1,PART,PRCNCT,PRSD,PRSD_SV,"2025-05-18 21:28:26",974,411,380,31,0,409,2,1100,689,303,106
35,SUCEAVA,"SCOALA GIMNAZIALĂ TODIREŞTI",494,TODIREŞTI,150524,1,PART,PRCNCT,PRSD,PRSD_SV,"2025-05-18 21:58:16",1212,602,533,69,0,595,7,1300,698,389,206
35,SUCEAVA,"SCOALA GIMNAZIALĂ ”VASILE BUMBAC” COSTÎNA",495,TODIREŞTI,150524,1,PART,PRCNCT,PRSD,PRSD_SV,"2025-05-18 21:54:19",1003,499,418,81,0,494,5,1100,601,331,163
35,SUCEAVA,"CĂMIN CULTURAL PĂRHĂUȚI",496,TODIREŞTI,150524,1,PART,PRCNCT,PRSD,PRSD_SV,"2025-05-18 21:47:20",969,508,467,41,0,503,5,1100,592,285,218
35,SUCEAVA,"SCOALA GIMNAZIALĂ ”I.V.RACHIERU” SOLONEŢ",497,TODIREŞTI,150524,1,PART,PRCNCT,PRSD,PRSD_SV,"2025-05-18 21:43:02",1290,549,503,46,0,539,10,1400,851,320,219
35,SUCEAVA,"PRIMĂRIA COMUNEI UDEŞTI",498,UDEŞTI,150588,1,PART,PRCNCT,PRSD,PRSD_SV,"2025-05-18 21:47:18",1977,871,758,112,1,858,13,2100,1229,510,348
35,SUCEAVA,"CĂMINUL CULTURAL CHILIŞENI",499,UDEŞTI,150588,1,PART,PRCNCT,PRSD,PRSD_SV,"2025-05-18 21:47:07",674,320,276,44,0,306,14,700,380,187,119
35,SUCEAVA,"ŞCOALA PRIMARĂ LUNCUŞOARA",500,UDEŞTI,150588,1,PART,PRCNCT,PRSD,PRSD_SV,"2025-05-18 21:33:39",607,305,269,36,0,295,10,700,395,224,71
35,SUCEAVA,"GRĂDINIŢA CU PROGRAM NORMAL PLĂVĂLARI",501,UDEŞTI,150588,1,PART,PRCNCT,PRSD,PRSD_SV,"2025-05-18 21:45:50",923,410,375,34,1,405,5,1000,590,320,85
35,SUCEAVA,"CĂMINUL CULTURAL POIENI - SUCEAVA",502,UDEŞTI,150588,1,PART,PRCNCT,PRSD,PRSD_SV,"2025-05-18 21:30:24",544,287,245,42,0,284,3,600,313,225,59
35,SUCEAVA,"CĂMINUL CULTURAL RACOVA",503,UDEŞTI,150588,1,PART,PRCNCT,PRSD,PRSD_SV,"2025-05-18 21:20:08",231,135,113,22,0,135,0,300,165,76,59
35,SUCEAVA,"CASA TRADIȚIILOR",504,UDEŞTI,150588,1,PART,PRCNCT,PRSD,PRSD_SV,"2025-05-18 21:32:13",556,280,252,27,1,279,1,600,320,189,90
35,SUCEAVA,"ŞCOALA PRIMARĂ RUŞII - MĂNĂSTIOARA",505,UDEŞTI,150588,1,PART,PRCNCT,PRSD,PRSD_SV,"2025-05-18 22:26:03",435,245,193,52,0,245,0,500,255,144,101
35,SUCEAVA,"CĂMINUL CULTURAL ŞTIRBĂŢ",506,UDEŞTI,150588,1,PART,PRCNCT,PRSD,PRSD_SV,"2025-05-18 21:49:53",432,269,218,51,0,264,5,500,231,150,114
35,SUCEAVA,"CĂMINUL CULTURAL ULMA",507,ULMA,150702,1,PART,PRCNCT,PRSD,PRSD_SV,"2025-05-18 21:27:03",526,199,182,15,2,198,1,600,401,164,34
35,SUCEAVA,"ŞCOALA GIMNAZIALĂ LUPCINA",508,ULMA,150702,1,PART,PRCNCT,PRSD,PRSD_SV,"2025-05-18 21:32:16",769,386,337,49,0,379,7,800,414,354,25
35,SUCEAVA,"SALA DE ŞEDINŢE A CONSILIULUI LOCAL ULMA",509,ULMA,150702,1,PART,PRCNCT,PRSD,PRSD_SV,"2025-05-18 21:35:37",347,150,128,22,0,147,3,400,250,115,32
35,SUCEAVA,"ȘCOALA GIMNAZIALĂ NR 1 VADU MOLDOVEI",510,"VADU MOLDOVEI",150766,1,PART,PRCNCT,PRSD,PRSD_SV,"2025-05-18 22:04:08",902,488,438,50,0,475,13,1000,512,277,198
35,SUCEAVA,"ȘCOALA GIMNAZIALĂ NR 2 VADU MOLDOVEI",511,"VADU MOLDOVEI",150766,1,PART,PRCNCT,PRSD,PRSD_SV,"2025-05-18 21:26:21",329,183,149,34,0,179,4,400,217,111,68
35,SUCEAVA,"CĂMINUL CULTURAL CIUMULEȘTI",512,"VADU MOLDOVEI",150766,1,PART,PRCNCT,PRSD,PRSD_SV,"2025-05-18 21:37:43",740,427,377,50,0,422,5,800,373,352,70
35,SUCEAVA,"ȘCOALA PRIMARĂ DUMBRĂVIȚA",513,"VADU MOLDOVEI",150766,1,PART,PRCNCT,PRSD,PRSD_SV,"2025-05-18 21:42:36",850,410,371,39,0,403,7,900,490,269,134
35,SUCEAVA,"ȘCOALA PRIMARĂ IONEASA",514,"VADU MOLDOVEI",150766,1,PART,PRCNCT,PRSD,PRSD_SV,"2025-05-18 21:31:50",273,151,133,18,0,148,3,300,149,77,71
35,SUCEAVA,"ȘCOALA PRIMARĂ MESTECENI",515,"VADU MOLDOVEI",150766,1,PART,PRCNCT,PRSD,PRSD_SV,"2025-05-18 21:22:15",146,74,56,18,0,74,0,200,126,47,27
35,SUCEAVA,"ȘCOALA PRIMARĂ MOVILENI",516,"VADU MOLDOVEI",150766,1,PART,PRCNCT,PRSD,PRSD_SV,"2025-05-18 21:25:44",221,92,77,15,0,91,1,300,208,71,20
35,SUCEAVA,"ȘCOALA GIMNAZIALĂ NIGOTEȘTI",517,"VADU MOLDOVEI",150766,1,PART,PRCNCT,PRSD,PRSD_SV,"2025-05-18 21:24:57",319,177,143,34,0,175,2,400,223,114,61
35,SUCEAVA,"CĂMINUL CULTURAL VALEA MOLDOVEI",518,"VALEA MOLDOVEI",150891,1,PART,PRCNCT,PRSD,PRSD_SV,"2025-05-18 22:07:43",1431,707,663,44,0,695,12,1600,893,499,196
35,SUCEAVA,"GRĂDINIȚA MIRONU",519,"VALEA MOLDOVEI",150891,1,PART,PRCNCT,PRSD,PRSD_SV,"2025-05-18 22:06:32",1787,579,558,21,0,554,25,1900,1321,478,76
35,SUCEAVA,"CĂMIN CULTURAL VAMA",520,VAMA,150935,1,PART,PRCNCT,PRSD,PRSD_SV,"2025-05-18 21:48:59",990,490,444,45,1,484,6,1100,610,263,221
35,SUCEAVA,"SCOALA GIMNAZIALĂ ”IORGU G. TOMA” LOCALUL NR.2",521,VAMA,150935,1,PART,PRCNCT,PRSD,PRSD_SV,"2025-05-18 22:31:46",1703,967,874,90,3,957,10,1900,933,579,378
35,SUCEAVA,"ŞCOLA GIMNAZIALĂ ”IORGU G. TOMA” LOCALUL DIN SATUL MOLID",522,VAMA,150935,1,PART,PRCNCT,PRSD,PRSD_SV,"2025-05-18 21:43:32",521,298,264,34,0,295,3,600,302,172,123
35,SUCEAVA,"ŞCOALA GIMNAZIALĂ ”IORGU G. TOMA” LOCALUL DIN SATUL PRISACA DORNEI",523,VAMA,150935,1,PART,PRCNCT,PRSD,PRSD_SV,"2025-05-18 21:37:28",694,328,303,24,1,324,4,800,472,186,138
35,SUCEAVA,"ŞCOALA GIMNAZIALĂ ”IORGU G. TOMA” LOCALUL DIN SATUL STRÂMTURA",524,VAMA,150935,1,PART,PRCNCT,PRSD,PRSD_SV,"2025-05-18 22:03:40",1091,528,479,48,1,526,2,1200,672,336,190
35,SUCEAVA,"CĂMINUL CULTURAL VATRA MOLDOVIȚEI",525,"VATRA MOLDOVIŢEI",150980,1,PART,PRCNCT,PRSD,PRSD_SV,"2025-05-18 21:18:00",1164,612,564,48,0,603,9,1300,688,364,239
35,SUCEAVA,"CENTRU DE ZI PENTRU COPII",526,"VATRA MOLDOVIŢEI",150980,1,PART,PRCNCT,PRSD,PRSD_SV,"2025-05-18 21:18:44",623,350,301,37,12,346,4,700,350,185,161
35,SUCEAVA,"SALA POLIVALENTĂ CIUMÂRNA",527,"VATRA MOLDOVIŢEI",150980,1,PART,PRCNCT,PRSD,PRSD_SV,"2025-05-18 21:19:11",384,211,182,29,0,209,2,400,189,170,39
35,SUCEAVA,"CĂMINUL CULTURAL PALTINU",528,"VATRA MOLDOVIŢEI",150980,1,PART,PRCNCT,PRSD,PRSD_SV,"2025-05-18 21:23:46",680,358,331,24,3,355,3,800,442,251,104
35,SUCEAVA,"ŞCOALA PRIMARĂ SPĂRTURI",529,"VATRA MOLDOVIŢEI",150980,1,PART,PRCNCT,PRSD,PRSD_SV,"2025-05-18 21:20:59",709,408,379,26,3,407,1,800,392,294,113
35,SUCEAVA,"CAMINUL CULTURAL VERESTI",530,VEREŞTI,151022,1,PART,PRCNCT,PRSD,PRSD_SV,"2025-05-18 21:40:36",1229,583,541,42,0,570,13,1400,817,344,226
35,SUCEAVA,"SCOALA GIMNAZIALA BURSUCENI",531,VEREŞTI,151022,1,PART,PRCNCT,PRSD,PRSD_SV,"2025-05-18 21:30:36",1158,459,425,34,0,450,9,1300,841,315,135
35,SUCEAVA,"SCOALA GIMNAZIALA COROCAIESTI",532,VEREŞTI,151022,1,PART,PRCNCT,PRSD,PRSD_SV,"2025-05-18 21:26:02",1028,417,380,37,0,413,4,1100,683,294,119
35,SUCEAVA,"CAMINUL CULTURAL COROCAIESTI",533,VEREŞTI,151022,1,PART,PRCNCT,PRSD,PRSD_SV,"2025-05-18 21:39:19",1268,544,513,31,0,543,1,1400,856,405,138
35,SUCEAVA,"SALA DE SEDINTE A CONSILIULUI LOCAL VERESTI",534,VEREŞTI,151022,1,PART,PRCNCT,PRSD,PRSD_SV,"2025-05-18 21:30:38",963,429,397,32,0,420,9,1100,671,314,106
35,SUCEAVA,"SCOALA CU CLASELE I-VIII IOAN VICOVEANU",535,"VICOVU DE JOS",151077,1,PART,PRCNCT,PRSD,PRSD_SV,"2025-05-18 22:12:05",1353,705,653,49,3,697,8,1500,795,493,204
35,SUCEAVA,"ȘCOALA GIMNAZIALĂ NR.2 VICOVU DE JOS REMEZĂU",536,"VICOVU DE JOS",151077,1,PART,PRCNCT,PRSD,PRSD_SV,"2025-05-18 22:09:45",979,447,431,15,1,440,7,1100,653,352,88
35,SUCEAVA,"ȘCOALA GIMNAZIALĂ NR.2 VICOVU DE JOS REMEZĂU",537,"VICOVU DE JOS",151077,1,PART,PRCNCT,PRSD,PRSD_SV,"2025-05-18 21:49:05",1062,462,444,18,0,459,3,1200,738,342,117
35,SUCEAVA,"SCOALA CU CLASELE I-IV MARGINE",538,"VICOVU DE JOS",151077,1,PART,PRCNCT,PRSD,PRSD_SV,"2025-05-18 21:53:13",766,366,347,19,0,359,7,800,434,218,141
35,SUCEAVA,"GRĂDINIŢA ”POD DABÎCA”",539,"VICOVU DE JOS",151077,1,PART,PRCNCT,PRSD,PRSD_SV,"2025-05-18 22:02:12",1097,547,521,26,0,544,3,1200,653,431,113
35,SUCEAVA,"CĂMINUL CULTURAL VOITINEL",540,VOITINEL,151558,1,PART,PRCNCT,PRSD,PRSD_SV,"2025-05-18 22:34:21",1904,783,732,37,14,762,21,2100,1317,653,109
35,SUCEAVA,"SCOALA CU CLASELE I-VIII VOITINEL",541,VOITINEL,151558,1,PART,PRCNCT,PRSD,PRSD_SV,"2025-05-18 22:18:20",1769,902,857,31,14,880,22,1900,998,670,210
35,SUCEAVA,"CĂMINUL CULTURAL",542,VOLOVĂŢ,151120,1,PART,PRCNCT,PRSD,PRSD_SV,"2025-05-18 21:37:39",1700,692,669,23,0,687,5,1900,1208,492,195
35,SUCEAVA,"CĂMINUL CULTURAL",543,VOLOVĂŢ,151120,1,PART,PRCNCT,PRSD,PRSD_SV,"2025-05-18 21:36:32",1737,742,710,31,1,728,14,1900,1158,543,185
35,SUCEAVA,"PRIMĂRIA COMUNEI VOLOVĂŢ",544,VOLOVĂŢ,151120,2,PART,PRCNCT,PRSD,PRSD_SV,"2025-05-19 02:08:07",971,378,357,19,2,369,9,1100,722,239,130
35,SUCEAVA,"ŞCOALA GIMNAZIALĂ ”CONSTANTIN TOMESCU” PLEŞEŞTI",545,VULTUREŞTI,151157,1,PART,PRCNCT,PRSD,PRSD_SV,"2025-05-18 21:17:25",519,257,216,41,0,255,2,600,343,180,75
35,SUCEAVA,"SCOALA GIMNAZIALĂ GIURGEŞTI",546,VULTUREŞTI,151157,1,PART,PRCNCT,PRSD,PRSD_SV,"2025-05-18 21:54:54",572,277,240,35,2,274,3,600,323,193,81
35,SUCEAVA,"IMOBIL CONSTRUCȚIE P+1 SAT HREAȚCA",547,VULTUREŞTI,151157,1,PART,PRCNCT,PRSD,PRSD_SV,"2025-05-18 21:25:20",341,172,153,19,0,168,4,400,228,124,44
35,SUCEAVA,"CLĂDIRE ADMINISTRATIVĂ",548,VULTUREŞTI,151157,1,PART,PRCNCT,PRSD,PRSD_SV,"2025-05-18 21:10:43",123,66,49,17,0,66,0,200,134,48,18
35,SUCEAVA,"ŞCOALA CU CLASELE I - IV",549,VULTUREŞTI,151157,1,PART,PRCNCT,PRSD,PRSD_SV,"2025-05-18 21:22:51",185,94,74,19,1,94,0,200,106,44,50
35,SUCEAVA,"SCOALA PRIMARĂ OSOI",550,VULTUREŞTI,151157,1,PART,PRCNCT,PRSD,PRSD_SV,"2025-05-18 21:40:21",263,127,105,21,1,125,2,300,173,83,42
35,SUCEAVA,"ŞCOALA GIMNAZIALĂ VALEA GLODULUI",551,VULTUREŞTI,151157,1,PART,PRCNCT,PRSD,PRSD_SV,"2025-05-18 21:51:38",731,283,261,20,2,280,3,800,517,215,65
35,SUCEAVA,"CĂMINUL CULTURAL ZAMOSTEA",552,ZAMOSTEA,151246,1,PART,PRCNCT,PRSD,PRSD_SV,"2025-05-18 21:48:26",1246,522,469,53,0,520,2,1400,878,339,181
35,SUCEAVA,"ȘCOALA PRIMARĂ CIOMÎRTAN",553,ZAMOSTEA,151246,1,PART,PRCNCT,PRSD,PRSD_SV,"2025-05-18 21:37:43",435,209,184,25,0,204,5,500,291,136,68
35,SUCEAVA,"ȘCOALA PRIMARĂ LUNCA",554,ZAMOSTEA,151246,1,PART,PRCNCT,PRSD,PRSD_SV,"2025-05-18 21:16:49",183,92,75,17,0,92,0,200,108,59,33
35,SUCEAVA,"ȘCOALA PRIMARĂ NICANI",555,ZAMOSTEA,151246,1,PART,PRCNCT,PRSD,PRSD_SV,"2025-05-18 21:29:01",422,189,170,19,0,188,1,500,311,101,87
35,SUCEAVA,"ȘCOALA PRIMARĂ TĂUTEȘTI",556,ZAMOSTEA,151246,1,PART,PRCNCT,PRSD,PRSD_SV,"2025-05-18 21:19:50",152,100,82,18,0,98,2,200,100,62,36
35,SUCEAVA,"ŞCOALA GENERALĂ ZVORIŞTEA",557,ZVORIŞTEA,151344,1,PART,PRCNCT,PRSD,PRSD_SV,"2025-05-18 21:22:21",755,393,310,46,37,391,2,800,407,166,225
35,SUCEAVA,"ŞCOALA GENERALĂ BUDA",558,ZVORIŞTEA,151344,1,PART,PRCNCT,PRSD,PRSD_SV,"2025-05-18 21:24:56",928,363,331,25,7,355,8,1000,637,221,134
35,SUCEAVA,"ŞCOALA GENERALĂ BUDA",559,ZVORIŞTEA,151344,1,PART,PRCNCT,PRSD,PRSD_SV,"2025-05-18 21:32:13",714,286,252,34,0,282,4,800,514,167,115
35,SUCEAVA,"ȘCOALA PRIMARĂ POIANA",560,ZVORIŞTEA,151344,1,PART,PRCNCT,PRSD,PRSD_SV,"2025-05-18 21:19:35",459,225,191,34,0,223,2,500,275,129,94
35,SUCEAVA,"ŞCOALA PRIMARĂ SLOBOZIA",561,ZVORIŞTEA,151344,1,PART,PRCNCT,PRSD,PRSD_SV,"2025-05-18 21:22:52",471,228,206,22,0,225,3,500,272,130,95
35,SUCEAVA,"ŞCOALA PRIMARĂ STÂNCA",562,ZVORIŞTEA,151344,1,PART,PRCNCT,PRSD,PRSD_SV,"2025-05-18 21:12:38",487,211,177,27,7,208,3,500,289,125,83
35,SUCEAVA,"CASA DE PRĂZNUIRE A PAROHIEI ORTODOXE STÂNCUȚA",563,ZVORIŞTEA,151344,1,PART,PRCNCT,PRSD,PRSD_SV,"2025-05-18 21:17:05",137,87,61,26,0,86,1,200,113,58,28
35,SUCEAVA,"ŞCOALA GENERALĂ ŞERBĂNEŞTI",564,ZVORIŞTEA,151344,1,PART,PRCNCT,PRSD,PRSD_SV,"2025-05-18 21:18:07",913,396,357,36,3,393,3,1000,604,268,125
36,TELEORMAN,"ȘCOALA AJUTĂTOARE ALEXANDRIA",1,"MUNICIPIUL ALEXANDRIA",151790,1,PART,PRCNCT,PRSD,PRSD_SV,"2025-05-18 21:50:00",1439,831,705,88,38,817,14,1559,728,360,457
36,TELEORMAN,"ȘCOALA GIMNAZIALĂ NR.7",2,"MUNICIPIUL ALEXANDRIA",151790,1,PART,PRCNCT,PRSD,PRSD_SV,"2025-05-18 21:38:48",1148,583,487,55,41,577,6,1265,682,272,305
36,TELEORMAN,"ȘCOALA GIMNAZIALĂ NR.7",3,"MUNICIPIUL ALEXANDRIA",151790,1,PART,PRCNCT,PRSD,PRSD_SV,"2025-05-18 21:40:03",1211,595,548,47,0,589,6,1320,725,279,310
36,TELEORMAN,"ȘCOALA GIMNAZIALĂ NR.7",4,"MUNICIPIUL ALEXANDRIA",151790,1,PART,PRCNCT,PRSD,PRSD_SV,"2025-05-18 21:44:17",1298,629,620,8,1,616,13,1415,786,309,307
36,TELEORMAN,"ȘCOALA GIMNAZIALĂ NR.7",5,"MUNICIPIUL ALEXANDRIA",151790,1,PART,PRCNCT,PRSD,PRSD_SV,"2025-05-18 22:24:18",1124,618,566,52,0,609,9,1240,622,226,383
36,TELEORMAN,"LICEUL TEHNOLOGIC ”NICOLAE BĂLCESCU”",6,"MUNICIPIUL ALEXANDRIA",151790,1,PART,PRCNCT,PRSD,PRSD_SV,"2025-05-18 21:56:14",1346,748,704,43,1,733,15,1465,717,321,412
36,TELEORMAN,"LICEUL TEHNOLOGIC ”NICOLAE BĂLCESCU”",7,"MUNICIPIUL ALEXANDRIA",151790,1,PART,PRCNCT,PRSD,PRSD_SV,"2025-05-18 21:38:56",1000,544,487,57,0,538,6,1105,561,197,341
36,TELEORMAN,"COLEGIUL NAȚIONAL ”AL. D. GHICA”",8,"MUNICIPIUL ALEXANDRIA",151790,1,PART,PRCNCT,PRSD,PRSD_SV,"2025-05-18 21:45:20",1406,740,679,59,2,730,10,1535,795,274,456
36,TELEORMAN,"COLEGIUL NAȚIONAL ”AL. D. GHICA”",9,"MUNICIPIUL ALEXANDRIA",151790,1,PART,PRCNCT,PRSD,PRSD_SV,"2025-05-18 21:38:59",1118,569,543,25,1,559,10,1230,661,218,341
36,TELEORMAN,"LICEUL TEORETIC ”C. NOICA”",10,"MUNICIPIUL ALEXANDRIA",151790,1,PART,PRCNCT,PRSD,PRSD_SV,"2025-05-18 21:55:27",1216,639,573,66,0,626,13,1330,691,202,424
36,TELEORMAN,"LICEUL TEORETIC ”C. NOICA”",11,"MUNICIPIUL ALEXANDRIA",151790,1,PART,PRCNCT,PRSD,PRSD_SV,"2025-05-18 21:52:43",937,523,448,75,0,514,9,1030,507,188,326
36,TELEORMAN,"LICEUL PEDAGOGIC ”MIRCEA SCARLAT”",12,"MUNICIPIUL ALEXANDRIA",151790,1,PART,PRCNCT,PRSD,PRSD_SV,"2025-05-18 21:54:38",1129,607,550,57,0,599,8,1245,638,236,363
36,TELEORMAN,"ȘCOALA GIMNAZIALĂ NR.5",13,"MUNICIPIUL ALEXANDRIA",151790,1,PART,PRCNCT,PRSD,PRSD_SV,"2025-05-18 21:55:20",869,494,422,72,0,483,11,960,466,171,312
36,TELEORMAN,"GRĂDINIȚA CU PROGRAM PRELUNGIT NR.7",14,"MUNICIPIUL ALEXANDRIA",151790,1,PART,PRCNCT,PRSD,PRSD_SV,"2025-05-18 22:29:12",996,533,480,52,1,526,7,1100,567,199,327
36,TELEORMAN,"GRĂDINIȚA CU PROGRAM PRELUNGIT NR.7",15,"MUNICIPIUL ALEXANDRIA",151790,1,PART,PRCNCT,PRSD,PRSD_SV,"2025-05-18 21:49:34",968,530,487,41,2,517,13,1070,540,177,340
36,TELEORMAN,"SALA POLIVALENTĂ",16,"MUNICIPIUL ALEXANDRIA",151790,1,PART,PRCNCT,PRSD,PRSD_SV,"2025-05-18 21:52:06",1368,644,574,70,0,634,10,1490,846,358,276
36,TELEORMAN,"SALA POLIVALENTĂ",17,"MUNICIPIUL ALEXANDRIA",151790,1,PART,PRCNCT,PRSD,PRSD_SV,"2025-05-18 22:18:16",1093,494,458,35,1,488,6,1200,706,204,284
36,TELEORMAN,"ȘCOALA GIMNAZIALĂ ”ȘTEFAN CEL MARE”",18,"MUNICIPIUL ALEXANDRIA",151790,1,PART,PRCNCT,PRSD,PRSD_SV,"2025-05-18 21:55:02",783,496,391,87,18,485,11,860,364,202,283
36,TELEORMAN,"ȘCOALA GIMNAZIALĂ ”ȘTEFAN CEL MARE”",19,"MUNICIPIUL ALEXANDRIA",151790,1,PART,PRCNCT,PRSD,PRSD_SV,"2025-05-18 21:46:26",902,513,468,45,0,500,13,990,477,189,311
36,TELEORMAN,"ȘCOALA GIMNAZIALĂ ”MIHAI VITEAZUL”",20,"MUNICIPIUL ALEXANDRIA",151790,1,PART,PRCNCT,PRSD,PRSD_SV,"2025-05-18 21:49:30",1258,683,608,75,0,675,8,1365,682,257,418
36,TELEORMAN,"ȘCOALA GIMNAZIALĂ ”MIHAI VITEAZUL”",21,"MUNICIPIUL ALEXANDRIA",151790,1,PART,PRCNCT,PRSD,PRSD_SV,"2025-05-18 21:46:48",999,517,477,40,0,512,5,1100,583,197,315
36,TELEORMAN,"ȘCOALA GIMNAZIALĂ NR.6",22,"MUNICIPIUL ALEXANDRIA",151790,1,PART,PRCNCT,PRSD,PRSD_SV,"2025-05-18 21:59:36",898,387,354,33,0,383,4,985,598,195,188
36,TELEORMAN,"ȘCOALA GIMNAZIALĂ NR.6",23,"MUNICIPIUL ALEXANDRIA",151790,1,PART,PRCNCT,PRSD,PRSD_SV,"2025-05-18 21:49:44",904,378,351,27,0,371,7,995,617,171,200
36,TELEORMAN,"COLEGIUL NAȚIONAL ”AL. I. CUZA”",24,"MUNICIPIUL ALEXANDRIA",151790,1,PART,PRCNCT,PRSD,PRSD_SV,"2025-05-18 21:50:25",935,442,401,40,1,434,8,1030,588,198,236
36,TELEORMAN,"COLEGIUL NAȚIONAL ”AL. I. CUZA”",25,"MUNICIPIUL ALEXANDRIA",151790,1,PART,PRCNCT,PRSD,PRSD_SV,"2025-05-18 21:54:59",961,511,436,74,1,503,8,1060,549,192,311
36,TELEORMAN,"COLEGIUL NAȚIONAL ”AL. I. CUZA”",26,"MUNICIPIUL ALEXANDRIA",151790,1,PART,PRCNCT,PRSD,PRSD_SV,"2025-05-18 21:55:48",888,457,402,55,0,447,10,980,523,170,277
36,TELEORMAN,"ȘCOALA GIMNAZIALĂ ”ALEXANDRU COLFESCU”",27,"MUNICIPIUL ALEXANDRIA",151790,1,PART,PRCNCT,PRSD,PRSD_SV,"2025-05-18 22:11:29",1237,530,486,43,1,526,4,1345,815,222,304
36,TELEORMAN,"ȘCOALA GIMNAZIALĂ ”ALEXANDRU COLFESCU”",28,"MUNICIPIUL ALEXANDRIA",151790,1,PART,PRCNCT,PRSD,PRSD_SV,"2025-05-18 21:49:31",1303,561,501,59,1,545,16,1420,859,230,315
36,TELEORMAN,"ȘCOALA GIMNAZIALĂ ”ALEXANDRU COLFESCU”",29,"MUNICIPIUL ALEXANDRIA",151790,1,PART,PRCNCT,PRSD,PRSD_SV,"2025-05-18 21:40:57",1290,588,554,34,0,577,11,1400,812,256,321
36,TELEORMAN,"ȘCOALA GIMNAZIALĂ ”ALEXANDRU COLFESCU”",30,"MUNICIPIUL ALEXANDRIA",151790,1,PART,PRCNCT,PRSD,PRSD_SV,"2025-05-18 22:24:50",1281,672,624,47,1,660,12,1405,733,270,390
36,TELEORMAN,"GRĂDINIȚA CU PROGRAM PRELUNGIT NR.4",31,"MUNICIPIUL ALEXANDRIA",151790,1,PART,PRCNCT,PRSD,PRSD_SV,"2025-05-18 21:36:52",1197,490,458,32,0,481,9,1310,820,252,229
36,TELEORMAN,"GRĂDINIȚA CU PROGRAM PRELUNGIT NR.4",32,"MUNICIPIUL ALEXANDRIA",151790,1,PART,PRCNCT,PRSD,PRSD_SV,"2025-05-18 21:45:54",1370,552,509,43,0,540,12,1490,938,348,192
36,TELEORMAN,"ȘCOALA DE ȘOFERI AMATORI",33,"MUNICIPIUL ALEXANDRIA",151790,1,PART,PRCNCT,PRSD,PRSD_SV,"2025-05-18 21:31:51",1415,578,538,40,0,562,16,1542,964,318,244
36,TELEORMAN,"GRĂDINIȚA CU PROGRAM PRELUNGIT NR.8",34,"MUNICIPIUL ALEXANDRIA",151790,1,PART,PRCNCT,PRSD,PRSD_SV,"2025-05-18 21:24:01",1189,289,257,32,0,276,13,1300,1011,166,110
36,TELEORMAN,"ŞCOALA GIMNAZIALĂ ”ZAHARIA STANCU”",35,"MUNICIPIUL ROŞIORI DE VEDE",151870,2,PART,PRCNCT,PRSD,PRSD_SV,"2025-05-18 23:03:31",1102,572,465,59,48,560,12,1215,643,255,305
36,TELEORMAN,"ŞCOALA GIMNAZIALĂ ”ZAHARIA STANCU”",36,"MUNICIPIUL ROŞIORI DE VEDE",151870,1,PART,PRCNCT,PRSD,PRSD_SV,"2025-05-18 21:51:04",1047,483,446,37,0,470,13,1155,672,227,243
36,TELEORMAN,"GRĂDINIȚA CU PROGRAM PRELUNGIT NR.1",37,"MUNICIPIUL ROŞIORI DE VEDE",151870,1,PART,PRCNCT,PRSD,PRSD_SV,"2025-05-18 21:40:25",1071,473,431,40,2,465,8,1180,707,236,229
36,TELEORMAN,"GRĂDINIŢA CU PROGRAM PRELUNGIT NR.1",38,"MUNICIPIUL ROŞIORI DE VEDE",151870,1,PART,PRCNCT,PRSD,PRSD_SV,"2025-05-18 21:42:13",966,448,424,24,0,439,9,1070,622,173,266
36,TELEORMAN,"COLEGIUL TEHNIC ”ANGHEL SALIGNY”",39,"MUNICIPIUL ROŞIORI DE VEDE",151870,1,PART,PRCNCT,PRSD,PRSD_SV,"2025-05-18 21:46:11",985,470,420,50,0,465,5,1085,615,188,277
36,TELEORMAN,"CENTRUL CULTURAL",40,"MUNICIPIUL ROŞIORI DE VEDE",151870,1,PART,PRCNCT,PRSD,PRSD_SV,"2025-05-18 22:15:10",979,466,422,44,0,458,8,1081,615,202,256
36,TELEORMAN,"ŞCOALA GIMNAZIALĂ ”GALA GALACTION”",41,"MUNICIPIUL ROŞIORI DE VEDE",151870,1,PART,PRCNCT,PRSD,PRSD_SV,"2025-05-18 22:07:36",1008,449,407,42,0,444,5,1115,666,217,227
36,TELEORMAN,"ŞCOALA GIMNAZIALĂ ”GALA GALACTION”",42,"MUNICIPIUL ROŞIORI DE VEDE",151870,1,PART,PRCNCT,PRSD,PRSD_SV,"2025-05-18 22:01:04",1092,407,377,29,1,401,6,1200,793,237,164
36,TELEORMAN,"MUZEUL DE ISTORIE",43,"MUNICIPIUL ROŞIORI DE VEDE",151870,1,PART,PRCNCT,PRSD,PRSD_SV,"2025-05-18 22:12:01",969,449,398,50,1,439,10,1075,626,179,260
36,TELEORMAN,"CLUBUL COPIILOR",44,"MUNICIPIUL ROŞIORI DE VEDE",151870,2,PART,PRCNCT,PRSD,PRSD_SV,"2025-05-18 23:32:52",1216,636,542,51,43,630,6,1325,689,247,383
36,TELEORMAN,"ŞCOALA GIMNAZIALĂ ”ALEXANDRU DEPĂRĂŢEANU”",45,"MUNICIPIUL ROŞIORI DE VEDE",151870,1,PART,PRCNCT,PRSD,PRSD_SV,"2025-05-18 21:51:22",1186,503,458,34,11,496,7,1300,797,212,284
36,TELEORMAN,"ŞCOALA GIMNAZIALĂ ”ALEXANDRU DEPĂRĂŢEANU”",46,"MUNICIPIUL ROŞIORI DE VEDE",151870,1,PART,PRCNCT,PRSD,PRSD_SV,"2025-05-18 21:53:33",1280,447,407,40,0,436,11,1400,953,274,162
36,TELEORMAN,"ŞCOALA GIMNAZIALĂ ”ALEXANDRU DEPĂRĂŢEANU”",47,"MUNICIPIUL ROŞIORI DE VEDE",151870,1,PART,PRCNCT,PRSD,PRSD_SV,"2025-05-18 21:57:26",986,485,447,37,1,482,3,1095,610,217,265
36,TELEORMAN,"GRĂDINITA CU PROGRAM NORMAL NR.5",48,"MUNICIPIUL ROŞIORI DE VEDE",151870,1,PART,PRCNCT,PRSD,PRSD_SV,"2025-05-18 21:38:27",1306,580,524,56,0,576,4,1425,845,289,287
36,TELEORMAN,"GRĂDINIȚA CU PROGRAM NORMAL NR.5",49,"MUNICIPIUL ROŞIORI DE VEDE",151870,1,PART,PRCNCT,PRSD,PRSD_SV,"2025-05-18 21:55:33",1004,518,469,46,3,510,8,1110,592,272,238
36,TELEORMAN,"LICEUL TEHNOLOGIC ”EMIL RACOVIŢĂ”",50,"MUNICIPIUL ROŞIORI DE VEDE",151870,1,PART,PRCNCT,PRSD,PRSD_SV,"2025-05-18 21:43:08",1224,626,534,81,11,620,6,1330,704,290,330
36,TELEORMAN,"CASA DE CULTURĂ",51,"MUNICIPIUL ROŞIORI DE VEDE",151870,1,PART,PRCNCT,PRSD,PRSD_SV,"2025-05-18 21:41:32",986,501,433,68,0,492,9,1085,584,250,242
36,TELEORMAN,"COLEGIUL NAŢIONAL ”ANASTASESCU”",52,"MUNICIPIUL ROŞIORI DE VEDE",151870,1,PART,PRCNCT,PRSD,PRSD_SV,"2025-05-18 22:27:02",1308,613,542,71,0,605,8,1425,812,273,332
36,TELEORMAN,"GRĂDINIŢA CU PROGRAM NORMAL NR. 3",53,"MUNICIPIUL ROŞIORI DE VEDE",151870,1,PART,PRCNCT,PRSD,PRSD_SV,"2025-05-18 22:08:01",1149,513,463,49,1,508,5,1275,762,262,246
36,TELEORMAN,"LICEUL TEHNOLOGIC ”VIRGIL MADGEARU”",54,"MUNICIPIUL ROŞIORI DE VEDE",151870,1,PART,PRCNCT,PRSD,PRSD_SV,"2025-05-18 22:29:35",1072,492,434,57,1,482,10,1175,683,219,263
36,TELEORMAN,"GRĂDINIŢA CU PROGRAM NORMAL NR. 6",55,"MUNICIPIUL ROŞIORI DE VEDE",151870,1,PART,PRCNCT,PRSD,PRSD_SV,"2025-05-18 21:32:05",951,413,376,37,0,409,4,1050,637,213,196
36,TELEORMAN,"GRĂDINIŢA CU PROGRAM NORMAL NR.3",56,"MUNICIPIUL TURNU MĂGURELE",151683,1,PART,PRCNCT,PRSD,PRSD_SV,"2025-05-18 21:44:48",1187,545,523,22,0,539,6,1300,755,327,212
36,TELEORMAN,"GRĂDINIȚA CU PROGRAM NORMAL NR.3",57,"MUNICIPIUL TURNU MĂGURELE",151683,1,PART,PRCNCT,PRSD,PRSD_SV,"2025-05-18 21:48:49",1015,456,401,54,1,449,7,1125,669,248,201
36,TELEORMAN,"ŞCOALA GIMNAZIALĂ NR.4",58,"MUNICIPIUL TURNU MĂGURELE",151683,1,PART,PRCNCT,PRSD,PRSD_SV,"2025-05-18 21:47:57",1548,605,546,59,0,590,15,1685,1080,342,248
36,TELEORMAN,"ȘCOALA GIMNAZIALĂ NR. 4",59,"MUNICIPIUL TURNU MĂGURELE",151683,1,PART,PRCNCT,PRSD,PRSD_SV,"2025-05-18 21:48:45",1619,634,584,50,0,634,0,1765,1131,369,265
36,TELEORMAN,"LICEUL TEHNOLOGIC ”GENERAL DAVID PRAPORGESCU”",60,"MUNICIPIUL TURNU MĂGURELE",151683,1,PART,PRCNCT,PRSD,PRSD_SV,"2025-05-18 22:03:52",1257,528,494,34,0,522,6,1370,842,255,267
36,TELEORMAN,"LICEUL TEHNOLOGIC ”GENERAL DAVID PRAPORGESCU”",61,"MUNICIPIUL TURNU MĂGURELE",151683,1,PART,PRCNCT,PRSD,PRSD_SV,"2025-05-18 21:46:33",958,405,347,58,0,396,9,1055,650,195,201
36,TELEORMAN,"GRĂDINIŢA CU PROGRAM PRELUNGIT NR.1",62,"MUNICIPIUL TURNU MĂGURELE",151683,1,PART,PRCNCT,PRSD,PRSD_SV,"2025-05-18 21:39:55",834,309,275,34,0,300,9,920,611,162,138
36,TELEORMAN,"GRĂDINIȚA CU PROGRAM PRELUNGIT NR.1",63,"MUNICIPIUL TURNU MĂGURELE",151683,2,PART,PRCNCT,PRSD,PRSD_SV,"2025-05-18 23:58:19",1159,317,302,15,0,306,11,1275,958,185,121
36,TELEORMAN,"COLEGIUL NAŢIONAL ”UNIREA”",64,"MUNICIPIUL TURNU MĂGURELE",151683,1,PART,PRCNCT,PRSD,PRSD_SV,"2025-05-18 21:50:43",1015,537,442,82,13,532,5,1125,588,197,335
36,TELEORMAN,"COLEGIUL NAŢIONAL ”UNIREA”",65,"MUNICIPIUL TURNU MĂGURELE",151683,1,PART,PRCNCT,PRSD,PRSD_SV,"2025-05-18 21:42:08",1091,536,463,49,24,534,2,1200,664,207,327
36,TELEORMAN,"ŞCOALA GIMNAZIALĂ ”MIRCEA CEL BĂTRÂN”",66,"MUNICIPIUL TURNU MĂGURELE",151683,1,PART,PRCNCT,PRSD,PRSD_SV,"2025-05-18 21:35:25",1032,443,391,49,3,435,8,1140,697,169,266
36,TELEORMAN,"ŞCOALA GIMNAZIALĂ ”MIRCEA CEL BĂTRÂN”",67,"MUNICIPIUL TURNU MĂGURELE",151683,1,PART,PRCNCT,PRSD,PRSD_SV,"2025-05-18 21:58:12",1393,665,603,61,1,650,15,1515,850,254,396
36,TELEORMAN,"LICEUL TEHNOLOGIC ”SF. HARALAMBIE”",68,"MUNICIPIUL TURNU MĂGURELE",151683,1,PART,PRCNCT,PRSD,PRSD_SV,"2025-05-18 21:48:20",1457,674,613,61,0,665,9,1590,916,239,426
36,TELEORMAN,"LICEUL TEORETIC ”MARIN PREDA”",69,"MUNICIPIUL TURNU MĂGURELE",151683,1,PART,PRCNCT,PRSD,PRSD_SV,"2025-05-18 21:32:03",1104,487,442,41,4,480,7,1220,733,224,256
36,TELEORMAN,"LICEUL TEORETIC ”MARIN PREDA”",70,"MUNICIPIUL TURNU MĂGURELE",151683,1,PART,PRCNCT,PRSD,PRSD_SV,"2025-05-18 21:38:48",950,465,419,44,2,457,8,1050,585,167,290
36,TELEORMAN,"CENTRU EDUCAȚIONAL",71,"MUNICIPIUL TURNU MĂGURELE",151683,1,PART,PRCNCT,PRSD,PRSD_SV,"2025-05-18 21:26:38",1192,432,394,38,0,419,13,1305,873,225,194
36,TELEORMAN,"ŞCOALA GIMNAZIALĂ NR.2",72,"MUNICIPIUL TURNU MĂGURELE",151683,1,PART,PRCNCT,PRSD,PRSD_SV,"2025-05-18 21:53:32",1332,477,442,35,0,472,5,1450,973,248,224
36,TELEORMAN,"GRĂDINIȚA CU PROGRAM NORMAL NR.2",73,"MUNICIPIUL TURNU MĂGURELE",151683,2,PART,PRCNCT,PRSD,PRSD_SV,"2025-05-19 00:43:50",1180,485,457,28,0,474,11,1300,815,253,221
36,TELEORMAN,"ȘCOALA GIMNAZIALĂ CU CLASELE I-VIII, NR. 2",74,"ORAŞ VIDELE",151905,1,PART,PRCNCT,PRSD,PRSD_SV,"2025-05-18 22:36:47",1618,964,825,138,1,949,15,1770,806,434,515
36,TELEORMAN,"LICEUL TEORETIC",75,"ORAŞ VIDELE",151905,1,PART,PRCNCT,PRSD,PRSD_SV,"2025-05-18 21:51:19",1359,835,669,166,0,813,22,1480,645,377,436
36,TELEORMAN,"CASA DE CULTURA VIDELE",76,"ORAŞ VIDELE",151905,1,PART,PRCNCT,PRSD,PRSD_SV,"2025-05-18 22:48:26",1439,850,727,123,0,839,11,1560,710,412,427
36,TELEORMAN,"GRĂDINIȚA CU PROGRAM NORMAL NR. 4, FOTĂCHEȘTI",77,"ORAŞ VIDELE",151905,1,PART,PRCNCT,PRSD,PRSD_SV,"2025-05-18 21:48:25",892,442,343,63,36,435,7,985,543,280,155
36,TELEORMAN,"GRĂDINIȚA CU PROGRAM NORMAL NR. 3, FURCULEȘTI",78,"ORAŞ VIDELE",151905,1,PART,PRCNCT,PRSD,PRSD_SV,"2025-05-18 22:16:50",1282,710,630,80,0,700,10,1400,690,437,263
36,TELEORMAN,"GRĂDINIȚA CU PROGRAM NORMAL NR. 5, CARTOJANCA",79,"ORAŞ VIDELE",151905,1,PART,PRCNCT,PRSD,PRSD_SV,"2025-05-18 21:43:17",630,354,309,45,0,348,6,695,341,229,119
36,TELEORMAN,"GRĂDINIȚA CU PROGRAM NORMAL NR. 2, TĂMĂȘEȘTI",80,"ORAŞ VIDELE",151905,1,PART,PRCNCT,PRSD,PRSD_SV,"2025-05-18 21:46:39",644,359,315,43,1,356,3,710,351,230,126
36,TELEORMAN,"GRĂDINIȚA CU PROGRAM NORMAL NR. 6, PARISEȘTI",81,"ORAŞ VIDELE",151905,1,PART,PRCNCT,PRSD,PRSD_SV,"2025-05-18 21:30:12",461,281,233,47,1,279,2,510,229,214,65
36,TELEORMAN,"GRĂDINIȚA CU PROGRAM NORMAL NR. 7, COȘOAIA",82,"ORAŞ VIDELE",151905,1,PART,PRCNCT,PRSD,PRSD_SV,"2025-05-18 21:36:48",248,149,100,49,0,147,2,275,126,104,43
36,TELEORMAN,"ȘCOALA PRIMARĂ NR.4",83,"ORAŞ ZIMNICEA",151978,1,PART,PRCNCT,PRSD,PRSD_SV,"2025-05-18 21:57:31",1254,574,535,33,6,563,11,1370,796,297,266
36,TELEORMAN,"ȘCOALA PRIMARĂ NR.4",84,"ORAŞ ZIMNICEA",151978,1,PART,PRCNCT,PRSD,PRSD_SV,"2025-05-18 22:04:27",1384,670,623,47,0,659,11,1310,640,384,275
36,TELEORMAN,"S.C. URBANA SERV S.R.L.",85,"ORAŞ ZIMNICEA",151978,1,PART,PRCNCT,PRSD,PRSD_SV,"2025-05-18 21:51:35",1412,599,557,42,0,584,15,1240,641,384,200
36,TELEORMAN,"ȘCOALA GIMNAZIALĂ NR.3",86,"ORAŞ ZIMNICEA",151978,1,PART,PRCNCT,PRSD,PRSD_SV,"2025-05-18 22:09:55",1399,586,535,51,0,578,8,1530,944,326,252
36,TELEORMAN,"ȘCOALA GIMNAZIALĂ ”MIRON RADU PARASCHIVESCU”",87,"ORAŞ ZIMNICEA",151978,1,PART,PRCNCT,PRSD,PRSD_SV,"2025-05-18 21:47:08",1356,563,522,41,0,561,2,1485,922,291,270
36,TELEORMAN,"GRĂDINIȚA CU PROGRAM PRELUNGIT NR.5, NIVEL ȘCOLARIZARE PRE PP",88,"ORAŞ ZIMNICEA",151978,1,PART,PRCNCT,PRSD,PRSD_SV,"2025-05-18 22:16:34",1169,519,476,43,0,513,6,1290,771,262,251
36,TELEORMAN,"GRĂDINIȚA CU PROGRAM PRELUNGIT NR.5, NIVEL ȘCOLARIZARE PRE PP",89,"ORAŞ ZIMNICEA",151978,1,PART,PRCNCT,PRSD,PRSD_SV,"2025-05-18 22:04:35",1057,534,499,35,0,530,4,1165,631,247,283
36,TELEORMAN,"ȘCOALA GIMNAZIALĂ NR.2",90,"ORAŞ ZIMNICEA",151978,1,PART,PRCNCT,PRSD,PRSD_SV,"2025-05-18 21:41:29",1185,600,574,26,0,592,8,1300,700,338,254
36,TELEORMAN,"ȘCOALA GIMNAZIALĂ NR.2",91,"ORAŞ ZIMNICEA",151978,1,PART,PRCNCT,PRSD,PRSD_SV,"2025-05-18 21:47:49",1173,615,583,31,1,605,10,1295,680,319,286
36,TELEORMAN,"CĂMINUL CULTURAL BALCI",92,BALACI,151996,1,PART,PRCNCT,PRSD,PRSD_SV,"2025-05-18 22:08:32",620,434,305,129,0,425,9,690,256,244,181
36,TELEORMAN,"CĂMINUL CULTURAL TECUCI",93,BALACI,151996,1,PART,PRCNCT,PRSD,PRSD_SV,"2025-05-18 21:34:03",478,427,242,183,2,424,3,525,98,280,144
36,TELEORMAN,"ŞCOALA GIMNAZIALĂ BĂBĂIŢA",94,BĂBĂIŢA,152038,1,PART,PRCNCT,PRSD,PRSD_SV,"2025-05-18 21:48:51",1346,683,577,100,6,680,3,1465,782,516,164
36,TELEORMAN,"ŞCOALA GIMNAZIALĂ MERIŞANI",95,BĂBĂIŢA,152038,1,PART,PRCNCT,PRSD,PRSD_SV,"2025-05-18 21:45:37",808,422,357,64,1,418,4,895,473,313,105
36,TELEORMAN,"GRĂDINIŢA DE COPII CU PROGRAM NORMAL NR. 1 BECIU",96,BECIU,155083,1,PART,PRCNCT,PRSD,PRSD_SV,"2025-05-18 21:59:11",688,381,286,95,0,380,1,760,379,223,157
36,TELEORMAN,"GRĂDINIŢA DE COPII CU PROGRAM NORMAL NR.2 SMÂRDAN",97,BECIU,155083,1,PART,PRCNCT,PRSD,PRSD_SV,"2025-05-18 21:43:07",428,260,205,55,0,257,3,470,210,171,86
36,TELEORMAN,"CĂMINUL CULTURAL BEUCA",98,BEUCA,155092,1,PART,PRCNCT,PRSD,PRSD_SV,"2025-05-18 21:52:34",785,463,324,75,64,458,5,865,402,218,240
36,TELEORMAN,"CĂMINUL CULTURAL PLOPI",99,BEUCA,155092,1,PART,PRCNCT,PRSD,PRSD_SV,"2025-05-18 21:18:48",133,101,67,28,6,101,0,145,44,54,47
36,TELEORMAN,"ŞCOALA GIMNAZIALA NR.1 BLEJEŞTI",100,BLEJEŞTI,152083,1,PART,PRCNCT,PRSD,PRSD_SV,"2025-05-18 21:53:57",980,522,463,58,1,514,8,1080,558,345,169
36,TELEORMAN,"GRĂDINIŢA CU PROGRAM NORMAL NR.2 BLEJEŞTI",101,BLEJEŞTI,152083,1,PART,PRCNCT,PRSD,PRSD_SV,"2025-05-18 21:56:07",825,491,427,64,0,487,4,905,414,325,162
36,TELEORMAN,"ŞCOALA GIMNAZIALĂ NR.2 BACIU COMUNA BLEJEŞTI",102,BLEJEŞTI,152083,1,PART,PRCNCT,PRSD,PRSD_SV,"2025-05-18 22:03:43",760,452,371,81,0,449,3,840,388,314,135
36,TELEORMAN,"GRĂDINIŢA DE COPII CU PROGRAM NORMAL SERICU COMUNA BLEJEŞTI",103,BLEJEŞTI,152083,1,PART,PRCNCT,PRSD,PRSD_SV,"2025-05-18 21:49:26",305,214,174,40,0,210,4,335,121,149,61
36,TELEORMAN,"ŞCOALA GIMNAZIALĂ BOGDANA",104,BOGDANA,152127,1,PART,PRCNCT,PRSD,PRSD_SV,"2025-05-18 21:24:45",672,387,304,83,0,381,6,735,348,244,137
36,TELEORMAN,"GRĂDINIŢA DE COPII CU PROGRAM NORMAL NR.2 ULMENI",105,BOGDANA,152127,1,PART,PRCNCT,PRSD,PRSD_SV,"2025-05-18 21:31:30",482,264,211,52,1,261,3,535,271,157,104
36,TELEORMAN,"DISPENSAR UMAN (HOL)",106,BOGDANA,152127,1,PART,PRCNCT,PRSD,PRSD_SV,"2025-05-18 21:31:37",467,385,257,128,0,377,8,515,130,234,143
36,TELEORMAN,"GRĂDINIȚA CU PROGRAM NORMAL ”DR.GHEORGHE FURTUNĂ”",107,BOTOROAGA,152172,1,PART,PRCNCT,PRSD,PRSD_SV,"2025-05-18 22:01:28",940,524,379,121,24,520,4,1025,501,316,204
36,TELEORMAN,"ŞCOALA GIMNAZIALĂ NR. 1 CĂLUGĂRU",108,BOTOROAGA,152172,1,PART,PRCNCT,PRSD,PRSD_SV,"2025-05-18 21:44:23",607,331,246,67,18,331,0,670,339,212,119
36,TELEORMAN,"GRĂDINIŢA CU PROGRAM NORMAL NR.2",109,BOTOROAGA,152172,1,PART,PRCNCT,PRSD,PRSD_SV,"2025-05-18 22:05:51",882,582,372,177,33,572,10,980,398,345,227
36,TELEORMAN,"ŞCOALA CU CLASELE I-IV TUNARI",110,BOTOROAGA,152172,1,PART,PRCNCT,PRSD,PRSD_SV,"2025-05-18 21:31:50",130,106,60,42,4,104,2,142,36,66,38
36,TELEORMAN,"GRĂDINIȚA CU PROGRAM NORMAL NR. 3",111,BOTOROAGA,152172,1,PART,PRCNCT,PRSD,PRSD_SV,"2025-05-18 21:32:51",995,636,446,147,43,629,7,1100,464,364,265
36,TELEORMAN,"PRIMĂRIA VECHE",112,BRAGADIRU,152234,1,PART,PRCNCT,PRSD,PRSD_SV,"2025-05-18 21:46:11",942,472,389,74,9,466,6,1040,568,215,251
36,TELEORMAN,"CĂMINUL CULTURAL",113,BRAGADIRU,152234,1,PART,PRCNCT,PRSD,PRSD_SV,"2025-05-18 22:05:21",859,510,415,85,10,505,5,950,440,223,282
36,TELEORMAN,"GRĂDINIŢA CU PROGRAM NORMAL BRAGADIRU",114,BRAGADIRU,152234,1,PART,PRCNCT,PRSD,PRSD_SV,"2025-05-18 22:08:21",999,453,394,53,6,452,1,1100,647,229,223
36,TELEORMAN,"CĂMIN CULTURAL",115,BRÂNCENI,152252,1,PART,PRCNCT,PRSD,PRSD_SV,"2025-05-18 21:44:46",1144,613,538,54,21,593,20,1265,652,293,300
36,TELEORMAN,"SCOALA GIMNAZIALA BRANCENI",116,BRÂNCENI,152252,1,PART,PRCNCT,PRSD,PRSD_SV,"2025-05-18 21:36:19",998,599,498,79,22,590,9,1105,506,318,272
36,TELEORMAN,"CĂMINUL CULTURAL BUJORENI",117,BUJORENI,152270,1,PART,PRCNCT,PRSD,PRSD_SV,"2025-05-18 21:47:50",379,375,159,213,3,370,5,420,45,196,174
36,TELEORMAN,"ŞCOALA CU CLASELE I-IV PRUNARU",118,BUJORENI,152270,1,PART,PRCNCT,PRSD,PRSD_SV,"2025-05-18 21:29:44",310,202,114,88,0,196,6,338,136,125,71
36,TELEORMAN,"ȘCOALA GIMNAZIALĂ",119,BUJORU,152314,1,PART,PRCNCT,PRSD,PRSD_SV,"2025-05-18 21:48:12",651,323,270,40,13,323,0,725,402,176,147
36,TELEORMAN,"GRĂDINIȚA CU PROGRAM NORMAL",120,BUJORU,152314,1,PART,PRCNCT,PRSD,PRSD_SV,"2025-05-18 22:04:51",699,433,328,75,30,425,8,770,337,221,204
36,TELEORMAN,"CĂMIN CULTURAL",121,BUZESCU,152332,1,PART,PRCNCT,PRSD,PRSD_SV,"2025-05-18 22:00:16",1120,541,436,104,1,534,7,1235,694,298,236
36,TELEORMAN,"GRĂDINIŢA CU PROGRAM NORMAL",122,BUZESCU,152332,1,PART,PRCNCT,PRSD,PRSD_SV,"2025-05-18 21:43:18",1149,330,307,23,0,317,13,1265,935,212,105
36,TELEORMAN,"ŞCOALA GIMNAZIALĂ BUZESCU",123,BUZESCU,152332,1,PART,PRCNCT,PRSD,PRSD_SV,"2025-05-18 21:24:21",1122,536,490,46,0,527,9,1235,699,309,218
36,TELEORMAN,"ȘCOALA GIMNAZIALĂ CĂLINEȘTI",124,CĂLINEŞTI,152350,1,PART,PRCNCT,PRSD,PRSD_SV,"2025-05-18 22:08:05",1059,578,469,109,0,576,2,1165,587,305,271
36,TELEORMAN,"ȘCOALA GIMNAZIALĂ ANTONEŞTI",125,CĂLINEŞTI,152350,1,PART,PRCNCT,PRSD,PRSD_SV,"2025-05-18 21:38:52",212,164,103,53,8,162,2,235,71,99,63
36,TELEORMAN,"ȘCOALA GIMNAZIALĂ COPĂCEANCA",126,CĂLINEŞTI,152350,2,PART,PRCNCT,PRSD,PRSD_SV,"2025-05-18 23:35:04",659,390,289,101,0,386,4,725,335,205,181
36,TELEORMAN,"ȘCOALA GIMNAZIALĂ LICURICIU",127,CĂLINEŞTI,152350,1,PART,PRCNCT,PRSD,PRSD_SV,"2025-05-18 21:36:34",340,261,163,81,17,258,3,380,119,134,124
36,TELEORMAN,"ŞCOALA GIMNAZIALĂ CĂLMĂŢUIU (FOST LOCAL AL ȘCOLII CU CLASELE I-IV)",128,CĂLMĂŢUIU,152412,1,PART,PRCNCT,PRSD,PRSD_SV,"2025-05-18 21:29:40",445,249,195,54,0,249,0,490,241,144,105
36,TELEORMAN,"ŞCOALA GIMNAZIALĂ CĂLMĂȚUIU ( FOST LOCAL AL ȘCOLII CU CLASELE I-IV )",129,CĂLMĂŢUIU,152412,1,PART,PRCNCT,PRSD,PRSD_SV,"2025-05-18 21:29:50",203,160,98,61,1,159,1,225,65,126,33
36,TELEORMAN,"PROPRIETATE PRIVATĂ (PERSOANĂ FIZICĂ AUTORIZATĂ )",130,CĂLMĂŢUIU,152412,1,PART,PRCNCT,PRSD,PRSD_SV,"2025-05-18 21:15:26",166,91,62,29,0,87,4,185,94,56,31
36,TELEORMAN,"ŞCOALA GIMNAZIALĂ CĂLMĂȚUIU ( FOST LOCAL AL ȘCOLII NICOLAE BĂLCESCU )",131,CĂLMĂŢUIU,152412,1,PART,PRCNCT,PRSD,PRSD_SV,"2025-05-18 21:30:47",409,253,176,74,3,250,3,450,197,176,74
36,TELEORMAN,"GRĂDINIȚA DE COPII CU PROGRAM NORMAL NR.1 CĂLMĂȚUIU DE SUS",132,"CĂLMĂŢUIU DE SUS",152467,1,PART,PRCNCT,PRSD,PRSD_SV,"2025-05-18 21:30:32",596,369,287,73,9,367,2,660,291,182,185
36,TELEORMAN,"CLĂDIRE PRIMĂRIE -FOST SEDIU CAP BĂCĂLEȘTI",133,"CĂLMĂŢUIU DE SUS",152467,1,PART,PRCNCT,PRSD,PRSD_SV,"2025-05-18 21:39:55",666,359,243,88,28,355,4,735,376,199,156
36,TELEORMAN,"GRĂDINIȚA DE COPII CU PROGRAM NORMAL NR. 3 IONAȘCU",134,"CĂLMĂŢUIU DE SUS",152467,1,PART,PRCNCT,PRSD,PRSD_SV,"2025-05-18 21:27:31",256,156,115,32,9,153,3,285,129,71,82
36,TELEORMAN,"ȘCOALA GIMNAZIALĂ CERVENIA",135,CERVENIA,152500,1,PART,PRCNCT,PRSD,PRSD_SV,"2025-05-18 21:46:26",1190,548,459,89,0,542,6,1300,752,358,184
36,TELEORMAN,"ȘCOALA GIMNAZIALĂ CERVENIA",136,CERVENIA,152500,1,PART,PRCNCT,PRSD,PRSD_SV,"2025-05-18 21:35:12",1010,434,352,81,1,428,6,1115,681,274,154
36,TELEORMAN,"ŞCOALA GIMNAZIALĂ NR. 1 CIOLĂNEŞTII DIN DEAL",137,CIOLĂNEŞTI,152528,1,PART,PRCNCT,PRSD,PRSD_SV,"2025-05-18 21:33:19",621,376,255,121,0,367,9,690,314,208,159
36,TELEORMAN,"ŞCOALA GIMNAZIALĂ NR. 2 CIOLĂNEŞTII DIN DEAL",138,CIOLĂNEŞTI,152528,2,PART,PRCNCT,PRSD,PRSD_SV,"2025-05-19 00:16:41",497,293,230,62,1,290,3,545,252,191,99
36,TELEORMAN,"ŞCOALA BALDOVINEŞTI",139,CIOLĂNEŞTI,152528,1,PART,PRCNCT,PRSD,PRSD_SV,"2025-05-18 21:28:58",341,167,142,25,0,167,0,375,208,123,44
36,TELEORMAN,"ŞCOALA GENERALA NR. 3 CIOLĂNEŞTII DIN VALE",140,CIOLĂNEŞTI,152528,1,PART,PRCNCT,PRSD,PRSD_SV,"2025-05-18 21:27:37",433,227,157,69,1,227,0,480,253,148,79
36,TELEORMAN,"CĂMIN CULTURAL",141,CIUPERCENI,151709,1,PART,PRCNCT,PRSD,PRSD_SV,"2025-05-18 22:06:18",703,435,332,76,27,431,4,775,340,228,203
36,TELEORMAN,"CLUB SĂTESC",142,CIUPERCENI,151709,1,PART,PRCNCT,PRSD,PRSD_SV,"2025-05-18 21:48:49",444,403,273,97,33,401,2,490,87,141,260
36,TELEORMAN,"GRĂDINIŢA CU PROGRAM NORMAL CONŢEŞTI",143,CONŢEŞTI,152564,1,PART,PRCNCT,PRSD,PRSD_SV,"2025-05-18 21:42:13",1270,574,527,47,0,563,11,1385,811,285,278
36,TELEORMAN,"CĂMIN CULTURAL CONŢEŞTI",144,CONŢEŞTI,152564,1,PART,PRCNCT,PRSD,PRSD_SV,"2025-05-18 22:00:32",1145,608,510,98,0,604,4,1265,657,312,292
36,TELEORMAN,"ȘCOALA GIMNAZIALĂ NR.2 COSMEȘTI",145,COSMEŞTI,152582,1,PART,PRCNCT,PRSD,PRSD_SV,"2025-05-18 21:34:50",815,511,433,68,10,507,4,900,389,373,134
36,TELEORMAN,"GRĂDINIŢA CU PROGRAM NORMAL NR. 2 CIUPERCENI",146,COSMEŞTI,152582,1,PART,PRCNCT,PRSD,PRSD_SV,"2025-05-18 21:38:17",1065,542,445,93,4,537,5,1175,633,322,215
36,TELEORMAN,"CĂMIN CULTURAL",147,CRÂNGENI,152617,1,PART,PRCNCT,PRSD,PRSD_SV,"2025-05-18 21:57:59",1051,554,434,114,6,550,4,1155,601,334,216
36,TELEORMAN,"GRĂDINIȚA CU PROGRAM NORMAL NR. 2",148,CRÂNGENI,152617,1,PART,PRCNCT,PRSD,PRSD_SV,"2025-05-18 22:11:48",515,255,182,66,7,252,3,570,315,144,108
36,TELEORMAN,"CLĂDIRE PRIMĂRIE FOSTA ŞCOALĂ CU CLASELE I-IV DOROBANŢU",149,CRÂNGENI,152617,2,PART,PRCNCT,PRSD,PRSD_SV,"2025-05-19 00:54:49",191,123,74,49,0,117,6,209,86,69,48
36,TELEORMAN,"CLĂDIRE PRIMĂRIE FOSTA ŞCOALĂ CU CLASELE I-IV STEJARU",150,CRÂNGENI,152617,1,PART,PRCNCT,PRSD,PRSD_SV,"2025-05-18 21:30:22",169,108,86,22,0,107,1,185,77,76,31
36,TELEORMAN,"CĂMINUL CULTURAL DIN SATUL CRÂNGU",151,CRÂNGU,152662,1,PART,PRCNCT,PRSD,PRSD_SV,"2025-05-18 21:38:44",818,399,245,107,47,397,2,900,501,168,229
36,TELEORMAN,"SEDIUL ADMINISTRATIV DIN SATUL SECARA",152,CRÂNGU,152662,1,PART,PRCNCT,PRSD,PRSD_SV,"2025-05-18 21:36:22",247,186,112,57,17,180,6,272,86,85,95
36,TELEORMAN,"GRĂDINIŢA CU PROGRAM NORMAL NR. 1 CREVENICU",153,CREVENICU,151932,1,PART,PRCNCT,PRSD,PRSD_SV,"2025-05-18 22:06:32",638,425,294,131,0,418,7,705,280,218,200
36,TELEORMAN,"CĂMINUL CULTURAL RĂDULEŞTI",154,CREVENICU,151932,1,PART,PRCNCT,PRSD,PRSD_SV,"2025-05-18 21:40:10",383,245,191,54,0,245,0,425,180,166,79
36,TELEORMAN,"CĂMINUL CULTURAL DIDEȘTI",155,DIDEŞTI,152724,1,PART,PRCNCT,PRSD,PRSD_SV,"2025-05-18 21:28:22",842,455,372,83,0,453,2,930,475,200,253
36,TELEORMAN,"ȘCOALA GIMNAZIALĂ NR.1",156,DOBROTEŞTI,152760,2,PART,PRCNCT,PRSD,PRSD_SV,"2025-05-19 00:23:36",1241,646,534,112,0,636,10,1350,704,346,290
36,TELEORMAN,"CENTRUL DE ÎNGRIJIRE DE ZI PENTRU COPIII ÎN SITUAȚII DE RISC ÎN COMUNA DOBROTEȘTI",157,DOBROTEŞTI,152760,1,PART,PRCNCT,PRSD,PRSD_SV,"2025-05-18 21:37:22",1184,562,472,88,2,556,6,1300,738,267,289
36,TELEORMAN,"ȘCOALA GIMNAZIALĂ NR. 2",158,DOBROTEŞTI,152760,1,PART,PRCNCT,PRSD,PRSD_SV,"2025-05-18 21:47:54",874,518,404,113,1,511,7,965,447,307,204
36,TELEORMAN,"GRĂDINIŢA CU PROGRAM NORMAL DRACEA",159,DRACEA,155109,1,PART,PRCNCT,PRSD,PRSD_SV,"2025-05-18 21:47:21",993,983,406,504,73,971,12,1095,112,238,733
36,TELEORMAN,"CENTRU DE ZI",160,DRACEA,155109,1,PART,PRCNCT,PRSD,PRSD_SV,"2025-05-18 21:26:05",59,64,37,20,7,64,0,100,36,16,48
36,TELEORMAN,"CENTRU DE ZI",161,DRACEA,155109,1,PART,PRCNCT,PRSD,PRSD_SV,"2025-05-18 21:23:28",129,145,71,44,30,144,1,205,60,29,115
36,TELEORMAN,"ŞCOALA CU CLASELE I-IV DRĂCŞENEI",162,DRĂCŞENEI,152797,1,PART,PRCNCT,PRSD,PRSD_SV,"2025-05-18 21:52:14",516,271,195,62,14,271,0,565,294,132,139
36,TELEORMAN,"ŞCOALA GIMNAZIALĂ DRĂCŞANI",163,DRĂCŞENEI,152797,1,PART,PRCNCT,PRSD,PRSD_SV,"2025-05-18 21:34:13",299,162,120,37,5,162,0,330,168,56,106
36,TELEORMAN,"ŞCOALA CU CLASELE I-IV ODOBEASCA",164,DRĂCŞENEI,152797,1,PART,PRCNCT,PRSD,PRSD_SV,"2025-05-18 21:47:35",406,189,166,21,2,186,3,450,261,112,74
36,TELEORMAN,"ŞCOALA GİMNAZİALĂ DRĂGĂNEŞTİ DE VEDE",165,"DRĂGĂNEŞTI DE VEDE",152868,1,PART,PRCNCT,PRSD,PRSD_SV,"2025-05-18 22:43:08",1078,596,486,66,44,591,5,1200,604,363,228
36,TELEORMAN,"GRĂDİNİŢA CU PROGRAM NORMAL NR.2",166,"DRĂGĂNEŞTI DE VEDE",152868,1,PART,PRCNCT,PRSD,PRSD_SV,"2025-05-18 22:11:17",525,288,240,23,25,287,1,580,292,195,92
36,TELEORMAN,"LICEUL TEHNOLOGIC DRĂGĂNEŞTI VLAŞCA",167,DRĂGĂNEŞTI-VLAŞCA,152902,1,PART,PRCNCT,PRSD,PRSD_SV,"2025-05-18 21:56:08",1572,847,668,125,54,841,6,1715,868,450,391
36,TELEORMAN,"ŞCOALA GIMNAZIALĂ DRĂGĂNEŞTI VLAŞCA",168,DRĂGĂNEŞTI-VLAŞCA,152902,1,PART,PRCNCT,PRSD,PRSD_SV,"2025-05-18 21:22:11",974,516,377,102,37,508,8,1075,559,216,292
36,TELEORMAN,"ȘCOALA CU CLASELE I-IV COMOARA",169,DRĂGĂNEŞTI-VLAŞCA,152902,1,PART,PRCNCT,PRSD,PRSD_SV,"2025-05-18 21:34:03",285,209,129,66,14,206,3,315,106,95,111
36,TELEORMAN,"ȘCOALA CU CLASELE I - IV VĂCENI",170,DRĂGĂNEŞTI-VLAŞCA,152902,1,PART,PRCNCT,PRSD,PRSD_SV,"2025-05-18 21:12:10",169,137,81,46,10,137,0,185,48,57,80
36,TELEORMAN,"ŞCOALA GIMNAZIALĂ FÂNTÂNELE",171,FÂNTÂNELE,155118,1,PART,PRCNCT,PRSD,PRSD_SV,"2025-05-18 21:46:30",1126,657,498,108,51,647,10,1245,588,431,216
36,TELEORMAN,"LOCALUL ŞCOLII GIMNAZIALE FRĂSINET",172,FRĂSINET,155127,1,PART,PRCNCT,PRSD,PRSD_SV,"2025-05-18 22:20:48",1334,731,588,124,19,725,6,1455,724,440,285
36,TELEORMAN,"LOCALUL GRĂDINIŢEI CLĂNIŢA",173,FRĂSINET,155127,1,PART,PRCNCT,PRSD,PRSD_SV,"2025-05-18 21:48:04",499,325,236,73,16,321,4,550,225,165,156
36,TELEORMAN,"CĂMINUL CULTURAL FRUMOASA",174,FRUMOASA,152993,1,PART,PRCNCT,PRSD,PRSD_SV,"2025-05-18 21:44:30",664,420,316,96,8,413,7,735,315,231,182
36,TELEORMAN,"GRĂDINIȚA CU PROGRAM NORMAL NR. 2 FRUMOASA",175,FRUMOASA,152993,1,PART,PRCNCT,PRSD,PRSD_SV,"2025-05-18 21:52:03",410,255,198,53,4,250,5,450,195,158,92
36,TELEORMAN,"GRĂDINIȚA CU PROGRAM NORMAL NR. 2 PĂULEASCA",176,FRUMOASA,152993,1,PART,PRCNCT,PRSD,PRSD_SV,"2025-05-18 21:35:15",369,238,181,57,0,235,3,410,172,166,69
36,TELEORMAN,"ŞCOALA GIMNAZIALĂ FURCULEŞTI",177,FURCULEŞTI,152948,2,PART,PRCNCT,PRSD,PRSD_SV,"2025-05-18 22:51:32",1344,510,391,103,16,497,13,1365,855,309,188
36,TELEORMAN,"ŞCOALA CU CLASELE I - VIII SPĂTĂREI",178,FURCULEŞTI,152948,1,PART,PRCNCT,PRSD,PRSD_SV,"2025-05-18 21:30:35",714,408,312,96,0,404,4,785,377,240,164
36,TELEORMAN,"GRĂDINIŢA CU PROGRAM NORMAL VOIEVODA",179,FURCULEŞTI,152948,1,PART,PRCNCT,PRSD,PRSD_SV,"2025-05-18 21:19:39",467,251,192,59,0,251,0,515,264,151,100
36,TELEORMAN,"ŞCOALA PRIMARĂ GĂLĂTENI",180,GĂLĂTENI,153026,1,PART,PRCNCT,PRSD,PRSD_SV,"2025-05-18 21:54:51",1238,614,471,97,46,610,4,1345,731,381,229
36,TELEORMAN,"ŞCOALA GIMNAZIALĂ GĂLĂTENI",181,GĂLĂTENI,153026,1,PART,PRCNCT,PRSD,PRSD_SV,"2025-05-18 21:27:27",633,437,282,115,40,432,5,695,258,250,182
36,TELEORMAN,"GRĂDINIȚA CU PROGRAM NORMAL NR. 1",182,GRATIA,153062,1,PART,PRCNCT,PRSD,PRSD_SV,"2025-05-18 22:05:57",923,545,452,91,2,541,4,1020,475,350,191
36,TELEORMAN,"ȘCOALA GIMNAZIALĂ GRATIA",183,GRATIA,153062,1,PART,PRCNCT,PRSD,PRSD_SV,"2025-05-18 22:06:08",1035,668,516,151,1,666,2,1040,372,421,245
36,TELEORMAN,"CĂMINUL CULTURAL",184,ISLAZ,151736,1,PART,PRCNCT,PRSD,PRSD_SV,"2025-05-18 22:00:05",1018,579,439,135,5,572,7,1135,556,331,241
36,TELEORMAN,"GRĂDINIȚA CU PROGRAM NORMAL NR. 2",185,ISLAZ,151736,1,PART,PRCNCT,PRSD,PRSD_SV,"2025-05-18 22:26:18",1426,698,601,89,8,690,8,1555,857,458,232
36,TELEORMAN,"ŞCOALA GIMNAZIALĂ NR. 1 ISLAZ",186,ISLAZ,151736,1,PART,PRCNCT,PRSD,PRSD_SV,"2025-05-18 21:35:57",666,327,266,60,1,325,2,735,408,171,154
36,TELEORMAN,"ŞCOALA GENERALĂ MOLDOVENI",187,ISLAZ,151736,1,PART,PRCNCT,PRSD,PRSD_SV,"2025-05-18 21:36:41",656,375,295,76,4,369,6,725,350,201,168
36,TELEORMAN,"GRĂDINIŢA DE COPII IZVOARELE",188,IZVOARELE,153106,1,PART,PRCNCT,PRSD,PRSD_SV,"2025-05-18 21:40:48",1008,501,440,59,2,497,4,1115,614,286,211
36,TELEORMAN,"GRĂDINIŢA DE COPII IZVOARELE",189,IZVOARELE,153106,1,PART,PRCNCT,PRSD,PRSD_SV,"2025-05-18 21:48:35",812,459,394,65,0,451,8,900,441,251,200
36,TELEORMAN,"PRIMĂRIA LISA",190,LISA,153124,1,PART,PRCNCT,PRSD,PRSD_SV,"2025-05-18 21:54:30",1168,634,495,82,57,628,6,1290,656,211,417
36,TELEORMAN,"GRĂDINIŢA VÂNĂTORI",191,LISA,153124,1,PART,PRCNCT,PRSD,PRSD_SV,"2025-05-18 21:52:11",474,323,218,63,42,321,2,520,197,141,180
36,TELEORMAN,"ȘCOALA GIMNAZIALĂ LIȚA",192,LIŢA,151763,1,PART,PRCNCT,PRSD,PRSD_SV,"2025-05-18 21:45:50",947,577,461,112,4,569,8,1050,473,321,248
36,TELEORMAN,"GRĂDINIȚA CU PROGRAM NORMAL NR. 2",193,LIŢA,151763,1,PART,PRCNCT,PRSD,PRSD_SV,"2025-05-18 22:00:36",1033,503,440,61,2,494,9,1135,632,266,228
36,TELEORMAN,"ȘCOALA GIMNAZIALĂ NUMĂRUL 1 LUNCA",194,LUNCA,153151,1,PART,PRCNCT,PRSD,PRSD_SV,"2025-05-18 21:52:32",798,522,397,112,13,517,5,885,363,244,273
36,TELEORMAN,"GRĂDINIȚA CU PROGRAM NORMAL NUMĂRUL 1 LUNCA",195,LUNCA,153151,1,PART,PRCNCT,PRSD,PRSD_SV,"2025-05-18 21:50:57",544,329,277,50,2,327,2,600,271,190,137
36,TELEORMAN,"ȘCOALA GIMNAZIALĂ NUMĂRUL 2 PRUNDU",196,LUNCA,153151,1,PART,PRCNCT,PRSD,PRSD_SV,"2025-05-18 21:56:57",1258,437,412,25,0,427,10,1370,933,362,65
36,TELEORMAN,"ŞCOALA GIMNAZIALĂ MAVRODIN",197,MAVRODIN,153204,1,PART,PRCNCT,PRSD,PRSD_SV,"2025-05-18 22:03:32",1022,508,431,64,13,501,7,1125,617,268,233
36,TELEORMAN,"ŞCOALA GIMNAZIALĂ MAVRODIN",198,MAVRODIN,153204,1,PART,PRCNCT,PRSD,PRSD_SV,"2025-05-18 21:49:12",850,492,403,85,4,488,4,940,448,273,215
36,TELEORMAN,"CĂMINUL CULTURAL MĂGURA",199,MĂGURA,153240,1,PART,PRCNCT,PRSD,PRSD_SV,"2025-05-18 21:42:31",1333,753,626,127,0,743,10,1450,697,480,263
36,TELEORMAN,"CĂMINUL CULTURAL GURUIENI",200,MĂGURA,153240,1,PART,PRCNCT,PRSD,PRSD_SV,"2025-05-18 21:32:17",671,400,331,69,0,397,3,745,345,260,137
36,TELEORMAN,"SCOALA GIMNAZIALA NR.1",201,MĂLDĂENI,153277,1,PART,PRCNCT,PRSD,PRSD_SV,"2025-05-18 21:48:10",1108,541,475,65,1,535,6,1225,684,313,222
36,TELEORMAN,"GRADINITA CU PROGRAM NORMAL NR.1",202,MĂLDĂENI,153277,1,PART,PRCNCT,PRSD,PRSD_SV,"2025-05-18 21:47:27",881,487,419,68,0,480,7,975,488,314,166
36,TELEORMAN,"GRADINITA CU PROGRAM NORMAL NR.2",203,MĂLDĂENI,153277,1,PART,PRCNCT,PRSD,PRSD_SV,"2025-05-18 21:50:57",1164,631,565,66,0,626,5,1280,649,356,270
36,TELEORMAN,"ŞCOALA GIMNAZIALĂ NR.1 MÎRZĂNEŞTI",204,MÂRZĂNEŞTI,153339,1,PART,PRCNCT,PRSD,PRSD_SV,"2025-05-18 21:53:27",466,273,193,80,0,270,3,525,252,164,106
36,TELEORMAN,"ŞCOALA GIMNAZIALĂ NR. 2, CERNETU",205,MÂRZĂNEŞTI,153339,1,PART,PRCNCT,PRSD,PRSD_SV,"2025-05-18 22:09:20",997,593,476,117,0,587,6,1100,507,364,223
36,TELEORMAN,"ŞCOALA GIMNAZIALĂ TELEORMANU",206,MÂRZĂNEŞTI,153339,1,PART,PRCNCT,PRSD,PRSD_SV,"2025-05-18 21:35:40",657,380,250,128,2,376,4,725,345,189,187
36,TELEORMAN,"GRĂDINIŢA CU PROGRAM NORMAL NR.3 VALEA PĂRULUI",207,MÂRZĂNEŞTI,153339,1,PART,PRCNCT,PRSD,PRSD_SV,"2025-05-18 22:04:48",595,365,279,85,1,360,5,655,290,197,163
36,TELEORMAN,"SCOALA GIMNAZIALĂ CU CLASELE I-VIII MERENII DE JOS",208,MERENI,153295,1,PART,PRCNCT,PRSD,PRSD_SV,"2025-05-18 21:55:05",1181,681,564,117,0,673,8,1300,619,371,302
36,TELEORMAN,"GRĂDINIȚA CU PROGRAM NORMAL NR. 1",209,MERENI,153295,1,PART,PRCNCT,PRSD,PRSD_SV,"2025-05-18 21:41:44",735,384,289,95,0,380,4,810,426,240,140
36,TELEORMAN,"ȘCOALA GIMNAZIALĂ MOȘTENI",210,MOŞTENI,153384,1,PART,PRCNCT,PRSD,PRSD_SV,"2025-05-18 21:36:20",605,333,292,40,1,332,1,670,337,186,146
36,TELEORMAN,"ŞCOALA GIMNAZIALĂ MOŞTENI",211,MOŞTENI,153384,1,PART,PRCNCT,PRSD,PRSD_SV,"2025-05-18 21:22:43",453,275,211,62,2,273,2,500,225,158,115
36,TELEORMAN,"ȘCOALA GIMNAZIALĂ NANOV",212,NANOV,151816,1,PART,PRCNCT,PRSD,PRSD_SV,"2025-05-18 22:29:22",1650,1033,839,194,0,1017,16,1800,767,529,488
36,TELEORMAN,"PROPRIETATE PRIVATĂ (PERSOANĂ FIZICĂ)",213,NANOV,151816,1,PART,PRCNCT,PRSD,PRSD_SV,"2025-05-18 22:36:42",1336,694,607,87,0,684,10,1460,766,341,343
36,TELEORMAN,"ȘCOALA GIMNAZIALĂ NĂSTURELU",214,NĂSTURELU,153400,1,PART,PRCNCT,PRSD,PRSD_SV,"2025-05-18 21:32:51",1183,453,402,51,0,448,5,1300,847,304,144
36,TELEORMAN,"ȘCOALA GIMNAZIALĂ ZIMNICELE",215,NĂSTURELU,153400,1,PART,PRCNCT,PRSD,PRSD_SV,"2025-05-18 21:40:56",696,345,317,28,0,339,6,770,425,223,116
36,TELEORMAN,"LOCALUL ŞCOLII CU CLASELE I-IV NECŞEŞTI",216,NECŞEŞTI,153437,1,PART,PRCNCT,PRSD,PRSD_SV,"2025-05-18 21:26:09",388,260,173,80,7,256,4,425,165,111,145
36,TELEORMAN,"LOCALUL ŞCOLII CU CLASELE I-VIII GÂRDEŞTI",217,NECŞEŞTI,153437,1,PART,PRCNCT,PRSD,PRSD_SV,"2025-05-18 21:29:26",327,224,137,87,0,222,2,360,136,154,68
36,TELEORMAN,"ȘCOALA GIMNAZIALĂ NENCIULEȘTI",218,NENCIULEŞTI,154996,1,PART,PRCNCT,PRSD,PRSD_SV,"2025-05-18 21:58:18",618,366,255,97,14,356,10,685,319,179,177
36,TELEORMAN,"GRĂDINIȚA CU PROGRAM NORMAL NR. 1 NENCIULEȘTI",219,NENCIULEŞTI,154996,1,PART,PRCNCT,PRSD,PRSD_SV,"2025-05-18 21:55:11",710,408,321,62,25,401,7,775,367,185,216
36,TELEORMAN,"GRĂDINIȚA CU PROGRAM NORMAL NR. 2 PĂRU ROTUND",220,NENCIULEŞTI,154996,1,PART,PRCNCT,PRSD,PRSD_SV,"2025-05-18 21:37:05",453,222,185,30,7,220,2,505,283,161,59
36,TELEORMAN,"ŞCOALA GIMNAZIALĂ NR.1 OLTENI",221,OLTENI,153473,2,PART,PRCNCT,PRSD,PRSD_SV,"2025-05-18 23:10:26",1442,718,611,107,0,707,11,1565,847,400,307
36,TELEORMAN,"ŞCOALA GIMNAZIALĂ NR.2 PERII-BROŞTENI",222,OLTENI,153473,1,PART,PRCNCT,PRSD,PRSD_SV,"2025-05-18 21:23:56",832,396,326,70,0,396,0,915,519,251,145
36,TELEORMAN,"ŞCOALA GIMNAZIALÃ NR. 2 ORBEASCA DE JOS ( CORP A)",223,ORBEASCA,153507,1,PART,PRCNCT,PRSD,PRSD_SV,"2025-05-18 21:30:42",876,422,354,68,0,413,9,970,548,266,147
36,TELEORMAN,"ŞCOALA GIMNAZIALÃ NR. 2 ORBEASCA DE JOS (CORP A)",224,ORBEASCA,153507,1,PART,PRCNCT,PRSD,PRSD_SV,"2025-05-18 21:52:56",703,385,302,81,2,379,6,775,390,223,156
36,TELEORMAN,"ŞCOALA GIMNAZIALÃ NR.3 LACENI (CORP A)",225,ORBEASCA,153507,1,PART,PRCNCT,PRSD,PRSD_SV,"2025-05-18 21:26:24",818,375,326,49,0,367,8,900,525,233,134
36,TELEORMAN,"ŞCOALA GIMNAZIALÃ NR.3 LACENI (CORP A)",226,ORBEASCA,153507,2,PART,PRCNCT,PRSD,PRSD_SV,"2025-05-18 22:43:24",996,461,403,57,1,455,6,1100,639,296,159
36,TELEORMAN,"ŞCOALA GIMNAZIALÃ NR. 1 ORBEASCA DE SUS (CORP B)",227,ORBEASCA,153507,1,PART,PRCNCT,PRSD,PRSD_SV,"2025-05-18 21:39:21",950,491,398,93,0,484,7,1045,554,325,159
36,TELEORMAN,"ŞCOALA GIMNAZIALÃ NR. 1 ORBEASCA DE SUS (CORP B)",228,ORBEASCA,153507,1,PART,PRCNCT,PRSD,PRSD_SV,"2025-05-18 21:40:41",1222,574,509,63,2,566,8,1325,751,345,221
36,TELEORMAN,"ŞCOALA GIMNAZIALĂ ”GRIGORE DIMITRIE GHICA” PERETU",229,PERETU,153543,1,PART,PRCNCT,PRSD,PRSD_SV,"2025-05-18 21:50:27",888,382,340,42,0,379,3,985,603,202,177
36,TELEORMAN,"ŞCOALA GIMNAZIALĂ ”GRIGORE DIMITRIE GHICA” PERETU",230,PERETU,153543,1,PART,PRCNCT,PRSD,PRSD_SV,"2025-05-18 21:54:00",1066,475,432,43,0,474,1,1170,695,243,231
36,TELEORMAN,"CĂMINUL CULTURAL PERETU",231,PERETU,153543,1,PART,PRCNCT,PRSD,PRSD_SV,"2025-05-18 21:58:15",1223,484,434,50,0,474,10,1330,846,237,237
36,TELEORMAN,"GRĂDINIŢA CU PROGRAM NORMAL PERETU",232,PERETU,153543,1,PART,PRCNCT,PRSD,PRSD_SV,"2025-05-18 21:32:36",1297,528,456,72,0,527,1,1415,887,257,270
36,TELEORMAN,"GRĂDINIŢA CU PROGRAM NORMAL PERETU",233,PERETU,153543,1,PART,PRCNCT,PRSD,PRSD_SV,"2025-05-18 21:36:31",992,398,342,56,0,393,5,1095,697,179,214
36,TELEORMAN,"ȘCOALA GIMNAZIALĂ PIATRA",234,PIATRA,153561,1,PART,PRCNCT,PRSD,PRSD_SV,"2025-05-18 21:53:02",817,536,450,86,0,529,7,900,364,279,250
36,TELEORMAN,"GRĂDINIȚA CU PROGRAM NORMAL PIATRA",235,PIATRA,153561,1,PART,PRCNCT,PRSD,PRSD_SV,"2025-05-18 21:51:02",663,495,350,145,0,486,9,735,240,253,233
36,TELEORMAN,"SALA DE PROTOCOL PRIMĂRIA COMUNEI PIATRA",236,PIATRA,153561,1,PART,PRCNCT,PRSD,PRSD_SV,"2025-05-18 21:34:04",757,445,362,83,0,440,5,835,390,272,168
36,TELEORMAN,"ŞCOALA GIMNAZIALĂ(ŞCOALA VECHE)",237,PIETROŞANI,153589,1,PART,PRCNCT,PRSD,PRSD_SV,"2025-05-18 21:56:22",915,502,391,73,38,498,4,1005,503,308,190
36,TELEORMAN,"ŞCOALA GIMNAZIALĂ(ŞCOALA NOUĂ)",238,PIETROŞANI,153589,1,PART,PRCNCT,PRSD,PRSD_SV,"2025-05-18 21:52:56",998,579,441,98,40,574,5,1105,526,369,205
36,TELEORMAN,"ŞCOALA GIMNAZIALĂ PLOPII SLĂVITEŞTI",239,PLOPII-SLĂVITEŞTI,153623,1,PART,PRCNCT,PRSD,PRSD_SV,"2025-05-18 21:29:50",500,334,245,69,20,330,4,550,216,187,143
36,TELEORMAN,"GRĂDINIŢA CU PROGRAM NORMAL NR.3",240,PLOPII-SLĂVITEŞTI,153623,1,PART,PRCNCT,PRSD,PRSD_SV,"2025-05-18 21:45:09",713,369,302,55,12,365,4,790,421,247,118
36,TELEORMAN,"GRĂDINIŢA CU PROGRAM NORMAL NR.2",241,PLOPII-SLĂVITEŞTI,153623,1,PART,PRCNCT,PRSD,PRSD_SV,"2025-05-18 21:27:17",546,296,237,50,9,291,5,605,309,196,95
36,TELEORMAN,"CĂMINUL CULTURAL",242,PLOSCA,153605,1,PART,PRCNCT,PRSD,PRSD_SV,"2025-05-18 21:57:15",1172,595,528,67,0,588,7,1290,695,345,243
36,TELEORMAN,"ŞCOALA RĂSFIRAŢI",243,PLOSCA,153605,1,PART,PRCNCT,PRSD,PRSD_SV,"2025-05-18 21:46:21",1327,583,539,44,0,581,2,1450,867,263,318
36,TELEORMAN,"ŞCOALA GIMNAZIALĂ PLOSCA",244,PLOSCA,153605,1,PART,PRCNCT,PRSD,PRSD_SV,"2025-05-18 21:49:47",734,324,283,41,0,320,4,810,486,178,142
36,TELEORMAN,"ŞCOALA MICĂ",245,PLOSCA,153605,1,PART,PRCNCT,PRSD,PRSD_SV,"2025-05-18 21:40:23",1129,494,452,42,0,487,7,1245,751,266,221
36,TELEORMAN,"ȘCOALA GENERALĂ POENI",246,POENI,153696,1,PART,PRCNCT,PRSD,PRSD_SV,"2025-05-18 22:13:22",1099,665,527,137,1,656,9,1200,535,472,184
36,TELEORMAN,"ȘCOALA PRIMARĂ CĂTUNU",247,POENI,153696,1,PART,PRCNCT,PRSD,PRSD_SV,"2025-05-18 21:35:29",307,237,143,94,0,235,2,340,103,154,81
36,TELEORMAN,"ȘCOALA GENERALĂ PREAJBA",248,POENI,153696,1,PART,PRCNCT,PRSD,PRSD_SV,"2025-05-18 21:41:08",304,241,173,68,0,238,3,335,94,175,63
36,TELEORMAN,"ȘCOALA GENERALĂ VĂTAȘI",249,POENI,153696,1,PART,PRCNCT,PRSD,PRSD_SV,"2025-05-18 21:47:45",416,282,201,80,1,280,2,460,178,179,101
36,TELEORMAN,"ŞCOALA GIMNAZIALĂ POROSCHIA",250,POROSCHIA,151834,1,PART,PRCNCT,PRSD,PRSD_SV,"2025-05-18 21:55:59",1398,725,654,71,0,711,14,1525,800,386,325
36,TELEORMAN,"ȘCOALA GENERALĂ POROSCHIA",251,POROSCHIA,151834,1,PART,PRCNCT,PRSD,PRSD_SV,"2025-05-18 21:43:31",1370,815,714,74,27,799,16,1495,680,430,369
36,TELEORMAN,"GRĂDINIȚA CU PROGRAM NORMAL CALOMFIREȘTI",252,POROSCHIA,151834,1,PART,PRCNCT,PRSD,PRSD_SV,"2025-05-18 21:34:59",752,435,396,37,2,427,8,835,400,194,233
36,TELEORMAN,"ŞCOALA GIMNAZIALĂ PURANII DE SUS",253,PURANI,155136,1,PART,PRCNCT,PRSD,PRSD_SV,"2025-05-18 22:32:02",1081,831,595,131,105,820,11,1190,359,477,343
36,TELEORMAN,"GRĂDINIȚA CU PROGRAM NORMAL NR.1 PUTINEIU",254,PUTINEIU,153829,1,PART,PRCNCT,PRSD,PRSD_SV,"2025-05-18 21:53:47",979,771,562,163,46,762,9,1085,314,305,457
36,TELEORMAN,"GRĂDINIȚA CU PROGRAM NORMAL NR.2 BĂDULEASA",255,PUTINEIU,153829,3,PART,PRCNCT,PRSD,PRSD_SV,"2025-05-19 00:50:35",472,433,284,129,20,425,8,525,92,172,253
36,TELEORMAN,"CĂMIN CULTURAL",256,RĂDOIEŞTI,153865,1,PART,PRCNCT,PRSD,PRSD_SV,"2025-05-18 21:21:26",460,247,194,52,1,243,4,505,258,130,113
36,TELEORMAN,"ȘCOALA GENERALĂ RĂDOIEȘTI CETATEA",257,RĂDOIEŞTI,153865,1,PART,PRCNCT,PRSD,PRSD_SV,"2025-05-18 21:16:13",262,154,95,59,0,152,2,290,136,86,66
36,TELEORMAN,"ȘCOALA GIMNAZIALĂ RĂDOIEȘTI",258,RĂDOIEŞTI,153865,1,PART,PRCNCT,PRSD,PRSD_SV,"2025-05-18 21:38:22",722,410,335,75,0,406,4,795,385,268,138
36,TELEORMAN,"CĂMINUL CULTURAL RĂSMIREŞTI",259,RĂSMIREŞTI,153909,1,PART,PRCNCT,PRSD,PRSD_SV,"2025-05-18 21:51:50",580,477,307,169,1,471,6,640,163,249,222
36,TELEORMAN,"ŞCOALA GIMNAZIALĂ SAELELE",260,SAELELE,155145,1,PART,PRCNCT,PRSD,PRSD_SV,"2025-05-18 22:02:01",1107,689,567,109,13,682,7,1220,531,355,327
36,TELEORMAN,"GRĂDINIŢA PLEAŞOV",261,SAELELE,155145,1,PART,PRCNCT,PRSD,PRSD_SV,"2025-05-18 21:36:39",599,417,287,100,30,415,2,665,248,219,196
36,TELEORMAN,"LOCALUL CĂMINULUI CULTURAL SALCIA",262,SALCIA,153936,1,PART,PRCNCT,PRSD,PRSD_SV,"2025-05-18 21:38:19",676,345,235,83,27,338,7,745,400,212,126
36,TELEORMAN,"LOCALUL CĂMINULUI CULTURAL DIN SATUL BĂNEASA",263,SALCIA,153936,1,PART,PRCNCT,PRSD,PRSD_SV,"2025-05-18 21:35:35",623,434,307,93,34,428,6,685,251,167,261
36,TELEORMAN,"LOCALUL CĂMINULUI CULTURAL DIN SATUL TUDOR VLADIMIRESCU",264,SALCIA,153936,1,PART,PRCNCT,PRSD,PRSD_SV,"2025-05-18 21:29:38",539,339,261,56,22,337,2,595,256,206,131
36,TELEORMAN,"CĂMIN CULTURAL",265,SĂCENI,153972,2,PART,PRCNCT,PRSD,PRSD_SV,"2025-05-18 23:46:42",517,258,198,60,0,256,2,570,312,140,116
36,TELEORMAN,"CLĂDIREA FOSTA ȘCOALĂ GIMNAZIALĂ CIURARI",266,SĂCENI,153972,1,PART,PRCNCT,PRSD,PRSD_SV,"2025-05-18 21:35:06",273,166,104,62,0,164,2,300,134,94,70
36,TELEORMAN,"LOCALUL ŞCOLII GIMNAZIALE SÂRBENII DE JOS",267,SÂRBENI,154308,1,PART,PRCNCT,PRSD,PRSD_SV,"2025-05-18 21:21:46",184,184,106,72,6,183,1,300,116,82,101
36,TELEORMAN,"GRĂDINIŢA CU PROGRAM NORMAL NR. 2",268,SÂRBENI,154308,1,PART,PRCNCT,PRSD,PRSD_SV,"2025-05-18 21:35:11",517,399,292,99,8,391,8,570,171,247,144
36,TELEORMAN,"GRĂDINIŢA CU PROGRAM NORMAL NR. 3",269,SÂRBENI,154308,1,PART,PRCNCT,PRSD,PRSD_SV,"2025-05-18 21:39:39",329,277,191,79,7,272,5,365,88,199,73
36,TELEORMAN,"CĂMIN CULTURAL SCRIOAȘTEA",270,SCRIOAŞTEA,154013,1,PART,PRCNCT,PRSD,PRSD_SV,"2025-05-18 21:48:32",1723,1138,892,182,64,1127,11,1880,742,433,694
36,TELEORMAN,"GRĂDINIŢA DE COPII",271,SCRIOAŞTEA,154013,1,PART,PRCNCT,PRSD,PRSD_SV,"2025-05-18 21:31:51",549,363,289,55,19,354,9,605,242,178,176
36,TELEORMAN,"CĂMIN CULTURAL CUCUEŢI",272,SCRIOAŞTEA,154013,1,PART,PRCNCT,PRSD,PRSD_SV,"2025-05-18 21:44:07",640,448,346,65,37,445,3,705,257,169,276
36,TELEORMAN,"LOCALUL ŞCOLII GENERALE CU CLASELE I – VIII SCURTU MARE",273,"SCURTU MARE",154068,1,PART,PRCNCT,PRSD,PRSD_SV,"2025-05-18 21:59:12",763,543,348,159,36,532,11,840,297,315,217
36,TELEORMAN,"LOCALUL ŞCOLII CU CLASELE I-IV ALBENI",274,"SCURTU MARE",154068,1,PART,PRCNCT,PRSD,PRSD_SV,"2025-05-18 21:37:59",120,98,43,26,29,98,0,125,27,41,57
36,TELEORMAN,"LOCALUL ŞCOLII CU CLASELE I-IV DRACESTI",275,"SCURTU MARE",154068,1,PART,PRCNCT,PRSD,PRSD_SV,"2025-05-18 21:32:08",256,160,102,32,26,157,3,285,125,74,83
36,TELEORMAN,"GRADINITA CU PROGRAM NORMAL ,NR.1 SEACA , SAT SEACA , JUDETUL TELEORMAN , STRADA VICTORIEI , NR.75",276,SEACA,154139,1,PART,PRCNCT,PRSD,PRSD_SV,"2025-05-18 21:38:56",1174,544,392,108,44,538,6,1295,751,237,301
36,TELEORMAN,"GRADINITA CU PROGRAM NORMAL NR.2 NAVODARI , SAT NAVODARI, COMUNA SEACA , JUDETUL TELEORMAN, STRADA DUNARII, NR.107",277,SEACA,154139,1,PART,PRCNCT,PRSD,PRSD_SV,"2025-05-18 21:27:59",600,371,274,68,29,361,10,660,289,176,185
36,TELEORMAN,"GRĂDINIŢA DE COPII CU PROGRAM NORMAL NR.1 SEGARCEA-VALE",278,SEGARCEA-VALE,154184,1,PART,PRCNCT,PRSD,PRSD_SV,"2025-05-18 21:27:59",714,359,276,83,0,356,3,790,431,204,152
36,TELEORMAN,"GRĂDINIŢA DE COPII CU PROGRAM NORMAL NR.3 OLTEANCA",279,SEGARCEA-VALE,154184,1,PART,PRCNCT,PRSD,PRSD_SV,"2025-05-18 21:48:51",644,348,264,84,0,344,4,710,362,214,130
36,TELEORMAN,"LOCALUL ŞCOLII CU CLASELE I-VIII SEGARCEA DEAL",280,SEGARCEA-VALE,154184,1,PART,PRCNCT,PRSD,PRSD_SV,"2025-05-18 22:04:11",792,376,322,54,0,368,8,875,499,236,132
36,TELEORMAN,"LOCALUL CĂMINULUI CULTURAL SFINŢEŞTI",281,SFINŢEŞTI,154166,1,PART,PRCNCT,PRSD,PRSD_SV,"2025-05-18 21:44:36",798,493,357,95,41,489,4,880,387,288,201
36,TELEORMAN,"CĂMINUL CULTURAL SILIŞTEA",282,SILIŞTEA,154228,1,PART,PRCNCT,PRSD,PRSD_SV,"2025-05-18 22:08:58",952,603,487,116,0,594,9,1045,442,394,200
36,TELEORMAN,"GRĂDINIȚA CU PROGRAM NORMAL NR. 2 BUTEȘTI (FOST LOCAL AL ȘCOLII CU CLASELE I-IV BUTEȘTI)",283,SILIŞTEA,154228,1,PART,PRCNCT,PRSD,PRSD_SV,"2025-05-18 21:36:39",430,288,205,83,0,286,2,475,187,169,117
36,TELEORMAN,"GRĂDINIȚA CU PROGRAM NORMAL NR. 3 SILIȘTEA MICĂ (FOST LOCAL AL ȘCOLII CU CLASELE I-IV SILIȘTEA MICĂ)",284,SILIŞTEA,154228,2,PART,PRCNCT,PRSD,PRSD_SV,"2025-05-19 00:02:29",250,157,112,45,0,156,1,275,118,132,24
36,TELEORMAN,"CENTRUL MEMORIAL ”MARIN PREDA”",285,SILIŞTEA-GUMEŞTI,154282,1,PART,PRCNCT,PRSD,PRSD_SV,"2025-05-18 22:28:31",1062,636,465,129,42,632,4,1175,539,419,213
36,TELEORMAN,"ȘCOALA CU CLASELE I-IV ”MĂGURA”",286,SILIŞTEA-GUMEŞTI,154282,1,PART,PRCNCT,PRSD,PRSD_SV,"2025-05-18 21:40:03",697,416,317,63,36,415,1,770,354,272,143
36,TELEORMAN,"ȘCOALA GIMNAZIALĂ SLOBOZIA MÂNDRA",287,"SLOBOZIA MÂNDRA",154344,1,PART,PRCNCT,PRSD,PRSD_SV,"2025-05-18 21:49:32",528,398,233,114,51,395,3,580,182,199,196
36,TELEORMAN,"ȘCOALA GIMNAZIALĂ SLOBOZIA MÂNDRA",288,"SLOBOZIA MÂNDRA",154344,1,PART,PRCNCT,PRSD,PRSD_SV,"2025-05-18 21:58:32",626,396,238,101,57,389,7,695,299,220,169
36,TELEORMAN,"ŞCOALA GIMNAZIALĂ SMÎRDIOASA",289,SMÂRDIOASA,154380,1,PART,PRCNCT,PRSD,PRSD_SV,"2025-05-18 21:58:06",1455,698,595,101,2,682,16,1580,882,449,233
36,TELEORMAN,"ŞCOALA PRIMARĂ ŞOIMU",290,SMÂRDIOASA,154380,1,PART,PRCNCT,PRSD,PRSD_SV,"2025-05-18 21:34:28",311,201,139,61,1,200,1,340,139,109,91
36,TELEORMAN,"CĂMIN CULTURAL STEJARU",291,STEJARU,154415,2,PART,PRCNCT,PRSD,PRSD_SV,"2025-05-18 23:52:38",557,321,240,55,26,320,1,575,254,200,120
36,TELEORMAN,"SEDIUL FOSTEI PRIMĂRII COMUNALE BRATCOV",292,STEJARU,154415,1,PART,PRCNCT,PRSD,PRSD_SV,"2025-05-18 21:13:38",88,57,32,20,5,57,0,95,38,23,34
36,TELEORMAN,"CLĂDIREA ŞCOLII ELEMENTARE GRESIA",293,STEJARU,154415,1,PART,PRCNCT,PRSD,PRSD_SV,"2025-05-18 21:16:57",91,89,53,33,3,85,4,140,51,45,40
36,TELEORMAN,"CLĂDIREA ŞCOLII GENERALE SOCETU",294,STEJARU,154415,1,PART,PRCNCT,PRSD,PRSD_SV,"2025-05-18 21:26:02",565,360,264,76,20,356,4,625,265,211,145
36,TELEORMAN,"ŞCOALA GIMNAZIALĂ SUHAIA",295,SUHAIA,154460,1,PART,PRCNCT,PRSD,PRSD_SV,"2025-05-18 22:17:37",756,954,470,448,36,946,8,1035,81,331,615
36,TELEORMAN,"GRĂDINIŢA CU PROGRAM NORMAL SUHAIA",296,SUHAIA,154460,1,PART,PRCNCT,PRSD,PRSD_SV,"2025-05-18 22:56:51",845,1126,536,552,38,1113,13,1229,103,335,778
36,TELEORMAN,"SCOALA GIMNAZIALA ”VASILE RACOTTA”",297,ŞTOROBĂNEASA,154497,1,PART,PRCNCT,PRSD,PRSD_SV,"2025-05-18 21:45:55",1307,654,540,103,11,646,8,1420,766,435,211
36,TELEORMAN,"SCOALA CU CLASELE I-VIII ” BADEA NEGREANU ”",298,ŞTOROBĂNEASA,154497,1,PART,PRCNCT,PRSD,PRSD_SV,"2025-05-18 21:38:52",1011,573,453,114,6,563,10,1115,542,359,204
36,TELEORMAN,"ȘCOALA GIMNAZIALĂ COMUNA TALPA",299,TALPA,154521,1,PART,PRCNCT,PRSD,PRSD_SV,"2025-05-18 21:34:48",641,508,293,111,104,503,5,705,197,263,240
36,TELEORMAN,"CĂMIN CULTURAL",300,TALPA,154521,1,PART,PRCNCT,PRSD,PRSD_SV,"2025-05-18 21:46:05",593,493,306,123,64,488,5,655,162,236,252
36,TELEORMAN,"ŞCOALA GIMNAZIALĂ TĂTĂRĂŞTII DE JOS",301,"TĂTĂRĂŞTII DE JOS",154585,1,PART,PRCNCT,PRSD,PRSD_SV,"2025-05-18 22:12:54",1073,551,405,146,0,545,6,1185,634,347,198
36,TELEORMAN,"GRĂDINIŢA NEGRENII DE SUS",302,"TĂTĂRĂŞTII DE JOS",154585,1,PART,PRCNCT,PRSD,PRSD_SV,"2025-05-18 21:28:37",592,285,204,81,0,282,3,650,365,141,141
36,TELEORMAN,"ŞCOALA GIMNAZIALĂ SLĂVEŞTI",303,"TĂTĂRĂŞTII DE JOS",154585,1,PART,PRCNCT,PRSD,PRSD_SV,"2025-05-18 21:35:12",684,367,271,96,0,361,6,755,388,243,118
36,TELEORMAN,"ȘCOALA GIMNAZIALĂ TĂTĂRĂȘTII DE SUS",304,"TĂTĂRĂŞTII DE SUS",154665,1,PART,PRCNCT,PRSD,PRSD_SV,"2025-05-18 21:27:14",986,554,411,135,8,548,6,1085,531,320,228
36,TELEORMAN,"ȘCOALA GIMNAZIALĂ TĂTĂRĂȘTII DE SUS",305,"TĂTĂRĂŞTII DE SUS",154665,1,PART,PRCNCT,PRSD,PRSD_SV,"2025-05-18 21:30:11",1086,648,496,142,10,639,9,1200,552,336,303
36,TELEORMAN,"SPAŢII BIROURI, STRADA PRINCIPALĂ NR. 116",306,TRAIAN,154736,1,PART,PRCNCT,PRSD,PRSD_SV,"2025-05-18 21:51:05",583,339,248,81,10,330,9,640,301,185,145
36,TELEORMAN,"ŞCOALA GIMNAZIALĂ TRAIAN, STRADA PRINCIPALĂ NR. 188",307,TRAIAN,154736,1,PART,PRCNCT,PRSD,PRSD_SV,"2025-05-18 21:43:59",733,355,260,85,10,349,6,805,450,208,141
36,TELEORMAN,"GRᾸDINIṬA TRIVALEA-SAT (FOSTA)",308,TRIVALEA-MOŞTENI,154754,1,PART,PRCNCT,PRSD,PRSD_SV,"2025-05-18 21:40:07",694,380,296,80,4,374,6,765,385,259,115
36,TELEORMAN,"DISPENSARUL BRᾸTᾸŞANI",309,TRIVALEA-MOŞTENI,154754,1,PART,PRCNCT,PRSD,PRSD_SV,"2025-05-18 21:42:47",498,295,214,75,6,292,3,550,255,162,130
36,TELEORMAN,"GRᾸDINIṬA CU PROGRAM NORMAL NR.2",310,TRIVALEA-MOŞTENI,154754,1,PART,PRCNCT,PRSD,PRSD_SV,"2025-05-18 21:51:02",686,366,252,113,1,366,0,760,394,212,154
36,TELEORMAN,"ȘCOALA GIMNAZIALĂ ”ION PREOTU”",311,TROIANUL,154790,1,PART,PRCNCT,PRSD,PRSD_SV,"2025-05-18 22:07:15",1158,575,480,88,7,568,7,1150,575,307,261
36,TELEORMAN,"ȘCOALA GENARALĂ NR. 2",312,TROIANUL,154790,1,PART,PRCNCT,PRSD,PRSD_SV,"2025-05-18 21:26:31",735,389,310,66,13,378,11,810,421,191,187
36,TELEORMAN,"CĂMINUL CULTURAL",313,TROIANUL,154790,1,PART,PRCNCT,PRSD,PRSD_SV,"2025-05-18 21:21:57",45,61,12,42,7,61,0,100,39,21,40
36,TELEORMAN,"ȘCOALA GENERALĂ",314,TROIANUL,154790,1,PART,PRCNCT,PRSD,PRSD_SV,"2025-05-18 21:43:56",140,93,55,30,8,90,3,155,62,44,46
36,TELEORMAN,"ȘCOALA CU CLASELE I-IV",315,ŢIGĂNEŞTI,154834,1,PART,PRCNCT,PRSD,PRSD_SV,"2025-05-18 21:31:56",1319,709,622,87,0,699,10,1445,736,404,295
36,TELEORMAN,"GRĂDINIȚA CU PROGRAM NORMAL",316,ŢIGĂNEŞTI,154834,1,PART,PRCNCT,PRSD,PRSD_SV,"2025-05-18 21:54:04",1172,649,588,61,0,638,11,1290,641,366,272
36,TELEORMAN,"ȘCOALA GIMNAZIALĂ ”I.GH.DUCA”",317,ŢIGĂNEŞTI,154834,1,PART,PRCNCT,PRSD,PRSD_SV,"2025-05-18 21:53:41",1395,743,675,66,2,732,11,1520,777,444,288
36,TELEORMAN,"LOCALUL CĂMINULUI CULTURAL UDA CLOCOCIOV",318,UDA-CLOCOCIOV,155154,1,PART,PRCNCT,PRSD,PRSD_SV,"2025-05-18 21:31:31",531,382,235,103,44,375,7,585,203,191,184
36,TELEORMAN,"LOCALUL ŞCOLII CU CLASELE I – VIII UDA PACIUREA",319,UDA-CLOCOCIOV,155154,1,PART,PRCNCT,PRSD,PRSD_SV,"2025-05-18 21:27:23",519,322,215,77,30,319,3,570,248,152,167
36,TELEORMAN,"CĂMINUL CULTURAL VIRTOAPELE DE SUS",320,VÂRTOAPE,154932,1,PART,PRCNCT,PRSD,PRSD_SV,"2025-05-18 21:33:53",748,473,347,126,0,469,4,825,352,292,177
36,TELEORMAN,"CĂMINUL CULTURAL GĂRĂGĂU",321,VÂRTOAPE,154932,1,PART,PRCNCT,PRSD,PRSD_SV,"2025-05-18 21:20:42",496,245,187,58,0,243,2,545,300,172,71
36,TELEORMAN,"CĂMINUL CULTURAL VIRTOAPELE DE JOS",322,VÂRTOAPE,154932,1,PART,PRCNCT,PRSD,PRSD_SV,"2025-05-18 21:45:30",657,375,262,113,0,373,2,720,345,242,131
36,TELEORMAN,"ȘCOALA GIMNAZIALĂ VEDEA",323,VEDEA,154852,1,PART,PRCNCT,PRSD,PRSD_SV,"2025-05-18 21:16:48",456,261,223,38,0,257,4,505,244,139,118
36,TELEORMAN,"ȘCOALA CU CLASELE I - IV ALBEȘTI",324,VEDEA,154852,1,PART,PRCNCT,PRSD,PRSD_SV,"2025-05-18 21:41:45",476,295,232,63,0,290,5,525,230,147,143
36,TELEORMAN,"ȘCOALA CU CLASELE I -IV COȘOTENI",325,VEDEA,154852,1,PART,PRCNCT,PRSD,PRSD_SV,"2025-05-18 21:19:34",422,248,196,52,0,248,0,465,217,173,75
36,TELEORMAN,"ŞCOALA CU CLASELE I – VIII DULCEANCA",326,VEDEA,154852,1,PART,PRCNCT,PRSD,PRSD_SV,"2025-05-18 21:21:37",423,255,220,35,0,249,6,465,210,139,110
36,TELEORMAN,"ŞCOALA CU CLASELE I – IV MERI",327,VEDEA,154852,1,PART,PRCNCT,PRSD,PRSD_SV,"2025-05-18 21:18:33",364,227,193,34,0,226,1,400,173,132,94
36,TELEORMAN,"ȘCOALĂ GIMNAZIALĂ",328,VIIŞOARA,154914,1,PART,PRCNCT,PRSD,PRSD_SV,"2025-05-18 21:56:32",617,435,327,85,23,428,7,675,240,205,223
36,TELEORMAN,"GRĂDINIȚĂ CU PROGRAM NORMAL",329,VIIŞOARA,154914,1,PART,PRCNCT,PRSD,PRSD_SV,"2025-05-18 21:46:14",546,376,302,63,11,371,5,600,224,210,161
36,TELEORMAN,"GRĂDINIȚA CU PROGRAM NORMAL NR. 1 VITĂNEȘTI",330,VITĂNEŞTI,153776,1,PART,PRCNCT,PRSD,PRSD_SV,"2025-05-18 22:00:54",907,579,404,128,47,567,12,1000,421,318,249
36,TELEORMAN,"CĂMIN CULTURAL SAT PURANI",331,VITĂNEŞTI,153776,1,PART,PRCNCT,PRSD,PRSD_SV,"2025-05-18 21:35:22",548,326,221,80,25,320,6,605,279,209,111
36,TELEORMAN,"CĂMIN CULTURAL SAT SILIŞTEA",332,VITĂNEŞTI,153776,1,PART,PRCNCT,PRSD,PRSD_SV,"2025-05-18 21:54:00",619,406,233,149,24,399,7,690,284,204,195
36,TELEORMAN,"FOST SEDIU PRIMĂRIE",333,ZÂMBREASCA,154978,1,PART,PRCNCT,PRSD,PRSD_SV,"2025-05-18 21:32:44",658,338,238,80,20,335,3,725,387,156,179
36,TELEORMAN,"ŞCOALA PRIMARĂ",334,ZÂMBREASCA,154978,1,PART,PRCNCT,PRSD,PRSD_SV,"2025-05-18 21:24:13",331,161,123,35,3,158,3,365,204,103,55
37,TIMIŞ,"UNIVERSITATEA DE MEDICINĂ ŞI FARMACIE ”VICTOR BABEŞ”",1,"MUNICIPIUL TIMIŞOARA",155243,1,PART,PRCNCT,PRSD,PRSD_SV,"2025-05-18 21:36:40",1155,656,376,273,7,647,9,1200,544,137,510
37,TIMIŞ,"UNIVERSITATEA DE MEDICINĂ ŞI FARMACIE ”VICTOR BABEŞ”",2,"MUNICIPIUL TIMIŞOARA",155243,1,PART,PRCNCT,PRSD,PRSD_SV,"2025-05-18 22:03:39",1085,1104,497,587,20,1093,11,1200,96,197,896
37,TIMIŞ,"COLEGIUL NAȚIONAL PEDAGOGIC ”CARMEN SYLVA” TIMIȘOARA",3,"MUNICIPIUL TIMIŞOARA",155243,1,PART,PRCNCT,PRSD,PRSD_SV,"2025-05-18 21:25:35",575,541,228,243,70,532,9,700,159,134,398
37,TIMIŞ,"COLEGIUL TEHNIC ”EMANUIL UNGUREANU” TIMIȘOARA",4,"MUNICIPIUL TIMIŞOARA",155243,1,PART,PRCNCT,PRSD,PRSD_SV,"2025-05-18 22:04:57",1367,1049,580,421,48,1041,8,1500,451,270,771
37,TIMIŞ,"LICEUL TEORETIC ”NIKOLAUS LENAU” TIMIȘOARA",5,"MUNICIPIUL TIMIŞOARA",155243,1,PART,PRCNCT,PRSD,PRSD_SV,"2025-05-18 21:53:24",654,676,300,300,76,671,5,1100,424,188,483
37,TIMIŞ,"LICEUL TEORETIC ”NIKOLAUS LENAU” TIMIȘOARA",6,"MUNICIPIUL TIMIŞOARA",155243,1,PART,PRCNCT,PRSD,PRSD_SV,"2025-05-18 21:52:35",727,731,319,318,94,724,7,800,69,221,503
37,TIMIŞ,"LICEUL TEORETIC ”NIKOLAUS LENAU”TIMIȘOARA",7,"MUNICIPIUL TIMIŞOARA",155243,1,PART,PRCNCT,PRSD,PRSD_SV,"2025-05-18 21:47:29",572,652,269,308,75,645,7,1000,348,210,435
37,TIMIŞ,"COLEGIUL TEHNIC ”HENRI COANDĂ” TIMIȘOARA",8,"MUNICIPIUL TIMIŞOARA",155243,1,PART,PRCNCT,PRSD,PRSD_SV,"2025-05-18 22:02:39",721,480,300,179,1,472,8,800,320,106,366
37,TIMIŞ,"COLEGIUL TEHNIC ”HENRI COANDĂ” TIMIȘOARA",9,"MUNICIPIUL TIMIŞOARA",155243,1,PART,PRCNCT,PRSD,PRSD_SV,"2025-05-18 22:09:01",1075,717,507,175,35,711,6,1100,383,154,557
37,TIMIŞ,"LICEUL TEORETIC ”NIKOLAUS LENAU”",10,"MUNICIPIUL TIMIŞOARA",155243,1,PART,PRCNCT,PRSD,PRSD_SV,"2025-05-18 21:59:51",489,597,227,302,68,592,5,824,227,156,436
37,TIMIŞ,"INSPECTORATUL TERITORIAL AL POLIŢIEI DE FRONTIERĂ TIMIȘOARA",11,"MUNICIPIUL TIMIŞOARA",155243,1,PART,PRCNCT,PRSD,PRSD_SV,"2025-05-18 22:01:36",1162,650,520,130,0,638,12,1200,550,214,424
37,TIMIŞ,"INSPECTORATUL TERITORIAL AL POLIŢIEI DE FRONTIERĂ TIMIȘOARA",12,"MUNICIPIUL TIMIŞOARA",155243,1,PART,PRCNCT,PRSD,PRSD_SV,"2025-05-18 22:07:49",1275,745,611,134,0,733,12,1400,655,224,509
37,TIMIŞ,"FUNDAŢIA IOAN SLAVICI",13,"MUNICIPIUL TIMIŞOARA",155243,1,PART,PRCNCT,PRSD,PRSD_SV,"2025-05-18 21:39:39",1139,737,570,167,0,729,8,1200,463,283,446
37,TIMIŞ,"FUNDAŢIA IOAN SLAVICI",14,"MUNICIPIUL TIMIŞOARA",155243,1,PART,PRCNCT,PRSD,PRSD_SV,"2025-05-18 21:48:12",1279,811,664,147,0,799,12,1400,589,250,549
37,TIMIŞ,"ȘCOALA GIMNAZIALĂ NR.7 ”SFÂNTA MARIA” TIMIȘOARA",15,"MUNICIPIUL TIMIŞOARA",155243,1,PART,PRCNCT,PRSD,PRSD_SV,"2025-05-18 21:43:28",981,599,502,97,0,594,5,1100,501,223,371
37,TIMIŞ,"ȘCOALA GIMNAZIALĂ NR.7 ”SFÂNTA MARIA” TIMIȘOARA",16,"MUNICIPIUL TIMIŞOARA",155243,1,PART,PRCNCT,PRSD,PRSD_SV,"2025-05-18 21:24:07",1034,585,493,92,0,581,4,1200,615,209,372
37,TIMIŞ,"ȘCOALA GIMNAZIALĂ NR.7 ”SFÂNTA MARIA”TIMIȘOARA",17,"MUNICIPIUL TIMIŞOARA",155243,1,PART,PRCNCT,PRSD,PRSD_SV,"2025-05-18 22:55:47",1584,852,782,68,2,844,8,1700,848,327,517
37,TIMIŞ,"GRĂDINIŢA CU PROGRAM PRELUNGIT NR. 36 (FOSTA GRĂDINIŢĂ NR. 37)",18,"MUNICIPIUL TIMIŞOARA",155243,1,PART,PRCNCT,PRSD,PRSD_SV,"2025-05-18 21:59:13",1596,1064,820,244,0,1055,9,1700,636,245,810
37,TIMIŞ,"GRĂDINIŢA CU PROGRAM PRELUNGIT NR. 36 (FOSTA GRĂDINIŢĂ NR. 37)",19,"MUNICIPIUL TIMIŞOARA",155243,1,PART,PRCNCT,PRSD,PRSD_SV,"2025-05-18 22:26:14",1317,898,615,283,0,889,9,1400,502,246,643
37,TIMIŞ,"UNIVERSITATEA DE ȘTIINȚELE VIEȚII, ”REGELE MIHAI I”",20,"MUNICIPIUL TIMIŞOARA",155243,2,PART,PRCNCT,PRSD,PRSD_SV,"2025-05-19 01:15:53",1879,1305,1021,284,0,1293,12,1900,595,301,992
37,TIMIŞ,"UNIVERSITATEA DE ȘTIINȚELE VIEȚII, ”REGELE MIHAI I”",21,"MUNICIPIUL TIMIŞOARA",155243,1,PART,PRCNCT,PRSD,PRSD_SV,"2025-05-18 21:49:48",1861,1509,1000,509,0,1487,22,2100,591,358,1129
37,TIMIŞ,"UNIVERSITATEA DE ȘTIINȚELE VIEȚII, ”REGELE MIHAI I”",22,"MUNICIPIUL TIMIŞOARA",155243,1,PART,PRCNCT,PRSD,PRSD_SV,"2025-05-18 22:14:18",1751,1182,858,318,6,1165,17,1800,618,327,838
37,TIMIŞ,"UNIVERSITATEA DE ȘTIINȚELE VIEȚII, ”REGELE MIHAI I”",23,"MUNICIPIUL TIMIŞOARA",155243,1,PART,PRCNCT,PRSD,PRSD_SV,"2025-05-18 22:00:33",1827,1188,895,292,1,1180,8,1800,612,258,922
37,TIMIŞ,"UNIVERSITATEA DE ȘTIINȚELE VIEȚII, ”REGELE MIHAI I”",24,"MUNICIPIUL TIMIŞOARA",155243,1,PART,PRCNCT,PRSD,PRSD_SV,"2025-05-18 21:54:15",1915,1258,1084,174,0,1246,12,2000,742,299,947
37,TIMIŞ,"ŞCOALA GIMNAZIALĂ NR.24 (GRĂDINIŢA CU PROGRAM PRELUNGIT NR.27)",25,"MUNICIPIUL TIMIŞOARA",155243,1,PART,PRCNCT,PRSD,PRSD_SV,"2025-05-18 22:53:39",1207,908,607,300,1,897,11,1300,392,265,632
37,TIMIŞ,"ŞCOALA GIMNAZIALĂ NR.24 (GRĂDINIŢA CU PROGRAM PRELUNGIT NR.27)",26,"MUNICIPIUL TIMIŞOARA",155243,1,PART,PRCNCT,PRSD,PRSD_SV,"2025-05-18 21:38:25",1181,752,582,170,0,743,9,1300,548,206,537
37,TIMIŞ,"ŞCOALA GIMNAZIALĂ NR.19 ”AVRAM IANCU” TIMIȘOARA",27,"MUNICIPIUL TIMIŞOARA",155243,1,PART,PRCNCT,PRSD,PRSD_SV,"2025-05-18 21:32:43",1299,911,726,183,2,895,16,1400,489,292,603
37,TIMIŞ,"ŞCOALA GIMNAZIALĂ NR.19 ”AVRAM IANCU” TIMIȘOARA",28,"MUNICIPIUL TIMIŞOARA",155243,1,PART,PRCNCT,PRSD,PRSD_SV,"2025-05-18 22:07:14",1416,882,738,144,0,864,18,1500,618,232,632
37,TIMIŞ,"ŞCOALA GIMNAZIALĂ NR.24",29,"MUNICIPIUL TIMIŞOARA",155243,1,PART,PRCNCT,PRSD,PRSD_SV,"2025-05-18 21:22:03",1137,784,549,234,1,778,6,1200,416,182,596
37,TIMIŞ,"ŞCOALA GIMNAZIALĂ NR.24",30,"MUNICIPIUL TIMIŞOARA",155243,1,PART,PRCNCT,PRSD,PRSD_SV,"2025-05-18 21:34:30",1208,719,616,101,2,704,15,1300,581,199,505
37,TIMIŞ,"ŞCOALA GIMNAZIALĂ NR.24",31,"MUNICIPIUL TIMIŞOARA",155243,1,PART,PRCNCT,PRSD,PRSD_SV,"2025-05-18 22:10:44",695,612,340,272,0,604,8,1000,388,165,439
37,TIMIŞ,"ŞCOALA GIMNAZIALĂ NR.24",32,"MUNICIPIUL TIMIŞOARA",155243,1,PART,PRCNCT,PRSD,PRSD_SV,"2025-05-18 21:25:23",833,531,431,100,0,524,7,900,369,132,392
37,TIMIŞ,"ŞCOALA GIMNAZIALĂ NR.24",33,"MUNICIPIUL TIMIŞOARA",155243,1,PART,PRCNCT,PRSD,PRSD_SV,"2025-05-18 21:43:01",1198,699,583,116,0,689,10,1300,601,173,516
37,TIMIŞ,"ŞCOALA GIMNAZIALĂ NR.24",34,"MUNICIPIUL TIMIŞOARA",155243,2,PART,PRCNCT,PRSD,PRSD_SV,"2025-05-18 23:22:54",985,608,491,117,0,603,5,1100,492,149,454
37,TIMIŞ,"ŞCOALA GIMNAZIALĂ NR.24",35,"MUNICIPIUL TIMIŞOARA",155243,1,PART,PRCNCT,PRSD,PRSD_SV,"2025-05-18 21:21:10",1123,689,587,102,0,678,11,1200,511,161,517
37,TIMIŞ,"ŞCOALA GIMNAZIALĂ NR.24",36,"MUNICIPIUL TIMIŞOARA",155243,1,PART,PRCNCT,PRSD,PRSD_SV,"2025-05-18 21:23:43",1164,770,626,143,1,763,7,1200,430,213,550
37,TIMIŞ,"ŞCOALA GIMNAZIALĂ NR.18",37,"MUNICIPIUL TIMIŞOARA",155243,1,PART,PRCNCT,PRSD,PRSD_SV,"2025-05-18 21:54:34",1357,772,651,120,1,761,11,1400,628,197,564
37,TIMIŞ,"ŞCOALA GIMNAZIALĂ NR.18",38,"MUNICIPIUL TIMIŞOARA",155243,1,PART,PRCNCT,PRSD,PRSD_SV,"2025-05-18 22:02:15",1368,809,680,129,0,798,11,1400,591,229,569
37,TIMIŞ,"ŞCOALA GIMNAZIALĂ NR.18",39,"MUNICIPIUL TIMIŞOARA",155243,1,PART,PRCNCT,PRSD,PRSD_SV,"2025-05-18 22:06:23",1122,687,545,142,0,676,11,1200,513,206,470
37,TIMIŞ,"CLUBUL SPORTIV ŞCOLAR NR.1",40,"MUNICIPIUL TIMIŞOARA",155243,1,PART,PRCNCT,PRSD,PRSD_SV,"2025-05-18 21:42:01",821,548,443,105,0,538,10,900,352,133,405
37,TIMIŞ,"GRĂDINIŢA CU PROGRAM PRELUNGIT NR.36",41,"MUNICIPIUL TIMIŞOARA",155243,1,PART,PRCNCT,PRSD,PRSD_SV,"2025-05-18 22:12:41",1131,853,526,327,0,839,14,1200,347,239,600
37,TIMIŞ,"ŞCOALA GIMNAZIALĂ NR.19 ”AVRAM IANCU”",42,"MUNICIPIUL TIMIŞOARA",155243,2,PART,PRCNCT,PRSD,PRSD_SV,"2025-05-19 00:52:58",933,645,506,137,2,638,7,1000,355,145,493
37,TIMIŞ,"ŞCOALA GIMNAZIALĂ NR.19 ”AVRAM IANCU”",43,"MUNICIPIUL TIMIŞOARA",155243,1,PART,PRCNCT,PRSD,PRSD_SV,"2025-05-18 21:35:32",1026,738,519,219,0,728,10,1100,362,201,527
37,TIMIŞ,"ŞCOALA GIMNAZIALĂ NR.19 ”AVRAM IANCU”",44,"MUNICIPIUL TIMIŞOARA",155243,1,PART,PRCNCT,PRSD,PRSD_SV,"2025-05-18 21:34:21",1154,817,627,188,2,804,13,1200,383,189,615
37,TIMIŞ,"ŞCOALA GIMNAZIALĂ NR.19 ”AVRAM IANCU”",45,"MUNICIPIUL TIMIŞOARA",155243,1,PART,PRCNCT,PRSD,PRSD_SV,"2025-05-18 21:47:52",1227,680,573,106,1,674,6,1300,620,190,484
37,TIMIŞ,"GRĂDINIŢA CU PROGRAM PRELUNGIT NR.26",46,"MUNICIPIUL TIMIŞOARA",155243,1,PART,PRCNCT,PRSD,PRSD_SV,"2025-05-18 22:07:46",1180,748,580,167,1,737,11,1300,552,158,579
37,TIMIŞ,"GRĂDINIŢA CU PROGRAM PRELUNGIT NR.26",47,"MUNICIPIUL TIMIŞOARA",155243,1,PART,PRCNCT,PRSD,PRSD_SV,"2025-05-18 22:04:20",1181,743,573,168,2,729,14,1300,557,180,549
37,TIMIŞ,"GRĂDINIŢA CU PROGRAM PRELUNGIT NR.20 (GRĂDINIŢA CU PROGRAM PRELUNGIT NR.9 ”CARLA PELZ”)",48,"MUNICIPIUL TIMIŞOARA",155243,1,PART,PRCNCT,PRSD,PRSD_SV,"2025-05-18 21:54:23",1354,893,765,127,1,877,16,1400,507,280,597
37,TIMIŞ,"GRĂDINIŢA CU PROGRAM PRELUNGIT NR.20 (GRĂDINIŢA CU PROGRAM PRELUNGIT NR.9 ”CARLA PELZ”)",49,"MUNICIPIUL TIMIŞOARA",155243,1,PART,PRCNCT,PRSD,PRSD_SV,"2025-05-18 21:47:08",1240,762,675,87,0,748,14,1300,538,180,568
37,TIMIŞ,"BIROUL LOCUINŢE/DIRECŢIA CLĂDIRI, TERENURI ŞI DOTĂRI DIVERSE- PRIMĂRIA MUNICIPIULUI TIMIŞOARA",50,"MUNICIPIUL TIMIŞOARA",155243,1,PART,PRCNCT,PRSD,PRSD_SV,"2025-05-18 22:12:05",595,566,314,193,59,555,11,800,234,145,410
37,TIMIŞ,"LICEUL TEHNOLOGIC DE INDUSTRIE ALIMENTARĂ",51,"MUNICIPIUL TIMIŞOARA",155243,1,PART,PRCNCT,PRSD,PRSD_SV,"2025-05-18 22:03:18",957,656,508,148,0,646,10,1000,344,213,433
37,TIMIŞ,"LICEUL TEHNOLOGIC DE INDUSTRIE ALIMENTARĂ",52,"MUNICIPIUL TIMIŞOARA",155243,1,PART,PRCNCT,PRSD,PRSD_SV,"2025-05-18 21:26:16",1115,729,625,103,1,715,14,1200,471,214,501
37,TIMIŞ,"LICEUL TEHNOLOGIC UCECOM ”SPIRU HARET”",53,"MUNICIPIUL TIMIŞOARA",155243,1,PART,PRCNCT,PRSD,PRSD_SV,"2025-05-18 22:29:45",1176,879,621,258,0,871,8,1200,321,295,576
37,TIMIŞ,"LICEUL TEHNOLOGIC UCECOM ”SPIRU HARET”",54,"MUNICIPIUL TIMIŞOARA",155243,1,PART,PRCNCT,PRSD,PRSD_SV,"2025-05-18 21:52:20",1555,1007,920,86,1,994,13,1600,593,300,694
37,TIMIŞ,"COLEGIUL TEHNIC ”HENRI COANDĂ” (ŞCOALA PRIMARĂ NR.11)",55,"MUNICIPIUL TIMIŞOARA",155243,1,PART,PRCNCT,PRSD,PRSD_SV,"2025-05-18 21:49:02",1734,1074,966,108,0,1057,17,1800,726,361,696
37,TIMIŞ,"COLEGIUL TEHNIC ”HENRI COANDĂ” (ŞCOALA PRIMARĂ NR.11)",56,"MUNICIPIUL TIMIŞOARA",155243,1,PART,PRCNCT,PRSD,PRSD_SV,"2025-05-18 21:47:13",1596,974,851,122,1,961,13,1700,726,393,568
37,TIMIŞ,"COLEGIUL TEHNIC ”HENRI COANDĂ” (ŞCOALA PRIMARĂ NR.11)",57,"MUNICIPIUL TIMIŞOARA",155243,1,PART,PRCNCT,PRSD,PRSD_SV,"2025-05-18 22:21:33",1904,1139,1045,93,1,1131,8,2000,861,378,753
37,TIMIŞ,"ŞCOALA GIMNAZIALĂ NR.19 ”AVRAM IANCU” (ŞCOALA PRIMARĂ NR.19)",58,"MUNICIPIUL TIMIŞOARA",155243,1,PART,PRCNCT,PRSD,PRSD_SV,"2025-05-18 22:37:20",1756,1009,876,133,0,998,11,1800,791,352,646
37,TIMIŞ,"ŞCOALA GIMNAZIALĂ NR.19 ”AVRAM IANCU” (ŞCOALA PRIMARĂ NR.19)",59,"MUNICIPIUL TIMIŞOARA",155243,1,PART,PRCNCT,PRSD,PRSD_SV,"2025-05-18 21:42:29",1565,917,841,76,0,902,15,1700,783,261,641
37,TIMIŞ,"ŞCOALA GIMNAZIALĂ NR.19 ”AVRAM IANCU” (ŞCOALA PRIMARĂ NR.19)",60,"MUNICIPIUL TIMIŞOARA",155243,1,PART,PRCNCT,PRSD,PRSD_SV,"2025-05-18 21:34:32",1466,713,623,90,0,702,11,1600,887,281,421
37,TIMIŞ,"CENTRUL DE SOCIALIZARE ȘI PETRECERE A TIMPULUI LIBER - CLUBUL PENSIONARILOR",61,"MUNICIPIUL TIMIŞOARA",155243,1,PART,PRCNCT,PRSD,PRSD_SV,"2025-05-18 22:14:45",1249,674,497,177,0,662,12,1300,626,296,366
37,TIMIŞ,"S.C. DRUMURI MUNICIPALE TIMIŞOARA S.A.(FOSTA ADMINISTRAREA DOMENIULUI PUBLIC )",62,"MUNICIPIUL TIMIŞOARA",155243,1,PART,PRCNCT,PRSD,PRSD_SV,"2025-05-18 22:00:48",1123,681,523,137,21,670,11,1200,519,258,412
37,TIMIŞ,"S.C. DRUMURI MUNICIPALE TIMIŞOARA S.A.(FOSTA ADMINISTRAREA DOMENIULUI PUBLIC )",63,"MUNICIPIUL TIMIŞOARA",155243,1,PART,PRCNCT,PRSD,PRSD_SV,"2025-05-18 21:51:18",1302,719,549,137,33,712,7,1400,681,302,410
37,TIMIŞ,"LICEUL TEHNOLOGIC DE VEST TIMIȘOARA",64,"MUNICIPIUL TIMIŞOARA",155243,1,PART,PRCNCT,PRSD,PRSD_SV,"2025-05-18 22:08:21",1111,543,445,94,4,535,8,800,257,159,376
37,TIMIŞ,"LICEUL TEHNOLOGIC DE VEST TIMIȘOARA",65,"MUNICIPIUL TIMIŞOARA",155243,1,PART,PRCNCT,PRSD,PRSD_SV,"2025-05-18 21:27:28",993,539,437,102,0,524,15,1100,561,173,351
37,TIMIŞ,"LICEUL TEHNOLOGIC DE VEST TIMIȘOARA",66,"MUNICIPIUL TIMIŞOARA",155243,1,PART,PRCNCT,PRSD,PRSD_SV,"2025-05-18 21:43:29",859,542,416,124,2,536,6,900,358,165,371
37,TIMIŞ,"ŞCOALA GIMNAZIALĂ NR.12",67,"MUNICIPIUL TIMIŞOARA",155243,1,PART,PRCNCT,PRSD,PRSD_SV,"2025-05-18 21:36:08",898,652,420,231,1,645,7,1000,348,257,388
37,TIMIŞ,"ŞCOALA GIMNAZIALĂ NR.12",68,"MUNICIPIUL TIMIŞOARA",155243,1,PART,PRCNCT,PRSD,PRSD_SV,"2025-05-18 21:49:25",1110,657,521,136,0,646,11,1200,543,247,399
37,TIMIŞ,"COLEGIUL ECONOMIC ”FRANCESCO SEVERIO NITTI” TIMIȘOARA",69,"MUNICIPIUL TIMIŞOARA",155243,1,PART,PRCNCT,PRSD,PRSD_SV,"2025-05-18 22:03:26",1025,559,416,143,0,554,5,1300,741,169,385
37,TIMIŞ,"COLEGIUL ECONOMIC ”FRANCESCO SEVERIO NITTI” TIMIȘOARA",70,"MUNICIPIUL TIMIŞOARA",155243,1,PART,PRCNCT,PRSD,PRSD_SV,"2025-05-18 21:35:01",1054,571,480,64,27,565,6,1100,529,216,349
37,TIMIŞ,"COLEGIUL ECONOMIC ”FRANCESCO SEVERIO NITTI” TIMIȘOARA",71,"MUNICIPIUL TIMIŞOARA",155243,1,PART,PRCNCT,PRSD,PRSD_SV,"2025-05-18 21:59:23",1168,695,602,64,29,682,13,1200,505,197,485
37,TIMIŞ,"COLEGIUL ECONOMIC ”FRANCESCO SEVERIO NITTI” TIMIȘOARA",72,"MUNICIPIUL TIMIŞOARA",155243,1,PART,PRCNCT,PRSD,PRSD_SV,"2025-05-18 22:00:40",1148,645,548,81,16,639,6,1200,555,189,450
37,TIMIŞ,"LICEUL TEORETIC ”GRIGORE MOISIL” (ŞCOALA GIMNAZIALĂ NR.22)",73,"MUNICIPIUL TIMIŞOARA",155243,1,PART,PRCNCT,PRSD,PRSD_SV,"2025-05-18 22:12:58",832,636,447,182,7,625,11,1100,464,156,469
37,TIMIŞ,"LICEUL TEORETIC ”GRIGORE MOISIL” (ŞCOALA GIMNAZIALĂ NR.22)",74,"MUNICIPIUL TIMIŞOARA",155243,1,PART,PRCNCT,PRSD,PRSD_SV,"2025-05-18 22:44:20",873,572,431,140,1,567,5,900,328,157,410
37,TIMIŞ,"LICEUL TEORETIC ”GRIGORE MOISIL” (ŞCOALA GIMNAZIALĂ NR.22)",75,"MUNICIPIUL TIMIŞOARA",155243,1,PART,PRCNCT,PRSD,PRSD_SV,"2025-05-18 21:37:42",927,550,438,109,3,542,8,1000,450,131,411
37,TIMIŞ,"LICEUL TEORETIC ”GRIGORE MOISIL” (ŞCOALA GIMNAZIALĂ NR.22)",76,"MUNICIPIUL TIMIŞOARA",155243,1,PART,PRCNCT,PRSD,PRSD_SV,"2025-05-18 21:49:21",961,678,510,167,1,674,4,1000,322,151,523
37,TIMIŞ,"LICEUL TEORETIC ”GRIGORE MOISIL” TIMIȘOARA",77,"MUNICIPIUL TIMIŞOARA",155243,1,PART,PRCNCT,PRSD,PRSD_SV,"2025-05-18 21:33:33",893,544,450,92,2,540,4,1000,456,113,427
37,TIMIŞ,"LICEUL TEORETIC ”GRIGORE MOISIL” TIMIȘOARA",78,"MUNICIPIUL TIMIŞOARA",155243,1,PART,PRCNCT,PRSD,PRSD_SV,"2025-05-18 21:46:34",827,501,421,61,19,490,11,1100,599,125,365
37,TIMIŞ,"LICEUL TEOLOGIC ORTODOX ”SFÂNTUL ANTIM IVIREANUL” TIMIȘOARA",79,"MUNICIPIUL TIMIŞOARA",155243,1,PART,PRCNCT,PRSD,PRSD_SV,"2025-05-18 22:33:11",1566,1002,889,111,2,987,15,1600,598,292,695
37,TIMIŞ,"LICEUL TEOLOGIC ORTODOX ”SFÂNTUL ANTIM IVIREANUL” TIMIȘOARA",80,"MUNICIPIUL TIMIŞOARA",155243,1,PART,PRCNCT,PRSD,PRSD_SV,"2025-05-18 21:42:29",1390,727,653,74,0,717,10,1500,773,238,479
37,TIMIŞ,"LICEUL TEOLOGIC ORTODOX ”SFÂNTUL ANTIM IVIREANUL” TIMIȘOARA",81,"MUNICIPIUL TIMIŞOARA",155243,1,PART,PRCNCT,PRSD,PRSD_SV,"2025-05-18 21:39:09",1517,894,809,85,0,881,13,1600,706,248,633
37,TIMIŞ,"LICEUL TEOLOGIC ORTODOX ”SFÂNTUL ANTIM IVIREANUL” TIMIȘOARA",82,"MUNICIPIUL TIMIŞOARA",155243,1,PART,PRCNCT,PRSD,PRSD_SV,"2025-05-18 22:29:54",1440,749,681,65,3,742,7,1500,751,187,555
37,TIMIŞ,"ŞCOALA GIMNAZIALĂ NR.27 (GRADINIŢA CU PROGRAM PRELUNGIT NR. 3)",83,"MUNICIPIUL TIMIŞOARA",155243,1,PART,PRCNCT,PRSD,PRSD_SV,"2025-05-18 21:37:57",1160,688,547,141,0,674,14,1200,512,221,453
37,TIMIŞ,"ŞCOALA GIMNAZIALĂ NR.27 (GRADINIŢA CU PROGRAM PRELUNGIT NR. 3)",84,"MUNICIPIUL TIMIŞOARA",155243,1,PART,PRCNCT,PRSD,PRSD_SV,"2025-05-18 21:28:10",1124,666,552,114,0,660,6,1200,534,233,427
37,TIMIŞ,"ŞCOALA GIMNAZIALĂ NR. 27",85,"MUNICIPIUL TIMIŞOARA",155243,1,PART,PRCNCT,PRSD,PRSD_SV,"2025-05-18 21:41:58",1520,790,697,93,0,780,10,1600,810,270,510
37,TIMIŞ,"ŞCOALA GIMNAZIALĂ NR. 27",86,"MUNICIPIUL TIMIŞOARA",155243,1,PART,PRCNCT,PRSD,PRSD_SV,"2025-05-18 22:05:51",1495,933,759,174,0,920,13,1600,667,298,622
37,TIMIŞ,"ŞCOALA GIMNAZIALĂ NR. 27",87,"MUNICIPIUL TIMIŞOARA",155243,1,PART,PRCNCT,PRSD,PRSD_SV,"2025-05-18 21:52:42",1488,902,736,165,1,890,12,1600,698,307,583
37,TIMIŞ,"ŞCOALA GIMNAZIALĂ NR. 27",88,"MUNICIPIUL TIMIŞOARA",155243,1,PART,PRCNCT,PRSD,PRSD_SV,"2025-05-18 21:47:04",1490,894,702,192,0,887,7,1600,706,313,574
37,TIMIŞ,"ŞCOALA GIMNAZIALĂ NR. 6",89,"MUNICIPIUL TIMIŞOARA",155243,1,PART,PRCNCT,PRSD,PRSD_SV,"2025-05-18 22:12:55",1002,496,421,75,0,488,8,1100,604,169,319
37,TIMIŞ,"ŞCOALA GIMNAZIALĂ NR. 6",90,"MUNICIPIUL TIMIŞOARA",155243,1,PART,PRCNCT,PRSD,PRSD_SV,"2025-05-18 21:31:38",1152,683,588,93,2,675,8,1200,517,223,452
37,TIMIŞ,"ŞCOALA GIMNAZIALĂ NR. 6",91,"MUNICIPIUL TIMIŞOARA",155243,1,PART,PRCNCT,PRSD,PRSD_SV,"2025-05-18 21:31:02",1149,668,593,75,0,658,10,1200,532,222,436
37,TIMIŞ,"ŞCOALA GIMNAZIALĂ NR. 6",92,"MUNICIPIUL TIMIŞOARA",155243,1,PART,PRCNCT,PRSD,PRSD_SV,"2025-05-18 21:48:28",1358,695,621,74,0,684,11,1400,705,278,406
37,TIMIŞ,"LICEUL TEHNOLOGIC TRANSPORTURI AUTO",93,"MUNICIPIUL TIMIŞOARA",155243,1,PART,PRCNCT,PRSD,PRSD_SV,"2025-05-18 22:10:33",1481,935,778,157,0,928,7,1500,565,320,608
37,TIMIŞ,"LICEUL TEHNOLOGIC TRANSPORTURI AUTO",94,"MUNICIPIUL TIMIŞOARA",155243,1,PART,PRCNCT,PRSD,PRSD_SV,"2025-05-18 22:23:24",1663,996,861,135,0,983,13,1700,704,383,600
37,TIMIŞ,"LICEUL TEHNOLOGIC TRANSPORTURI AUTO",95,"MUNICIPIUL TIMIŞOARA",155243,1,PART,PRCNCT,PRSD,PRSD_SV,"2025-05-18 21:27:50",1511,799,714,84,1,789,10,1600,801,313,476
37,TIMIŞ,"LICEUL TEHNOLOGIC TRANSPORTURI AUTO (ŞCOALA GIMNAZIALĂ NR. 29)",96,"MUNICIPIUL TIMIŞOARA",155243,1,PART,PRCNCT,PRSD,PRSD_SV,"2025-05-18 21:51:41",1290,704,636,68,0,696,8,1300,596,308,388
37,TIMIŞ,"LICEUL TEHNOLOGIC TRANSPORTURI AUTO (ŞCOALA GIMNAZIALĂ NR. 29)",97,"MUNICIPIUL TIMIŞOARA",155243,1,PART,PRCNCT,PRSD,PRSD_SV,"2025-05-18 21:40:57",1322,617,533,84,0,608,9,1400,783,335,273
37,TIMIŞ,"LICEUL TEHNOLOGIC TRANSPORTURI AUTO (ŞCOALA GIMNAZIALĂ NR. 29)",98,"MUNICIPIUL TIMIŞOARA",155243,1,PART,PRCNCT,PRSD,PRSD_SV,"2025-05-18 21:32:51",1121,597,552,45,0,583,14,1200,603,202,381
37,TIMIŞ,"ŞCOALA GIMNAZIALĂ NR.15 (ŞCOALA PRIMARĂ NR.15)",99,"MUNICIPIUL TIMIŞOARA",155243,1,PART,PRCNCT,PRSD,PRSD_SV,"2025-05-18 21:46:37",1378,737,652,85,0,727,10,1500,763,260,467
37,TIMIŞ,"ŞCOALA GIMNAZIALĂ NR.15 (ŞCOALA PRIMARĂ NR.15)",100,"MUNICIPIUL TIMIŞOARA",155243,2,PART,PRCNCT,PRSD,PRSD_SV,"2025-05-18 22:28:22",1402,773,697,76,0,766,7,1500,727,302,464
37,TIMIŞ,"ŞCOALA GIMNAZIALĂ NR.2 (GRĂDINIŢA CU PROGRAM PRELUNGIT NR. 29)",101,"MUNICIPIUL TIMIŞOARA",155243,1,PART,PRCNCT,PRSD,PRSD_SV,"2025-05-18 21:39:03",1275,741,581,159,1,728,13,1300,559,212,516
37,TIMIŞ,"ŞCOALA GIMNAZIALĂ NR.2 (GRĂDINIŢA CU PROGRAM PRELUNGIT NR. 29)",102,"MUNICIPIUL TIMIŞOARA",155243,1,PART,PRCNCT,PRSD,PRSD_SV,"2025-05-18 22:03:18",1109,679,540,139,0,666,13,1200,521,182,484
37,TIMIŞ,"ŞCOALA GIMNAZIALĂ NR.2",103,"MUNICIPIUL TIMIŞOARA",155243,1,PART,PRCNCT,PRSD,PRSD_SV,"2025-05-18 21:38:14",1362,833,626,206,1,820,13,1400,567,303,517
37,TIMIŞ,"ŞCOALA GIMNAZIALĂ NR.2",104,"MUNICIPIUL TIMIŞOARA",155243,1,PART,PRCNCT,PRSD,PRSD_SV,"2025-05-18 22:06:01",1238,755,612,143,0,748,7,1300,545,248,500
37,TIMIŞ,"ŞCOALA GIMNAZIALĂ NR.2",105,"MUNICIPIUL TIMIŞOARA",155243,1,PART,PRCNCT,PRSD,PRSD_SV,"2025-05-18 21:48:42",1183,680,554,124,2,668,12,1300,620,227,441
37,TIMIŞ,"GRĂDINIŢA CU PROGRAM PRELUNGIT NR.2 (GRĂDINIŢA CU PROGRAM PRELUNGIT NR. 1)",106,"MUNICIPIUL TIMIŞOARA",155243,1,PART,PRCNCT,PRSD,PRSD_SV,"2025-05-18 22:26:14",1940,1279,1148,131,0,1264,15,2000,721,264,1000
37,TIMIŞ,"GRĂDINIŢA CU PROGRAM PRELUNGIT NR.2 (GRĂDINIŢA CU PROGRAM PRELUNGIT NR. 1)",107,"MUNICIPIUL TIMIŞOARA",155243,1,PART,PRCNCT,PRSD,PRSD_SV,"2025-05-18 22:11:12",1813,1140,1001,139,0,1129,11,1900,760,360,769
37,TIMIŞ,"LICEUL TEORETIC ”VLAD ŢEPEȘ” TIMIȘOARA (GRĂDINIŢA CU PROGRAM PRELUNGIT NR.28)",108,"MUNICIPIUL TIMIŞOARA",155243,1,PART,PRCNCT,PRSD,PRSD_SV,"2025-05-18 22:42:16",1166,826,566,260,0,816,10,1200,374,228,588
37,TIMIŞ,"LICEUL CU PROGRAM SPORTIV ”BANATUL”",109,"MUNICIPIUL TIMIŞOARA",155243,1,PART,PRCNCT,PRSD,PRSD_SV,"2025-05-18 21:50:49",1179,810,582,228,0,793,17,1300,490,171,622
37,TIMIŞ,"LICEUL DE ARTĂ ”ION VIDU” TIMIȘOARA",110,"MUNICIPIUL TIMIŞOARA",155243,1,PART,PRCNCT,PRSD,PRSD_SV,"2025-05-18 22:29:22",492,1378,255,1120,3,1368,10,1800,422,219,1149
37,TIMIŞ,"FUNDAŢIA JUDEŢEANĂ PENTRU TINERET TIMIŞ (FOSTA CASA TINERETULUI)",111,"MUNICIPIUL TIMIŞOARA",155243,1,PART,PRCNCT,PRSD,PRSD_SV,"2025-05-18 22:04:09",1107,970,552,417,1,956,14,1400,430,193,763
37,TIMIŞ,"FUNDAŢIA JUDEŢEANĂ PENTRU TINERET TIMIŞ (FOSTA CASA TINERETULUI)",112,"MUNICIPIUL TIMIŞOARA",155243,1,PART,PRCNCT,PRSD,PRSD_SV,"2025-05-18 23:01:28",1690,1153,843,308,2,1140,13,1900,747,232,908
37,TIMIŞ,"FUNDAŢIA JUDEŢEANĂ PENTRU TINERET TIMIŞ (FOSTA CASA TINERETULUI)",113,"MUNICIPIUL TIMIŞOARA",155243,1,PART,PRCNCT,PRSD,PRSD_SV,"2025-05-18 22:07:00",995,532,453,79,0,519,13,1300,768,178,341
37,TIMIŞ,"LICEUL TEORETIC ”JEAN LOUIS CALDERON” (FOSTA ŞCOALA GIMNAZIALĂ NR.28) ” CORP B ”",114,"MUNICIPIUL TIMIŞOARA",155243,1,PART,PRCNCT,PRSD,PRSD_SV,"2025-05-18 22:00:33",810,654,338,316,0,651,3,900,246,186,465
37,TIMIŞ,"ŞCOALA GIMNAZIALĂ NR.30",115,"MUNICIPIUL TIMIŞOARA",155243,1,PART,PRCNCT,PRSD,PRSD_SV,"2025-05-18 21:58:42",1702,1156,907,247,2,1140,16,1800,644,267,873
37,TIMIŞ,"ŞCOALA GIMNAZIALĂ NR.30",116,"MUNICIPIUL TIMIŞOARA",155243,1,PART,PRCNCT,PRSD,PRSD_SV,"2025-05-18 21:44:25",1204,864,616,247,1,855,9,1300,436,259,596
37,TIMIŞ,"ŞCOALA GIMNAZIALĂ NR.30",117,"MUNICIPIUL TIMIŞOARA",155243,1,PART,PRCNCT,PRSD,PRSD_SV,"2025-05-18 21:58:12",1342,1000,728,272,0,985,15,1400,400,276,709
37,TIMIŞ,"ŞCOALA GIMNAZIALĂ NR.30",118,"MUNICIPIUL TIMIŞOARA",155243,1,PART,PRCNCT,PRSD,PRSD_SV,"2025-05-18 22:08:21",1621,988,815,173,0,977,11,1700,712,271,706
37,TIMIŞ,"ŞCOALA GIMNAZIALĂ NR.30",119,"MUNICIPIUL TIMIŞOARA",155243,1,PART,PRCNCT,PRSD,PRSD_SV,"2025-05-18 22:09:09",1192,915,615,299,1,905,10,1200,285,269,636
37,TIMIŞ,"UNIVERSITATEA POLITEHNICA TIMIŞOARA - CANTINA STUDENŢEASCĂ",120,"MUNICIPIUL TIMIŞOARA",155243,2,PART,PRCNCT,PRSD,PRSD_SV,"2025-05-19 00:37:54",799,1532,323,1207,2,1515,17,1900,368,288,1227
37,TIMIŞ,"UNIVERSITATEA POLITEHNICA TIMIŞOARA- CANTINA STUDENŢEASCĂ",121,"MUNICIPIUL TIMIŞOARA",155243,2,PART,PRCNCT,PRSD,PRSD_SV,"2025-05-19 01:43:35",786,1679,324,1345,10,1661,16,2000,321,279,1382
37,TIMIŞ,"LICEUL TEORETIC ”WILLIAM SHAKESPEARE” (FOSTA ŞCOALA GIMNAZIALĂ NR. 5 )",122,"MUNICIPIUL TIMIŞOARA",155243,1,PART,PRCNCT,PRSD,PRSD_SV,"2025-05-18 22:17:07",1230,741,589,132,20,732,9,1300,559,238,494
37,TIMIŞ,"LICEUL TEORETIC ”WILLIAM SHAKESPEARE” ( FOSTA ŞCOALA GIMNAZIALĂ NR. 5 )",123,"MUNICIPIUL TIMIŞOARA",155243,1,PART,PRCNCT,PRSD,PRSD_SV,"2025-05-18 22:03:32",1042,694,524,168,2,685,9,1100,406,184,501
37,TIMIŞ,"GRĂDINIŢA CU PROGRAM PRELUNGIT NR.11 TIMIȘOARA",124,"MUNICIPIUL TIMIŞOARA",155243,1,PART,PRCNCT,PRSD,PRSD_SV,"2025-05-18 21:27:31",1128,678,534,136,8,666,12,1200,522,210,456
37,TIMIŞ,"GRĂDINIŢA CU PROGRAM PRELUNGIT NR.11 TIMIȘOARA",125,"MUNICIPIUL TIMIŞOARA",155243,1,PART,PRCNCT,PRSD,PRSD_SV,"2025-05-18 21:34:09",947,662,470,183,9,657,5,1000,338,194,463
37,TIMIŞ,"LICEUL TEHNOLOGIC ”AZUR” TIMIȘOARA",126,"MUNICIPIUL TIMIŞOARA",155243,1,PART,PRCNCT,PRSD,PRSD_SV,"2025-05-18 21:45:48",1183,761,534,197,30,748,13,1300,539,235,513
37,TIMIŞ,"LICEUL TEHNOLOGIC ”AZUR” TIMIȘOARA",127,"MUNICIPIUL TIMIŞOARA",155243,1,PART,PRCNCT,PRSD,PRSD_SV,"2025-05-18 22:21:37",918,746,525,188,33,739,7,1300,554,176,563
37,TIMIŞ,"LICEUL TEHNOLOGIC ”AZUR” TIMIȘOARA",128,"MUNICIPIUL TIMIŞOARA",155243,1,PART,PRCNCT,PRSD,PRSD_SV,"2025-05-18 22:00:25",1008,641,460,149,32,634,7,1100,459,199,435
37,TIMIŞ,"LICEUL TEHNOLOGIC ”AZUR” TIMIȘOARA",129,"MUNICIPIUL TIMIŞOARA",155243,1,PART,PRCNCT,PRSD,PRSD_SV,"2025-05-18 22:12:46",1108,747,519,195,33,737,10,1200,453,209,528
37,TIMIŞ,"LICEUL TEHNOLOGIC ”AZUR” TIMIȘOARA",130,"MUNICIPIUL TIMIŞOARA",155243,1,PART,PRCNCT,PRSD,PRSD_SV,"2025-05-18 22:17:42",1258,834,607,194,33,817,17,1300,466,247,570
37,TIMIŞ,"LICEUL TEHNOLOGIC ”AZUR” TIMIȘOARA",131,"MUNICIPIUL TIMIŞOARA",155243,1,PART,PRCNCT,PRSD,PRSD_SV,"2025-05-18 21:28:46",1008,664,466,175,23,651,13,1100,436,197,454
37,TIMIŞ,"LICEUL TEORETIC ”IRIS”",132,"MUNICIPIUL TIMIŞOARA",155243,1,PART,PRCNCT,PRSD,PRSD_SV,"2025-05-18 22:15:58",1290,869,605,264,0,855,14,1400,531,262,593
37,TIMIŞ,"ŞCOALA GIMNAZIALĂ NR.25",133,"MUNICIPIUL TIMIŞOARA",155243,1,PART,PRCNCT,PRSD,PRSD_SV,"2025-05-18 21:47:54",1412,872,703,169,0,854,18,1500,628,233,621
37,TIMIŞ,"ŞCOALA GIMNAZIALĂ NR.25",134,"MUNICIPIUL TIMIŞOARA",155243,1,PART,PRCNCT,PRSD,PRSD_SV,"2025-05-18 21:39:40",1407,931,686,245,0,917,14,1700,769,235,682
37,TIMIŞ,"ŞCOALA GIMNAZIALĂ NR.25",135,"MUNICIPIUL TIMIŞOARA",155243,1,PART,PRCNCT,PRSD,PRSD_SV,"2025-05-18 22:26:15",1783,1167,1026,138,3,1155,12,1800,633,261,894
37,TIMIŞ,"ŞCOALA GIMNAZIALĂ NR.25",136,"MUNICIPIUL TIMIŞOARA",155243,1,PART,PRCNCT,PRSD,PRSD_SV,"2025-05-18 22:22:25",1538,867,817,50,0,854,13,1600,733,272,582
37,TIMIŞ,"ŞCOALA GIMNAZIALĂ NR.25",137,"MUNICIPIUL TIMIŞOARA",155243,1,PART,PRCNCT,PRSD,PRSD_SV,"2025-05-18 21:57:22",1473,1042,749,293,0,1029,13,1600,558,290,739
37,TIMIŞ,"GRĂDINIŢA CU PROGRAM PRELUNGIT NR. 11 ( GRĂDINIŢA CU PROGRAM PRELUNGIT NR.12)",138,"MUNICIPIUL TIMIŞOARA",155243,1,PART,PRCNCT,PRSD,PRSD_SV,"2025-05-18 21:43:28",703,413,324,89,0,409,4,800,387,122,287
37,TIMIŞ,"ŞCOALA GIMNAZIALĂ NR.15",139,"MUNICIPIUL TIMIŞOARA",155243,1,PART,PRCNCT,PRSD,PRSD_SV,"2025-05-18 22:13:54",1275,744,621,123,0,726,18,1400,656,256,470
37,TIMIŞ,"ŞCOALA GIMNAZIALĂ NR.15",140,"MUNICIPIUL TIMIŞOARA",155243,1,PART,PRCNCT,PRSD,PRSD_SV,"2025-05-18 22:05:35",980,659,488,171,0,654,5,1100,441,232,422
37,TIMIŞ,"ŞCOALA GIMNAZIALĂ NR.15",141,"MUNICIPIUL TIMIŞOARA",155243,1,PART,PRCNCT,PRSD,PRSD_SV,"2025-05-18 21:36:54",1193,764,648,115,1,750,14,1300,536,258,492
37,TIMIŞ,"ŞCOALA GIMNAZIALĂ NR.15",142,"MUNICIPIUL TIMIŞOARA",155243,1,PART,PRCNCT,PRSD,PRSD_SV,"2025-05-18 21:21:59",1224,603,548,55,0,594,9,1300,697,234,360
37,TIMIŞ,"S.C.” DRUMURI MUNICIPALE TIMIŞOARA ” S.A.",143,"MUNICIPIUL TIMIŞOARA",155243,1,PART,PRCNCT,PRSD,PRSD_SV,"2025-05-18 21:37:29",1593,710,635,74,1,705,5,1300,590,306,399
37,TIMIŞ,"S.C.” DRUMURI MUNICIPALE TIMIŞOARA ” S.A.",144,"MUNICIPIUL TIMIŞOARA",155243,1,PART,PRCNCT,PRSD,PRSD_SV,"2025-05-18 21:25:05",1550,722,647,75,0,715,7,1200,478,302,413
37,TIMIŞ,"GRADINIŢA CU PROGRAM PRELUNGIT NR.23",145,"MUNICIPIUL TIMIŞOARA",155243,1,PART,PRCNCT,PRSD,PRSD_SV,"2025-05-18 21:52:20",1077,705,524,181,0,700,5,1200,495,220,480
37,TIMIŞ,"ŞCOALA GIMNAZIALĂ NR.13",146,"MUNICIPIUL TIMIŞOARA",155243,1,PART,PRCNCT,PRSD,PRSD_SV,"2025-05-18 22:02:01",1093,597,485,112,0,589,8,1200,603,233,356
37,TIMIŞ,"ŞCOALA GIMNAZIALĂ NR.13",147,"MUNICIPIUL TIMIŞOARA",155243,1,PART,PRCNCT,PRSD,PRSD_SV,"2025-05-18 21:37:11",1220,815,593,222,0,805,10,1300,485,301,504
37,TIMIŞ,"ŞCOALA GIMNAZIALĂ NR.13",148,"MUNICIPIUL TIMIŞOARA",155243,1,PART,PRCNCT,PRSD,PRSD_SV,"2025-05-18 21:30:47",1091,543,492,49,2,534,9,1200,657,226,308
37,TIMIŞ,"ŞCOALA GIMNAZIALĂ NR.13",149,"MUNICIPIUL TIMIŞOARA",155243,1,PART,PRCNCT,PRSD,PRSD_SV,"2025-05-18 21:59:17",985,500,448,52,0,493,7,1100,600,181,312
37,TIMIŞ,"LICEUL TEHNOLOGIC ELECTROTIMIŞ TIMIȘOARA",150,"MUNICIPIUL TIMIŞOARA",155243,1,PART,PRCNCT,PRSD,PRSD_SV,"2025-05-18 22:01:09",1586,1166,859,307,0,1156,10,1600,434,343,813
37,TIMIŞ,"LICEUL TEHNOLOGIC ELECTROTIMIŞ TIMIȘOARA",151,"MUNICIPIUL TIMIŞOARA",155243,1,PART,PRCNCT,PRSD,PRSD_SV,"2025-05-18 22:28:29",1605,1008,809,199,0,993,15,1700,692,424,569
37,TIMIŞ,"LICEUL TEHNOLOGIC ELECTROTIMIŞ TIMIȘOARA",152,"MUNICIPIUL TIMIŞOARA",155243,1,PART,PRCNCT,PRSD,PRSD_SV,"2025-05-18 22:03:44",1564,1013,823,188,2,1000,13,1600,587,341,659
37,TIMIŞ,"LICEUL TEHNOLOGIC ELECTROTIMIŞ TIMIȘOARA",153,"MUNICIPIUL TIMIŞOARA",155243,1,PART,PRCNCT,PRSD,PRSD_SV,"2025-05-18 22:11:44",1434,906,595,310,1,901,5,1500,594,400,501
37,TIMIŞ,"LICEUL TEORETIC ”VLAD ȚEPEȘ” TIMIȘOARA",154,"MUNICIPIUL TIMIŞOARA",155243,1,PART,PRCNCT,PRSD,PRSD_SV,"2025-05-18 21:52:47",1391,1013,747,265,1,1004,9,1400,387,261,743
37,TIMIŞ,"LICEUL TEORETIC ”VLAD ȚEPEȘ” TIMIȘOARA",155,"MUNICIPIUL TIMIŞOARA",155243,1,PART,PRCNCT,PRSD,PRSD_SV,"2025-05-18 21:20:34",1104,588,461,127,0,583,5,1200,612,214,369
37,TIMIŞ,"CENTRUL ȘCOLAR PENTRU EDUCAȚIE INCLUZIVĂ ”CONSTANTIN PUFAN”",156,"MUNICIPIUL TIMIŞOARA",155243,1,PART,PRCNCT,PRSD,PRSD_SV,"2025-05-18 21:57:14",1117,794,555,239,0,788,6,1200,406,179,609
37,TIMIŞ,"ȘCOALA GIMNAZIALĂ NR.30 TIMIȘOARA",157,"MUNICIPIUL TIMIŞOARA",155243,1,PART,PRCNCT,PRSD,PRSD_SV,"2025-05-18 21:54:28",1458,992,744,248,0,982,10,1700,708,279,703
37,TIMIŞ,"ȘCOALA GIMNAZIALĂ NR.30 TIMIȘOARA",158,"MUNICIPIUL TIMIŞOARA",155243,1,PART,PRCNCT,PRSD,PRSD_SV,"2025-05-18 22:04:50",1386,800,693,107,0,791,9,1500,700,231,560
37,TIMIŞ,"ŞCOALA GIMNAZIALĂ NR.16 ” TAKE IONESCU ”",159,"MUNICIPIUL TIMIŞOARA",155243,1,PART,PRCNCT,PRSD,PRSD_SV,"2025-05-18 22:07:51",1296,858,646,142,70,842,16,1400,542,249,593
37,TIMIŞ,"ŞCOALA GIMNAZIALĂ NR.16 ” TAKE IONESCU ”",160,"MUNICIPIUL TIMIŞOARA",155243,1,PART,PRCNCT,PRSD,PRSD_SV,"2025-05-18 21:59:13",973,818,513,215,90,802,16,1200,382,234,568
37,TIMIŞ,"ŞCOALA GIMNAZIALĂ NR.16 ” TAKE IONESCU ”",161,"MUNICIPIUL TIMIŞOARA",155243,1,PART,PRCNCT,PRSD,PRSD_SV,"2025-05-18 22:18:25",881,849,461,304,84,842,7,1000,151,220,622
37,TIMIŞ,"ȘCOALA GIMNAZIALĂ NR.16 ”TAKE IONESCU”",162,"MUNICIPIUL TIMIŞOARA",155243,1,PART,PRCNCT,PRSD,PRSD_SV,"2025-05-18 21:40:24",993,746,524,140,82,734,12,1000,254,213,521
37,TIMIŞ,"LICEUL DE ARTE PLASTICE TIMIȘOARA ( FOSTUL GRUP ȘCOLAR TUDOR TĂNĂSESCU)",163,"MUNICIPIUL TIMIŞOARA",155243,1,PART,PRCNCT,PRSD,PRSD_SV,"2025-05-18 22:01:55",1521,820,742,51,27,811,9,1600,780,272,539
37,TIMIŞ,"LICEUL DE ARTE PLASTICE TIMIȘOARA ( FOSTUL GRUP ȘCOLAR TUDOR TĂNĂSESCU)",164,"MUNICIPIUL TIMIŞOARA",155243,1,PART,PRCNCT,PRSD,PRSD_SV,"2025-05-18 21:37:17",1292,617,522,72,23,608,9,1300,683,289,319
37,TIMIŞ,"LICEUL DE ARTE PLASTICE TIMIȘOARA ( FOSTUL GRUP ȘCOLAR TUDOR TĂNĂSESCU)",165,"MUNICIPIUL TIMIŞOARA",155243,1,PART,PRCNCT,PRSD,PRSD_SV,"2025-05-18 21:33:37",851,443,368,64,11,439,4,1000,557,182,257
37,TIMIŞ,"ŞCOALA GIMNAZIALĂ NR.21 ” VICENŢIU BABEŞ ”",166,"MUNICIPIUL TIMIŞOARA",155243,1,PART,PRCNCT,PRSD,PRSD_SV,"2025-05-18 21:51:26",1225,961,576,385,0,954,7,1300,339,354,600
37,TIMIŞ,"ŞCOALA GIMNAZIALĂ NR.21 ” VICENŢIU BABEŞ ”",167,"MUNICIPIUL TIMIŞOARA",155243,1,PART,PRCNCT,PRSD,PRSD_SV,"2025-05-18 22:16:29",1391,845,688,156,1,836,9,1500,655,321,515
37,TIMIŞ,"ŞCOALA GIMNAZIALĂ NR.21 ” VICENŢIU BABEŞ ”",168,"MUNICIPIUL TIMIŞOARA",155243,1,PART,PRCNCT,PRSD,PRSD_SV,"2025-05-18 21:58:42",1324,957,694,263,0,939,18,1400,443,309,630
37,TIMIŞ,"ŞCOALA GIMNAZIALĂ NR.21 ” VICENŢIU BABEŞ ”",169,"MUNICIPIUL TIMIŞOARA",155243,1,PART,PRCNCT,PRSD,PRSD_SV,"2025-05-18 22:07:34",1027,700,488,212,0,690,10,1100,400,256,434
37,TIMIŞ,"ŞCOALA GIMNAZIALĂ NR.7 ”SFÂNTA MARIA ”",170,"MUNICIPIUL TIMIŞOARA",155243,1,PART,PRCNCT,PRSD,PRSD_SV,"2025-05-18 21:54:36",1628,1192,832,359,1,1178,14,1700,508,342,836
37,TIMIŞ,"ŞCOALA GIMNAZIALĂ NR.7 ”SFÂNTA MARIA ”",171,"MUNICIPIUL TIMIŞOARA",155243,1,PART,PRCNCT,PRSD,PRSD_SV,"2025-05-18 21:41:38",1311,872,622,250,0,866,6,1500,628,327,539
37,TIMIŞ,"ŞCOALA GIMNAZIALĂ NR.7 ”SFÂNTA MARIA ”",172,"MUNICIPIUL TIMIŞOARA",155243,1,PART,PRCNCT,PRSD,PRSD_SV,"2025-05-18 22:00:36",1281,903,678,225,0,889,14,1400,497,255,634
37,TIMIŞ,"ŞCOALA GIMNAZIALĂ NR.7 ”SFÂNTA MARIA ”",173,"MUNICIPIUL TIMIŞOARA",155243,1,PART,PRCNCT,PRSD,PRSD_SV,"2025-05-18 21:34:32",1237,1007,633,374,0,989,18,1300,293,377,612
37,TIMIŞ,"ŞCOALA GIMNAZIALĂ NR.7 ”SFÂNTA MARIA ”",174,"MUNICIPIUL TIMIŞOARA",155243,1,PART,PRCNCT,PRSD,PRSD_SV,"2025-05-18 21:26:17",990,640,522,118,0,624,16,1100,460,161,463
37,TIMIŞ,"ŞCOALA GIMNAZIALĂ NR.7 ”SFÂNTA MARIA ”",175,"MUNICIPIUL TIMIŞOARA",155243,1,PART,PRCNCT,PRSD,PRSD_SV,"2025-05-18 22:19:32",1071,650,547,103,0,641,9,1224,574,221,420
37,TIMIŞ,"GRĂDINIŢA CU PROGRAM PRELUNGIT NR.20 TIMIȘOARA",176,"MUNICIPIUL TIMIŞOARA",155243,1,PART,PRCNCT,PRSD,PRSD_SV,"2025-05-18 21:48:09",1402,787,658,129,0,771,16,1500,713,256,515
37,TIMIŞ,"GRĂDINIŢA CU PROGRAM PRELUNGIT NR.20 TIMIȘOARA",177,"MUNICIPIUL TIMIŞOARA",155243,1,PART,PRCNCT,PRSD,PRSD_SV,"2025-05-18 21:47:43",1460,857,740,117,0,844,13,1500,643,271,573
37,TIMIŞ,"GRĂDINIŢA CU PROGRAM PRELUNGIT NR.20 TIMIȘOARA",178,"MUNICIPIUL TIMIŞOARA",155243,1,PART,PRCNCT,PRSD,PRSD_SV,"2025-05-18 21:20:48",1266,772,698,73,1,762,10,1300,528,222,540
37,TIMIŞ,"DIRECȚIA DE ASISTENȚĂ SOCIALĂ A MUNICIPIULUI TIMIȘOARA, COMPLEXUL DE SERVICII SOCIALE PENTRU PERSOANE VÂRSTNICE „SF. ARH. MIHAIL ȘI GAVRIL”",179,"MUNICIPIUL TIMIŞOARA",155243,3,PART,PRCNCT,PRSD,PRSD_SV,"2025-05-18 22:29:05",1214,815,596,219,0,803,12,1300,485,296,507
37,TIMIŞ,"DIRECȚIA DE ASISTENȚĂ SOCIALĂ A MUNICIPIULUI TIMIȘOARA, COMPLEXUL DE SERVICII SOCIALE PENTRU PERSOANE VÂRSTNICE „SF. ARH. MIHAIL ȘI GAVRIL”",180,"MUNICIPIUL TIMIŞOARA",155243,1,PART,PRCNCT,PRSD,PRSD_SV,"2025-05-18 21:50:20",1127,718,570,133,15,710,8,1200,482,215,495
37,TIMIŞ,"LICEUL TEHNOLOGIC ENERGETIC ”REGELE FERDINAND I” TIMIȘOARA - CĂMIN NR.1 (FOST GRUP ŞCOLAR ”TUDOR TĂNĂSESCU”)",181,"MUNICIPIUL TIMIŞOARA",155243,1,PART,PRCNCT,PRSD,PRSD_SV,"2025-05-18 21:43:36",1311,753,636,103,14,742,11,1400,647,251,491
37,TIMIŞ,"LICEUL TEHNOLOGIC ENERGETIC ”REGELE FERDINAND I” TIMIȘOARA - CĂMIN NR.1 (FOST GRUP ŞCOLAR ”TUDOR TĂNĂSESCU”)",182,"MUNICIPIUL TIMIŞOARA",155243,1,PART,PRCNCT,PRSD,PRSD_SV,"2025-05-18 21:24:07",1083,615,499,89,27,610,5,1200,585,214,396
37,TIMIŞ,"LICEUL TEHNOLOGIC ENERGETIC ”REGELE FERDINAND I” TIMIȘOARA - CĂMIN NR.1 (FOST GRUP ŞCOLAR ”TUDOR TĂNĂSESCU”)",183,"MUNICIPIUL TIMIŞOARA",155243,1,PART,PRCNCT,PRSD,PRSD_SV,"2025-05-18 21:54:51",1320,718,606,92,20,703,15,1400,682,243,460
37,TIMIŞ,"LICEUL TEHNOLOGIC ENERGETIC ”REGELE FERDINAND I” TIMIȘOARA - CĂMIN NR.1 (FOST GRUP ŞCOLAR ”TUDOR TĂNĂSESCU”)",184,"MUNICIPIUL TIMIŞOARA",155243,1,PART,PRCNCT,PRSD,PRSD_SV,"2025-05-18 21:33:30",1230,653,541,95,17,647,6,1300,647,194,453
37,TIMIŞ,"LICEUL TEORETIC ”WILLIAM SHAKESPEARE”",185,"MUNICIPIUL TIMIŞOARA",155243,1,PART,PRCNCT,PRSD,PRSD_SV,"2025-05-18 21:39:22",1222,796,619,173,4,781,15,1300,504,212,569
37,TIMIŞ,"CENTRUL ȘCOLAR PENTRU EDUCAȚIE INCLUZIVĂ ”PAUL POPESCU NEVEANU”",186,"MUNICIPIUL TIMIŞOARA",155243,1,PART,PRCNCT,PRSD,PRSD_SV,"2025-05-18 21:45:59",1071,490,432,56,2,482,8,1200,710,191,291
37,TIMIŞ,"CENTRUL ȘCOLAR PENTRU EDUCAȚIE INCLUZIVĂ ”PAUL POPESCU NEVEANU”",187,"MUNICIPIUL TIMIŞOARA",155243,1,PART,PRCNCT,PRSD,PRSD_SV,"2025-05-18 21:37:28",1100,571,522,49,0,564,7,1100,529,209,355
37,TIMIŞ,"CENTRUL ȘCOLAR PENTRU EDUCAȚIE INCLUZIVĂ ”PAUL POPESCU NEVEANU”",188,"MUNICIPIUL TIMIŞOARA",155243,1,PART,PRCNCT,PRSD,PRSD_SV,"2025-05-18 21:38:56",1075,532,434,95,3,527,5,1200,668,182,345
37,TIMIŞ,"CENTRUL ŞCOLAR PENTRU EDUCAŢIE INCLUZIVĂ ”PAUL POPESCU NEVEANU”",189,"MUNICIPIUL TIMIŞOARA",155243,1,PART,PRCNCT,PRSD,PRSD_SV,"2025-05-18 21:49:31",998,522,466,55,1,518,4,1100,578,187,331
37,TIMIŞ,"LICEUL TEORETIC ”JEAN LOUIS CALDERON ” TIMIȘOARA - CORP A",190,"MUNICIPIUL TIMIŞOARA",155243,1,PART,PRCNCT,PRSD,PRSD_SV,"2025-05-18 21:46:13",997,599,443,155,1,592,7,1100,501,196,396
37,TIMIŞ,"LICEUL TEORETIC ”JEAN LOUIS CALDERON ” TIMIȘOARA - CORP A",191,"MUNICIPIUL TIMIŞOARA",155243,1,PART,PRCNCT,PRSD,PRSD_SV,"2025-05-18 21:53:02",1094,689,546,143,0,677,12,1200,511,194,483
37,TIMIŞ,"LICEUL TEORETIC ”JEAN LOUIS CALDERON ” TIMIȘOARA - CORP A",192,"MUNICIPIUL TIMIŞOARA",155243,1,PART,PRCNCT,PRSD,PRSD_SV,"2025-05-18 21:41:58",1069,668,506,161,1,654,14,1100,432,164,490
37,TIMIŞ,"LICEUL TEORETIC ”JEAN LOUIS CALDERON ” TIMIȘOARA - CORP A",193,"MUNICIPIUL TIMIŞOARA",155243,1,PART,PRCNCT,PRSD,PRSD_SV,"2025-05-18 21:50:48",899,577,425,151,1,569,8,1000,423,141,428
37,TIMIŞ,"LICEUL TEOLOGIC PENTICOSTAL LOGOS",194,"MUNICIPIUL TIMIŞOARA",155243,1,PART,PRCNCT,PRSD,PRSD_SV,"2025-05-18 21:39:17",1265,782,641,141,0,765,17,1300,518,258,507
37,TIMIŞ,"LICEUL TEOLOGIC PENTICOSTAL LOGOS",195,"MUNICIPIUL TIMIŞOARA",155243,1,PART,PRCNCT,PRSD,PRSD_SV,"2025-05-18 21:28:02",919,483,413,70,0,477,6,1000,517,163,314
37,TIMIŞ,"LICEUL TEOLOGIC PENTICOSTAL LOGOS",196,"MUNICIPIUL TIMIŞOARA",155243,1,PART,PRCNCT,PRSD,PRSD_SV,"2025-05-18 21:30:20",1020,596,473,123,0,589,7,1100,504,223,366
37,TIMIŞ,"LICEUL TEOLOGIC PENTICOSTAL LOGOS",197,"MUNICIPIUL TIMIŞOARA",155243,1,PART,PRCNCT,PRSD,PRSD_SV,"2025-05-18 21:33:49",1111,560,497,63,0,555,5,1200,640,170,385
37,TIMIŞ,"ŞCOALA GIMNAZIALĂ NR.6 (GRADINIŢA CU PROGRAM PRELUNGIT NR. 30)",198,"MUNICIPIUL TIMIŞOARA",155243,1,PART,PRCNCT,PRSD,PRSD_SV,"2025-05-18 21:46:18",1549,757,668,84,5,748,9,1200,443,312,436
37,TIMIŞ,"ŞCOALA GIMNAZIALĂ NR.6 (GRADINIŢA CU PROGRAM PRELUNGIT NR. 30)",199,"MUNICIPIUL TIMIŞOARA",155243,1,PART,PRCNCT,PRSD,PRSD_SV,"2025-05-18 21:41:30",1572,777,692,84,1,768,9,1700,923,301,467
37,TIMIŞ,"LICEUL TEHNOLOGIC ELECTROTIMIŞ TIMIȘOARA (ŞCOALA GIMNAZIALĂ NR.20 )",200,"MUNICIPIUL TIMIŞOARA",155243,1,PART,PRCNCT,PRSD,PRSD_SV,"2025-05-18 22:09:10",1913,1640,1304,335,1,1614,26,2000,360,408,1206
37,TIMIŞ,"ŞCOALA GIMNAZIALĂ NR.1( ŞCOALA GIMNAZIALĂ NR. 4 )",201,"MUNICIPIUL TIMIŞOARA",155243,1,PART,PRCNCT,PRSD,PRSD_SV,"2025-05-18 21:35:47",1601,1025,872,97,56,1011,14,1700,675,424,587
37,TIMIŞ,"ŞCOALA GIMNAZIALĂ NR.1( ŞCOALA GIMNAZIALĂ NR. 4 )",202,"MUNICIPIUL TIMIŞOARA",155243,1,PART,PRCNCT,PRSD,PRSD_SV,"2025-05-18 21:40:33",1462,890,808,82,0,879,11,1500,610,295,584
37,TIMIŞ,"GRĂDINIŢA CU PROGRAM PRELUNGIT NR.38 ( GRĂDINIŢA CU PROGRAM PRELUNGIT NR.6 )",203,"MUNICIPIUL TIMIŞOARA",155243,1,PART,PRCNCT,PRSD,PRSD_SV,"2025-05-18 21:42:39",1265,772,712,60,0,764,8,1300,528,304,460
37,TIMIŞ,"GRĂDINIŢA CU PROGRAM PRELUNGIT NR.38 ( GRĂDINIŢA CU PROGRAM PRELUNGIT NR.6 )",204,"MUNICIPIUL TIMIŞOARA",155243,1,PART,PRCNCT,PRSD,PRSD_SV,"2025-05-18 21:29:57",1223,724,651,73,0,719,5,1300,576,288,431
37,TIMIŞ,"ȘCOALA GIMNAZIALĂ NR.1 TIMIȘOARA",205,"MUNICIPIUL TIMIŞOARA",155243,1,PART,PRCNCT,PRSD,PRSD_SV,"2025-05-18 22:01:01",1242,629,494,135,0,621,8,1300,671,287,334
37,TIMIŞ,"ȘCOALA GIMNAZIALĂ NR.1 TIMIȘOARA",206,"MUNICIPIUL TIMIŞOARA",155243,1,PART,PRCNCT,PRSD,PRSD_SV,"2025-05-18 22:08:10",969,500,446,54,0,495,5,1000,500,165,330
37,TIMIŞ,"GRĂDINIȚA CU PROGRAM PRELUNGIT NR.13 TIMIȘOARA",207,"MUNICIPIUL TIMIŞOARA",155243,1,PART,PRCNCT,PRSD,PRSD_SV,"2025-05-18 21:30:05",437,298,252,46,0,297,1,500,202,152,145
37,TIMIŞ,"COLEGIUL NAŢIONAL ”IULIA HAŞDEU”",208,"MUNICIPIUL LUGOJ",155350,1,PART,PRCNCT,PRSD,PRSD_SV,"2025-05-18 21:49:42",1098,624,498,126,0,615,9,1200,576,277,338
37,TIMIŞ,"ŞCOALA GIMNAZIALĂ NR.3",209,"MUNICIPIUL LUGOJ",155350,1,PART,PRCNCT,PRSD,PRSD_SV,"2025-05-18 21:45:37",1387,717,588,128,1,712,5,1500,783,355,357
37,TIMIŞ,"GRĂDINIŢA ”BALTA LATĂ”",210,"MUNICIPIUL LUGOJ",155350,1,PART,PRCNCT,PRSD,PRSD_SV,"2025-05-18 22:34:58",1608,747,707,39,1,732,15,1700,953,401,331
37,TIMIŞ,"GRĂDINIŢA ”BALTA LATĂ”",211,"MUNICIPIUL LUGOJ",155350,1,PART,PRCNCT,PRSD,PRSD_SV,"2025-05-18 22:29:46",1355,763,695,66,2,752,11,1400,637,426,326
37,TIMIŞ,"GRĂDINIŢA CU PROGRAM PRELUNGIT NR.4",212,"MUNICIPIUL LUGOJ",155350,1,PART,PRCNCT,PRSD,PRSD_SV,"2025-05-18 21:36:13",1156,527,470,56,1,520,7,1200,673,224,296
37,TIMIŞ,"GRĂDINIŢA CU PROGRAM PRELUNGIT NR.4",213,"MUNICIPIUL LUGOJ",155350,1,PART,PRCNCT,PRSD,PRSD_SV,"2025-05-18 21:46:54",999,490,447,43,0,487,3,1100,610,267,220
37,TIMIŞ,"GRĂDINIȚA CU PROGRAM NORMAL NR.2",214,"MUNICIPIUL LUGOJ",155350,1,PART,PRCNCT,PRSD,PRSD_SV,"2025-05-18 21:47:50",931,492,426,66,0,483,9,1000,508,228,255
37,TIMIŞ,"GRĂDINIŢA CU PROGRAM NORMAL NR.2",215,"MUNICIPIUL LUGOJ",155350,1,PART,PRCNCT,PRSD,PRSD_SV,"2025-05-18 21:57:14",1021,538,498,40,0,528,10,1200,662,240,288
37,TIMIŞ,"GRĂDINIŢA CU PROGRAM PRELUNGIT NR.5",216,"MUNICIPIUL LUGOJ",155350,1,PART,PRCNCT,PRSD,PRSD_SV,"2025-05-18 21:42:07",1234,566,522,44,0,563,3,1400,834,267,296
37,TIMIŞ,"GRĂDINIŢA CU PROGRAM PRELUNGIT NR.5",217,"MUNICIPIUL LUGOJ",155350,1,PART,PRCNCT,PRSD,PRSD_SV,"2025-05-18 21:25:52",1081,494,459,35,0,489,5,1200,706,235,254
37,TIMIŞ,"ŞCOALA GIMNAZIALĂ NR.2",218,"MUNICIPIUL LUGOJ",155350,1,PART,PRCNCT,PRSD,PRSD_SV,"2025-05-18 22:09:13",1419,677,603,74,0,672,5,1500,823,347,325
37,TIMIŞ,"IMOBIL PROPRIETATE A SOCIETĂȚII VITIDA MINERAL SRL-FOST MAGAZIN PREZENTARE",219,"MUNICIPIUL LUGOJ",155350,1,PART,PRCNCT,PRSD,PRSD_SV,"2025-05-18 21:35:01",1334,634,574,59,1,623,11,1400,766,340,283
37,TIMIŞ,"SALA SPORTURILOR ”IOAN KUNST GHERMĂNESCU”",220,"MUNICIPIUL LUGOJ",155350,1,PART,PRCNCT,PRSD,PRSD_SV,"2025-05-18 21:38:12",710,470,383,87,0,463,7,1000,530,199,264
37,TIMIŞ,"SALA SPORTURILOR ”IOAN KUNST GHERMĂNESCU”",221,"MUNICIPIUL LUGOJ",155350,1,PART,PRCNCT,PRSD,PRSD_SV,"2025-05-18 21:57:55",1298,673,586,87,0,662,11,1400,727,260,402
37,TIMIŞ,"SALA SPORTURILOR ”IOAN KUNST GHERMĂNESCU”",222,"MUNICIPIUL LUGOJ",155350,1,PART,PRCNCT,PRSD,PRSD_SV,"2025-05-18 22:20:23",1155,617,541,75,1,607,10,1200,583,231,376
37,TIMIŞ,"SALA SPORTURILOR ”IOAN KUNST GHERMĂNESCU”",223,"MUNICIPIUL LUGOJ",155350,1,PART,PRCNCT,PRSD,PRSD_SV,"2025-05-18 22:34:07",1109,542,486,55,1,533,9,1200,658,222,311
37,TIMIŞ,"ŞCOALA GIMNAZIALĂ ”EFTIMIE MURGU”",224,"MUNICIPIUL LUGOJ",155350,1,PART,PRCNCT,PRSD,PRSD_SV,"2025-05-18 22:16:00",1111,597,534,63,0,587,10,1200,603,229,358
37,TIMIŞ,"ŞCOALA GIMNAZIALĂ ”EFTIMIE MURGU”",225,"MUNICIPIUL LUGOJ",155350,1,PART,PRCNCT,PRSD,PRSD_SV,"2025-05-18 21:42:03",1157,558,506,50,2,548,10,1300,742,207,341
37,TIMIŞ,"GRĂDINIŢA CU PROGRAM NORMAL NR.13",226,"MUNICIPIUL LUGOJ",155350,1,PART,PRCNCT,PRSD,PRSD_SV,"2025-05-18 22:31:13",1527,790,720,68,2,782,8,1600,810,286,496
37,TIMIŞ,"COLEGIUL TEHNIC ”VALERIU BRANIŞTE”",227,"MUNICIPIUL LUGOJ",155350,1,PART,PRCNCT,PRSD,PRSD_SV,"2025-05-18 21:38:56",1111,698,570,79,49,689,9,1200,502,260,429
37,TIMIŞ,"GRĂDINIŢA CU PROGRAM PRELUNGIT NR.2",228,"MUNICIPIUL LUGOJ",155350,1,PART,PRCNCT,PRSD,PRSD_SV,"2025-05-18 21:29:58",1401,592,555,37,0,583,9,1500,908,252,331
37,TIMIŞ,"IMOBIL PROPRIETATE A SOCIETĂȚII BOTEȘTI S.R.L.",229,"MUNICIPIUL LUGOJ",155350,1,PART,PRCNCT,PRSD,PRSD_SV,"2025-05-18 21:35:46",1349,736,686,50,0,726,10,1400,664,262,464
37,TIMIŞ,"IMOBIL PROPRIETATE A SOCIETĂȚII RIVA INTIMA S.R.L.",230,"MUNICIPIUL LUGOJ",155350,1,PART,PRCNCT,PRSD,PRSD_SV,"2025-05-18 22:19:47",1307,684,626,57,1,670,14,1400,716,278,392
37,TIMIŞ,"IMOBIL PROPRIETATE A FUNDAȚIEI MISIUNEA PÂINEA VIEȚII",231,"MUNICIPIUL LUGOJ",155350,1,PART,PRCNCT,PRSD,PRSD_SV,"2025-05-18 21:44:05",462,263,234,29,0,262,1,700,437,187,75
37,TIMIŞ,"CINEMATOGRAFUL ”BELA LUGOSI”",232,"MUNICIPIUL LUGOJ",155350,1,PART,PRCNCT,PRSD,PRSD_SV,"2025-05-18 21:38:28",1002,543,414,129,0,540,3,1100,557,263,277
37,TIMIŞ,"SALA DE LUPTE ŞI GIMNASTICĂ ”FRANCISC HORVATH”",233,"MUNICIPIUL LUGOJ",155350,1,PART,PRCNCT,PRSD,PRSD_SV,"2025-05-18 21:41:02",983,439,384,55,0,433,6,1100,661,202,231
37,TIMIŞ,"SALA DE LUPTE ȘI GIMNASTICĂ, „FRANCISC HORVATH”",234,"MUNICIPIUL LUGOJ",155350,1,PART,PRCNCT,PRSD,PRSD_SV,"2025-05-18 21:47:02",1112,558,525,33,0,547,11,1200,642,221,326
37,TIMIŞ,"SALA SPORTURILOR ”LAVINIA MILOŞOVICI”",235,"MUNICIPIUL LUGOJ",155350,2,PART,PRCNCT,PRSD,PRSD_SV,"2025-05-19 01:44:49",1544,823,763,59,1,805,18,1600,777,406,399
37,TIMIŞ,"SALA SPORTURILOR ”LAVINIA MILOŞOVICI”",236,"MUNICIPIUL LUGOJ",155350,1,PART,PRCNCT,PRSD,PRSD_SV,"2025-05-18 21:43:56",1349,728,653,75,0,723,5,1600,872,328,395
37,TIMIŞ,"SALA SPORTURILOR ”LAVINIA MILOŞOVICI”",237,"MUNICIPIUL LUGOJ",155350,1,PART,PRCNCT,PRSD,PRSD_SV,"2025-05-18 22:30:49",1451,733,656,76,1,723,10,1500,767,304,419
37,TIMIŞ,"CĂMINUL CULTURAL MĂGURI",238,"MUNICIPIUL LUGOJ",155350,1,PART,PRCNCT,PRSD,PRSD_SV,"2025-05-18 21:55:56",756,222,202,20,0,221,1,1100,878,198,23
37,TIMIŞ,"GRĂDINIŢA CU PROGRAM NORMAL NR.5 TĂPIA",239,"MUNICIPIUL LUGOJ",155350,1,PART,PRCNCT,PRSD,PRSD_SV,"2025-05-18 21:25:38",273,135,119,16,0,133,2,300,165,75,58
37,TIMIŞ,"ŞCOALA GIMNAZIALĂ BUZIAŞ",240,"ORAŞ BUZIAŞ",155403,1,PART,PRCNCT,PRSD,PRSD_SV,"2025-05-18 21:47:46",1491,782,597,99,86,775,7,1600,818,376,399
37,TIMIŞ,"ŞCOALA GENERALĂ",241,"ORAŞ BUZIAŞ",155403,1,PART,PRCNCT,PRSD,PRSD_SV,"2025-05-18 21:59:16",1299,726,519,123,84,710,16,1600,874,362,348
37,TIMIŞ,"LICEUL TEORETIC",242,"ORAŞ BUZIAŞ",155403,1,PART,PRCNCT,PRSD,PRSD_SV,"2025-05-18 21:39:08",1743,980,696,282,2,967,13,1800,820,486,481
37,TIMIŞ,"ŞCOALA PRIMARĂ SILAGIU",243,"ORAŞ BUZIAŞ",155403,1,PART,PRCNCT,PRSD,PRSD_SV,"2025-05-18 21:50:19",619,378,316,62,0,375,3,1000,622,190,185
37,TIMIŞ,"ŞCOALA GIMNAZIALĂ BACOVA",244,"ORAŞ BUZIAŞ",155403,1,PART,PRCNCT,PRSD,PRSD_SV,"2025-05-18 21:31:47",1633,598,522,68,8,596,2,1700,1102,394,202
37,TIMIŞ,"PRIMĂRIA ORAȘULUI CIACOVA",245,"ORAŞ CIACOVA",156357,1,PART,PRCNCT,PRSD,PRSD_SV,"2025-05-18 21:35:23",1305,610,528,80,2,600,10,1600,990,293,307
37,TIMIŞ,"LICEUL TEORETIC ”ALEXANDRU MOCIONI ”CIACOVA",246,"ORAŞ CIACOVA",156357,1,PART,PRCNCT,PRSD,PRSD_SV,"2025-05-18 21:45:00",1011,439,384,40,15,435,4,1100,661,202,233
37,TIMIŞ,"ȘCOALA PRIMARĂ CEBZA",247,"ORAŞ CIACOVA",156357,1,PART,PRCNCT,PRSD,PRSD_SV,"2025-05-18 21:32:18",638,365,259,106,0,364,1,700,335,230,134
37,TIMIŞ,"ȘCOALA PRIMARĂ MACEDONIA",248,"ORAŞ CIACOVA",156357,1,PART,PRCNCT,PRSD,PRSD_SV,"2025-05-18 21:36:33",389,205,163,42,0,204,1,400,195,130,74
37,TIMIŞ,"ŞCOALA PRIMARĂ OBAD",249,"ORAŞ CIACOVA",156357,1,PART,PRCNCT,PRSD,PRSD_SV,"2025-05-18 21:30:42",535,307,286,21,0,305,2,600,293,241,64
37,TIMIŞ,"ŞCOALA PRIMARĂ PETROMAN",250,"ORAŞ CIACOVA",156357,1,PART,PRCNCT,PRSD,PRSD_SV,"2025-05-18 21:31:43",603,339,263,76,0,338,1,700,361,232,106
37,TIMIŞ,"LICEUL TEHNOLOGIC ”SFÂNTUL NICOLAE” DETA",251,"ORAŞ DETA",155458,1,PART,PRCNCT,PRSD,PRSD_SV,"2025-05-18 21:51:45",1641,730,614,106,10,723,7,1900,1170,400,323
37,TIMIŞ,"ȘCOALA GIMNAZIALĂ DETA",252,"ORAŞ DETA",155458,1,PART,PRCNCT,PRSD,PRSD_SV,"2025-05-18 21:57:11",1514,576,501,75,0,568,8,1600,1024,318,250
37,TIMIŞ,"ȘCOALA GIMNAZIALĂ DETA",253,"ORAŞ DETA",155458,1,PART,PRCNCT,PRSD,PRSD_SV,"2025-05-18 22:03:40",1572,501,469,32,0,493,8,1600,1099,254,239
37,TIMIŞ,"CENTRUL CULTURAL AL ORAȘULUI DETA",254,"ORAŞ DETA",155458,1,PART,PRCNCT,PRSD,PRSD_SV,"2025-05-18 21:52:00",1091,395,361,34,0,391,4,1200,805,223,168
37,TIMIŞ,"CĂMINUL CULTURAL OPATIŢA",255,"ORAŞ DETA",155458,1,PART,PRCNCT,PRSD,PRSD_SV,"2025-05-18 21:39:17",572,279,247,32,0,276,3,700,421,180,96
37,TIMIŞ,"LICEUL TEORETIC ”TRAIAN VUIA” FĂGET",256,"ORAŞ FĂGET",156801,1,PART,PRCNCT,PRSD,PRSD_SV,"2025-05-18 21:51:28",1661,859,718,138,3,845,14,1900,1041,412,433
37,TIMIŞ,"SC TRANSPORT MIXT FĂGEȚEANA SA",257,"ORAŞ FĂGET",156801,1,PART,PRCNCT,PRSD,PRSD_SV,"2025-05-18 21:40:07",295,194,148,36,10,187,7,400,206,88,99
37,TIMIŞ,"GRĂDINIŢA CU PROGRAM NORMAL FĂGET",258,"ORAŞ FĂGET",156801,1,PART,PRCNCT,PRSD,PRSD_SV,"2025-05-18 21:49:02",1158,670,620,47,3,665,5,1400,730,367,298
37,TIMIŞ,"ŞCOALA PRIMARĂ BĂTEȘTI,",259,"ORAŞ FĂGET",156801,1,PART,PRCNCT,PRSD,PRSD_SV,"2025-05-18 21:44:24",450,267,238,29,0,263,4,500,233,195,68
37,TIMIŞ,"FOSTA ŞCOALĂ GIMNAZIALĂ BEGHEIU MIC",260,"ORAŞ FĂGET",156801,1,PART,PRCNCT,PRSD,PRSD_SV,"2025-05-18 21:26:26",272,163,141,20,2,163,0,300,137,109,54
37,TIMIŞ,"CĂMINUL CULTURAL BICHIGI",261,"ORAŞ FĂGET",156801,1,PART,PRCNCT,PRSD,PRSD_SV,"2025-05-18 21:45:12",518,291,267,24,0,287,4,600,309,195,92
37,TIMIŞ,"CĂMINUL CULTURAL BRĂNEŞTI",262,"ORAŞ FĂGET",156801,1,PART,PRCNCT,PRSD,PRSD_SV,"2025-05-18 21:23:33",387,223,202,21,0,222,1,400,177,166,56
37,TIMIŞ,"ȘCOALA PRIMARĂ BUNEA MARE",263,"ORAŞ FĂGET",156801,1,PART,PRCNCT,PRSD,PRSD_SV,"2025-05-18 21:17:22",156,90,74,16,0,88,2,200,110,61,27
37,TIMIŞ,"ŞCOALA PRIMARĂ , COLONIA MICĂ",264,"ORAŞ FĂGET",156801,1,PART,PRCNCT,PRSD,PRSD_SV,"2025-05-18 21:23:16",360,189,174,15,0,182,7,400,211,149,33
37,TIMIŞ,"FOSTA ȘCOALĂ GENERALĂ JUPÂNEŞTI",265,"ORAŞ FĂGET",156801,1,PART,PRCNCT,PRSD,PRSD_SV,"2025-05-18 22:04:42",146,89,73,16,0,88,1,200,111,52,36
37,TIMIŞ,"CĂMINUL CULTURAL POVÂRGINA",266,"ORAŞ FĂGET",156801,1,PART,PRCNCT,PRSD,PRSD_SV,"2025-05-18 21:26:45",122,80,61,19,0,78,2,200,120,55,23
37,TIMIŞ,"CĂMINUL CULTURAL TEMEREŞTI",267,"ORAŞ FĂGET",156801,1,PART,PRCNCT,PRSD,PRSD_SV,"2025-05-18 21:37:11",408,216,188,28,0,213,3,500,284,134,79
37,TIMIŞ,"CASA DE CULTURĂ GĂTAIA",268,"ORAŞ GĂTAIA",157086,1,PART,PRCNCT,PRSD,PRSD_SV,"2025-05-18 21:47:21",1359,633,536,96,1,627,6,1500,867,346,281
37,TIMIŞ,"PRIMARIA ORAS GATAIA",269,"ORAŞ GĂTAIA",157086,1,PART,PRCNCT,PRSD,PRSD_SV,"2025-05-18 21:38:13",1306,574,475,98,1,563,11,1500,926,306,257
37,TIMIŞ,"SCOALA PRIMARA SCULIA",270,"ORAŞ GĂTAIA",157086,1,PART,PRCNCT,PRSD,PRSD_SV,"2025-05-18 21:40:36",1704,841,747,67,27,829,12,1800,959,531,298
37,TIMIŞ,"ŞCOALA PRIMARĂ BUTIN",271,"ORAŞ GĂTAIA",157086,1,PART,PRCNCT,PRSD,PRSD_SV,"2025-05-18 21:26:35",302,183,154,29,0,183,0,400,217,157,26
37,TIMIŞ,"CĂMINUL CULTURAL PERCOSOVA",272,"ORAŞ GĂTAIA",157086,1,PART,PRCNCT,PRSD,PRSD_SV,"2025-05-18 21:30:51",224,142,105,37,0,142,0,300,158,92,50
37,TIMIŞ,"SCOALA PRIMARA SEMLACU MARE",273,"ORAŞ GĂTAIA",157086,1,PART,PRCNCT,PRSD,PRSD_SV,"2025-05-18 21:23:05",250,140,103,37,0,139,1,300,160,96,43
37,TIMIŞ,"ŞCOALA PRIMARĂ ŞEMLACUL MIC",274,"ORAŞ GĂTAIA",157086,1,PART,PRCNCT,PRSD,PRSD_SV,"2025-05-18 21:26:12",138,76,48,28,0,76,0,200,124,52,24
37,TIMIŞ,"LICEUL TEHNOLOGIC JIMBOLIA",275,"ORAŞ JIMBOLIA",155494,1,PART,PRCNCT,PRSD,PRSD_SV,"2025-05-18 21:35:04",1679,615,555,60,0,609,6,1800,1185,348,261
37,TIMIŞ,"LICEUL TEHNOLOGIC JIMBOLIA",276,"ORAŞ JIMBOLIA",155494,1,PART,PRCNCT,PRSD,PRSD_SV,"2025-05-18 21:36:07",1360,491,446,34,11,487,4,1400,909,247,240
37,TIMIŞ,"ŞCOALA GIMNAZIALĂ JIMBOLIA",277,"ORAŞ JIMBOLIA",155494,1,PART,PRCNCT,PRSD,PRSD_SV,"2025-05-18 21:29:34",1624,627,591,35,1,622,5,1800,1173,320,302
37,TIMIŞ,"ŞCOALA GIMNAZIALĂ JIMBOLIA",278,"ORAŞ JIMBOLIA",155494,1,PART,PRCNCT,PRSD,PRSD_SV,"2025-05-18 21:54:18",1706,657,621,36,0,648,9,1800,1143,388,260
37,TIMIŞ,"INCUBATORUL DE AFACERI JIMBOLIA",279,"ORAŞ JIMBOLIA",155494,1,PART,PRCNCT,PRSD,PRSD_SV,"2025-05-18 21:44:47",1423,591,529,61,1,583,8,1600,1009,287,296
37,TIMIŞ,"CASA DE CULTURĂ",280,"ORAŞ JIMBOLIA",155494,1,PART,PRCNCT,PRSD,PRSD_SV,"2025-05-18 22:07:27",1551,589,545,43,1,586,3,1700,1111,284,302
37,TIMIŞ,"CASA DE CULTURĂ",281,"ORAŞ JIMBOLIA",155494,1,PART,PRCNCT,PRSD,PRSD_SV,"2025-05-18 21:50:20",1227,475,391,48,36,465,10,1400,925,272,193
37,TIMIŞ,"GRADINITA CU PROGRAM NORMAL CLARII VII",282,"ORAŞ JIMBOLIA",155494,1,PART,PRCNCT,PRSD,PRSD_SV,"2025-05-18 21:21:14",217,77,61,16,0,77,0,400,323,46,31
37,TIMIŞ,"PRIMĂRIA RECAȘ",283,"ORAŞ RECAŞ",158314,1,PART,PRCNCT,PRSD,PRSD_SV,"2025-05-18 21:40:39",1925,820,705,115,0,805,15,2200,1380,569,236
37,TIMIŞ,"GRĂDINIȚA CU P.P. RECAȘ",284,"ORAŞ RECAŞ",158314,1,PART,PRCNCT,PRSD,PRSD_SV,"2025-05-18 21:53:03",1397,617,571,46,0,612,5,1600,983,391,221
37,TIMIŞ,"LICEUL TEORETIC RECAȘ",285,"ORAŞ RECAŞ",158314,1,PART,PRCNCT,PRSD,PRSD_SV,"2025-05-18 22:27:38",1829,1010,843,167,0,997,13,2000,990,612,385
37,TIMIŞ,"ȘCOALA GIMNAZIALĂ BAZOȘ",286,"ORAŞ RECAŞ",158314,1,PART,PRCNCT,PRSD,PRSD_SV,"2025-05-18 21:51:48",838,491,365,126,0,487,4,900,409,246,241
37,TIMIŞ,"ȘCOALA PRIMARĂ HERNEACOVA",287,"ORAŞ RECAŞ",158314,1,PART,PRCNCT,PRSD,PRSD_SV,"2025-05-18 21:45:50",384,231,176,53,2,229,2,600,369,161,68
37,TIMIŞ,"ȘCOALA GIMNAZIALĂ IZVIN",288,"ORAŞ RECAŞ",158314,1,PART,PRCNCT,PRSD,PRSD_SV,"2025-05-18 22:37:11",1426,816,691,124,1,801,14,1500,684,493,308
37,TIMIŞ,"ȘCOALA PRIMARĂ PETROVASELO",289,"ORAŞ RECAŞ",158314,1,PART,PRCNCT,PRSD,PRSD_SV,"2025-05-18 21:27:30",216,147,88,59,0,145,2,300,153,78,67
37,TIMIŞ,"ȘCOALA PRIMARĂ STANCIOVA",290,"ORAŞ RECAŞ",158314,1,PART,PRCNCT,PRSD,PRSD_SV,"2025-05-18 21:18:17",309,201,138,63,0,198,3,400,199,142,56
37,TIMIŞ,"SALA CASEI DE CULTURĂ (CASTEL NAKO)ETAJ 1",291,"ORAŞ SÂNNICOLAU MARE",155528,1,PART,PRCNCT,PRSD,PRSD_SV,"2025-05-18 21:38:42",1214,616,548,67,1,611,5,1500,884,243,368
37,TIMIŞ,"SALA CASEI DE CULTURĂ (CASTEL NAKO) DEMISOL",292,"ORAŞ SÂNNICOLAU MARE",155528,1,PART,PRCNCT,PRSD,PRSD_SV,"2025-05-18 21:46:26",1523,700,645,55,0,689,11,1800,1100,312,377
37,TIMIŞ,"PRIMĂRIA ORAŞULUI SÂNNICOLAU MARE",293,"ORAŞ SÂNNICOLAU MARE",155528,1,PART,PRCNCT,PRSD,PRSD_SV,"2025-05-18 22:02:23",1781,985,887,98,0,979,6,2000,1015,452,527
37,TIMIŞ,"GRĂDINIŢA PP1 NR.1 PARTER, SÂNNICOLAU MARE",294,"ORAŞ SÂNNICOLAU MARE",155528,1,PART,PRCNCT,PRSD,PRSD_SV,"2025-05-18 21:52:46",1949,943,858,83,2,927,16,2200,1257,522,405
37,TIMIŞ,"GRĂDINIŢA PP1 NR.1 ETAJ, SÂNNICOLAU MARE",295,"ORAŞ SÂNNICOLAU MARE",155528,1,PART,PRCNCT,PRSD,PRSD_SV,"2025-05-18 21:41:09",1460,659,640,19,0,650,9,1700,1041,275,375
37,TIMIŞ,"LICEUL TEHNOLOGIC CRISTOFOR NAKO ORAŞ SÂNNICOLAU MARE",296,"ORAŞ SÂNNICOLAU MARE",155528,1,PART,PRCNCT,PRSD,PRSD_SV,"2025-05-18 21:56:13",1771,792,649,122,21,787,5,2000,1208,421,366
37,TIMIŞ,"ŞCOALA GIMNAZIALA THEODOR BUCURESCU NR.1, SÂNNICOLAU MARE, PARTER",297,"ORAŞ SÂNNICOLAU MARE",155528,1,PART,PRCNCT,PRSD,PRSD_SV,"2025-05-18 21:43:06",1761,968,784,123,61,954,14,2000,1032,478,476
37,TIMIŞ,"CĂMINUL CULTURAL BALINŢ",298,BALINŢ,155546,1,PART,PRCNCT,PRSD,PRSD_SV,"2025-05-18 21:47:48",402,272,170,95,7,270,2,500,228,140,130
37,TIMIŞ,"GRADINITA PN BODO",299,BALINŢ,155546,1,PART,PRCNCT,PRSD,PRSD_SV,"2025-05-18 21:28:56",436,281,192,81,8,275,6,600,319,90,185
37,TIMIŞ,"ŞCOALA PRIMARĂ FĂDIMAC",300,BALINŢ,155546,1,PART,PRCNCT,PRSD,PRSD_SV,"2025-05-18 21:21:53",182,142,99,43,0,142,0,300,158,63,79
37,TIMIŞ,"ŞCOALA PRIMARĂ TÂRGOVIŞTE",301,BALINŢ,155546,1,PART,PRCNCT,PRSD,PRSD_SV,"2025-05-18 21:34:20",254,167,134,29,4,165,2,300,133,88,77
37,TIMIŞ,"PRIMĂRIA BANLOC",302,BANLOC,155591,1,PART,PRCNCT,PRSD,PRSD_SV,"2025-05-18 21:49:40",1323,549,474,73,2,539,10,1500,951,329,210
37,TIMIŞ,"GRĂDINIŢA CU PROGRAM NORMAL OFSENIŢA",303,BANLOC,155591,1,PART,PRCNCT,PRSD,PRSD_SV,"2025-05-18 21:26:48",314,106,89,17,0,104,2,400,294,83,21
37,TIMIŞ,"GRĂDINIŢA CU PROGRAM NORMAL PARTOŞ",304,BANLOC,155591,1,PART,PRCNCT,PRSD,PRSD_SV,"2025-05-18 21:20:01",377,177,129,48,0,174,3,500,323,111,63
37,TIMIŞ,"GRĂDINIŢA CU PROGRAM NORMAL SOCA",305,BANLOC,155591,1,PART,PRCNCT,PRSD,PRSD_SV,"2025-05-18 21:17:43",447,199,172,27,0,197,2,500,301,147,50
37,TIMIŞ,"PRIMARIA BARA",306,BARA,155662,1,PART,PRCNCT,PRSD,PRSD_SV,"2025-05-18 21:40:41",147,101,68,33,0,99,2,400,299,74,25
37,TIMIŞ,"CLĂDIREA COMUNEI BARA ( FOSTA SCOALĂ DOBRESTI)",307,BARA,155662,1,PART,PRCNCT,PRSD,PRSD_SV,"2025-05-18 21:24:48",36,83,15,68,0,81,2,200,117,61,20
37,TIMIŞ,"CĂMINUL CULTURAL LĂPUŞNIC",308,BARA,155662,1,PART,PRCNCT,PRSD,PRSD_SV,"2025-05-18 21:22:50",52,57,25,32,0,56,1,100,43,38,18
37,TIMIŞ,"CĂMINUL CULTURAL RĂDMĂNEŞTI",309,BARA,155662,1,PART,PRCNCT,PRSD,PRSD_SV,"2025-05-18 21:13:11",43,43,16,27,0,42,1,100,57,21,21
37,TIMIŞ,"CĂMINUL CULTURAL BÂRNA",310,BÂRNA,155957,1,PART,PRCNCT,PRSD,PRSD_SV,"2025-05-18 21:29:33",416,172,143,29,0,169,3,700,528,129,40
37,TIMIŞ,"CĂMINUL CULTURAL BOTINEŞTI",311,BÂRNA,155957,1,PART,PRCNCT,PRSD,PRSD_SV,"2025-05-18 21:23:04",144,90,69,21,0,90,0,200,110,58,32
37,TIMIŞ,"CĂMINUL CULTURAL DRINOVA",312,BÂRNA,155957,1,PART,PRCNCT,PRSD,PRSD_SV,"2025-05-18 21:27:44",141,118,93,25,0,117,1,202,84,66,51
37,TIMIŞ,"CĂMINUL CULTURAL JUREŞTI",313,BÂRNA,155957,1,PART,PRCNCT,PRSD,PRSD_SV,"2025-05-18 21:26:13",177,112,83,29,0,111,1,200,88,63,48
37,TIMIŞ,"CĂMINUL CULTURAL POGĂNEŞTI",314,BÂRNA,155957,1,PART,PRCNCT,PRSD,PRSD_SV,"2025-05-18 21:28:30",269,141,125,16,0,140,1,300,159,107,33
37,TIMIŞ,"PRIMĂRIA COMUNEI BEBA VECHE",315,"BEBA VECHE",155724,1,PART,PRCNCT,PRSD,PRSD_SV,"2025-05-18 21:42:36",809,360,322,38,0,358,2,1000,640,212,146
37,TIMIŞ,"CĂMINUL CULTURAL CHEREŞTUR",316,"BEBA VECHE",155724,1,PART,PRCNCT,PRSD,PRSD_SV,"2025-05-18 21:24:38",397,219,197,22,0,215,4,500,281,132,83
37,TIMIŞ,"GRĂDINIŢA CU PROGRAM PRELUNGIT BECICHERECU MIC",317,"BECICHERECU MIC",155760,1,PART,PRCNCT,PRSD,PRSD_SV,"2025-05-18 21:36:15",1591,961,765,191,5,950,11,1800,839,500,450
37,TIMIŞ,"BIBLIOTECA LOCALĂ ”DIMITRIE ŢICHINDEAL” BECICHERECU MIC",318,"BECICHERECU MIC",155760,1,PART,PRCNCT,PRSD,PRSD_SV,"2025-05-18 21:44:40",1171,627,507,120,0,615,12,1400,773,294,321
37,TIMIŞ,"PRIMĂRIA BELINŢ",319,BELINŢ,155797,1,PART,PRCNCT,PRSD,PRSD_SV,"2025-05-18 21:56:04",1100,670,535,135,0,662,8,1300,630,395,267
37,TIMIŞ,"CĂMIN CULTURAL BABȘA",320,BELINŢ,155797,1,PART,PRCNCT,PRSD,PRSD_SV,"2025-05-18 21:38:24",169,125,85,40,0,124,1,200,75,56,68
37,TIMIŞ,"GRADINITA CU PROGRAM NORMAL CHIZATAU",321,BELINŢ,155797,1,PART,PRCNCT,PRSD,PRSD_SV,"2025-05-18 21:38:28",591,364,283,81,0,363,1,700,336,192,171
37,TIMIŞ,"GRADINITA CU PROGRAM NORMAL BABSA-GRUNI",322,BELINŢ,155797,1,PART,PRCNCT,PRSD,PRSD_SV,"2025-05-18 21:36:59",186,140,97,43,0,139,1,300,160,85,54
37,TIMIŞ,"PRIMĂRIA BETHAUSEN",323,BETHAUSEN,155840,1,PART,PRCNCT,PRSD,PRSD_SV,"2025-05-18 21:23:24",742,361,317,44,0,357,4,1000,639,259,98
37,TIMIŞ,"ȘCOALA PRIMARĂ CLADOVA ȘI GRĂDINIȚA CU PROGRAM NORMAL CLADOVA",324,BETHAUSEN,155840,1,PART,PRCNCT,PRSD,PRSD_SV,"2025-05-18 21:17:55",374,199,181,18,0,195,4,400,201,157,38
37,TIMIŞ,"CĂMINUL CULTURAL CLICIOVA",325,BETHAUSEN,155840,1,PART,PRCNCT,PRSD,PRSD_SV,"2025-05-18 21:30:56",350,200,159,41,0,198,2,400,200,150,48
37,TIMIŞ,"ŞCOALA PRIMARĂ CUTINA",326,BETHAUSEN,155840,1,PART,PRCNCT,PRSD,PRSD_SV,"2025-05-18 21:38:17",234,165,126,38,1,164,1,300,135,120,44
37,TIMIŞ,"ŞCOALA PRIMARĂ LEUCUŞEŞTI",327,BETHAUSEN,155840,1,PART,PRCNCT,PRSD,PRSD_SV,"2025-05-18 21:36:41",379,217,184,31,2,215,2,400,183,129,86
37,TIMIŞ,"CĂMINUL CULTURAL NEVRINCEA",328,BETHAUSEN,155840,1,PART,PRCNCT,PRSD,PRSD_SV,"2025-05-18 21:23:44",190,92,69,22,1,91,1,300,208,51,40
37,TIMIŞ,"CAMINUL CULTURAL BILED",329,BILED,155911,2,PART,PRCNCT,PRSD,PRSD_SV,"2025-05-19 00:51:42",1948,933,827,101,5,916,16,2100,1167,468,448
37,TIMIŞ,"ȘCOALA GIMNAZIALĂ COMUNA BILED",330,BILED,155911,1,PART,PRCNCT,PRSD,PRSD_SV,"2025-05-18 22:14:35",1512,660,597,53,10,653,7,1700,1040,332,321
37,TIMIŞ,"ŞCOALA GIMNAZIALĂ BIRDA",331,BIRDA,159366,1,PART,PRCNCT,PRSD,PRSD_SV,"2025-05-18 21:55:40",913,486,412,59,15,481,5,1100,614,246,235
37,TIMIŞ,"CĂMINUL CULTURAL BERECUŢA",332,BIRDA,159366,1,PART,PRCNCT,PRSD,PRSD_SV,"2025-05-18 21:17:25",160,109,89,20,0,109,0,300,191,81,28
37,TIMIŞ,"CĂMINUL CULTURAL MÂNĂSTIRE",333,BIRDA,159366,1,PART,PRCNCT,PRSD,PRSD_SV,"2025-05-18 21:28:48",171,125,88,29,8,124,1,200,75,72,52
37,TIMIŞ,"ŞCOALA PRIMARĂ SÂNGEORGE",334,BIRDA,159366,1,PART,PRCNCT,PRSD,PRSD_SV,"2025-05-18 21:23:39",462,251,205,38,8,251,0,500,249,157,94
37,TIMIŞ,"SEDIUL PRIMĂRIEI BOGDA",335,BOGDA,156035,1,PART,PRCNCT,PRSD,PRSD_SV,"2025-05-18 21:40:31",266,176,108,66,2,171,5,400,224,91,80
37,TIMIŞ,"CASA DE CULTURĂ BUZAD",336,BOGDA,156035,1,PART,PRCNCT,PRSD,PRSD_SV,"2025-05-18 21:39:21",169,142,72,62,8,139,3,300,158,55,84
37,TIMIŞ,"ŞCOALA GIMNAZIALĂ BOLDUR",337,BOLDUR,156106,1,PART,PRCNCT,PRSD,PRSD_SV,"2025-05-18 21:44:13",498,347,288,59,0,345,2,600,253,153,192
37,TIMIŞ,"ŞCOALA PRIMARĂ JABĂR",338,BOLDUR,156106,1,PART,PRCNCT,PRSD,PRSD_SV,"2025-05-18 21:40:40",339,220,169,50,1,217,3,500,280,117,100
37,TIMIŞ,"ŞCOALA PRIMARĂ OHABA-FORGACI",339,BOLDUR,156106,1,PART,PRCNCT,PRSD,PRSD_SV,"2025-05-18 22:17:41",642,416,343,71,2,414,2,700,284,215,199
37,TIMIŞ,"ŞCOALA PRIMARĂ SINERSIG",340,BOLDUR,156106,1,PART,PRCNCT,PRSD,PRSD_SV,"2025-05-18 21:55:34",509,317,257,60,0,310,7,700,383,184,126
37,TIMIŞ,"PRIMĂRIA BRESTOVĂŢ",341,BRESTOVĂŢ,156151,1,PART,PRCNCT,PRSD,PRSD_SV,"2025-05-18 21:20:13",209,147,89,58,0,145,2,400,253,98,47
37,TIMIŞ,"CLĂDIREA COMUNEI BRESTOVĂŢ (FOSTA ŞCOALĂ GENERALĂ COŞARII)",342,BRESTOVĂŢ,156151,1,PART,PRCNCT,PRSD,PRSD_SV,"2025-05-18 21:14:05",126,94,64,30,0,92,2,200,106,57,35
37,TIMIŞ,"CĂMINUL CULTURAL TEŞ",343,BRESTOVĂŢ,156151,1,PART,PRCNCT,PRSD,PRSD_SV,"2025-05-18 21:13:09",226,152,110,42,0,150,2,300,148,88,62
37,TIMIŞ,"CĂMINUL CULTURAL BUCOVĂŢ",344,BUCOVĂŢ,159516,1,PART,PRCNCT,PRSD,PRSD_SV,"2025-05-18 22:49:54",1885,1480,1107,373,0,1463,17,2000,520,659,804
37,TIMIŞ,"CĂMINUL CULTURAL BAZOŞU NOU",345,BUCOVĂŢ,159516,1,PART,PRCNCT,PRSD,PRSD_SV,"2025-05-18 21:42:04",555,449,353,96,0,444,5,800,351,196,248
37,TIMIŞ,"PRIMĂRIA COMUNEI CĂRPINIŞ",346,CĂRPINIŞ,156213,1,PART,PRCNCT,PRSD,PRSD_SV,"2025-05-18 21:48:48",1774,695,639,56,0,689,6,2000,1305,418,271
37,TIMIŞ,"CĂMINUL CULTURAL CĂRPINIŞ",347,CĂRPINIŞ,156213,1,PART,PRCNCT,PRSD,PRSD_SV,"2025-05-18 22:03:11",1784,726,649,75,2,714,12,2000,1274,426,288
37,TIMIŞ,"CĂMINUL CULTURAL IECEA MICĂ",348,CĂRPINIŞ,156213,1,PART,PRCNCT,PRSD,PRSD_SV,"2025-05-18 21:33:08",994,391,340,51,0,387,4,1100,709,257,130
37,TIMIŞ,"ŞCOALA GIMNAZIALĂ CENAD",349,CENAD,156259,1,PART,PRCNCT,PRSD,PRSD_SV,"2025-05-18 21:42:45",1977,675,596,78,1,665,10,2200,1525,437,228
37,TIMIŞ,"ŞCOALA GIMNAZIALĂ CENAD",350,CENAD,156259,1,PART,PRCNCT,PRSD,PRSD_SV,"2025-05-18 21:37:22",1857,625,552,70,3,624,1,1900,1275,406,218
37,TIMIŞ,"SEDIUL PRIMĂRIEI CENEI",351,CENEI,156277,1,PART,PRCNCT,PRSD,PRSD_SV,"2025-05-18 21:49:13",1775,862,709,144,9,855,7,2000,1138,566,289
37,TIMIŞ,"ŞCOALA PRIMARĂ BOBDA",352,CENEI,156277,1,PART,PRCNCT,PRSD,PRSD_SV,"2025-05-18 21:48:49",750,444,353,88,3,442,2,900,456,289,153
37,TIMIŞ,"CĂMINUL CULTURAL CHECEA",353,CHECEA,159375,1,PART,PRCNCT,PRSD,PRSD_SV,"2025-05-18 21:53:58",1781,717,643,74,0,703,14,2000,1283,466,237
37,TIMIŞ,"ȘCOALA GIMNAZIALĂ CHEVEREȘU MARE",354,"CHEVEREŞU MARE",156311,1,PART,PRCNCT,PRSD,PRSD_SV,"2025-05-18 21:38:04",1167,524,417,105,2,523,1,1400,876,347,176
37,TIMIŞ,"ŞCOALA PRIMARĂ DRAGŞINA",355,"CHEVEREŞU MARE",156311,1,PART,PRCNCT,PRSD,PRSD_SV,"2025-05-18 21:27:43",567,383,262,121,0,379,4,700,317,198,181
37,TIMIŞ,"ŞCOALA PRIMARĂ VUCOVA",356,"CHEVEREŞU MARE",156311,1,PART,PRCNCT,PRSD,PRSD_SV,"2025-05-18 21:30:59",344,232,156,75,1,229,3,500,268,113,116
37,TIMIŞ,"ŞCOALA GIMNAZIALĂ COMLOŞU MARE",357,"COMLOŞU MARE",156437,1,PART,PRCNCT,PRSD,PRSD_SV,"2025-05-18 21:41:09",1451,623,535,42,46,604,19,1708,1085,402,202
37,TIMIŞ,"CĂMINUL CULTURAL COMLOŞU MARE",358,"COMLOŞU MARE",156437,1,PART,PRCNCT,PRSD,PRSD_SV,"2025-05-18 21:48:33",1527,589,517,72,0,581,8,1800,1211,423,158
37,TIMIŞ,"ŞCOALA PRIMARĂ COMLOŞU MIC",359,"COMLOŞU MARE",156437,1,PART,PRCNCT,PRSD,PRSD_SV,"2025-05-18 21:36:10",871,364,325,39,0,358,6,900,536,266,92
37,TIMIŞ,"ŞCOALA PRIMARĂ LUNGA",360,"COMLOŞU MARE",156437,1,PART,PRCNCT,PRSD,PRSD_SV,"2025-05-18 21:31:20",460,185,157,28,0,185,0,700,515,118,67
37,TIMIŞ,"CĂMINUL CULTURAL COŞTEIU",361,COŞTEIU,156473,1,PART,PRCNCT,PRSD,PRSD_SV,"2025-05-18 21:34:57",667,404,332,71,1,401,3,900,496,231,170
37,TIMIŞ,"PRIMĂRIA VECHECOŞTEIU",362,COŞTEIU,156473,1,PART,PRCNCT,PRSD,PRSD_SV,"2025-05-18 21:51:52",1192,586,523,63,0,580,6,1300,714,347,233
37,TIMIŞ,"ŞCOALA PRIMARĂ HEZERIȘ",363,COŞTEIU,156473,1,PART,PRCNCT,PRSD,PRSD_SV,"2025-05-18 21:29:38",223,112,93,19,0,111,1,400,288,74,37
37,TIMIŞ,"CĂMINUL CULTURAL PĂRU",364,COŞTEIU,156473,1,PART,PRCNCT,PRSD,PRSD_SV,"2025-05-18 21:22:26",208,132,93,39,0,131,1,300,168,75,56
37,TIMIŞ,"CĂMINUL CULTURAL ŢIPARI",365,COŞTEIU,156473,1,PART,PRCNCT,PRSD,PRSD_SV,"2025-05-18 21:20:51",743,380,324,56,0,377,3,800,420,219,158
37,TIMIŞ,"CĂMINUL CULTURAL VALEA LUNGĂ ROMÂNĂ",366,COŞTEIU,156473,1,PART,PRCNCT,PRSD,PRSD_SV,"2025-05-18 21:18:33",122,73,47,26,0,73,0,200,127,48,25
37,TIMIŞ,"CĂMINUL CULTURAL CRICIOVA",367,CRICIOVA,156534,1,PART,PRCNCT,PRSD,PRSD_SV,"2025-05-18 21:33:09",619,376,335,41,0,368,8,800,424,233,135
37,TIMIŞ,"CĂMINUL CULTURAL CIREŞU",368,CRICIOVA,156534,1,PART,PRCNCT,PRSD,PRSD_SV,"2025-05-18 21:46:46",276,161,131,30,0,160,1,400,239,106,54
37,TIMIŞ,"CĂMINUL CULTURAL JDIOARA",369,CRICIOVA,156534,1,PART,PRCNCT,PRSD,PRSD_SV,"2025-05-18 21:35:30",446,267,233,34,0,260,7,600,333,156,104
37,TIMIŞ,"CĂMINUL CULTURAL CURTEA",370,CURTEA,156589,1,PART,PRCNCT,PRSD,PRSD_SV,"2025-05-18 21:20:15",547,351,305,46,0,343,8,700,349,230,113
37,TIMIŞ,"CĂMINUL CULTURAL COŞAVA",371,CURTEA,156589,1,PART,PRCNCT,PRSD,PRSD_SV,"2025-05-18 21:39:04",466,305,207,98,0,300,5,600,295,200,100
37,TIMIŞ,"SCOALA GIMNAZIALA COMUNA DAROVA",372,DAROVA,156623,1,PART,PRCNCT,PRSD,PRSD_SV,"2025-05-18 21:32:44",1779,666,624,40,2,661,5,1900,1234,476,185
37,TIMIŞ,"GRADINITA PN",373,DAROVA,156623,1,PART,PRCNCT,PRSD,PRSD_SV,"2025-05-18 21:19:37",295,173,152,19,2,172,1,300,127,103,69
37,TIMIŞ,"SCOALA PRIMARA",374,DAROVA,156623,1,PART,PRCNCT,PRSD,PRSD_SV,"2025-05-18 21:42:32",663,379,310,66,3,377,2,800,421,250,127
37,TIMIŞ,"SCOALA GIMNAZIALA DENTA",375,DENTA,156669,1,PART,PRCNCT,PRSD,PRSD_SV,"2025-05-18 21:44:06",1008,505,435,70,0,502,3,1100,595,322,180
37,TIMIŞ,"SCOALA GIMNAZIALA DENTA",376,DENTA,156669,1,PART,PRCNCT,PRSD,PRSD_SV,"2025-05-18 21:28:25",993,408,375,29,4,404,4,1000,592,280,124
37,TIMIŞ,"CLĂDIRE ADMINISTRATIVĂ ȘI SOCIAL CULTURALĂ",377,DENTA,156669,1,PART,PRCNCT,PRSD,PRSD_SV,"2025-05-18 21:30:05",396,213,162,51,0,211,2,500,287,89,122
37,TIMIŞ,"CĂMINUL CULTURAL ROVINIŢA MARE",378,DENTA,156669,1,PART,PRCNCT,PRSD,PRSD_SV,"2025-05-18 21:36:46",325,204,169,35,0,203,1,500,296,124,79
37,TIMIŞ,"GRĂDINIȚA CU PROGRAM PRELUNGIT DUDEȘTII NOI",379,"DUDEŞTII NOI",159384,1,PART,PRCNCT,PRSD,PRSD_SV,"2025-05-18 22:08:29",1519,772,649,123,0,761,11,1700,928,419,342
37,TIMIŞ,"GRĂDINIȚA CU PROGRAM PRELUNGIT DUDEȘTII NOI",380,"DUDEŞTII NOI",159384,2,PART,PRCNCT,PRSD,PRSD_SV,"2025-05-18 23:32:00",1641,791,702,89,0,789,2,1800,1009,410,379
37,TIMIŞ,"LICEUL TEORETIC ”SFINȚII KIRIL ȘI METODII” DUDEȘTII VECHI",381,"DUDEŞTII VECHI",156712,1,PART,PRCNCT,PRSD,PRSD_SV,"2025-05-18 21:54:05",1572,809,718,90,1,802,7,1700,891,392,410
37,TIMIŞ,"CONSILIUL LOCAL DUDEŞTII VECHI",382,"DUDEŞTII VECHI",156712,1,PART,PRCNCT,PRSD,PRSD_SV,"2025-05-18 21:49:23",1456,691,599,90,2,681,10,1600,909,334,347
37,TIMIŞ,"CLĂDIRE ADMINISTRATIVĂ",383,"DUDEŞTII VECHI",156712,1,PART,PRCNCT,PRSD,PRSD_SV,"2025-05-18 21:29:40",530,238,196,41,1,238,0,700,462,145,93
37,TIMIŞ,"SEDIUL PRIMARIEI DUMBRAVA",384,DUMBRAVA,156767,1,PART,PRCNCT,PRSD,PRSD_SV,"2025-05-18 22:00:50",937,481,405,74,2,478,3,1100,619,268,210
37,TIMIŞ,"CĂMIN CULTURAL BUCOVĂȚ",385,DUMBRAVA,156767,1,PART,PRCNCT,PRSD,PRSD_SV,"2025-05-18 21:23:00",395,234,203,31,0,232,2,500,266,162,70
37,TIMIŞ,"ŞCOALA GIMNAZIALĂ RĂCHITA",386,DUMBRAVA,156767,1,PART,PRCNCT,PRSD,PRSD_SV,"2025-05-18 22:01:07",909,459,410,49,0,454,5,1100,641,347,107
37,TIMIŞ,"ŞCOALA GIMNAZIALĂ DUMBRĂVIŢA",387,DUMBRĂVIŢA,155261,1,PART,PRCNCT,PRSD,PRSD_SV,"2025-05-18 22:04:38",1774,1321,1163,158,0,1309,12,1800,479,260,1049
37,TIMIŞ,"ŞCOALA GIMNAZIALĂ DUMBRĂVIŢA",388,DUMBRĂVIŢA,155261,1,PART,PRCNCT,PRSD,PRSD_SV,"2025-05-18 22:04:00",1654,1216,1007,209,0,1207,9,1700,484,252,955
37,TIMIŞ,"ŞCOALA GIMNAZIALĂ DUMBRĂVIŢA",389,DUMBRĂVIŢA,155261,1,PART,PRCNCT,PRSD,PRSD_SV,"2025-05-18 22:25:45",1690,1438,1149,289,0,1428,10,1800,362,312,1116
37,TIMIŞ,"ŞCOALA GIMNAZIALĂ DUMBRĂVIŢA",390,DUMBRĂVIŢA,155261,1,PART,PRCNCT,PRSD,PRSD_SV,"2025-05-18 21:54:35",1784,1661,1116,543,2,1641,20,1800,139,394,1247
37,TIMIŞ,"ŞCOALA GIMNAZIALĂ DUMBRĂVIŢA",391,DUMBRĂVIŢA,155261,1,PART,PRCNCT,PRSD,PRSD_SV,"2025-05-18 21:54:21",1750,1430,1055,373,2,1414,16,1800,370,271,1143
37,TIMIŞ,"ȘCOALA GIMNAZIALĂ DUMBRĂVIŢA",392,DUMBRĂVIŢA,155261,1,PART,PRCNCT,PRSD,PRSD_SV,"2025-05-18 22:10:24",1755,1232,1054,176,2,1219,13,1800,568,239,980
37,TIMIŞ,"ȘCOALA GIMNAZIALĂ DUMBRĂVIŢA",393,DUMBRĂVIŢA,155261,1,PART,PRCNCT,PRSD,PRSD_SV,"2025-05-18 23:28:10",1790,1511,1138,373,0,1490,21,1800,289,335,1155
37,TIMIŞ,"ȘCOALA GIMNAZIALĂ DUMBRĂVIȚA",394,DUMBRĂVIŢA,155261,1,PART,PRCNCT,PRSD,PRSD_SV,"2025-05-18 23:32:45",1728,1149,1001,145,3,1133,16,2000,851,262,871
37,TIMIŞ,"ȘCOALA GIMNAZIALĂ DUMBRĂVIȚA",395,DUMBRĂVIŢA,155261,2,PART,PRCNCT,PRSD,PRSD_SV,"2025-05-19 00:28:38",1752,1230,1116,114,0,1216,14,2000,770,235,981
37,TIMIŞ,"ŞCOALA GIMNAZIALĂ DUMBRĂVIŢA",396,DUMBRĂVIŢA,155261,1,PART,PRCNCT,PRSD,PRSD_SV,"2025-05-18 21:54:18",1793,1539,1115,420,4,1522,17,1800,261,333,1189
37,TIMIŞ,"CENTRUL DE INFORMARE TURISTICĂ",397,FÂRDEA,156927,1,PART,PRCNCT,PRSD,PRSD_SV,"2025-05-18 21:26:42",559,407,289,111,7,404,3,700,293,265,139
37,TIMIŞ,"CĂMINUL CULTURAL DRĂGSINEŞTI",398,FÂRDEA,156927,2,PART,PRCNCT,PRSD,PRSD_SV,"2025-05-19 01:13:17",380,233,200,33,0,229,4,500,267,144,85
37,TIMIŞ,"CĂMINUL CULTURAL GLADNA ROMÂNĂ",399,FÂRDEA,156927,1,PART,PRCNCT,PRSD,PRSD_SV,"2025-05-18 21:34:50",441,260,217,40,3,257,3,600,340,149,108
37,TIMIŞ,"CĂMINUL CULTURAL FIBIŞ",400,FIBIŞ,159393,1,PART,PRCNCT,PRSD,PRSD_SV,"2025-05-18 21:25:16",1467,850,676,154,20,844,6,1500,650,504,340
37,TIMIŞ,"ŞCOALA GIMNAZIALĂ FOENI",401,FOENI,157004,1,PART,PRCNCT,PRSD,PRSD_SV,"2025-05-18 21:44:16",984,612,484,128,0,609,3,1100,488,329,280
37,TIMIŞ,"PRIMĂRIA VECHE CRUCENI",402,FOENI,157004,1,PART,PRCNCT,PRSD,PRSD_SV,"2025-05-18 21:29:26",469,266,207,59,0,262,4,500,234,175,87
37,TIMIŞ,"CĂMINUL CULTURAL GĂVOJDIA",403,GAVOJDIA,157031,1,PART,PRCNCT,PRSD,PRSD_SV,"2025-05-18 21:29:21",1084,532,444,88,0,529,3,1300,768,312,217
37,TIMIŞ,"CĂMINUL CULTURAL JENA",404,GAVOJDIA,157031,1,PART,PRCNCT,PRSD,PRSD_SV,"2025-05-18 21:20:02",398,257,195,61,1,255,2,500,243,157,98
37,TIMIŞ,"CAMIN CULTURAL LUGOJEL",405,GAVOJDIA,157031,1,PART,PRCNCT,PRSD,PRSD_SV,"2025-05-18 21:27:26",638,392,319,73,0,390,2,800,408,228,162
37,TIMIŞ,"CĂMINUL CULTURAL SĂLBĂGEL",406,GAVOJDIA,157031,1,PART,PRCNCT,PRSD,PRSD_SV,"2025-05-18 21:22:37",231,151,122,29,0,149,2,300,149,104,45
37,TIMIŞ,"ŞCOALA GIMNAZIALA GHILAD",407,GHILAD,159400,1,PART,PRCNCT,PRSD,PRSD_SV,"2025-05-19 00:25:45",1627,715,637,78,0,708,7,1700,985,439,269
37,TIMIŞ,"CĂMINUL CULTURAL GAD",408,GHILAD,159400,1,PART,PRCNCT,PRSD,PRSD_SV,"2025-05-18 21:49:19",122,94,48,46,0,94,0,200,106,58,36
37,TIMIŞ,"ŞCOALA GIMNAZIALĂ GHIRODA",409,GHIRODA,155289,1,PART,PRCNCT,PRSD,PRSD_SV,"2025-05-18 21:45:44",1243,904,755,149,0,891,13,1300,396,305,586
37,TIMIŞ,"ŞCOALA GIMNAZIALĂ GHIRODA",410,GHIRODA,155289,2,PART,PRCNCT,PRSD,PRSD_SV,"2025-05-19 00:28:51",1334,1053,715,336,2,1042,11,1400,347,364,678
37,TIMIŞ,"CĂMINUL CULTURAL GHIRODA",411,GHIRODA,155289,1,PART,PRCNCT,PRSD,PRSD_SV,"2025-05-18 22:15:28",1767,1344,1067,275,2,1328,16,1800,456,464,864
37,TIMIŞ,"ȘCOALA GIMNAZIALǍ GHIRODA",412,GHIRODA,155289,1,PART,PRCNCT,PRSD,PRSD_SV,"2025-05-18 21:45:23",1379,1028,803,225,0,1008,20,1400,372,358,650
37,TIMIŞ,"CĂMINUL CULTURAL GIARMATA - VII",413,GHIRODA,155289,1,PART,PRCNCT,PRSD,PRSD_SV,"2025-05-18 21:53:36",916,810,576,234,0,798,12,1000,190,274,524
37,TIMIŞ,"CǍMINUL CULTURAL GIARMATA VII",414,GHIRODA,155289,1,PART,PRCNCT,PRSD,PRSD_SV,"2025-05-18 22:33:14",1164,904,741,163,0,884,20,1300,396,314,570
37,TIMIŞ,"SEDIUL PRIMARIEI GHIZELA",415,GHIZELA,157193,1,PART,PRCNCT,PRSD,PRSD_SV,"2025-05-18 21:33:24",408,228,175,41,12,227,1,600,372,105,122
37,TIMIŞ,"CĂMINUL CULTURAL PANIOVA",416,GHIZELA,157193,1,PART,PRCNCT,PRSD,PRSD_SV,"2025-05-18 21:31:33",202,117,74,42,1,116,1,301,184,75,41
37,TIMIŞ,"CASA NATIONALĂ ”NICOLAE URSU” ŞANOVIŢA",417,GHIZELA,157193,1,PART,PRCNCT,PRSD,PRSD_SV,"2025-05-18 21:31:57",384,232,179,51,2,231,1,400,168,149,82
37,TIMIŞ,"GRĂDINIȚA CU PROGRAM PRELUNGIT GIARMATA",418,GIARMATA,157246,1,PART,PRCNCT,PRSD,PRSD_SV,"2025-05-18 22:26:56",1722,847,732,114,1,839,8,1900,1053,426,413
37,TIMIŞ,"ȘCOALA GIMNAZIALĂ GIARMATA",419,GIARMATA,157246,1,PART,PRCNCT,PRSD,PRSD_SV,"2025-05-18 22:09:08",1820,1007,844,163,0,994,13,1900,893,482,512
37,TIMIŞ,"CASA DE CULTURĂ",420,GIARMATA,157246,1,PART,PRCNCT,PRSD,PRSD_SV,"2025-05-18 22:09:51",1711,1052,853,199,0,1036,16,1800,748,473,563
37,TIMIŞ,"ŞCOALA PRIMARĂ CERNETEAZ",421,GIARMATA,157246,1,PART,PRCNCT,PRSD,PRSD_SV,"2025-05-18 22:22:10",1303,707,553,154,0,703,4,1400,693,427,276
37,TIMIŞ,"SEDIUL PRIMARIEI GIERA",422,GIERA,157273,1,PART,PRCNCT,PRSD,PRSD_SV,"2025-05-18 21:30:19",627,231,200,30,1,229,2,800,569,147,82
37,TIMIŞ,"GRADINITA CU PROGRAM NORMAL GRĂNICERII",423,GIERA,157273,1,PART,PRCNCT,PRSD,PRSD_SV,"2025-05-18 21:17:04",196,77,60,17,0,76,1,300,223,54,22
37,TIMIŞ,"GRADINITA CU PROGRAM NORMAL TOAGER",424,GIERA,157273,1,PART,PRCNCT,PRSD,PRSD_SV,"2025-05-18 21:28:50",304,150,120,30,0,149,1,400,250,102,47
37,TIMIŞ,"LICEUL TEORETIC ”DAVID VONIGA”",425,GIROC,155314,1,PART,PRCNCT,PRSD,PRSD_SV,"2025-05-18 22:12:28",1919,1516,1132,384,0,1506,10,2000,484,394,1112
37,TIMIŞ,"LICEUL TEORETIC ”DAVID VONIGA”",426,GIROC,155314,1,PART,PRCNCT,PRSD,PRSD_SV,"2025-05-18 21:53:47",2020,1580,1085,495,0,1560,20,2000,420,423,1137
37,TIMIŞ,"LICEUL TEORETIC ”DAVID VONIGA”",427,GIROC,155314,1,PART,PRCNCT,PRSD,PRSD_SV,"2025-05-18 23:07:04",2048,1446,1148,297,1,1431,15,2100,654,363,1068
37,TIMIŞ,"CĂMINUL CULTURAL GIROC",428,GIROC,155314,1,PART,PRCNCT,PRSD,PRSD_SV,"2025-05-18 23:02:13",1683,1426,1000,424,2,1403,23,1800,374,492,911
37,TIMIŞ,"CĂMINUL CULTURAL GIROC",429,GIROC,155314,1,PART,PRCNCT,PRSD,PRSD_SV,"2025-05-18 22:37:56",1801,1473,1088,385,0,1459,14,2000,527,424,1035
37,TIMIŞ,"LICEUL TEORETIC ”DAVID VONIGA” GIROC",430,GIROC,155314,1,PART,PRCNCT,PRSD,PRSD_SV,"2025-05-18 22:14:04",1435,1186,863,323,0,1173,13,1500,314,369,804
37,TIMIŞ,"LICEUL TEORETIC ”DAVID VONIGA” GIROC",431,GIROC,155314,1,PART,PRCNCT,PRSD,PRSD_SV,"2025-05-18 21:43:17",1565,1280,1028,251,1,1269,11,1600,320,391,878
37,TIMIŞ,"LICEUL TEORETIC DAVID VONIGA GIROC",432,GIROC,155314,1,PART,PRCNCT,PRSD,PRSD_SV,"2025-05-18 21:34:09",1423,1136,787,349,0,1122,14,1600,464,375,747
37,TIMIŞ,"ANEXA ADMINISTRATIVĂ A FOSTEI UNITĂȚI MILITARE - GIROC",433,GIROC,155314,1,PART,PRCNCT,PRSD,PRSD_SV,"2025-05-18 22:00:30",1867,1592,1067,524,1,1572,19,2000,409,458,1114
37,TIMIŞ,"ANEXA ADMINISTRATIVĂ A FOSTEI UNITĂȚI MILITARE - GIROC",434,GIROC,155314,1,PART,PRCNCT,PRSD,PRSD_SV,"2025-05-18 22:09:24",1910,1591,1171,418,2,1565,26,2000,409,328,1237
37,TIMIŞ,"ȘCOALA GENERALĂ ”IOSIF CIOROGARIU”",435,GIROC,155314,1,PART,PRCNCT,PRSD,PRSD_SV,"2025-05-18 21:32:54",1306,949,758,191,0,929,20,1400,451,308,621
37,TIMIŞ,"ŞCOALA GIMNAZIALĂ ”IOSIF CIOROGARIU” ,CHIȘODA",436,GIROC,155314,1,PART,PRCNCT,PRSD,PRSD_SV,"2025-05-18 21:50:41",1360,1016,857,157,2,1002,14,1700,684,337,665
37,TIMIŞ,"ŞCOALA GIMNAZIALĂ ”IOSIF CIOROGARIU” ,CHIȘODA",437,GIROC,155314,1,PART,PRCNCT,PRSD,PRSD_SV,"2025-05-18 22:20:03",1475,1104,900,203,1,1088,16,1600,496,372,716
37,TIMIŞ,"PRIMĂRIA COMUNEI GIULVĂZ",438,GIULVĂZ,157317,1,PART,PRCNCT,PRSD,PRSD_SV,"2025-05-18 21:43:38",1076,509,424,85,0,505,4,1200,691,303,202
37,TIMIŞ,"CĂMIN CULTURAL CRAI NOU",439,GIULVĂZ,157317,1,PART,PRCNCT,PRSD,PRSD_SV,"2025-05-18 21:34:45",342,218,151,67,0,218,0,400,182,144,74
37,TIMIŞ,"CĂMIN CULTURAL IVANDA",440,GIULVĂZ,157317,2,PART,PRCNCT,PRSD,PRSD_SV,"2025-05-18 23:57:35",500,261,201,60,0,260,1,600,339,179,81
37,TIMIŞ,"CĂMIN CULTURAL RUDNA",441,GIULVĂZ,157317,1,PART,PRCNCT,PRSD,PRSD_SV,"2025-05-18 21:41:55",592,289,220,69,0,287,2,600,311,218,69
37,TIMIŞ,"CLĂDIREA COMUNEI GOTTLOB (SALA DE ŞEDINŢE)",442,GOTTLOB,159419,1,PART,PRCNCT,PRSD,PRSD_SV,"2025-05-18 21:50:03",1816,650,594,56,0,645,5,2000,1350,403,242
37,TIMIŞ,"GRĂDINIŢA CU PROGRAM NORMAL VIZEJDIA",443,GOTTLOB,159419,1,PART,PRCNCT,PRSD,PRSD_SV,"2025-05-18 21:28:47",368,122,98,24,0,121,1,500,378,80,41
37,TIMIŞ,"PRIMARIA IECEA MARE",444,"IECEA MARE",159428,1,PART,PRCNCT,PRSD,PRSD_SV,"2025-05-18 22:23:18",1152,464,410,48,6,457,7,1300,836,329,128
37,TIMIŞ,"ȘCOALA GIMNAZIALĂ CLASELE V-VIII",445,"IECEA MARE",159428,1,PART,PRCNCT,PRSD,PRSD_SV,"2025-05-18 21:49:29",1204,458,417,41,0,449,9,1300,842,310,139
37,TIMIŞ,"PRIMARIA JAMU MARE",446,"JAMU MARE",157362,1,PART,PRCNCT,PRSD,PRSD_SV,"2025-05-18 21:42:12",1148,494,435,59,0,490,4,1300,806,348,142
37,TIMIŞ,"ŞCOALA PRIMARA CLOPODIA",447,"JAMU MARE",157362,1,PART,PRCNCT,PRSD,PRSD_SV,"2025-05-18 21:30:12",544,238,195,43,0,236,2,600,362,160,76
37,TIMIŞ,"ŞCOALA PRIMARA FERENDIA",448,"JAMU MARE",157362,1,PART,PRCNCT,PRSD,PRSD_SV,"2025-05-18 21:28:47",302,182,117,65,0,181,1,400,218,127,54
37,TIMIŞ,"CĂMINUL CULTURAL GHERMAN",449,"JAMU MARE",157362,1,PART,PRCNCT,PRSD,PRSD_SV,"2025-05-18 21:22:12",193,135,94,41,0,134,1,200,65,79,55
37,TIMIŞ,"CLADIREA COMUNEI JAMU MARE (FOSTA ŞCOALA LĂŢUNAŞ)",450,"JAMU MARE",157362,1,PART,PRCNCT,PRSD,PRSD_SV,"2025-05-18 21:26:10",179,135,82,53,0,135,0,200,65,82,53
37,TIMIŞ,"CASA NATIONALA EFTA BOTOCA",451,JEBEL,157424,2,PART,PRCNCT,PRSD,PRSD_SV,"2025-05-19 01:49:58",1511,927,700,180,47,921,6,1700,773,533,388
37,TIMIŞ,"GRADINITA PN JEBEL",452,JEBEL,157424,1,PART,PRCNCT,PRSD,PRSD_SV,"2025-05-18 22:24:53",1612,842,684,116,42,827,15,1700,858,521,306
37,TIMIŞ,"CĂMINUL CULTURAL LENAUHEIM",453,LENAUHEIM,157451,1,PART,PRCNCT,PRSD,PRSD_SV,"2025-05-18 21:46:40",1546,636,564,72,0,626,10,1700,1064,418,208
37,TIMIŞ,"CĂMINUL CULTURAL BULGĂRUŞ",454,LENAUHEIM,157451,1,PART,PRCNCT,PRSD,PRSD_SV,"2025-05-18 21:53:36",1815,724,653,70,1,713,11,1900,1176,470,243
37,TIMIŞ,"CĂMINUL CULTURAL GRABAŢ",455,LENAUHEIM,157451,1,PART,PRCNCT,PRSD,PRSD_SV,"2025-05-18 21:46:55",1710,578,544,34,0,576,2,1800,1222,426,150
37,TIMIŞ,"CĂMINUL CULTURAL LIEBLING",456,LIEBLING,157497,1,PART,PRCNCT,PRSD,PRSD_SV,"2025-05-18 22:20:10",1510,676,611,65,0,668,8,1700,1024,449,219
37,TIMIŞ,"ȘCOALA GIMNAZIALĂ LIEBLING",457,LIEBLING,157497,1,PART,PRCNCT,PRSD,PRSD_SV,"2025-05-18 21:40:28",1298,648,581,67,0,646,2,1400,752,427,219
37,TIMIŞ,"CLADIREA FOSTEI PRIMARII DIN CERNA",458,LIEBLING,157497,1,PART,PRCNCT,PRSD,PRSD_SV,"2025-05-18 21:18:53",198,148,68,80,0,146,2,300,152,87,59
37,TIMIŞ,"CĂMINUL CULTURAL SATUL IOSIF",459,LIEBLING,157497,1,PART,PRCNCT,PRSD,PRSD_SV,"2025-05-18 21:24:27",322,209,162,47,0,209,0,400,191,127,82
37,TIMIŞ,"PRIMARIA COMUNEI LIVEZILE",460,LIVEZILE,159491,1,PART,PRCNCT,PRSD,PRSD_SV,"2025-05-18 21:49:39",878,414,351,61,2,405,9,1000,586,262,143
37,TIMIŞ,"ŞCOALA PRIMARA DOLAŢ",461,LIVEZILE,159491,1,PART,PRCNCT,PRSD,PRSD_SV,"2025-05-18 21:24:01",426,165,133,32,0,163,2,600,435,127,36
37,TIMIŞ,"CASA DE CULTURĂ LOVRIN",462,LOVRIN,157530,1,PART,PRCNCT,PRSD,PRSD_SV,"2025-05-18 21:36:54",1584,609,538,71,0,603,6,1700,1091,342,261
37,TIMIŞ,"BAZĂ DE AGREMENT ȘI TRATAMENT (ȘTRAND TERMAL)",463,LOVRIN,157530,1,PART,PRCNCT,PRSD,PRSD_SV,"2025-05-18 21:38:16",1732,693,620,73,0,687,6,1900,1207,398,289
37,TIMIŞ,"CĂMINUL CULTURAL MARGINA",464,MARGINA,157585,1,PART,PRCNCT,PRSD,PRSD_SV,"2025-05-18 21:47:19",929,754,424,330,0,747,7,1200,446,531,216
37,TIMIŞ,"CĂMINUL CULTURAL BREAZOVA",465,MARGINA,157585,1,PART,PRCNCT,PRSD,PRSD_SV,"2025-05-18 21:26:41",214,154,126,26,2,150,4,300,146,106,44
37,TIMIŞ,"CĂMINUL CULTURAL COŞTEIU DE SUS",466,MARGINA,157585,1,PART,PRCNCT,PRSD,PRSD_SV,"2025-05-18 21:24:07",156,112,71,40,1,108,4,200,88,75,33
37,TIMIŞ,"CĂMINUL CULTURAL GROŞI",467,MARGINA,157585,1,PART,PRCNCT,PRSD,PRSD_SV,"2025-05-18 21:23:45",74,57,28,29,0,56,1,100,43,37,19
37,TIMIŞ,"CĂMINUL CULTURAL SINTEŞTI",468,MARGINA,157585,1,PART,PRCNCT,PRSD,PRSD_SV,"2025-05-18 21:40:03",419,255,209,46,0,253,2,500,245,148,105
37,TIMIŞ,"PRIMĂRIA MAŞLOC",469,MAŞLOC,157683,1,PART,PRCNCT,PRSD,PRSD_SV,"2025-05-18 21:39:24",855,382,322,55,5,378,4,900,518,299,79
37,TIMIŞ,"CĂMINUL CULTURAL ALIOȘ",470,MAŞLOC,157683,1,PART,PRCNCT,PRSD,PRSD_SV,"2025-05-18 21:37:40",679,418,294,110,14,418,0,700,282,279,139
37,TIMIŞ,"CĂMINUL CULTURAL REMETEA MICĂ",471,MAŞLOC,157683,1,PART,PRCNCT,PRSD,PRSD_SV,"2025-05-18 21:24:47",425,235,190,45,0,235,0,500,265,149,86
37,TIMIŞ,"ŞCOALA GIMNAZIALĂ - ”GEORGE GÂRDA” MĂNĂŞTIUR (BIBLIOTECA)",472,MĂNĂŞTIUR,157736,1,PART,PRCNCT,PRSD,PRSD_SV,"2025-05-18 21:48:20",960,484,438,43,3,479,5,1000,516,315,164
37,TIMIŞ,"CLĂDIREA COMUNEI MĂNĂŞTIUR (FOSTA ŞCOALĂ GENERALĂ PĂDURANI)",473,MĂNĂŞTIUR,157736,1,PART,PRCNCT,PRSD,PRSD_SV,"2025-05-18 21:16:18",53,42,19,23,0,42,0,100,58,25,17
37,TIMIŞ,"GRĂDINIȚA CU PROGRAM NORMAL REMETEA-LUNCĂ",474,MĂNĂŞTIUR,157736,1,PART,PRCNCT,PRSD,PRSD_SV,"2025-05-18 21:40:56",330,207,179,28,0,206,1,500,293,168,38
37,TIMIŞ,"CASA NATIONALA DE CULTURA MORAVIŢA",475,MORAVIŢA,157781,1,PART,PRCNCT,PRSD,PRSD_SV,"2025-05-18 21:50:17",995,467,317,150,0,464,3,1100,633,293,171
37,TIMIŞ,"CASA NAŢIONALĂ DEJAN",476,MORAVIŢA,157781,1,PART,PRCNCT,PRSD,PRSD_SV,"2025-05-18 21:21:00",219,135,102,33,0,135,0,300,165,97,38
37,TIMIŞ,"CASA NAȚIONALĂ GAIU MIC",477,MORAVIŢA,157781,1,PART,PRCNCT,PRSD,PRSD_SV,"2025-05-18 21:22:39",138,84,50,34,0,84,0,200,116,61,23
37,TIMIŞ,"ŞCOALA PRIMARA STAMORA GERMANĂ",478,MORAVIŢA,157781,1,PART,PRCNCT,PRSD,PRSD_SV,"2025-05-18 21:27:36",868,337,299,38,0,335,2,900,563,227,108
37,TIMIŞ,"ȘCOALA GIMNAZIALĂ MOȘNIȚA NOUĂ",479,"MOŞNIŢA NOUĂ",157834,1,PART,PRCNCT,PRSD,PRSD_SV,"2025-05-18 22:26:48",1569,1289,914,372,3,1273,16,1800,511,408,865
37,TIMIŞ,"ȘCOALA GIMNAZIALĂ MOȘNIȚA NOUĂ",480,"MOŞNIŢA NOUĂ",157834,1,PART,PRCNCT,PRSD,PRSD_SV,"2025-05-18 22:43:23",1912,1664,1307,357,0,1644,20,1900,236,415,1229
37,TIMIŞ,"ȘCOALA GIMNAZIALĂ COMUNA MOȘNIȚA NOUĂ",481,"MOŞNIŢA NOUĂ",157834,1,PART,PRCNCT,PRSD,PRSD_SV,"2025-05-18 22:42:05",1522,1296,942,350,4,1281,15,1700,404,331,950
37,TIMIŞ,"ȘCOALA GIMNAZIALĂ COMUNA MOȘNIȚA NOUĂ",482,"MOŞNIŢA NOUĂ",157834,1,PART,PRCNCT,PRSD,PRSD_SV,"2025-05-18 22:11:22",1561,1458,1098,357,3,1445,13,1600,142,359,1086
37,TIMIŞ,"CLĂDIREA COMUNEI MOȘNIȚA NOUĂ FOSTA ȘCOALĂ PRIMARĂ ALBINA",483,"MOŞNIŢA NOUĂ",157834,1,PART,PRCNCT,PRSD,PRSD_SV,"2025-05-18 21:36:05",416,375,260,115,0,374,1,500,125,149,225
37,TIMIŞ,"ŞCOALA PRIMARĂ MOŞNIŢA VECHE",484,"MOŞNIŢA NOUĂ",157834,1,PART,PRCNCT,PRSD,PRSD_SV,"2025-05-18 21:48:40",1791,1299,1001,298,0,1281,18,1900,601,532,749
37,TIMIŞ,"ŞCOALA PRIMARĂ MOŞNIŢA VECHE",485,"MOŞNIŢA NOUĂ",157834,1,PART,PRCNCT,PRSD,PRSD_SV,"2025-05-18 23:13:59",1926,1784,1330,454,0,1769,15,1901,117,463,1306
37,TIMIŞ,"ȘCOALA PRIMARĂ MOȘNIȚA VECHE",486,"MOŞNIŢA NOUĂ",157834,1,PART,PRCNCT,PRSD,PRSD_SV,"2025-05-18 22:31:16",2061,1709,1485,222,2,1701,8,2100,391,297,1404
37,TIMIŞ,"ŞCOALA PRIMARĂ URSENI",487,"MOŞNIŢA NOUĂ",157834,1,PART,PRCNCT,PRSD,PRSD_SV,"2025-05-18 22:10:00",1390,1108,903,203,2,1101,7,1400,292,319,782
37,TIMIŞ,"ȘCOALA PRIMARĂ URSENI",488,"MOŞNIŢA NOUĂ",157834,1,PART,PRCNCT,PRSD,PRSD_SV,"2025-05-18 22:25:19",1171,942,697,240,5,934,8,1200,258,370,564
37,TIMIŞ,"PRIMĂRIA COMUNEI NĂDRAG",489,NĂDRAG,157898,1,PART,PRCNCT,PRSD,PRSD_SV,"2025-05-18 21:33:44",1021,499,453,45,1,495,4,1100,601,267,228
37,TIMIŞ,"LICEUL TEHNOLOGIC ”TRAIAN GROZĂVESCU” NĂDRAG",490,NĂDRAG,157898,1,PART,PRCNCT,PRSD,PRSD_SV,"2025-05-18 21:37:31",1022,490,463,26,1,486,4,1100,610,319,167
37,TIMIŞ,"CĂMINUL CULTURAL CRIVINA",491,NĂDRAG,157898,1,PART,PRCNCT,PRSD,PRSD_SV,"2025-05-18 21:32:27",227,157,134,23,0,153,4,300,143,104,49
37,TIMIŞ,"CĂMINUL CULTURAL NIȚCHIDORF",492,NIŢCHIDORF,157923,1,PART,PRCNCT,PRSD,PRSD_SV,"2025-05-18 21:28:16",1104,518,448,68,2,512,6,1200,682,300,212
37,TIMIŞ,"CASA NAŢIONALĂ BLAJOVA",493,NIŢCHIDORF,157923,1,PART,PRCNCT,PRSD,PRSD_SV,"2025-05-18 21:21:15",101,86,55,31,0,85,1,200,114,46,39
37,TIMIŞ,"CLADIREA COMUNEI NITCHIDORF(FOSTA SCOALA CU CLASELE I - IV)",494,NIŢCHIDORF,157923,1,PART,PRCNCT,PRSD,PRSD_SV,"2025-05-18 21:40:06",171,131,83,47,1,127,4,300,169,75,52
37,TIMIŞ,"CĂMINUL CULTURAL OHABA LUNGĂ",495,"OHABA LUNGĂ",157969,1,PART,PRCNCT,PRSD,PRSD_SV,"2025-05-18 21:23:56",294,182,143,36,3,180,2,400,218,106,74
37,TIMIŞ,"CĂMINUL CULTURAL DUBEŞTI",496,"OHABA LUNGĂ",157969,1,PART,PRCNCT,PRSD,PRSD_SV,"2025-05-18 21:14:02",187,101,87,14,0,100,1,200,99,62,38
37,TIMIŞ,"CĂMINUL CULTURAL IERŞNIC",497,"OHABA LUNGĂ",157969,1,PART,PRCNCT,PRSD,PRSD_SV,"2025-05-18 21:20:25",113,121,77,38,6,119,2,200,79,81,38
37,TIMIŞ,"CĂMINUL CULTURAL OHABA ROMÂNĂ",498,"OHABA LUNGĂ",157969,1,PART,PRCNCT,PRSD,PRSD_SV,"2025-05-18 21:15:25",166,100,74,23,3,99,1,200,100,60,39
37,TIMIŞ,"ȘCOALA PRIMARĂ ORȚIȘOARA",499,ORŢIŞOARA,158010,1,PART,PRCNCT,PRSD,PRSD_SV,"2025-05-18 21:29:57",1157,574,484,90,0,564,10,1200,626,332,232
37,TIMIŞ,"BIBLIOTECA COMUNALĂ ORȚIȘOARA",500,ORŢIŞOARA,158010,1,PART,PRCNCT,PRSD,PRSD_SV,"2025-05-18 21:19:50",989,585,458,127,0,578,7,1000,415,359,219
37,TIMIŞ,"ŞCOALA PRIMARĂ CĂLACEA",501,ORŢIŞOARA,158010,1,PART,PRCNCT,PRSD,PRSD_SV,"2025-05-18 21:30:01",642,358,286,71,1,356,2,700,342,217,139
37,TIMIŞ,"ŞCOALA PRIMARĂ CORNEŞTI",502,ORŢIŞOARA,158010,1,PART,PRCNCT,PRSD,PRSD_SV,"2025-05-18 21:51:19",595,413,305,106,2,408,5,600,187,192,216
37,TIMIŞ,"CĂMINUL CULTURAL SECEANI",503,ORŢIŞOARA,158010,3,PART,PRCNCT,PRSD,PRSD_SV,"2025-05-19 00:19:59",501,329,244,85,0,323,6,600,271,168,155
37,TIMIŞ,"ȘCOALA GIMNAZIALĂ OTELEC",504,OTELEC,159525,1,PART,PRCNCT,PRSD,PRSD_SV,"2025-05-18 21:28:17",652,318,262,51,5,315,3,692,374,114,201
37,TIMIŞ,"GRĂDINIȚA CU PROGRAM NORMAL IOHANISFELD",505,OTELEC,159525,1,PART,PRCNCT,PRSD,PRSD_SV,"2025-05-18 21:36:38",870,318,285,33,0,317,1,900,582,171,146
37,TIMIŞ,"ȘCOALA GIMNAZIALĂ PARȚA",506,PARŢA,159437,1,PART,PRCNCT,PRSD,PRSD_SV,"2025-05-18 21:56:12",1112,675,564,111,0,670,5,1200,525,341,329
37,TIMIŞ,"ȘCOALA GIMNAZIALĂ PARȚA",507,PARŢA,159437,1,PART,PRCNCT,PRSD,PRSD_SV,"2025-05-18 21:35:31",1073,664,541,121,2,654,10,1100,436,352,302
37,TIMIŞ,"CASA NAȚIONALĂ PĂDURENI",508,PĂDURENI,159446,2,PART,PRCNCT,PRSD,PRSD_SV,"2025-05-19 01:26:13",1794,1113,900,213,0,1107,6,1896,783,720,387
37,TIMIŞ,"LICEUL TEORETIC PECIU NOU",509,"PECIU NOU",158065,1,PART,PRCNCT,PRSD,PRSD_SV,"2025-05-18 21:41:46",1445,627,549,78,0,624,3,1500,873,355,269
37,TIMIŞ,"CĂMINUL CULTURAL PECIU NOU",510,"PECIU NOU",158065,1,PART,PRCNCT,PRSD,PRSD_SV,"2025-05-18 22:00:12",1615,950,765,185,0,940,10,1700,750,495,445
37,TIMIŞ,"CĂMINUL CULTURAL DINIAȘ",511,"PECIU NOU",158065,1,PART,PRCNCT,PRSD,PRSD_SV,"2025-05-18 21:30:21",982,549,453,96,0,544,5,1000,451,351,193
37,TIMIŞ,"ŞCOALA PRIMARĂ SÂNMARTINU SÂRBESC",512,"PECIU NOU",158065,1,PART,PRCNCT,PRSD,PRSD_SV,"2025-05-18 21:58:16",821,423,313,110,0,416,7,1000,577,266,150
37,TIMIŞ,"LICEUL TEORETIC PERIAM",513,PERIAM,158109,1,PART,PRCNCT,PRSD,PRSD_SV,"2025-05-18 21:58:41",1502,683,625,57,1,673,10,1600,917,436,237
37,TIMIŞ,"LICEUL TEORETIC PERIAM",514,PERIAM,158109,1,PART,PRCNCT,PRSD,PRSD_SV,"2025-05-18 21:48:19",1575,763,709,54,0,749,14,1800,1037,397,352
37,TIMIŞ,"CASA DE CULTURĂ",515,PERIAM,158109,1,PART,PRCNCT,PRSD,PRSD_SV,"2025-05-18 21:57:58",1049,367,326,40,1,363,4,1100,733,215,148
37,TIMIŞ,"BIBLIOTECA COMUNALĂ PESAC",516,PESAC,159507,1,PART,PRCNCT,PRSD,PRSD_SV,"2025-05-18 21:35:26",877,412,363,43,6,410,2,1000,588,260,150
37,TIMIŞ,"ȘCOALA GIMNAZIALĂ „MARIA BRINDEA”",517,PESAC,159507,1,PART,PRCNCT,PRSD,PRSD_SV,"2025-05-18 22:01:29",956,415,369,45,1,407,8,1100,685,334,73
37,TIMIŞ,"GRĂDINIȚA CU PROGRAM NORMAL PIETROASA",518,PIETROASA,158136,1,PART,PRCNCT,PRSD,PRSD_SV,"2025-05-18 21:29:45",267,185,167,18,0,183,2,300,115,106,77
37,TIMIŞ,"GRĂDINIȚA CU PROGRAM NORMAL CRIVINA DE SUS",519,PIETROASA,158136,1,PART,PRCNCT,PRSD,PRSD_SV,"2025-05-18 21:34:19",165,112,91,21,0,103,9,200,88,85,18
37,TIMIŞ,"ȘCOALA PRIMARĂ FĂRĂŞEŞTI",520,PIETROASA,158136,1,PART,PRCNCT,PRSD,PRSD_SV,"2025-05-18 21:19:32",190,121,105,16,0,120,1,201,80,84,36
37,TIMIŞ,"ȘCOALA PRIMARĂ POIENI",521,PIETROASA,158136,1,PART,PRCNCT,PRSD,PRSD_SV,"2025-05-18 21:39:16",224,169,144,25,0,165,4,300,131,127,38
37,TIMIŞ,"ȘCOALA GIMNAZIALĂ PIŞCHIA",522,PIŞCHIA,158181,1,PART,PRCNCT,PRSD,PRSD_SV,"2025-05-18 21:55:32",1152,611,491,119,1,600,11,1200,589,317,283
37,TIMIŞ,"CĂMINUL CULTURAL BENCECU DE JOS",523,PIŞCHIA,158181,1,PART,PRCNCT,PRSD,PRSD_SV,"2025-05-18 21:38:51",324,230,172,53,5,228,2,400,170,134,94
37,TIMIŞ,"ȘCOALA GIMNAZIALĂ BENCECU DE SUS",524,PIŞCHIA,158181,1,PART,PRCNCT,PRSD,PRSD_SV,"2025-05-18 21:25:22",746,448,357,90,1,446,2,800,352,312,134
37,TIMIŞ,"CĂMINUL CULTURAL MURANI",525,PIŞCHIA,158181,1,PART,PRCNCT,PRSD,PRSD_SV,"2025-05-18 21:38:10",502,326,237,89,0,317,9,600,274,187,130
37,TIMIŞ,"ŞCOALA GIMNAZIALĂ RACOVIŢA",526,RACOVIŢA,158243,1,PART,PRCNCT,PRSD,PRSD_SV,"2025-05-18 21:55:07",626,380,287,93,0,376,4,800,420,239,137
37,TIMIŞ,"ŞCOALA PRIMARĂ CĂPĂT",527,RACOVIŢA,158243,1,PART,PRCNCT,PRSD,PRSD_SV,"2025-05-18 21:26:13",185,141,96,43,2,140,1,200,59,94,46
37,TIMIŞ,"ŞCOALA PRIMARĂ DRĂGOIEȘTI",528,RACOVIŢA,158243,1,PART,PRCNCT,PRSD,PRSD_SV,"2025-05-18 21:52:20",349,190,142,48,0,187,3,400,210,124,63
37,TIMIŞ,"ŞCOALA PRIMARĂ FICĂTAR",529,RACOVIŢA,158243,1,PART,PRCNCT,PRSD,PRSD_SV,"2025-05-18 21:22:18",316,168,118,50,0,165,3,400,232,117,48
37,TIMIŞ,"ŞCOALA GIMNAZIALĂ HITIAŞ",530,RACOVIŢA,158243,1,PART,PRCNCT,PRSD,PRSD_SV,"2025-05-18 21:56:51",674,408,339,69,0,401,7,700,292,211,190
37,TIMIŞ,"ŞCOALA PRIMARĂ SÂRBOVA",531,RACOVIŢA,158243,1,PART,PRCNCT,PRSD,PRSD_SV,"2025-05-18 21:27:34",260,145,114,31,0,143,2,300,155,89,54
37,TIMIŞ,"ŞCOALA GIMNAZIALA REMETEA MARE",532,"REMETEA MARE",158396,1,PART,PRCNCT,PRSD,PRSD_SV,"2025-05-18 23:11:59",1712,1204,905,299,0,1194,10,1800,596,574,620
37,TIMIŞ,"ŞCOALA PRIMARA IANOVA",533,"REMETEA MARE",158396,1,PART,PRCNCT,PRSD,PRSD_SV,"2025-05-18 22:10:44",983,633,460,169,4,626,7,1000,367,311,315
37,TIMIŞ,"SCOALA GIMNAZIALA SACOSU TURCESC",534,"SACOŞU TURCESC",158449,1,PART,PRCNCT,PRSD,PRSD_SV,"2025-05-18 21:25:16",846,543,400,143,0,537,6,900,357,264,273
37,TIMIŞ,"ŞCOALA PRIMARA BERINI",535,"SACOŞU TURCESC",158449,1,PART,PRCNCT,PRSD,PRSD_SV,"2025-05-18 21:16:05",425,253,172,81,0,246,7,500,247,134,112
37,TIMIŞ,"CĂMINUL CULTURAL ICLODA",536,"SACOŞU TURCESC",158449,1,PART,PRCNCT,PRSD,PRSD_SV,"2025-05-18 21:23:58",245,191,126,65,0,189,2,300,109,103,86
37,TIMIŞ,"ŞCOALA PRIMARA OTVESTI",537,"SACOŞU TURCESC",158449,1,PART,PRCNCT,PRSD,PRSD_SV,"2025-05-18 21:24:07",291,180,127,53,0,178,2,400,220,71,107
37,TIMIŞ,"CLADIREA COMUNEI SACOSU TURCESC ( FOSTA SCOALA PRIMARA STAMORA ROMANA )",538,"SACOŞU TURCESC",158449,1,PART,PRCNCT,PRSD,PRSD_SV,"2025-05-18 21:21:29",228,178,90,88,0,174,4,300,122,91,83
37,TIMIŞ,"ŞCOALA GIMNAZIALA ULIUC",539,"SACOŞU TURCESC",158449,1,PART,PRCNCT,PRSD,PRSD_SV,"2025-05-18 21:59:18",626,374,282,92,0,369,5,700,326,233,136
37,TIMIŞ,"CAMIN CULTURAL UNIP",540,"SACOŞU TURCESC",158449,1,PART,PRCNCT,PRSD,PRSD_SV,"2025-05-18 21:35:39",199,141,89,52,0,140,1,200,59,89,51
37,TIMIŞ,"SALA PRIMARIEI NR. 167B, SARAVALE",541,SARAVALE,159455,1,PART,PRCNCT,PRSD,PRSD_SV,"2025-05-18 21:39:52",1300,564,521,43,0,560,4,1400,836,449,111
37,TIMIŞ,"CAMINUL CULTURAL NR. 673, SARAVALE",542,SARAVALE,159455,1,PART,PRCNCT,PRSD,PRSD_SV,"2025-05-18 21:39:33",861,377,353,24,0,376,1,1000,623,268,108
37,TIMIŞ,"SCOALA GIMNAZIALA SATCHINEZ",543,SATCHINEZ,158528,2,PART,PRCNCT,PRSD,PRSD_SV,"2025-05-18 22:22:42",1122,567,473,94,0,555,12,1200,633,390,165
37,TIMIŞ,"SCOALA GIMNAZIALA SATCHINEZ",544,SATCHINEZ,158528,1,PART,PRCNCT,PRSD,PRSD_SV,"2025-05-18 21:57:11",1498,702,645,57,0,688,14,1500,798,507,181
37,TIMIŞ,"ȘCOALA PRIMARĂ BĂRĂTEAZ",545,SATCHINEZ,158528,1,PART,PRCNCT,PRSD,PRSD_SV,"2025-05-18 21:48:01",608,321,279,41,1,319,2,700,379,219,100
37,TIMIŞ,"SCOALA GIMNAZIALA HODONI",546,SATCHINEZ,158528,1,PART,PRCNCT,PRSD,PRSD_SV,"2025-05-18 21:40:44",994,479,433,46,0,475,4,1000,521,268,207
37,TIMIŞ,"ŞCOALA GIMNAZIALĂ COMUNA SĂCĂLAZ",547,SĂCĂLAZ,158564,1,PART,PRCNCT,PRSD,PRSD_SV,"2025-05-18 21:44:12",1629,942,668,222,52,933,9,1700,758,496,437
37,TIMIŞ,"ŞCOALA GIMNAZIALĂ COMUNA SĂCĂLAZ",548,SĂCĂLAZ,158564,1,PART,PRCNCT,PRSD,PRSD_SV,"2025-05-18 22:09:15",1602,940,712,227,1,926,14,1600,660,460,466
37,TIMIŞ,"ŞCOALA GIMNAZIALĂ COMUNA SĂCĂLAZ",549,SĂCĂLAZ,158564,1,PART,PRCNCT,PRSD,PRSD_SV,"2025-05-18 23:00:36",1994,1396,1223,161,12,1379,17,2000,604,446,933
37,TIMIŞ,"CĂMINUL CULTURAL SĂCĂLAZ",550,SĂCĂLAZ,158564,1,PART,PRCNCT,PRSD,PRSD_SV,"2025-05-18 21:45:03",1646,1016,743,273,0,1005,11,1700,684,468,537
37,TIMIŞ,"CĂMINUL CULTURAL BEREGSĂU MARE",551,SĂCĂLAZ,158564,1,PART,PRCNCT,PRSD,PRSD_SV,"2025-05-18 21:41:54",1058,533,460,71,2,527,6,1100,567,297,230
37,TIMIŞ,"CĂMINUL CULTURAL BEREGSĂU MARE",552,SĂCĂLAZ,158564,1,PART,PRCNCT,PRSD,PRSD_SV,"2025-05-18 21:42:18",1099,609,518,91,0,604,5,1100,491,376,228
37,TIMIŞ,"CĂMINUL CULTURAL BEREGSĂU MIC",553,SĂCĂLAZ,158564,2,PART,PRCNCT,PRSD,PRSD_SV,"2025-05-18 22:35:57",788,433,371,62,0,430,3,900,467,267,163
37,TIMIŞ,"CĂMINUL CULTURAL SÂNANDREI",554,SÂNANDREI,158653,1,PART,PRCNCT,PRSD,PRSD_SV,"2025-05-18 22:44:52",1660,1457,972,484,1,1441,16,1700,243,596,845
37,TIMIŞ,"ŞCOALA GIMNAZIALĂ SÂNANDREI",555,SÂNANDREI,158653,1,PART,PRCNCT,PRSD,PRSD_SV,"2025-05-18 21:54:42",1366,765,589,176,0,755,10,1500,735,332,423
37,TIMIŞ,"ȘCOALA GIMNAZIALĂ SÂNANDREI",556,SÂNANDREI,158653,1,PART,PRCNCT,PRSD,PRSD_SV,"2025-05-18 21:49:52",1466,876,748,127,1,867,9,1500,624,405,462
37,TIMIŞ,"CĂMINUL CULTURAL CARANI",557,SÂNANDREI,158653,1,PART,PRCNCT,PRSD,PRSD_SV,"2025-05-18 21:41:04",1715,882,739,143,0,872,10,1800,918,501,371
37,TIMIŞ,"ŞCOALA PRIMARĂ COVACI",558,SÂNANDREI,158653,1,PART,PRCNCT,PRSD,PRSD_SV,"2025-05-18 21:59:46",929,727,507,217,3,714,13,1000,273,360,354
37,TIMIŞ,"PRIMĂRIA SÂNMIHAIU ROMÂN",559,"SÂNMIHAIU ROMÂN",158699,1,PART,PRCNCT,PRSD,PRSD_SV,"2025-05-18 22:29:50",1911,1261,1014,247,0,1244,17,2000,739,558,686
37,TIMIŞ,"ȘCOALA GIMNAZIALĂ SÂNMIHAIU ROMÂN",560,"SÂNMIHAIU ROMÂN",158699,1,PART,PRCNCT,PRSD,PRSD_SV,"2025-05-18 22:15:33",1959,1379,1139,237,3,1360,19,2000,621,514,846
37,TIMIŞ,"ŞCOALA PRIMARĂ SÂNMIHAIU GERMAN",561,"SÂNMIHAIU ROMÂN",158699,1,PART,PRCNCT,PRSD,PRSD_SV,"2025-05-18 21:39:44",923,520,420,98,2,516,4,1000,480,261,255
37,TIMIŞ,"GRĂDINIŢA PN UTVIN",562,"SÂNMIHAIU ROMÂN",158699,1,PART,PRCNCT,PRSD,PRSD_SV,"2025-05-18 21:49:15",1362,947,730,216,1,939,8,1400,453,425,514
37,TIMIŞ,"ȘCOALA GIMNAZIALĂ UTVIN",563,"SÂNMIHAIU ROMÂN",158699,2,PART,PRCNCT,PRSD,PRSD_SV,"2025-05-19 01:07:25",1666,1088,943,145,0,1080,8,1700,612,546,534
37,TIMIŞ,"PRIMĂRIA COMUNEI SÂNPETRU MARE",564,"SÂNPETRU MARE",158733,1,PART,PRCNCT,PRSD,PRSD_SV,"2025-05-18 21:29:49",957,368,327,41,0,368,0,1000,632,261,107
37,TIMIŞ,"PRIMĂRIA COMUNEI SÂNPETRU MARE",565,"SÂNPETRU MARE",158733,1,PART,PRCNCT,PRSD,PRSD_SV,"2025-05-18 21:31:00",857,389,343,43,3,386,3,1000,611,273,113
37,TIMIŞ,"ŞCOALA GIMNAZIALĂ ACADEMICIAN PROFESOR DOCTOR MUNTEANU IOAN IGRIȘ",566,"SÂNPETRU MARE",158733,1,PART,PRCNCT,PRSD,PRSD_SV,"2025-05-18 21:21:55",938,487,389,96,2,481,6,1000,513,321,160
37,TIMIŞ,"SEDIUL PRIMĂRIEI SECAŞ",567,SECAŞ,158608,1,PART,PRCNCT,PRSD,PRSD_SV,"2025-05-18 21:17:04",203,98,69,26,3,96,2,500,402,79,17
37,TIMIŞ,"CĂMINUL CULTURAL CRIVOBARA",568,SECAŞ,158608,1,PART,PRCNCT,PRSD,PRSD_SV,"2025-05-18 21:15:37",71,68,35,33,0,65,3,200,132,27,38
37,TIMIŞ,"ȘCOALĂ - MUZEU",569,ŞAG,158779,1,PART,PRCNCT,PRSD,PRSD_SV,"2025-05-18 22:03:14",1640,1281,1064,211,6,1269,12,1700,419,454,815
37,TIMIŞ,"CĂMINUL CULTURAL ȘAG",570,ŞAG,158779,1,PART,PRCNCT,PRSD,PRSD_SV,"2025-05-18 22:01:06",1416,1017,727,286,4,999,18,1500,483,408,591
37,TIMIŞ,"CĂMINUL CULTURAL ȘAG",571,ŞAG,158779,1,PART,PRCNCT,PRSD,PRSD_SV,"2025-05-18 21:57:54",1506,962,829,132,1,953,9,1600,638,411,542
37,TIMIŞ,"ȘCOALA GIMNAZIALĂ ȘANDRA",572,ŞANDRA,159464,1,PART,PRCNCT,PRSD,PRSD_SV,"2025-05-18 21:25:54",1125,570,496,74,0,565,5,1200,630,305,260
37,TIMIŞ,"ȘCOALA GIMNAZIALĂ ȘANDRA",573,ŞANDRA,159464,1,PART,PRCNCT,PRSD,PRSD_SV,"2025-05-18 21:45:44",952,447,411,36,0,443,4,1000,553,241,202
37,TIMIŞ,"ŞCOALA PRIMARĂ UIHEI",574,ŞANDRA,159464,1,PART,PRCNCT,PRSD,PRSD_SV,"2025-05-18 21:33:33",487,202,180,22,0,198,4,500,298,145,53
37,TIMIŞ,"CĂMINUL CULTURAL ŞTIUCA",575,ŞTIUCA,158804,1,PART,PRCNCT,PRSD,PRSD_SV,"2025-05-18 21:40:38",986,531,481,50,0,523,8,1100,569,442,81
37,TIMIŞ,"CĂMINUL CULTURAL DRAGOMIREŞTI",576,ŞTIUCA,158804,1,PART,PRCNCT,PRSD,PRSD_SV,"2025-05-18 21:35:50",332,133,117,16,0,132,1,400,267,104,28
37,TIMIŞ,"CĂMINUL CULTURAL OLOŞAG",577,ŞTIUCA,158804,1,PART,PRCNCT,PRSD,PRSD_SV,"2025-05-18 21:28:43",314,197,138,59,0,197,0,400,203,140,57
37,TIMIŞ,"CĂMINUL CULTURAL ZGRIBEŞTI",578,ŞTIUCA,158804,1,PART,PRCNCT,PRSD,PRSD_SV,"2025-05-18 21:27:03",176,123,82,41,0,122,1,200,77,70,52
37,TIMIŞ,"ȘCOALA GIMNAZIALĂ TEREMIA MARE",579,"TEREMIA MARE",158859,1,PART,PRCNCT,PRSD,PRSD_SV,"2025-05-18 21:19:15",1108,388,368,20,0,384,4,1200,812,231,153
37,TIMIŞ,"ȘCOALA GIMNAZIALĂ TEREMIA MARE",580,"TEREMIA MARE",158859,1,PART,PRCNCT,PRSD,PRSD_SV,"2025-05-18 21:18:12",1178,420,402,18,0,412,8,1200,780,274,138
37,TIMIŞ,"ȘCOALA PRIMARĂ NERĂU",581,"TEREMIA MARE",158859,1,PART,PRCNCT,PRSD,PRSD_SV,"2025-05-18 21:19:51",917,361,338,23,0,356,5,1000,639,237,119
37,TIMIŞ,"ŞCOALA PRIMARA TEREMIA MICĂ",582,"TEREMIA MARE",158859,1,PART,PRCNCT,PRSD,PRSD_SV,"2025-05-18 21:20:08",578,188,175,13,0,187,1,600,412,150,37
37,TIMIŞ,"CĂMINUL CULTURAL TOMEŞTI",583,TOMEŞTI,158895,1,PART,PRCNCT,PRSD,PRSD_SV,"2025-05-18 21:22:46",267,223,167,56,0,221,2,300,77,132,89
37,TIMIŞ,"CĂMINUL CULTURAL BALOȘEȘTI",584,TOMEŞTI,158895,1,PART,PRCNCT,PRSD,PRSD_SV,"2025-05-18 21:13:49",109,73,59,14,0,71,2,200,127,47,24
37,TIMIŞ,"CASA DE CULTURĂ COLONIA FABRICII",585,TOMEŞTI,158895,1,PART,PRCNCT,PRSD,PRSD_SV,"2025-05-18 21:42:02",618,318,275,43,0,308,10,700,382,121,187
37,TIMIŞ,"CĂMINUL CULTURAL LUNCANII DE JOS",586,TOMEŞTI,158895,1,PART,PRCNCT,PRSD,PRSD_SV,"2025-05-18 21:25:29",253,198,141,57,0,198,0,300,102,89,109
37,TIMIŞ,"CĂMINUL CULTURAL ROMÂNEŞTI",587,TOMEŞTI,158895,1,PART,PRCNCT,PRSD,PRSD_SV,"2025-05-18 21:37:04",408,269,213,56,0,262,7,500,231,167,95
37,TIMIŞ,"PRIMARIA COMUNEI TOMNATIC , CORP A",588,TOMNATIC,159473,1,PART,PRCNCT,PRSD,PRSD_SV,"2025-05-18 21:41:37",1669,554,523,30,1,547,7,1700,1146,371,176
37,TIMIŞ,"PRIMARIA COMUNEI TOMNATIC , CORP B",589,TOMNATIC,159473,1,PART,PRCNCT,PRSD,PRSD_SV,"2025-05-18 21:39:11",1401,512,473,38,1,508,4,1400,888,355,153
37,TIMIŞ,"PRIMĂRIA TOPOLOVĂŢU MARE",590,"TOPOLOVĂŢU MARE",158966,1,PART,PRCNCT,PRSD,PRSD_SV,"2025-05-18 22:05:05",932,562,405,157,0,558,4,900,338,305,253
37,TIMIŞ,"CĂMINUL CULTURAL CRALOVĂŢ",591,"TOPOLOVĂŢU MARE",158966,1,PART,PRCNCT,PRSD,PRSD_SV,"2025-05-18 21:21:58",94,98,38,60,0,97,1,200,102,43,54
37,TIMIŞ,"CLADIREA COMUNEI TOPOLOVATU MARE (SEDIUL FOSTULUI CAP ICTAR - BUDINŢI)",592,"TOPOLOVĂŢU MARE",158966,1,PART,PRCNCT,PRSD,PRSD_SV,"2025-05-18 21:16:56",349,274,172,102,0,270,4,400,126,133,137
37,TIMIŞ,"SCOALA PRIMARĂ IOSIFALĂU",593,"TOPOLOVĂŢU MARE",158966,2,PART,PRCNCT,PRSD,PRSD_SV,"2025-05-18 22:39:26",431,236,197,39,0,234,2,500,264,166,68
37,TIMIŞ,"CĂMINUL CULTURAL ŞUŞTRA",594,"TOPOLOVĂŢU MARE",158966,1,PART,PRCNCT,PRSD,PRSD_SV,"2025-05-18 21:37:50",344,225,149,74,2,224,1,400,175,114,110
37,TIMIŞ,"CĂMINUL CULTURAL TORMAC",595,TORMAC,159035,1,PART,PRCNCT,PRSD,PRSD_SV,"2025-05-18 22:15:34",1406,659,553,96,10,650,9,1500,841,315,335
37,TIMIŞ,"CĂMINUL CULTURAL CADAR",596,TORMAC,159035,1,PART,PRCNCT,PRSD,PRSD_SV,"2025-05-18 21:24:43",234,147,106,41,0,145,2,300,153,96,49
37,TIMIŞ,"CĂMINUL CULTURAL ŞIPET",597,TORMAC,159035,1,PART,PRCNCT,PRSD,PRSD_SV,"2025-05-18 22:15:35",740,338,287,51,0,336,2,800,462,226,110
37,TIMIŞ,"PRIMĂRIA COMUNEI TRAIAN VUIA",598,"TRAIAN VUIA",159071,1,PART,PRCNCT,PRSD,PRSD_SV,"2025-05-18 21:24:33",658,305,255,45,5,303,2,700,395,238,65
37,TIMIŞ,"CĂMINUL CULTURAL SĂCENI",599,"TRAIAN VUIA",159071,1,PART,PRCNCT,PRSD,PRSD_SV,"2025-05-18 21:16:28",169,113,89,24,0,112,1,200,87,78,34
37,TIMIŞ,"CĂMINUL CULTURAL SURDUCU MIC",600,"TRAIAN VUIA",159071,1,PART,PRCNCT,PRSD,PRSD_SV,"2025-05-18 21:21:41",262,144,102,42,0,144,0,300,156,100,44
37,TIMIŞ,"CĂMINUL CULTURAL SUSANI",601,"TRAIAN VUIA",159071,1,PART,PRCNCT,PRSD,PRSD_SV,"2025-05-18 21:35:01",293,157,131,25,1,154,3,400,243,96,58
37,TIMIŞ,"CĂMINUL CULTURAL TRAIAN VUIA",602,"TRAIAN VUIA",159071,1,PART,PRCNCT,PRSD,PRSD_SV,"2025-05-18 21:27:16",350,206,174,30,2,203,3,400,194,135,68
37,TIMIŞ,"CĂMINUL CULTURAL UIVAR",603,UIVAR,159142,1,PART,PRCNCT,PRSD,PRSD_SV,"2025-05-18 21:42:03",1187,419,373,46,0,412,7,1200,781,260,152
37,TIMIŞ,"CĂMINUL CULTURAL PUSTINIŞ",604,UIVAR,159142,1,PART,PRCNCT,PRSD,PRSD_SV,"2025-05-18 21:30:36",630,332,274,58,0,329,3,700,368,211,118
37,TIMIŞ,"CĂMINUL CULTURAL RĂUŢI",605,UIVAR,159142,1,PART,PRCNCT,PRSD,PRSD_SV,"2025-05-18 21:24:22",498,221,196,25,0,216,5,500,279,160,56
37,TIMIŞ,"CĂMINUL CULTURAL SÂNMARTINU MAGHIAR",606,UIVAR,159142,1,PART,PRCNCT,PRSD,PRSD_SV,"2025-05-18 21:30:07",229,120,89,31,0,119,1,300,180,78,41
37,TIMIŞ,"CĂMINUL CULTURAL VARIAŞ",607,VARIAŞ,159213,1,PART,PRCNCT,PRSD,PRSD_SV,"2025-05-18 22:17:29",1782,756,694,61,1,749,7,1900,1144,496,253
37,TIMIŞ,"ŞCOALA GIMNAZIALĂ VARIAŞ",608,VARIAŞ,159213,1,PART,PRCNCT,PRSD,PRSD_SV,"2025-05-18 21:54:42",1835,761,686,73,2,754,7,1900,1139,504,250
37,TIMIŞ,"ȘCOALA GIMNAZIALĂ GELU",609,VARIAŞ,159213,1,PART,PRCNCT,PRSD,PRSD_SV,"2025-05-18 22:19:33",1255,583,506,77,0,577,6,1300,717,435,142
37,TIMIŞ,"GRĂDINIŢA CU PROGRAM NORMAL SÂNPETRU MIC",610,VARIAŞ,159213,1,PART,PRCNCT,PRSD,PRSD_SV,"2025-05-18 21:30:02",452,147,123,24,0,146,1,500,353,94,52
37,TIMIŞ,"PRIMARIA VĂLCANI",611,VĂLCANI,159482,1,PART,PRCNCT,PRSD,PRSD_SV,"2025-05-18 21:25:49",1113,557,499,58,0,555,2,1200,643,358,197
37,TIMIŞ,"CĂMINUL CULTURAL V.V DELAMARINA",612,"VICTOR VLAD DELAMARINA",159259,1,PART,PRCNCT,PRSD,PRSD_SV,"2025-05-18 21:26:17",373,227,190,35,2,220,7,400,173,105,115
37,TIMIŞ,"CĂMINUL CULTURAL HERENDEŞTI",613,"VICTOR VLAD DELAMARINA",159259,1,PART,PRCNCT,PRSD,PRSD_SV,"2025-05-18 21:31:13",376,235,175,60,0,231,4,400,165,133,98
37,TIMIŞ,"CĂMINUL CULTURAL HONORICI",614,"VICTOR VLAD DELAMARINA",159259,1,PART,PRCNCT,PRSD,PRSD_SV,"2025-05-18 21:20:53",275,181,144,36,1,179,2,300,119,117,62
37,TIMIŞ,"CĂMINUL CULTURAL PĂDURENI",615,"VICTOR VLAD DELAMARINA",159259,1,PART,PRCNCT,PRSD,PRSD_SV,"2025-05-18 21:12:46",131,81,60,21,0,81,0,200,119,43,38
37,TIMIŞ,"ŞCOALA GIMNAZIALĂ PETROASA MARE",616,"VICTOR VLAD DELAMARINA",159259,1,PART,PRCNCT,PRSD,PRSD_SV,"2025-05-18 21:22:48",874,375,343,32,0,372,3,900,525,322,50
37,TIMIŞ,"ŞCOALA PRIMARĂ VISAG",617,"VICTOR VLAD DELAMARINA",159259,1,PART,PRCNCT,PRSD,PRSD_SV,"2025-05-18 21:17:48",267,121,91,30,0,118,3,300,179,83,35
37,TIMIŞ,"PRIMĂRIA VOITEG",618,VOITEG,159339,1,PART,PRCNCT,PRSD,PRSD_SV,"2025-05-18 21:36:35",1627,837,710,127,0,832,5,1800,963,513,319
37,TIMIŞ,"ŞCOALA PRIMARĂ FOLEA",619,VOITEG,159339,1,PART,PRCNCT,PRSD,PRSD_SV,"2025-05-18 21:28:32",393,204,148,56,0,204,0,400,196,138,66
38,TULCEA,"GRĂDINIŢA CU PROGRAM PRELUNGIT NR.18",1,"MUNICIPIUL TULCEA",159614,1,PART,PRCNCT,PRSD,PRSD_SV,"2025-05-18 22:14:05",1210,485,443,40,2,478,7,1299,814,260,218
38,TULCEA,"GRĂDINIŢA CU PROGRAM PRELUNGIT NR.18",2,"MUNICIPIUL TULCEA",159614,1,PART,PRCNCT,PRSD,PRSD_SV,"2025-05-18 21:57:49",1290,635,599,36,0,630,5,1420,785,358,272
38,TULCEA,"INTERNAT LICEUL TEORETIC „ION CREANGĂ”",3,"MUNICIPIUL TULCEA",159614,1,PART,PRCNCT,PRSD,PRSD_SV,"2025-05-18 21:41:19",1696,755,708,47,0,744,11,1865,1110,369,375
38,TULCEA,"INTERNAT LICEUL TEORETIC „ION CREANGĂ”",4,"MUNICIPIUL TULCEA",159614,1,PART,PRCNCT,PRSD,PRSD_SV,"2025-05-18 22:37:32",1549,745,693,52,0,733,12,1702,957,374,359
38,TULCEA,"GRĂDINIȚA CU PROGRAM PRELUNGIT NR. 13",5,"MUNICIPIUL TULCEA",159614,1,PART,PRCNCT,PRSD,PRSD_SV,"2025-05-18 21:43:00",1572,706,648,58,0,700,6,1730,1024,406,294
38,TULCEA,"GRĂDINIȚA CU PROGRAM PRELUNGIT NR. 13",6,"MUNICIPIUL TULCEA",159614,1,PART,PRCNCT,PRSD,PRSD_SV,"2025-05-18 22:03:08",1486,637,604,33,0,623,14,1633,996,332,291
38,TULCEA,"ȘCOALA GIMNAZIALĂ „ELENA DOAMNA”",7,"MUNICIPIUL TULCEA",159614,1,PART,PRCNCT,PRSD,PRSD_SV,"2025-05-18 21:53:50",1198,652,535,47,70,644,8,1318,666,289,355
38,TULCEA,"ȘCOALA GIMNAZIALĂ „ELENA DOAMNA”",8,"MUNICIPIUL TULCEA",159614,1,PART,PRCNCT,PRSD,PRSD_SV,"2025-05-18 22:07:05",1055,706,520,58,128,700,6,1162,456,358,342
38,TULCEA,"ȘCOALA GIMNAZIALĂ „ELENA DOAMNA”",9,"MUNICIPIUL TULCEA",159614,1,PART,PRCNCT,PRSD,PRSD_SV,"2025-05-18 21:58:25",1191,808,615,65,128,796,12,1309,501,344,452
38,TULCEA,"ȘCOALA GIMNAZIALĂ „ELENA DOAMNA”",10,"MUNICIPIUL TULCEA",159614,1,PART,PRCNCT,PRSD,PRSD_SV,"2025-05-18 22:08:55",858,587,413,51,123,581,6,945,358,296,285
38,TULCEA,"LICEUL DE ARTE ”GEORGE GEORGESCU”",11,"MUNICIPIUL TULCEA",159614,1,PART,PRCNCT,PRSD,PRSD_SV,"2025-05-18 21:36:20",1130,701,613,85,3,693,8,1246,545,310,383
38,TULCEA,"LICEUL DE ARTE ”GEORGE GEORGESCU”",12,"MUNICIPIUL TULCEA",159614,1,PART,PRCNCT,PRSD,PRSD_SV,"2025-05-18 21:58:41",882,484,431,51,2,475,9,970,486,197,278
38,TULCEA,"LICEUL DE ARTE ”GEORGE GEORGESCU”",13,"MUNICIPIUL TULCEA",159614,1,PART,PRCNCT,PRSD,PRSD_SV,"2025-05-18 21:46:27",884,528,418,110,0,522,6,973,445,260,262
38,TULCEA,"GRĂDINIŢA CU PROGRAM PRELUNGIT NR.12",14,"MUNICIPIUL TULCEA",159614,1,PART,PRCNCT,PRSD,PRSD_SV,"2025-05-18 22:01:39",1619,846,801,45,0,830,16,1779,933,341,489
38,TULCEA,"LICEUL TEORETIC ”ION CREANGĂ”",15,"MUNICIPIUL TULCEA",159614,1,PART,PRCNCT,PRSD,PRSD_SV,"2025-05-18 21:44:42",1084,736,544,97,95,725,11,1191,455,370,355
38,TULCEA,"LICEUL TEORETIC ”ION CREANGĂ”",16,"MUNICIPIUL TULCEA",159614,1,PART,PRCNCT,PRSD,PRSD_SV,"2025-05-18 22:07:16",971,567,480,16,71,561,6,1067,500,278,283
38,TULCEA,"SEMINARUL TEOLOGIC ORTODOX ”SF. IOAN CASIAN”",17,"MUNICIPIUL TULCEA",159614,1,PART,PRCNCT,PRSD,PRSD_SV,"2025-05-18 21:43:36",968,525,506,19,0,520,5,1066,541,209,311
38,TULCEA,"SEMINARUL TEOLOGIC ORTODOX ”SF. IOAN CASIAN”",18,"MUNICIPIUL TULCEA",159614,1,PART,PRCNCT,PRSD,PRSD_SV,"2025-05-18 21:55:29",885,506,455,48,3,496,10,973,467,223,273
38,TULCEA,"TEATRUL ”JEAN BART”",19,"MUNICIPIUL TULCEA",159614,2,PART,PRCNCT,PRSD,PRSD_SV,"2025-05-18 22:32:25",1382,877,707,169,1,863,14,1520,643,323,540
38,TULCEA,"ŞCOALA GIMNAZIALĂ ”GRIGORE ANTIPA”",20,"MUNICIPIUL TULCEA",159614,1,PART,PRCNCT,PRSD,PRSD_SV,"2025-05-18 21:50:58",1125,591,534,57,0,584,7,1236,645,285,299
38,TULCEA,"ŞCOALA GIMNAZIALĂ ”GRIGORE ANTIPA”",21,"MUNICIPIUL TULCEA",159614,1,PART,PRCNCT,PRSD,PRSD_SV,"2025-05-18 21:48:58",968,565,523,42,0,559,6,1064,499,202,357
38,TULCEA,"GARAJE, SPAȚII DE DEPOZITARE ȘI BIROURI ALE CONSILIULUI JUDEȚEAN TULCEA",22,"MUNICIPIUL TULCEA",159614,1,PART,PRCNCT,PRSD,PRSD_SV,"2025-05-18 21:51:00",1697,837,784,39,14,825,12,1866,1029,371,454
38,TULCEA,"ŞCOALA GIMNAZIALĂ ”ALEXANDRU CIUCURENCU”",23,"MUNICIPIUL TULCEA",159614,1,PART,PRCNCT,PRSD,PRSD_SV,"2025-05-18 22:24:53",1167,827,589,224,14,814,13,1285,458,392,422
38,TULCEA,"ŞCOALA GIMNAZIALĂ ”ALEXANDRU CIUCURENCU”",24,"MUNICIPIUL TULCEA",159614,1,PART,PRCNCT,PRSD,PRSD_SV,"2025-05-18 22:10:05",1517,803,728,75,0,794,9,1668,865,375,419
38,TULCEA,"ŞCOALA GIMNAZIALĂ ”CONSTANTIN GĂVENEA”",25,"MUNICIPIUL TULCEA",159614,1,PART,PRCNCT,PRSD,PRSD_SV,"2025-05-18 22:19:18",1579,801,734,66,1,792,9,1735,934,361,431
38,TULCEA,"ŞCOALA GIMNAZIALĂ ”CONSTANTIN GĂVENEA”",26,"MUNICIPIUL TULCEA",159614,1,PART,PRCNCT,PRSD,PRSD_SV,"2025-05-18 22:52:48",1341,725,641,84,0,714,11,1475,750,329,385
38,TULCEA,"ŞCOALA GIMNAZIALĂ ”CONSTANTIN GĂVENEA”",27,"MUNICIPIUL TULCEA",159614,1,PART,PRCNCT,PRSD,PRSD_SV,"2025-05-18 22:07:37",1424,789,713,76,0,777,12,1567,778,331,446
38,TULCEA,"PUNCT DE ÎNCASARE TAXE ŞI IMPOZITE LOCALE",28,"MUNICIPIUL TULCEA",159614,1,PART,PRCNCT,PRSD,PRSD_SV,"2025-05-18 22:01:54",1549,856,791,65,0,843,13,1702,846,369,474
38,TULCEA,"ȘCOALA GIMNAZIALĂ NR. 12",29,"MUNICIPIUL TULCEA",159614,1,PART,PRCNCT,PRSD,PRSD_SV,"2025-05-18 21:54:58",1156,649,598,51,0,640,9,1271,622,275,365
38,TULCEA,"ȘCOALA GIMNAZIALĂ NR. 12",30,"MUNICIPIUL TULCEA",159614,1,PART,PRCNCT,PRSD,PRSD_SV,"2025-05-18 21:49:28",1068,603,537,48,18,600,3,1175,572,276,324
38,TULCEA,"ŞCOALA GIMNAZIALĂ NR.12",31,"MUNICIPIUL TULCEA",159614,1,PART,PRCNCT,PRSD,PRSD_SV,"2025-05-18 21:56:19",1252,739,625,62,52,732,7,1377,638,317,415
38,TULCEA,"ŞCOALA GIMNAZIALĂ NR.12",32,"MUNICIPIUL TULCEA",159614,1,PART,PRCNCT,PRSD,PRSD_SV,"2025-05-18 22:07:17",1365,680,575,55,50,669,11,1511,831,364,305
38,TULCEA,"SALA DE SPORT MULTIFUNCŢIONALĂ „DANIEL IULIAN POHARIU”",33,"MUNICIPIUL TULCEA",159614,1,PART,PRCNCT,PRSD,PRSD_SV,"2025-05-18 22:26:38",1331,733,632,101,0,723,10,1467,734,383,340
38,TULCEA,"GRĂDINIŢA CU PROGRAM PRELUNGIT NR.17",34,"MUNICIPIUL TULCEA",159614,1,PART,PRCNCT,PRSD,PRSD_SV,"2025-05-18 22:01:49",1513,812,761,51,0,794,18,1667,855,430,364
38,TULCEA,"GRĂDINIŢA CU PROGRAM PRELUNGIT NR.17",35,"MUNICIPIUL TULCEA",159614,1,PART,PRCNCT,PRSD,PRSD_SV,"2025-05-18 21:57:24",1500,656,560,96,0,650,6,1649,993,408,242
38,TULCEA,"LICEUL TEHNOLOGIC ”HENRI COANDĂ” TULCEA",36,"MUNICIPIUL TULCEA",159614,1,PART,PRCNCT,PRSD,PRSD_SV,"2025-05-18 22:28:27",1433,934,676,258,0,920,14,1575,641,465,455
38,TULCEA,"BIBLIOTECA JUDEŢEANĂ PANAIT CERNA",37,"MUNICIPIUL TULCEA",159614,1,PART,PRCNCT,PRSD,PRSD_SV,"2025-05-18 21:55:33",1282,787,641,146,0,784,3,1409,622,351,433
38,TULCEA,"COLEGIUL ECONOMIC ” DELTA DUNĂRII”",38,"MUNICIPIUL TULCEA",159614,1,PART,PRCNCT,PRSD,PRSD_SV,"2025-05-18 21:49:56",1182,636,555,81,0,624,12,1299,663,381,243
38,TULCEA,"COLEGIUL ECONOMIC ” DELTA DUNĂRII”",39,"MUNICIPIUL TULCEA",159614,1,PART,PRCNCT,PRSD,PRSD_SV,"2025-05-18 22:01:39",959,487,451,36,0,485,2,1056,569,285,200
38,TULCEA,"GRĂDINIȚA CU PROGRAM PRELUNGIT A LICEULUI TEHNOLOGIC AGRICOL ”NICOLAE CORNĂȚEANU”",40,"MUNICIPIUL TULCEA",159614,1,PART,PRCNCT,PRSD,PRSD_SV,"2025-05-18 22:55:11",1668,1016,902,114,0,1008,8,1833,817,502,506
38,TULCEA,"LICEUL TEHNOLOGIC ”ANGHEL SALIGNY” TULCEA",41,"MUNICIPIUL TULCEA",159614,1,PART,PRCNCT,PRSD,PRSD_SV,"2025-05-18 22:17:41",1454,634,547,87,0,626,8,1599,965,423,203
38,TULCEA,"CASA DE CULTURĂ",42,"MUNICIPIUL TULCEA",159614,1,PART,PRCNCT,PRSD,PRSD_SV,"2025-05-18 22:18:53",1346,763,658,105,0,745,18,1483,720,344,401
38,TULCEA,"CASA DE CULTURĂ",43,"MUNICIPIUL TULCEA",159614,1,PART,PRCNCT,PRSD,PRSD_SV,"2025-05-18 21:31:34",502,364,227,137,0,359,5,553,189,212,147
38,TULCEA,"COLEGIUL NAȚIONAL „SPIRU HARET”",44,"MUNICIPIUL TULCEA",159614,1,PART,PRCNCT,PRSD,PRSD_SV,"2025-05-18 22:48:10",1707,1165,810,340,15,1145,20,1879,714,510,635
38,TULCEA,"ŞCOALA GIMNAZIALĂ ”NIFON BĂLĂŞESCU”",45,"MUNICIPIUL TULCEA",159614,1,PART,PRCNCT,PRSD,PRSD_SV,"2025-05-18 21:41:13",1016,517,481,36,0,512,5,1116,599,282,230
38,TULCEA,"ŞCOALA GIMNAZIALĂ ”NIFON BĂLĂŞESCU”",46,"MUNICIPIUL TULCEA",159614,1,PART,PRCNCT,PRSD,PRSD_SV,"2025-05-18 22:22:02",1459,808,736,72,0,801,7,1604,796,464,337
38,TULCEA,"ŞCOALA GIMNAZIALĂ ”NIFON BĂLĂŞESCU”",47,"MUNICIPIUL TULCEA",159614,1,PART,PRCNCT,PRSD,PRSD_SV,"2025-05-18 22:03:28",1306,677,608,50,19,665,12,1435,758,348,317
38,TULCEA,"ŞCOALA PROFESIONALĂ ”DANUBIUS”",48,"MUNICIPIUL TULCEA",159614,1,PART,PRCNCT,PRSD,PRSD_SV,"2025-05-18 21:44:53",1029,481,446,34,1,479,2,1131,650,285,194
38,TULCEA,"ŞCOALA PROFESIONALĂ ”DANUBIUS”",49,"MUNICIPIUL TULCEA",159614,1,PART,PRCNCT,PRSD,PRSD_SV,"2025-05-18 21:36:50",1047,533,488,45,0,524,9,1152,619,304,220
38,TULCEA,"ŞCOALA PRIMARĂ NR. 9",50,"MUNICIPIUL TULCEA",159614,1,PART,PRCNCT,PRSD,PRSD_SV,"2025-05-18 21:40:58",1125,560,519,40,1,554,6,1236,676,301,253
38,TULCEA,"ŞCOALA PRIMARĂ NR. 9",51,"MUNICIPIUL TULCEA",159614,1,PART,PRCNCT,PRSD,PRSD_SV,"2025-05-18 21:43:37",1366,656,625,30,1,642,14,1501,845,346,296
38,TULCEA,"ŞCOALA GIMNAZIALĂ ”IOAN NENIŢESCU”",52,"MUNICIPIUL TULCEA",159614,1,PART,PRCNCT,PRSD,PRSD_SV,"2025-05-18 22:01:10",1198,645,596,49,0,643,2,1318,673,323,320
38,TULCEA,"ŞCOALA GIMNAZIALĂ ”IOAN NENIŢESCU”",53,"MUNICIPIUL TULCEA",159614,1,PART,PRCNCT,PRSD,PRSD_SV,"2025-05-18 21:56:23",1471,827,774,52,1,821,6,1616,789,360,461
38,TULCEA,"LICEUL ”DIMITRIE CANTEMIR” BABADAG",54,"ORAŞ BABADAG",159650,1,PART,PRCNCT,PRSD,PRSD_SV,"2025-05-18 22:16:20",1611,651,564,87,0,641,10,1771,1120,397,244
38,TULCEA,"ȘCOALA GIMNAZIALĂ ”MIRCEA CEL BĂTRÂN” BABADAG",55,"ORAŞ BABADAG",159650,1,PART,PRCNCT,PRSD,PRSD_SV,"2025-05-18 22:13:04",1298,599,519,66,14,581,18,1426,827,367,214
38,TULCEA,"ȘCOALA GIMNAZIALĂ ”CONSTANTIN BRÂNCOVEANU” BABADAG CORP B",56,"ORAŞ BABADAG",159650,1,PART,PRCNCT,PRSD,PRSD_SV,"2025-05-18 21:42:59",1054,510,451,59,0,501,9,1159,649,335,166
38,TULCEA,"ŞCOALA GIMNAZIALĂ ”CONSTANTIN BRÂNCOVEANU” BABADAG CORP A",57,"ORAŞ BABADAG",159650,1,PART,PRCNCT,PRSD,PRSD_SV,"2025-05-18 22:08:31",1426,381,339,42,0,362,19,1566,1185,284,78
38,TULCEA,"ȘCOALA GIMNAZIALĂ ”CONSTANTIN BRÂNCOVEANU” BABADAG - GRĂDINIȚA PN",58,"ORAŞ BABADAG",159650,1,PART,PRCNCT,PRSD,PRSD_SV,"2025-05-18 21:53:26",1090,500,464,36,0,490,10,1198,698,358,132
38,TULCEA,"”SALA DE SPORT TOMA AUREL”",59,"ORAŞ BABADAG",159650,1,PART,PRCNCT,PRSD,PRSD_SV,"2025-05-18 21:58:17",1071,482,420,42,20,465,17,1170,688,307,158
38,TULCEA,"CASA DE CULTURĂ PAUL BARBĂNEAGRĂ",60,"ORAŞ ISACCEA",159687,1,PART,PRCNCT,PRSD,PRSD_SV,"2025-05-18 22:09:33",1212,643,582,60,1,636,7,1334,691,340,296
38,TULCEA,"LICEUL TEORETIC ”CONSTANTIN BRĂTESCU”",61,"ORAŞ ISACCEA",159687,3,PART,PRCNCT,PRSD,PRSD_SV,"2025-05-19 00:01:15",1128,637,533,103,1,632,5,1242,605,365,267
38,TULCEA,"GRĂDINIŢA „CONSTANTIN BRĂTESCU”",62,"ORAŞ ISACCEA",159687,2,PART,PRCNCT,PRSD,PRSD_SV,"2025-05-18 23:23:24",1266,637,590,47,0,616,21,1391,754,360,256
38,TULCEA,"COMPLEXUL DE SERVICII SOCIALE REVĂRSAREA-CENTRUL DE ZI PENTRU CONSILIERE ȘI SPRIJIN PENTRU FAMILIE ȘI COPII",63,"ORAŞ ISACCEA",159687,1,PART,PRCNCT,PRSD,PRSD_SV,"2025-05-18 21:33:05",374,231,150,60,21,219,12,411,180,107,112
38,TULCEA,"ŞCOALA GIMNAZIALĂ ”GHEORGHE BANEA”",64,"ORAŞ MĂCIN",159730,1,PART,PRCNCT,PRSD,PRSD_SV,"2025-05-18 22:14:37",1169,617,550,67,0,611,6,1284,667,365,246
38,TULCEA,"ŞCOALA GIMNAZIALĂ ”GHEORGHE BANEA”",65,"ORAŞ MĂCIN",159730,1,PART,PRCNCT,PRSD,PRSD_SV,"2025-05-18 21:59:52",1307,661,624,35,2,657,4,1438,777,375,282
38,TULCEA,"GRĂDINIŢA CU PROGRAM PRELUNGIT NR. 3",66,"ORAŞ MĂCIN",159730,1,PART,PRCNCT,PRSD,PRSD_SV,"2025-05-18 22:07:50",1074,556,486,47,23,552,4,1181,625,273,279
38,TULCEA,"ŞCOALA PRIMARĂ NR. 1",67,"ORAŞ MĂCIN",159730,1,PART,PRCNCT,PRSD,PRSD_SV,"2025-05-18 22:09:01",1962,875,854,17,4,862,13,2157,1282,464,398
38,TULCEA,"ŞCOALA PRIMARĂ NR. 1",68,"ORAŞ MĂCIN",159730,1,PART,PRCNCT,PRSD,PRSD_SV,"2025-05-18 21:41:24",659,352,279,72,1,350,2,724,372,179,171
38,TULCEA,"LICEUL TEORETIC” GHEORGHE MUNTEANU MURGOCI”",69,"ORAŞ MĂCIN",159730,1,PART,PRCNCT,PRSD,PRSD_SV,"2025-05-18 21:55:48",1286,579,532,46,1,573,6,1413,834,402,171
38,TULCEA,"LICEUL TEORETIC” GHEORGHE MUNTEANU MURGOCI”",70,"ORAŞ MĂCIN",159730,1,PART,PRCNCT,PRSD,PRSD_SV,"2025-05-18 21:50:34",884,332,307,24,1,331,1,971,639,242,89
38,TULCEA,"SCOALA I- IV - INCAPERE EXPOZITIONALA",71,"ORAŞ SULINA",159767,1,PART,PRCNCT,PRSD,PRSD_SV,"2025-05-18 21:48:25",939,637,428,205,4,632,5,1033,396,341,291
38,TULCEA,"ȘCOALA I-IV PROSPECT",72,"ORAŞ SULINA",159767,1,PART,PRCNCT,PRSD,PRSD_SV,"2025-05-18 21:24:39",190,114,96,18,0,112,2,209,95,69,43
38,TULCEA,"LICEUL TEORETIC „JEAN BART”",73,"ORAŞ SULINA",159767,1,PART,PRCNCT,PRSD,PRSD_SV,"2025-05-18 21:56:06",945,711,475,236,0,705,6,1040,329,333,372
38,TULCEA,"SALA DE EDUCAȚIE FIZICĂ ȘI SPORT",74,"ORAŞ SULINA",159767,1,PART,PRCNCT,PRSD,PRSD_SV,"2025-05-18 21:55:17",1002,717,467,250,0,712,5,1101,384,333,379
38,TULCEA,"ŞCOALA GIMNAZIALĂ BAIA",75,BAIA,159785,1,PART,PRCNCT,PRSD,PRSD_SV,"2025-05-18 21:58:23",1517,811,702,106,3,805,6,1667,856,551,254
38,TULCEA,"ŞCOALA CU CLASELE I-IV BAIA",76,BAIA,159785,1,PART,PRCNCT,PRSD,PRSD_SV,"2025-05-18 21:19:00",831,424,396,28,0,421,3,913,489,311,110
38,TULCEA,"ŞCOALA PRIMARĂ CAMENA",77,BAIA,159785,1,PART,PRCNCT,PRSD,PRSD_SV,"2025-05-18 21:19:39",269,145,114,31,0,143,2,296,151,84,59
38,TULCEA,"ŞCOALA CU CLASELE I-IV CAUGAGIA",78,BAIA,159785,1,PART,PRCNCT,PRSD,PRSD_SV,"2025-05-18 21:23:10",170,98,75,23,0,96,2,187,89,64,32
38,TULCEA,"ŞCOALA GIMNAZIALĂ CEAMURLIA DE SUS",79,BAIA,159785,1,PART,PRCNCT,PRSD,PRSD_SV,"2025-05-18 21:15:11",511,177,150,27,0,176,1,562,385,137,39
38,TULCEA,"ŞCOALA PRIMARĂ PANDURU",80,BAIA,159785,1,PART,PRCNCT,PRSD,PRSD_SV,"2025-05-18 21:30:08",331,178,146,31,1,173,5,364,186,101,72
38,TULCEA,"ȘCOALA GIMNAZIALĂ BEIDAUD",81,BEIDAUD,159847,1,PART,PRCNCT,PRSD,PRSD_SV,"2025-05-18 21:34:50",413,220,189,30,1,218,2,455,235,168,50
38,TULCEA,"ȘCOALA GIMNAZIALĂ NEATÂRNAREA",82,BEIDAUD,159847,1,PART,PRCNCT,PRSD,PRSD_SV,"2025-05-18 21:32:43",369,157,129,28,0,155,2,405,248,134,21
38,TULCEA,"ȘCOALA GIMNAZIALĂ SARIGHIOL DE DEAL",83,BEIDAUD,159847,1,PART,PRCNCT,PRSD,PRSD_SV,"2025-05-18 21:24:27",473,200,174,26,0,198,2,520,320,167,31
38,TULCEA,"ŞCOALA GIMNAZIALĂ BEŞTEPE",84,BEŞTEPE,161552,1,PART,PRCNCT,PRSD,PRSD_SV,"2025-05-18 22:16:43",1335,708,551,154,3,705,3,1449,741,441,264
38,TULCEA,ŞCOALA,85,BEŞTEPE,161552,1,PART,PRCNCT,PRSD,PRSD_SV,"2025-05-18 21:26:44",59,47,20,27,0,47,0,83,36,25,22
38,TULCEA,"ŞCOALA GIMNAZIALĂ CARCALIU",86,CARCALIU,159945,1,PART,PRCNCT,PRSD,PRSD_SV,"2025-05-18 21:59:42",1297,348,321,27,0,343,5,1425,1077,258,85
38,TULCEA,"ŞCOALA GIMNAZIALĂ CARCALIU",87,CARCALIU,159945,1,PART,PRCNCT,PRSD,PRSD_SV,"2025-05-18 21:55:41",1065,367,306,61,0,362,5,1170,803,248,114
38,TULCEA,"ŞCOALA GIMNAZIALĂ",88,"C.A. ROSETTI",159883,1,PART,PRCNCT,PRSD,PRSD_SV,"2025-05-18 21:21:55",193,99,67,32,0,97,2,212,113,61,36
38,TULCEA,"ŞCOALA PRIMARĂ",89,"C.A. ROSETTI",159883,1,PART,PRCNCT,PRSD,PRSD_SV,"2025-05-18 21:24:27",219,112,79,33,0,110,2,241,129,74,36
38,TULCEA,"ŞCOALA PRIMARĂ",90,"C.A. ROSETTI",159883,1,PART,PRCNCT,PRSD,PRSD_SV,"2025-05-18 21:17:00",144,79,56,23,0,79,0,158,79,42,37
38,TULCEA,"ŞCOALA GIMNAZIALĂ",91,CASIMCEA,159963,1,PART,PRCNCT,PRSD,PRSD_SV,"2025-05-18 22:35:17",1075,526,466,60,0,518,8,1161,635,380,138
38,TULCEA,ŞCOALA,92,CASIMCEA,159963,2,PART,PRCNCT,PRSD,PRSD_SV,"2025-05-19 00:28:29",26,29,18,11,0,29,0,50,21,18,11
38,TULCEA,"ŞCOALA PRIMARĂ",93,CASIMCEA,159963,1,PART,PRCNCT,PRSD,PRSD_SV,"2025-05-18 22:03:22",317,153,128,25,0,148,5,348,195,108,40
38,TULCEA,"ŞCOALA PRIMARĂ",94,CASIMCEA,159963,1,PART,PRCNCT,PRSD,PRSD_SV,"2025-05-18 21:26:32",247,132,106,26,0,132,0,271,139,100,32
38,TULCEA,"ŞCOALA PRIMARĂ",95,CASIMCEA,159963,1,PART,PRCNCT,PRSD,PRSD_SV,"2025-05-18 21:39:56",486,247,225,22,0,246,1,534,287,165,81
38,TULCEA,"ȘCOALA GIMNAZIALĂ CEAMURLIA DE JOS",96,"CEAMURLIA DE JOS",160092,1,PART,PRCNCT,PRSD,PRSD_SV,"2025-05-18 21:24:22",946,478,423,54,1,469,9,1041,563,370,99
38,TULCEA,"ŞCOALA PRIMARĂ LUNCA",97,"CEAMURLIA DE JOS",160092,1,PART,PRCNCT,PRSD,PRSD_SV,"2025-05-18 21:35:33",1007,491,415,75,1,487,4,1109,618,319,168
38,TULCEA,"CĂMINUL CULTURAL",98,CEATALCHIOI,160047,1,PART,PRCNCT,PRSD,PRSD_SV,"2025-05-18 21:35:05",352,221,157,63,1,217,4,387,166,157,60
38,TULCEA,"ŞCOALA VECHE",99,CEATALCHIOI,160047,1,PART,PRCNCT,PRSD,PRSD_SV,"2025-05-18 21:22:32",162,95,66,29,0,93,2,178,83,51,42
38,TULCEA,"ŞCOALA VECHE",100,CEATALCHIOI,160047,1,PART,PRCNCT,PRSD,PRSD_SV,"2025-05-18 21:23:14",25,31,10,21,0,31,0,50,19,14,17
38,TULCEA,"ŞCOALA GIMNAZIALĂ ”PANAIT CERNA”",101,CERNA,160127,1,PART,PRCNCT,PRSD,PRSD_SV,"2025-05-18 21:58:06",1571,684,603,81,0,680,4,1704,1020,419,261
38,TULCEA,"ŞCOALA GENERAL PRAPORGESCU",102,CERNA,160127,1,PART,PRCNCT,PRSD,PRSD_SV,"2025-05-18 21:22:43",148,66,50,16,0,64,2,164,98,30,34
38,TULCEA,"CĂMIN CULTURAL MIRCEA VODĂ",103,CERNA,160127,1,PART,PRCNCT,PRSD,PRSD_SV,"2025-05-18 21:45:28",393,178,155,23,0,178,0,432,254,122,56
38,TULCEA,"CĂMINUL CULTURAL",104,CERNA,160127,1,PART,PRCNCT,PRSD,PRSD_SV,"2025-05-18 21:56:50",769,374,325,49,0,368,6,845,471,285,83
38,TULCEA,"CĂMIN CULTURAL",105,"CHILIA VECHE",160172,1,PART,PRCNCT,PRSD,PRSD_SV,"2025-05-18 21:38:56",719,378,286,48,44,373,5,790,412,244,129
38,TULCEA,"CĂMIN CULTURAL",106,"CHILIA VECHE",160172,1,PART,PRCNCT,PRSD,PRSD_SV,"2025-05-18 21:54:06",763,401,312,89,0,398,3,838,437,233,165
38,TULCEA,"ŞCOALA GIMNAZIALĂ",107,CIUCUROVA,160225,1,PART,PRCNCT,PRSD,PRSD_SV,"2025-05-18 21:43:57",1144,496,431,65,0,488,8,1257,761,357,131
38,TULCEA,"ŞCOALA PRIMARĂ",108,CIUCUROVA,160225,1,PART,PRCNCT,PRSD,PRSD_SV,"2025-05-18 21:25:54",147,74,50,24,0,74,0,162,88,52,22
38,TULCEA,"GRĂDINIȚA CU PROGRAM NORMAL",109,CIUCUROVA,160225,1,PART,PRCNCT,PRSD,PRSD_SV,"2025-05-18 21:22:10",400,189,160,29,0,186,3,440,251,121,65
38,TULCEA,"ŞCOALA GIMNAZIALĂ CRISAN",110,CRIŞAN,160261,1,PART,PRCNCT,PRSD,PRSD_SV,"2025-05-18 22:23:20",363,433,187,246,0,430,3,450,17,187,243
38,TULCEA,"ȘCOALA GIMNAZIALĂ CARAORMAN",111,CRIŞAN,160261,1,PART,PRCNCT,PRSD,PRSD_SV,"2025-05-18 21:36:10",202,141,109,32,0,139,2,170,29,68,71
38,TULCEA,"ŞCOALA GIMNAZIALĂ MILA23",112,CRIŞAN,160261,1,PART,PRCNCT,PRSD,PRSD_SV,"2025-05-18 21:52:52",369,433,226,207,0,429,4,475,42,250,179
38,TULCEA,"CĂMIN CULTURAL",113,DĂENI,160305,1,PART,PRCNCT,PRSD,PRSD_SV,"2025-05-18 22:01:09",1515,736,640,95,1,731,5,1647,911,521,210
38,TULCEA,"SCOALA GIMNAZIALA DOROBANTU",114,DOROBANŢU,160323,1,PART,PRCNCT,PRSD,PRSD_SV,"2025-05-18 21:23:50",608,287,258,29,0,285,2,668,381,201,84
38,TULCEA,"CĂMIN CULTURAL",115,DOROBANŢU,160323,1,PART,PRCNCT,PRSD,PRSD_SV,"2025-05-18 21:41:19",320,129,108,21,0,128,1,355,226,74,54
38,TULCEA,"ȘCOALA MEȘTERU",116,DOROBANŢU,160323,1,PART,PRCNCT,PRSD,PRSD_SV,"2025-05-18 21:30:52",90,72,45,27,0,71,1,99,27,57,14
38,TULCEA,"CAMIN CULTURAL FRECATEI",117,FRECĂŢEI,160387,1,PART,PRCNCT,PRSD,PRSD_SV,"2025-05-18 22:12:13",966,528,432,96,0,521,7,1064,536,339,182
38,TULCEA,"CENTRU MULTIFUNCȚIONAL CATALOI",118,FRECĂŢEI,160387,1,PART,PRCNCT,PRSD,PRSD_SV,"2025-05-18 22:04:22",1001,545,429,116,0,537,8,1098,553,291,246
38,TULCEA,"CAMIN CULTURAL POSTA",119,FRECĂŢEI,160387,1,PART,PRCNCT,PRSD,PRSD_SV,"2025-05-18 21:51:21",513,349,256,93,0,341,8,566,217,227,114
38,TULCEA,"CĂMIN CULTURAL TELIȚA",120,FRECĂŢEI,160387,1,PART,PRCNCT,PRSD,PRSD_SV,"2025-05-18 21:47:44",436,251,186,65,0,250,1,479,228,149,101
38,TULCEA,"CĂMINUL CULTURAL GRECI",121,GRECI,160430,1,PART,PRCNCT,PRSD,PRSD_SV,"2025-05-18 22:35:26",1427,735,582,150,3,726,9,1568,833,415,311
38,TULCEA,"ŞCOALA GIMNAZIALĂ GRECI, CORP B",122,GRECI,160430,1,PART,PRCNCT,PRSD,PRSD_SV,"2025-05-18 21:53:46",1482,705,643,62,0,698,7,1633,928,438,260
38,TULCEA,"ŞCOALA GIMNAZIALĂ GRECI, CORP B",123,GRECI,160430,1,PART,PRCNCT,PRSD,PRSD_SV,"2025-05-18 22:02:26",1180,507,452,54,1,503,4,1297,790,297,206
38,TULCEA,"CENTRUL SOCIAL DE ZI PENTRU PERSOANE DEFAVORIZATE",124,GRINDU,160458,1,PART,PRCNCT,PRSD,PRSD_SV,"2025-05-18 22:26:48",1049,563,453,99,11,561,2,1155,592,417,144
38,TULCEA,"ȘCOALA GIMNAZIALĂ HAMCEARCA",125,HAMCEARCA,160476,1,PART,PRCNCT,PRSD,PRSD_SV,"2025-05-18 21:37:16",248,123,87,36,0,123,0,273,150,81,42
38,TULCEA,"GRĂDINIȚA CU PROGRAM NORMAL",126,HAMCEARCA,160476,2,PART,PRCNCT,PRSD,PRSD_SV,"2025-05-18 23:14:29",267,179,127,51,1,176,3,293,114,110,66
38,TULCEA,"GRĂDINIȚA CU PROGRAM NORMAL",127,HAMCEARCA,160476,1,PART,PRCNCT,PRSD,PRSD_SV,"2025-05-18 21:37:39",483,238,196,42,0,236,2,531,293,159,77
38,TULCEA,"GRĂDINIȚA CU PROGRAM NORMAL",128,HORIA,160528,1,PART,PRCNCT,PRSD,PRSD_SV,"2025-05-18 22:04:53",796,417,342,72,3,410,7,875,458,273,137
38,TULCEA,"ŞCOALA CU CLASELE I-IV",129,HORIA,160528,1,PART,PRCNCT,PRSD,PRSD_SV,"2025-05-18 21:28:11",77,44,26,18,0,43,1,85,41,29,14
38,TULCEA,"GRADINITA FLORESTI",130,HORIA,160528,1,PART,PRCNCT,PRSD,PRSD_SV,"2025-05-18 21:31:27",198,93,63,29,1,93,0,218,125,67,26
38,TULCEA,"CĂMINUL CULTURAL",131,I.C.BRĂTIANU,161525,1,PART,PRCNCT,PRSD,PRSD_SV,"2025-05-18 22:05:14",901,586,454,132,0,584,2,991,405,391,193
38,TULCEA,"ŞCOALA GIMNAZIALĂ",132,IZVOARELE,160564,1,PART,PRCNCT,PRSD,PRSD_SV,"2025-05-18 22:16:25",1187,594,482,111,1,590,4,1304,710,356,234
38,TULCEA,"ŞCOALA PRIMARĂ",133,IZVOARELE,160564,1,PART,PRCNCT,PRSD,PRSD_SV,"2025-05-18 21:33:29",180,126,79,47,0,126,0,197,71,81,45
38,TULCEA,"ŞCOALA PRIMARĂ",134,IZVOARELE,160564,1,PART,PRCNCT,PRSD,PRSD_SV,"2025-05-18 21:34:03",237,135,91,44,0,135,0,262,127,100,35
38,TULCEA,"ȘCOALA GIMNAZIALĂ JIJILA",135,JIJILA,160617,1,PART,PRCNCT,PRSD,PRSD_SV,"2025-05-18 21:57:24",1794,909,885,23,1,904,5,1971,1062,535,369
38,TULCEA,"ȘCOALA GIMNAZIALĂ JIJILA (CORP GRĂDINIȚA CU PROGRAM NORMAL JIJILA)",136,JIJILA,160617,1,PART,PRCNCT,PRSD,PRSD_SV,"2025-05-18 22:16:24",1577,863,795,68,0,860,3,1733,870,488,372
38,TULCEA,"CĂMINUL CULTURAL",137,JIJILA,160617,1,PART,PRCNCT,PRSD,PRSD_SV,"2025-05-18 21:59:57",1008,537,465,71,1,536,1,1108,571,320,216
38,TULCEA,"ȘCOALA GIMNAZIALĂ JURILOVCA",138,JURILOVCA,160644,1,PART,PRCNCT,PRSD,PRSD_SV,"2025-05-18 21:38:08",891,546,396,148,2,537,9,981,435,333,204
38,TULCEA,"CĂMINUL CULTURAL JURILOVCA",139,JURILOVCA,160644,1,PART,PRCNCT,PRSD,PRSD_SV,"2025-05-18 21:38:21",1013,510,414,93,3,498,12,1113,603,296,202
38,TULCEA,"CĂMINUL CULTURAL",140,JURILOVCA,160644,1,PART,PRCNCT,PRSD,PRSD_SV,"2025-05-18 21:44:42",992,613,510,93,10,605,8,1090,477,418,187
38,TULCEA,"ȘCOALA PRIMARĂ VIȘINA",141,JURILOVCA,160644,1,PART,PRCNCT,PRSD,PRSD_SV,"2025-05-18 21:41:42",550,354,258,91,5,353,1,604,250,250,103
38,TULCEA,"CĂMIN CULTURAL",142,LUNCAVIŢA,160680,1,PART,PRCNCT,PRSD,PRSD_SV,"2025-05-18 21:59:54",1604,778,667,111,0,774,4,1759,981,476,298
38,TULCEA,"CĂMIN CULTURAL",143,LUNCAVIŢA,160680,1,PART,PRCNCT,PRSD,PRSD_SV,"2025-05-18 21:58:45",1282,562,495,67,0,558,4,1409,847,341,217
38,TULCEA,"CASA PRAZNICALĂ",144,LUNCAVIŢA,160680,1,PART,PRCNCT,PRSD,PRSD_SV,"2025-05-18 21:40:17",608,321,240,81,0,321,0,668,347,174,147
38,TULCEA,"GRĂDINIȚA DE COPII CORP 2",145,MAHMUDIA,160724,1,PART,PRCNCT,PRSD,PRSD_SV,"2025-05-18 21:34:13",994,569,439,127,3,563,6,1092,523,309,254
38,TULCEA,"GRĂDINIȚA DE COPII CORP 2",146,MAHMUDIA,160724,1,PART,PRCNCT,PRSD,PRSD_SV,"2025-05-18 21:58:06",1044,607,494,110,3,601,6,1151,544,338,263
38,TULCEA,"CĂMIN CULTURAL MALIUC",147,MALIUC,160779,1,PART,PRCNCT,PRSD,PRSD_SV,"2025-05-18 21:19:47",285,168,132,35,1,166,2,265,97,99,67
38,TULCEA,"ȘCOALA PRIMARĂ GORGOVA",148,MALIUC,160779,1,PART,PRCNCT,PRSD,PRSD_SV,"2025-05-18 21:24:02",108,101,54,47,0,99,2,150,49,55,44
38,TULCEA,"ŞCOALA GIMNAZIALĂ ”IOAN NENIȚESCU ” PARTIZANI",149,MALIUC,160779,1,PART,PRCNCT,PRSD,PRSD_SV,"2025-05-18 21:24:26",309,196,153,41,2,196,0,340,144,111,85
38,TULCEA,"ȘCOALA GIMNAZIALĂ MIHAI BRAVU",150,"MIHAI BRAVU",160831,1,PART,PRCNCT,PRSD,PRSD_SV,"2025-05-18 21:34:20",526,215,172,42,1,215,0,578,363,163,52
38,TULCEA,"CĂMINUL CULTURAL SATU NOU",151,"MIHAI BRAVU",160831,1,PART,PRCNCT,PRSD,PRSD_SV,"2025-05-18 21:27:31",558,302,245,55,2,300,2,613,311,217,83
38,TULCEA,"ȘCOALA GIMNAZIALĂ TURDA",152,"MIHAI BRAVU",160831,1,PART,PRCNCT,PRSD,PRSD_SV,"2025-05-18 22:11:41",982,451,382,69,0,449,2,1079,628,310,139
38,TULCEA,"ŞCOALA GIMNAZIALĂ MIHAIL KOGĂLNICEANU",153,"MIHAIL KOGĂLNICEANU",160877,1,PART,PRCNCT,PRSD,PRSD_SV,"2025-05-18 21:48:55",1630,822,697,122,3,812,10,1791,969,570,242
38,TULCEA,"GRĂDINIȚA CU PROGRAM NORMAL LĂSTUNI",154,"MIHAIL KOGĂLNICEANU",160877,1,PART,PRCNCT,PRSD,PRSD_SV,"2025-05-18 22:13:10",372,179,155,24,0,177,2,409,230,130,47
38,TULCEA,"GRĂDINIȚA CU PROGRAM NORMAL RÂNDUNICA",155,"MIHAIL KOGĂLNICEANU",160877,1,PART,PRCNCT,PRSD,PRSD_SV,"2025-05-18 21:47:33",489,234,195,38,1,233,1,537,303,176,57
38,TULCEA,"CĂMIN CULTURAL MURIGHIOL",156,MURIGHIOL,160911,1,PART,PRCNCT,PRSD,PRSD_SV,"2025-05-18 22:18:32",1196,1024,562,462,0,1012,12,1314,290,548,464
38,TULCEA,"IMOBIL PROPRIETATE PRIVATĂ (FOST SPAȚIU COMERCIAL)",157,MURIGHIOL,160911,1,PART,PRCNCT,PRSD,PRSD_SV,"2025-05-18 21:27:47",102,84,55,29,0,84,0,112,28,56,28
38,TULCEA,"ŞCOALA PRIMARĂ DUNAVĂȚU DE JOS",158,MURIGHIOL,160911,1,PART,PRCNCT,PRSD,PRSD_SV,"2025-05-18 21:41:10",515,481,270,210,1,475,6,564,83,258,217
38,TULCEA,"ŞCOALA CU CLASELE I-IV DUNAVĂȚU DE SUS",159,MURIGHIOL,160911,1,PART,PRCNCT,PRSD,PRSD_SV,"2025-05-18 21:29:33",126,92,57,35,0,92,0,140,48,67,25
38,TULCEA,"ŞCOALA CU CLASELE I-IV PLOPUL",160,MURIGHIOL,160911,1,PART,PRCNCT,PRSD,PRSD_SV,"2025-05-18 21:33:10",465,221,164,57,0,216,5,511,290,140,76
38,TULCEA,"CĂMIN CULTURAL SARINASUF",161,MURIGHIOL,160911,1,PART,PRCNCT,PRSD,PRSD_SV,"2025-05-18 21:30:33",331,203,156,47,0,201,2,364,161,137,64
38,TULCEA,"ŞCOALA GIMNAZIALĂ NALBANT",162,NALBANT,160993,1,PART,PRCNCT,PRSD,PRSD_SV,"2025-05-18 21:48:48",762,349,299,50,0,342,7,838,489,252,90
38,TULCEA,"ȘCOALA PRIMARĂ NICOLAE BĂLCESCU",163,NALBANT,160993,1,PART,PRCNCT,PRSD,PRSD_SV,"2025-05-18 21:37:21",1017,411,369,42,0,409,2,1117,706,368,41
38,TULCEA,"CĂMINUL CULTURAL TRESTENIC",164,NALBANT,160993,1,PART,PRCNCT,PRSD,PRSD_SV,"2025-05-18 21:30:49",278,152,124,28,0,151,1,309,157,113,38
38,TULCEA,"PRIMĂRIA COMUNEI NICULIȚEL",165,NICULIŢEL,161035,1,PART,PRCNCT,PRSD,PRSD_SV,"2025-05-18 22:30:13",1238,637,532,105,0,628,9,1358,721,443,185
38,TULCEA,"ŞCOALA GIMNAZIALĂ ”NICHIFOR LUDOVIG”",166,NICULIŢEL,161035,1,PART,PRCNCT,PRSD,PRSD_SV,"2025-05-18 21:58:46",1149,525,472,52,1,520,5,1263,738,377,143
38,TULCEA,"GRĂDINIŢA CU PROGRAM NORMAL",167,NICULIŢEL,161035,1,PART,PRCNCT,PRSD,PRSD_SV,"2025-05-18 22:34:31",1194,590,515,75,0,586,4,1313,723,423,163
38,TULCEA,"CĂMINUL CULTURAL NUFĂRU",168,NUFĂRU,161053,2,PART,PRCNCT,PRSD,PRSD_SV,"2025-05-18 22:30:23",1009,547,424,123,0,543,4,1109,562,314,229
38,TULCEA,"CENTRUL CULTURAL ADMINISTRATIV SOCIAL",169,NUFĂRU,161053,1,PART,PRCNCT,PRSD,PRSD_SV,"2025-05-18 21:33:35",1103,572,486,86,0,571,1,1211,639,355,216
38,TULCEA,"ŞCOALA CU CLASELE I-IV",170,NUFĂRU,161053,1,PART,PRCNCT,PRSD,PRSD_SV,"2025-05-18 21:26:31",185,121,79,42,0,119,2,204,83,71,48
38,TULCEA,"GRĂDINIŢA DE COPII OSTROV",171,OSTROV,161106,2,PART,PRCNCT,PRSD,PRSD_SV,"2025-05-19 00:38:15",1486,627,567,59,1,623,4,1633,1006,394,229
38,TULCEA,"CAMINUL CULTURAL",172,PARDINA,161133,1,PART,PRCNCT,PRSD,PRSD_SV,"2025-05-18 21:39:11",449,229,165,64,0,228,1,497,268,160,68
38,TULCEA,"CĂMINUL CULTURAL",173,PECENEAGA,161151,1,PART,PRCNCT,PRSD,PRSD_SV,"2025-05-18 21:43:32",1308,688,561,116,11,683,5,1434,746,460,223
38,TULCEA,"ŞCOALA GIMNAZIALĂ SARICHIOI",174,SARICHIOI,161179,1,PART,PRCNCT,PRSD,PRSD_SV,"2025-05-18 21:51:27",1465,645,583,62,0,636,9,1610,965,440,196
38,TULCEA,"ŞCOALA GIMNAZIALĂ SARICHIOI",175,SARICHIOI,161179,1,PART,PRCNCT,PRSD,PRSD_SV,"2025-05-18 21:41:46",1345,570,507,63,0,567,3,1479,909,396,171
38,TULCEA,"ŞCOALA PRIMARĂ ENISALA",176,SARICHIOI,161179,1,PART,PRCNCT,PRSD,PRSD_SV,"2025-05-18 21:48:24",750,432,364,68,0,427,5,824,392,293,134
38,TULCEA,"GRĂDINIȚA CU PROGRAM NORMAL SABANGIA",177,SARICHIOI,161179,1,PART,PRCNCT,PRSD,PRSD_SV,"2025-05-18 21:23:41",432,270,188,82,0,268,2,476,206,161,107
38,TULCEA,"GRĂDINIȚA CU PROGRAM NORMAL VISTERNA",178,SARICHIOI,161179,1,PART,PRCNCT,PRSD,PRSD_SV,"2025-05-18 21:40:27",314,144,113,31,0,144,0,346,202,114,30
38,TULCEA,"ȘCOALA GIMNAZIALĂ ZEBIL",179,SARICHIOI,161179,1,PART,PRCNCT,PRSD,PRSD_SV,"2025-05-18 21:51:30",1042,545,413,131,1,535,10,1147,602,346,189
38,TULCEA,"CAMIN CULTURAL",180,"SFÂNTU GHEORGHE",161231,1,PART,PRCNCT,PRSD,PRSD_SV,"2025-05-18 22:21:54",673,462,316,144,2,458,4,743,281,220,238
38,TULCEA,"CONSILIUL LOCAL",181,"SLAVA CERCHEZĂ",161259,1,PART,PRCNCT,PRSD,PRSD_SV,"2025-05-18 21:36:45",957,395,295,100,0,391,4,1052,657,254,137
38,TULCEA,"CĂMINUL CULTURAL",182,"SLAVA CERCHEZĂ",161259,2,PART,PRCNCT,PRSD,PRSD_SV,"2025-05-18 23:13:10",884,379,294,85,0,376,3,971,592,283,93
38,TULCEA,"ŞCOALA GIMNAZIALĂ ”MAIOR IOAN MURGESCU”",183,SMÂRDAN,161286,1,PART,PRCNCT,PRSD,PRSD_SV,"2025-05-18 21:48:57",868,477,420,55,2,472,5,954,477,338,134
38,TULCEA,"ȘCOALA GIMNAZIALĂ ”TRAIAN COȘOVEI” SOMOVA",184,SOMOVA,161302,1,PART,PRCNCT,PRSD,PRSD_SV,"2025-05-18 21:35:29",927,542,444,98,0,539,3,1021,479,310,229
38,TULCEA,"ȘCOALA GIMNAZIALĂ ”TRAIAN COȘOVEI’’ SOMOVA",185,SOMOVA,161302,1,PART,PRCNCT,PRSD,PRSD_SV,"2025-05-18 21:42:57",1104,609,517,91,1,604,5,1214,605,335,269
38,TULCEA,"ŞCOALA GIMNAZIALĂ MINERI",186,SOMOVA,161302,1,PART,PRCNCT,PRSD,PRSD_SV,"2025-05-18 21:53:53",1669,913,803,109,1,906,7,1834,921,491,415
38,TULCEA,"GRĂDINIȚA CU PROGRAM NORMAL PARCHEȘ",187,SOMOVA,161302,1,PART,PRCNCT,PRSD,PRSD_SV,"2025-05-18 21:38:10",636,320,263,57,0,318,2,699,379,191,127
38,TULCEA,"CĂMINUL CULTURAL",188,STEJARU,161348,1,PART,PRCNCT,PRSD,PRSD_SV,"2025-05-18 21:35:53",465,282,211,43,28,282,0,512,230,125,157
38,TULCEA,"GRĂDINIȚA CU PROGRAM NORMAL MINA ALTÂN-TEPE",189,STEJARU,161348,1,PART,PRCNCT,PRSD,PRSD_SV,"2025-05-18 21:24:14",306,144,110,28,6,141,3,337,193,96,45
38,TULCEA,"GRĂDINIȚA CU PROGRAM NORMAL VASILE ALECSANDRI",190,STEJARU,161348,1,PART,PRCNCT,PRSD,PRSD_SV,"2025-05-18 21:34:23",400,198,169,26,3,197,1,440,242,149,48
38,TULCEA,"LICEUL TEHNOLOGIC TOPOLOG",191,TOPOLOG,161384,1,PART,PRCNCT,PRSD,PRSD_SV,"2025-05-18 21:24:18",918,452,409,41,2,442,10,1009,557,297,145
38,TULCEA,"LICEUL TEHNOLOGIC TOPOLOG",192,TOPOLOG,161384,1,PART,PRCNCT,PRSD,PRSD_SV,"2025-05-18 21:28:46",978,518,456,61,1,512,6,1075,557,340,172
38,TULCEA,"GRĂDINIȚA CU PROGRAM NORMAL CALFA",193,TOPOLOG,161384,1,PART,PRCNCT,PRSD,PRSD_SV,"2025-05-18 21:13:18",100,58,42,16,0,56,2,120,62,40,16
38,TULCEA,"ŞCOALA PRIMARĂ CERBU",194,TOPOLOG,161384,1,PART,PRCNCT,PRSD,PRSD_SV,"2025-05-18 21:27:03",170,87,67,20,0,86,1,188,101,60,26
38,TULCEA,"ŞCOALA GIMNAZIALĂ FĂGĂRAȘU NOU",195,TOPOLOG,161384,1,PART,PRCNCT,PRSD,PRSD_SV,"2025-05-18 21:38:52",470,276,227,49,0,274,2,516,240,198,76
38,TULCEA,"GRĂDINIȚA CU PROGRAM NORMAL LUMINIȚA",196,TOPOLOG,161384,1,PART,PRCNCT,PRSD,PRSD_SV,"2025-05-18 21:17:32",190,96,79,17,0,95,1,209,113,58,37
38,TULCEA,"GRĂDINIȚA CU PROGRAM NORMAL MĂGURELE",197,TOPOLOG,161384,1,PART,PRCNCT,PRSD,PRSD_SV,"2025-05-18 21:29:23",177,103,86,17,0,100,3,195,92,56,44
38,TULCEA,"ŞCOALA PRIMARĂ SÂMBĂTA NOUĂ",198,TOPOLOG,161384,1,PART,PRCNCT,PRSD,PRSD_SV,"2025-05-18 21:31:04",411,244,199,45,0,242,2,452,208,170,72
38,TULCEA,"ŞCOALA GIMNAZIALĂ ”DOBRE VLĂDESCU” TURCOAIA",199,TURCOAIA,161464,1,PART,PRCNCT,PRSD,PRSD_SV,"2025-05-18 22:06:02",1388,701,639,61,1,697,4,1526,825,471,226
38,TULCEA,"SCOALĂ GIMNAZIALĂ ” DOBRE VLĂDESCU” TURCOAIA",200,TURCOAIA,161464,1,PART,PRCNCT,PRSD,PRSD_SV,"2025-05-18 21:55:35",1153,558,520,29,9,556,2,1267,709,384,172
38,TULCEA,"CĂMINUL CULTURAL",201,"VALEA NUCARILOR",161482,1,PART,PRCNCT,PRSD,PRSD_SV,"2025-05-18 21:54:01",783,491,340,150,1,484,7,860,369,296,188
38,TULCEA,"CĂMINUL CULTURAL AGIGHIOL",202,"VALEA NUCARILOR",161482,1,PART,PRCNCT,PRSD,PRSD_SV,"2025-05-18 22:03:42",1317,705,581,121,3,695,10,1447,742,484,211
38,TULCEA,"CĂMIN CULTURAL IAZURILE",203,"VALEA NUCARILOR",161482,1,PART,PRCNCT,PRSD,PRSD_SV,"2025-05-18 21:25:30",619,344,251,93,0,338,6,683,339,204,134
38,TULCEA,"ŞCOALA GIMNAZIALĂ ”MIHAI EMINESCU” VALEA TEILOR",204,"VALEA TEILOR",161561,1,PART,PRCNCT,PRSD,PRSD_SV,"2025-05-18 22:27:11",1085,530,466,64,0,525,5,1193,663,430,95
38,TULCEA,"CĂMINUL CULTURAL VĂCĂRENI",205,VĂCĂRENI,161543,1,PART,PRCNCT,PRSD,PRSD_SV,"2025-05-18 22:06:13",1754,940,849,89,2,935,5,1923,983,547,388
39,VASLUI,"CASA DE CULTURĂ A SINDICATELOR ”CONSTANTIN TĂNASE”",1,"MUNICIPIUL VASLUI",161945,1,PART,PRCNCT,PRSD,PRSD_SV,"2025-05-18 22:15:54",1372,793,674,119,0,783,10,1400,607,234,549
39,VASLUI,"CASA DE CULTURĂ A SINDICATELOR ”CONSTANTIN TĂNASE”",2,"MUNICIPIUL VASLUI",161945,1,PART,PRCNCT,PRSD,PRSD_SV,"2025-05-18 22:19:07",1495,706,615,91,0,701,5,1600,894,220,481
39,VASLUI,"CENTRUL JUDEȚEAN DE RESURSE ȘI ASISTENȚĂ EDUCAȚIONALĂ",3,"MUNICIPIUL VASLUI",161945,1,PART,PRCNCT,PRSD,PRSD_SV,"2025-05-18 21:48:55",1794,164,150,14,0,162,2,2000,1836,49,113
39,VASLUI,"CENTRUL JUDEȚEAN DE RESURSE ȘI ASISTENȚĂ EDUCAȚIONALĂ",4,"MUNICIPIUL VASLUI",161945,1,PART,PRCNCT,PRSD,PRSD_SV,"2025-05-18 21:23:53",1694,21,9,12,0,20,1,1700,1679,9,11
39,VASLUI,"LICEUL TEORETIC ”MIHAIL KOGĂLNICEANU”",5,"MUNICIPIUL VASLUI",161945,1,PART,PRCNCT,PRSD,PRSD_SV,"2025-05-18 22:15:52",1593,466,446,20,0,461,5,1600,1134,173,288
39,VASLUI,"LICEUL TEORETIC ”MIHAIL KOGĂLNICEANU”",6,"MUNICIPIUL VASLUI",161945,1,PART,PRCNCT,PRSD,PRSD_SV,"2025-05-18 22:06:14",1612,286,277,7,2,286,0,1700,1414,107,179
39,VASLUI,"LICEUL TEORETIC ”MIHAIL KOGĂLNICEANU”",7,"MUNICIPIUL VASLUI",161945,2,PART,PRCNCT,PRSD,PRSD_SV,"2025-05-18 22:12:53",1763,51,37,14,0,51,0,1800,1749,15,36
39,VASLUI,"LICEUL TEORETIC ”MIHAIL KOGĂLNICEANU”",8,"MUNICIPIUL VASLUI",161945,1,PART,PRCNCT,PRSD,PRSD_SV,"2025-05-18 21:15:20",1697,31,0,31,0,31,0,1700,1669,9,22
39,VASLUI,"LICEUL TEORETIC ”MIHAIL KOGĂLNICEANU”",9,"MUNICIPIUL VASLUI",161945,1,PART,PRCNCT,PRSD,PRSD_SV,"2025-05-18 21:22:41",1613,49,0,36,13,49,0,1700,1651,20,29
39,VASLUI,"GRĂDINIȚA CU PROGRAM PRELUNGIT NR.14",10,"MUNICIPIUL VASLUI",161945,1,PART,PRCNCT,PRSD,PRSD_SV,"2025-05-18 22:14:33",1002,487,462,25,0,481,6,1200,713,158,323
39,VASLUI,"GRĂDINIȚA CU PROGRAM PRELUNGIT NR.14",11,"MUNICIPIUL VASLUI",161945,1,PART,PRCNCT,PRSD,PRSD_SV,"2025-05-18 21:56:17",974,453,427,26,0,446,7,1000,547,154,292
39,VASLUI,"GRĂDINIȚA CU PROGRAM PRELUNGIT NR.15",12,"MUNICIPIUL VASLUI",161945,1,PART,PRCNCT,PRSD,PRSD_SV,"2025-05-18 22:14:52",1412,619,581,37,1,609,10,1600,981,226,383
39,VASLUI,"ȘCOALA GIMNAZIALĂ ”CONSTANTIN PARFENE”",13,"MUNICIPIUL VASLUI",161945,1,PART,PRCNCT,PRSD,PRSD_SV,"2025-05-18 21:21:29",1755,141,118,21,2,141,0,1800,1659,45,96
39,VASLUI,"ȘCOALA GIMNAZIALĂ ”CONSTANTIN PARFENE”",14,"MUNICIPIUL VASLUI",161945,1,PART,PRCNCT,PRSD,PRSD_SV,"2025-05-18 21:28:47",1560,205,185,20,0,204,1,1600,1395,93,111
39,VASLUI,"ȘCOALA GIMNAZIALĂ ”CONSTANTIN PARFENE”",15,"MUNICIPIUL VASLUI",161945,1,PART,PRCNCT,PRSD,PRSD_SV,"2025-05-18 21:32:20",1600,225,102,13,110,221,4,1600,1375,146,75
39,VASLUI,"ȘCOALA GIMNAZIALĂ ”CONSTANTIN PARFENE”",16,"MUNICIPIUL VASLUI",161945,1,PART,PRCNCT,PRSD,PRSD_SV,"2025-05-18 21:46:04",1840,460,450,10,0,457,3,2000,1540,183,274
39,VASLUI,"ȘCOALA GIMNAZIALĂ ”CONSTANTIN PARFENE”",17,"MUNICIPIUL VASLUI",161945,1,PART,PRCNCT,PRSD,PRSD_SV,"2025-05-18 21:31:35",1844,212,196,15,1,209,3,2000,1788,89,120
39,VASLUI,"ȘCOALA GIMNAZIALĂ ”CONSTANTIN PARFENE”",18,"MUNICIPIUL VASLUI",161945,1,PART,PRCNCT,PRSD,PRSD_SV,"2025-05-18 21:25:34",1739,98,22,9,67,97,1,1800,1702,74,23
39,VASLUI,"ȘCOALA GIMNAZIALĂ ”CONSTANTIN PARFENE”",19,"MUNICIPIUL VASLUI",161945,1,PART,PRCNCT,PRSD,PRSD_SV,"2025-05-18 21:28:11",1683,122,0,24,98,119,3,1700,1578,91,28
39,VASLUI,"GRĂDINIȚA CU PROGRAM PRELUNGIT NR.5",20,"MUNICIPIUL VASLUI",161945,1,PART,PRCNCT,PRSD,PRSD_SV,"2025-05-18 22:14:22",1709,292,268,24,0,292,0,1800,1508,133,159
39,VASLUI,"GRĂDINIȚA CU PROGRAM PRELUNGIT NR.5",21,"MUNICIPIUL VASLUI",161945,1,PART,PRCNCT,PRSD,PRSD_SV,"2025-05-18 21:23:23",1694,133,1,24,108,131,2,1700,1567,86,45
39,VASLUI,"GRĂDINIȚA CU PROGRAM PRELUNGIT NR.5",22,"MUNICIPIUL VASLUI",161945,1,PART,PRCNCT,PRSD,PRSD_SV,"2025-05-18 21:29:20",696,121,64,22,35,120,1,800,679,44,76
39,VASLUI,"GRĂDINIȚA CU PROGRAM PRELUNGIT NR.5",23,"MUNICIPIUL VASLUI",161945,1,PART,PRCNCT,PRSD,PRSD_SV,"2025-05-18 21:35:05",1685,146,1,12,133,141,5,1700,1554,103,38
39,VASLUI,"ROMSILVA - RA - FILIALA VASLUI",24,"MUNICIPIUL VASLUI",161945,1,PART,PRCNCT,PRSD,PRSD_SV,"2025-05-18 21:50:43",1702,799,746,53,0,788,11,1800,1001,281,507
39,VASLUI,"CENTRUL ŞCOLAR DE EDUCAŢIE INCLUZIVĂ ”ELISABETA POLIHRONIADE”",25,"MUNICIPIUL VASLUI",161945,1,PART,PRCNCT,PRSD,PRSD_SV,"2025-05-18 22:19:00",1894,856,850,5,1,841,15,2000,1144,312,529
39,VASLUI,"CENTRUL ŞCOLAR DE EDUCAŢIE INCLUZIVĂ ”ELISABETA POLIHRONIADE”",26,"MUNICIPIUL VASLUI",161945,1,PART,PRCNCT,PRSD,PRSD_SV,"2025-05-18 21:18:37",1721,77,14,61,2,75,2,1800,1723,32,43
39,VASLUI,"CENTRUL ȘCOLAR DE EDUCAȚIE INCLUZIVĂ ”ELISABETA POLIHRONIADE”",27,"MUNICIPIUL VASLUI",161945,1,PART,PRCNCT,PRSD,PRSD_SV,"2025-05-18 21:30:16",1655,79,63,16,0,79,0,1700,1621,25,54
39,VASLUI,"CENTRUL ŞCOLAR DE EDUCAŢIE INCLUZIVĂ ”ELISABETA POLIHRONIADE”",28,"MUNICIPIUL VASLUI",161945,1,PART,PRCNCT,PRSD,PRSD_SV,"2025-05-18 21:54:02",941,335,324,11,0,326,9,1000,665,145,181
39,VASLUI,"CENTRUL ŞCOLAR DE EDUCAŢIE INCLUZIVĂ ”ELISABETA POLIHRONIADE„",29,"MUNICIPIUL VASLUI",161945,1,PART,PRCNCT,PRSD,PRSD_SV,"2025-05-18 21:44:28",1477,369,333,36,0,363,6,1600,1231,135,228
39,VASLUI,"CENTRUL ŞCOLAR DE EDUCAŢIE INCLUZIVĂ ”ELISABETA POLIHRONIADE„",30,"MUNICIPIUL VASLUI",161945,1,PART,PRCNCT,PRSD,PRSD_SV,"2025-05-18 22:02:30",1581,543,506,37,0,537,6,1600,1057,171,366
39,VASLUI,"ȘCOALA GIMNAZIALĂ ”DIMITRIE CANTEMIR”",31,"MUNICIPIUL VASLUI",161945,1,PART,PRCNCT,PRSD,PRSD_SV,"2025-05-18 22:16:08",1704,674,656,18,0,664,10,1800,1126,255,409
39,VASLUI,"ȘCOALA GIMNAZIALĂ ”DIMITRIE CANTEMIR”",32,"MUNICIPIUL VASLUI",161945,1,PART,PRCNCT,PRSD,PRSD_SV,"2025-05-18 21:31:04",1792,114,43,71,0,112,2,2000,1886,44,68
39,VASLUI,"ȘCOALA GIMNAZIALĂ ”DIMITRIE CANTEMIR”",33,"MUNICIPIUL VASLUI",161945,1,PART,PRCNCT,PRSD,PRSD_SV,"2025-05-18 21:58:13",1664,255,240,15,0,252,3,1700,1445,95,157
39,VASLUI,"LICEUL CU PROGRAM SPORTIV",34,"MUNICIPIUL VASLUI",161945,1,PART,PRCNCT,PRSD,PRSD_SV,"2025-05-18 22:06:12",1754,727,684,43,0,720,7,2000,1273,274,446
39,VASLUI,"LICEUL CU PROGRAM SPORTIV",35,"MUNICIPIUL VASLUI",161945,1,PART,PRCNCT,PRSD,PRSD_SV,"2025-05-18 21:15:49",1807,75,21,54,0,74,1,2000,1925,39,35
39,VASLUI,"LICEUL CU PROGRAM SPORTIV",36,"MUNICIPIUL VASLUI",161945,1,PART,PRCNCT,PRSD,PRSD_SV,"2025-05-18 21:15:52",1785,17,2,15,0,17,0,1800,1783,10,7
39,VASLUI,"LICEUL CU PROGRAM SPORTIV",37,"MUNICIPIUL VASLUI",161945,1,PART,PRCNCT,PRSD,PRSD_SV,"2025-05-18 21:16:09",764,104,12,10,82,101,3,800,696,51,50
39,VASLUI,"GRADINITA CU PROGRAM PRELUNGIT NR. 6",38,"MUNICIPIUL VASLUI",161945,1,PART,PRCNCT,PRSD,PRSD_SV,"2025-05-18 21:35:19",1591,68,38,30,0,65,3,1600,1532,34,31
39,VASLUI,"GRADINITA CU PROGRAM PRELUNGIT NR.17",39,"MUNICIPIUL VASLUI",161945,1,PART,PRCNCT,PRSD,PRSD_SV,"2025-05-18 21:56:33",1743,611,561,49,1,602,9,2000,1389,262,340
39,VASLUI,"ŞCOALA GIMNAZIALĂ „STEFAN CEL MARE”,",40,"MUNICIPIUL VASLUI",161945,1,PART,PRCNCT,PRSD,PRSD_SV,"2025-05-18 21:33:36",897,407,372,35,0,402,5,900,493,144,258
39,VASLUI,"ŞCOALA GIMNAZIALĂ „STEFAN CEL MARE”,",41,"MUNICIPIUL VASLUI",161945,1,PART,PRCNCT,PRSD,PRSD_SV,"2025-05-18 21:34:15",1647,676,657,18,1,666,10,1700,1024,233,433
39,VASLUI,"ŞCOALA GIMNAZIALĂ „STEFAN CEL MARE”,",42,"MUNICIPIUL VASLUI",161945,2,PART,PRCNCT,PRSD,PRSD_SV,"2025-05-18 22:04:52",1059,187,63,44,80,185,2,1200,1013,80,105
39,VASLUI,"ȘCOALA GIMNAZIALĂ ”CONSTANTIN MOTAȘ”",43,"MUNICIPIUL VASLUI",161945,1,PART,PRCNCT,PRSD,PRSD_SV,"2025-05-18 21:21:54",829,418,371,47,0,411,7,900,482,154,257
39,VASLUI,"ȘCOALA GIMNAZIALĂ ”CONSTANTIN MOTAȘ”",44,"MUNICIPIUL VASLUI",161945,1,PART,PRCNCT,PRSD,PRSD_SV,"2025-05-18 21:29:21",1042,454,431,23,0,454,0,1200,746,177,277
39,VASLUI,"LICEUL TEORETIC „EMIL RACOVIŢĂ”",45,"MUNICIPIUL VASLUI",161945,1,PART,PRCNCT,PRSD,PRSD_SV,"2025-05-18 22:32:00",1833,866,784,82,0,856,10,2000,1134,372,484
39,VASLUI,"CENTRUL DE ZI PENTRU COPII ȘCOLARI ”BUCURIA”",46,"MUNICIPIUL VASLUI",161945,1,PART,PRCNCT,PRSD,PRSD_SV,"2025-05-18 22:43:35",1214,549,511,36,2,541,8,1300,751,193,348
39,VASLUI,"CENTRUL DE ZI PENTRU COPII ȘCOLARI ”BUCURIA”",47,"MUNICIPIUL VASLUI",161945,1,PART,PRCNCT,PRSD,PRSD_SV,"2025-05-18 23:24:02",1134,584,530,54,0,577,7,1200,616,194,383
39,VASLUI,"PRIMĂRIA MUNICIPIULUI VASLUI – DAPTO – SEDIU ADMINISTRATIV BAZAR",48,"MUNICIPIUL VASLUI",161945,1,PART,PRCNCT,PRSD,PRSD_SV,"2025-05-18 21:59:57",1378,622,587,35,0,618,4,1400,778,192,426
39,VASLUI,"PRIMĂRIA MUNICIPIULUI VASLUI – DAPTO – SEDIU ADMINISTRATIV BAZAR",49,"MUNICIPIUL VASLUI",161945,1,PART,PRCNCT,PRSD,PRSD_SV,"2025-05-18 21:29:00",1498,263,230,33,0,261,2,1600,1337,102,159
39,VASLUI,"PRIMĂRIA MUNICIPIULUI VASLUI – DAPTO – SEDIU ADMINISTRATIV BAZAR",50,"MUNICIPIUL VASLUI",161945,1,PART,PRCNCT,PRSD,PRSD_SV,"2025-05-18 21:55:45",1639,423,393,29,1,417,6,1700,1277,125,292
39,VASLUI,"ȘCOALA GIMNAZIALĂ ”MIHAI EMINESCU”",51,"MUNICIPIUL VASLUI",161945,1,PART,PRCNCT,PRSD,PRSD_SV,"2025-05-18 22:29:16",1627,781,668,113,0,773,8,1700,919,265,508
39,VASLUI,"ȘCOALA GIMNAZIALĂ ”VASILE ALECSANDRI”",52,"MUNICIPIUL VASLUI",161945,1,PART,PRCNCT,PRSD,PRSD_SV,"2025-05-18 21:39:46",938,434,357,77,0,428,6,1000,566,155,273
39,VASLUI,"ȘCOALA GIMNAZIALĂ ”VASILE ALECSANDRI”",53,"MUNICIPIUL VASLUI",161945,1,PART,PRCNCT,PRSD,PRSD_SV,"2025-05-18 21:55:35",1382,413,379,34,0,405,8,1400,987,131,274
39,VASLUI,"ȘCOALA GIMNAZIALĂ ”VASILE ALECSANDRI”",54,"MUNICIPIUL VASLUI",161945,1,PART,PRCNCT,PRSD,PRSD_SV,"2025-05-18 22:02:21",1023,349,326,23,0,345,4,1200,851,153,192
39,VASLUI,"ȘCOALA GIMNAZIALĂ ”VASILE ALECSANDRI”",55,"MUNICIPIUL VASLUI",161945,1,PART,PRCNCT,PRSD,PRSD_SV,"2025-05-18 21:55:46",1397,558,536,22,0,553,5,1600,1042,200,353
39,VASLUI,"ȘCOALA GIMNAZIALĂ ”ALEXANDRA NECHITA”",56,"MUNICIPIUL VASLUI",161945,1,PART,PRCNCT,PRSD,PRSD_SV,"2025-05-18 21:22:02",1606,402,394,8,0,395,7,1700,1298,161,234
39,VASLUI,"ȘCOALA GIMNAZIALĂ ”ALEXANDRA NECHITA”",57,"MUNICIPIUL VASLUI",161945,1,PART,PRCNCT,PRSD,PRSD_SV,"2025-05-18 21:59:14",1838,478,467,11,0,474,4,2000,1522,190,284
39,VASLUI,"ȘCOALA GIMNAZIALĂ ”ALEXANDRA NICHITA”",58,"MUNICIPIUL VASLUI",161945,1,PART,PRCNCT,PRSD,PRSD_SV,"2025-05-18 21:24:02",1335,97,2,95,0,97,0,1600,1503,46,51
39,VASLUI,"ȘCOALA GIMNAZIALĂ ”ALEXANDRA NICHITA”",59,"MUNICIPIUL VASLUI",161945,1,PART,PRCNCT,PRSD,PRSD_SV,"2025-05-18 21:37:30",1597,595,574,21,0,585,10,1600,1005,250,335
39,VASLUI,"COLEGIUL ECONOMIC ”ANGHEL RUGINĂ”",60,"MUNICIPIUL VASLUI",161945,1,PART,PRCNCT,PRSD,PRSD_SV,"2025-05-18 22:07:39",1691,638,586,52,0,631,7,1700,1062,198,433
39,VASLUI,"COLEGIUL ECONOMIC ”ANGHEL RUGINĂ”",61,"MUNICIPIUL VASLUI",161945,1,PART,PRCNCT,PRSD,PRSD_SV,"2025-05-18 21:41:21",566,300,260,40,0,297,3,600,300,107,190
39,VASLUI,"ŞCOALA GIMNAZIALĂ ”ELENA CUZA”",62,"MUNICIPIUL VASLUI",161945,1,PART,PRCNCT,PRSD,PRSD_SV,"2025-05-18 21:49:54",963,507,411,94,2,495,12,1000,493,151,344
39,VASLUI,"ŞCOALA GIMNAZIALĂ ”ELENA CUZA”",63,"MUNICIPIUL VASLUI",161945,1,PART,PRCNCT,PRSD,PRSD_SV,"2025-05-18 21:55:07",865,417,384,32,1,412,5,900,483,148,264
39,VASLUI,"ŞCOALA GIMNAZIALĂ ”ALEXANDRU IOAN CUZA”",64,"MUNICIPIUL VASLUI",161945,1,PART,PRCNCT,PRSD,PRSD_SV,"2025-05-18 22:11:16",1655,510,479,31,0,502,8,1700,1190,289,213
39,VASLUI,"ŞCOALA GIMNAZIALĂ ”ALEXANDRU IOAN CUZA”",65,"MUNICIPIUL VASLUI",161945,1,PART,PRCNCT,PRSD,PRSD_SV,"2025-05-18 22:08:21",1621,619,608,10,1,610,9,1700,1081,193,417
39,VASLUI,"ŞCOALA GIMNAZIALĂ ”ALEXANDRU IOAN CUZA”",66,"MUNICIPIUL VASLUI",161945,1,PART,PRCNCT,PRSD,PRSD_SV,"2025-05-18 21:31:07",1218,94,39,55,0,92,2,1300,1206,42,50
39,VASLUI,"ŞCOALA PRIMARĂ",67,"MUNICIPIUL VASLUI",161945,2,PART,PRCNCT,PRSD,PRSD_SV,"2025-05-18 22:20:04",333,142,125,17,0,140,2,400,258,86,54
39,VASLUI,"ŞCOALA PRIMARĂ",68,"MUNICIPIUL VASLUI",161945,1,PART,PRCNCT,PRSD,PRSD_SV,"2025-05-18 21:21:25",963,287,279,8,0,280,7,1200,913,162,118
39,VASLUI,"ŞCOALA PRIMARĂ",69,"MUNICIPIUL VASLUI",161945,1,PART,PRCNCT,PRSD,PRSD_SV,"2025-05-18 21:10:55",758,148,129,19,0,146,2,800,652,97,49
39,VASLUI,"ŞCOALA GIMNAZIALĂ",70,"MUNICIPIUL VASLUI",161945,2,PART,PRCNCT,PRSD,PRSD_SV,"2025-05-18 22:42:26",1424,665,642,23,0,661,4,1600,935,369,292
39,VASLUI,"ŞCOALA GIMNAZIALĂ",71,"MUNICIPIUL VASLUI",161945,2,PART,PRCNCT,PRSD,PRSD_SV,"2025-05-18 22:59:52",1003,443,420,23,0,435,8,1200,757,203,232
39,VASLUI,"GRĂDINIȚA CU PROGRAM NORMAL",72,"MUNICIPIUL VASLUI",161945,1,PART,PRCNCT,PRSD,PRSD_SV,"2025-05-18 22:24:12",1917,1077,1031,45,1,1071,6,2000,923,426,645
39,VASLUI,"LICEUL ”ȘTEFAN PROCOPIU”",73,"MUNICIPIUL VASLUI",161945,1,PART,PRCNCT,PRSD,PRSD_SV,"2025-05-18 21:16:17",1701,96,69,27,0,96,0,1800,1704,59,37
39,VASLUI,"LICEUL ”ŞTEFAN PROCOPIU”",74,"MUNICIPIUL VASLUI",161945,1,PART,PRCNCT,PRSD,PRSD_SV,"2025-05-18 21:43:13",2039,725,699,26,0,719,6,2100,1375,264,455
39,VASLUI,"LICEUL ”ȘTEFAN PROCOPIU”",75,"MUNICIPIUL VASLUI",161945,1,PART,PRCNCT,PRSD,PRSD_SV,"2025-05-18 21:17:33",1044,59,18,41,0,59,0,1100,1041,32,27
39,VASLUI,"LICEUL ”ȘTEFAN PROCOPIU”",76,"MUNICIPIUL VASLUI",161945,1,PART,PRCNCT,PRSD,PRSD_SV,"2025-05-18 21:18:52",1742,34,23,11,0,34,0,2000,1966,15,19
39,VASLUI,"LICEUL ”ȘTEFAN PROCOPIU”",77,"MUNICIPIUL VASLUI",161945,1,PART,PRCNCT,PRSD,PRSD_SV,"2025-05-18 21:47:51",1783,69,31,38,0,69,0,2000,1931,34,35
39,VASLUI,"LICEUL ”ȘTEFAN PROCOPIU”",78,"MUNICIPIUL VASLUI",161945,1,PART,PRCNCT,PRSD,PRSD_SV,"2025-05-18 21:14:18",1827,22,11,11,0,22,0,2000,1978,13,9
39,VASLUI,"GRĂDINIŢA CU PROGRAM NORMAL NR. 22",79,"MUNICIPIUL VASLUI",161945,1,PART,PRCNCT,PRSD,PRSD_SV,"2025-05-18 21:36:53",1900,69,48,21,0,69,0,2000,1931,35,34
39,VASLUI,"CLĂDIRE SC. ROXCOFY SRL.",80,"MUNICIPIUL VASLUI",161945,1,PART,PRCNCT,PRSD,PRSD_SV,"2025-05-18 21:47:36",1847,372,360,12,0,368,4,2000,1628,192,176
39,VASLUI,"CLĂDIRE SC. ROXCOFY SRL.",81,"MUNICIPIUL VASLUI",161945,1,PART,PRCNCT,PRSD,PRSD_SV,"2025-05-18 22:07:42",1815,129,106,23,0,129,0,2000,1871,72,57
39,VASLUI,"CLUBUL ”PRIETENIA”",82,"MUNICIPIUL VASLUI",161945,1,PART,PRCNCT,PRSD,PRSD_SV,"2025-05-18 21:37:43",1408,71,46,25,0,68,3,1600,1529,19,49
39,VASLUI,"CLUBUL ”PRIETENIA”",83,"MUNICIPIUL VASLUI",161945,1,PART,PRCNCT,PRSD,PRSD_SV,"2025-05-18 21:20:51",1492,15,3,12,0,14,1,1600,1585,6,8
39,VASLUI,"CLUBUL PENSIONARILOR",84,"MUNICIPIUL VASLUI",161945,1,PART,PRCNCT,PRSD,PRSD_SV,"2025-05-18 21:13:37",1749,51,28,23,0,51,0,2000,1949,29,22
39,VASLUI,"CLUBUL PENSIONARILOR",85,"MUNICIPIUL VASLUI",161945,2,PART,PRCNCT,PRSD,PRSD_SV,"2025-05-18 21:49:49",1817,28,13,15,0,28,0,2000,1972,13,15
39,VASLUI,"SC GOSCOM SA",86,"MUNICIPIUL VASLUI",161945,1,PART,PRCNCT,PRSD,PRSD_SV,"2025-05-18 21:35:05",1744,79,61,17,1,79,0,2000,1921,29,50
39,VASLUI,"MINI SALĂ SPORT",87,"MUNICIPIUL VASLUI",161945,1,PART,PRCNCT,PRSD,PRSD_SV,"2025-05-18 21:50:39",1689,154,0,40,114,150,4,1700,1546,96,54
39,VASLUI,"ŞCOALA GIMNAZIALĂ NR. 10",88,"MUNICIPIUL BÂRLAD",161794,1,PART,PRCNCT,PRSD,PRSD_SV,"2025-05-18 21:34:27",1786,767,739,28,0,755,12,1800,1033,378,377
39,VASLUI,"ŞCOALA GIMNAZIALĂ NR. 10",89,"MUNICIPIUL BÂRLAD",161794,1,PART,PRCNCT,PRSD,PRSD_SV,"2025-05-18 22:03:52",1916,1037,993,44,0,1026,11,2000,963,478,548
39,VASLUI,"ŞCOALA GIMNAZIALĂ NR. 10",90,"MUNICIPIUL BÂRLAD",161794,1,PART,PRCNCT,PRSD,PRSD_SV,"2025-05-18 22:25:00",1693,856,777,56,23,843,13,1700,844,341,502
39,VASLUI,"ŞCOALA GENERALA NR. 7 ”CĂPITAN GRIGORE IGNAT”",91,"MUNICIPIUL BÂRLAD",161794,1,PART,PRCNCT,PRSD,PRSD_SV,"2025-05-18 21:47:44",824,379,364,15,0,374,5,900,521,153,221
39,VASLUI,"ŞCOALA GENERALA NR. 7 ”CĂPITAN GRIGORE IGNAT”",92,"MUNICIPIUL BÂRLAD",161794,1,PART,PRCNCT,PRSD,PRSD_SV,"2025-05-18 21:43:37",864,407,380,27,0,398,9,900,493,162,236
39,VASLUI,"COLEGIUL NAŢIONAL ”GHEORGHE ROŞCA CODREANU”",93,"MUNICIPIUL BÂRLAD",161794,1,PART,PRCNCT,PRSD,PRSD_SV,"2025-05-18 21:42:38",939,496,454,42,0,493,3,1000,504,190,303
39,VASLUI,"COLEGIUL NAŢIONAL ”GHEORGHE ROŞCA CODREANU”",94,"MUNICIPIUL BÂRLAD",161794,1,PART,PRCNCT,PRSD,PRSD_SV,"2025-05-18 21:45:30",1462,672,627,44,1,669,3,1600,928,335,334
39,VASLUI,"COLEGIUL NAŢIONAL ”GHEORGHE ROŞCA CODREANU”",95,"MUNICIPIUL BÂRLAD",161794,1,PART,PRCNCT,PRSD,PRSD_SV,"2025-05-18 21:47:25",966,594,500,92,2,591,3,1000,406,231,360
39,VASLUI,"GRĂDINIȚA CU PROGRAM PRELUNGIT NR. 5",96,"MUNICIPIUL BÂRLAD",161794,1,PART,PRCNCT,PRSD,PRSD_SV,"2025-05-18 21:49:12",1077,590,548,42,0,575,15,1200,610,226,349
39,VASLUI,"GRĂDINIȚA CU PROGRAM PRELUNGIT NR. 5",97,"MUNICIPIUL BÂRLAD",161794,1,PART,PRCNCT,PRSD,PRSD_SV,"2025-05-18 21:44:14",833,482,435,43,4,471,11,900,418,160,311
39,VASLUI,"SALA DE SPORT A ȘCOLII GIMNAZIALE ”EPISCOP IACOV ANTONOVICI”",98,"MUNICIPIUL BÂRLAD",161794,1,PART,PRCNCT,PRSD,PRSD_SV,"2025-05-18 21:48:27",582,389,228,118,43,383,6,600,211,175,208
39,VASLUI,"SALA DE SPORT A ȘCOLII GIMNAZIALE ”EPISCOP IACOV ANTONOVICI”",99,"MUNICIPIUL BÂRLAD",161794,1,PART,PRCNCT,PRSD,PRSD_SV,"2025-05-18 21:48:04",1200,565,528,37,0,557,8,1200,635,215,342
39,VASLUI,"SALA DE SPORT A ȘCOLII GIMNAZIALE ”EPISCOP IACOV ANTONOVICI”",100,"MUNICIPIUL BÂRLAD",161794,1,PART,PRCNCT,PRSD,PRSD_SV,"2025-05-18 21:50:39",1091,459,422,37,0,453,6,1200,741,173,280
39,VASLUI,"SALA DE SPORT A ȘCOLII GIMNAZIALE ”EPISCOP IACOV ANTONOVICI”",101,"MUNICIPIUL BÂRLAD",161794,1,PART,PRCNCT,PRSD,PRSD_SV,"2025-05-18 21:50:17",1430,593,573,19,1,590,3,1600,1007,229,361
39,VASLUI,"ŞCOALA GIMNAZIALĂ ”MANOLACHE COSTACHE EPUREANU”",102,"MUNICIPIUL BÂRLAD",161794,1,PART,PRCNCT,PRSD,PRSD_SV,"2025-05-18 21:55:37",1247,658,518,140,0,648,10,1300,642,315,333
39,VASLUI,"GRĂDINIȚA CU PROGRAM PRELUNGIT NR. 9",103,"MUNICIPIUL BÂRLAD",161794,1,PART,PRCNCT,PRSD,PRSD_SV,"2025-05-18 21:34:33",1521,525,507,18,0,518,7,1600,1075,214,304
39,VASLUI,"GRĂDINIȚA CU PROGRAM PRELUNGIT NR. 9",104,"MUNICIPIUL BÂRLAD",161794,1,PART,PRCNCT,PRSD,PRSD_SV,"2025-05-18 21:59:07",1248,617,523,46,48,611,6,1300,683,252,359
39,VASLUI,"GRĂDINIȚA CU PROGRAM PRELUNGIT NR. 9",105,"MUNICIPIUL BÂRLAD",161794,1,PART,PRCNCT,PRSD,PRSD_SV,"2025-05-18 21:52:48",1282,595,564,31,0,587,8,1300,705,205,382
39,VASLUI,"GRĂDINIȚA CU PROGRAM PRELUNGIT NR. 9",106,"MUNICIPIUL BÂRLAD",161794,1,PART,PRCNCT,PRSD,PRSD_SV,"2025-05-18 21:50:32",1147,465,383,31,51,455,10,1200,735,222,233
39,VASLUI,"GRĂDINIȚA CU PROGRAM PRELUNGIT NR. 9",107,"MUNICIPIUL BÂRLAD",161794,1,PART,PRCNCT,PRSD,PRSD_SV,"2025-05-18 21:46:25",1152,544,525,19,0,541,3,1200,656,238,303
39,VASLUI,"GRĂDINIȚA CU PROGRAM PRELUNGIT NR. 9",108,"MUNICIPIUL BÂRLAD",161794,1,PART,PRCNCT,PRSD,PRSD_SV,"2025-05-18 22:05:29",1305,589,559,30,0,584,5,1400,811,225,359
39,VASLUI,"GRĂDINIȚA CU PROGRAM PRELUNGIT NR. 9",109,"MUNICIPIUL BÂRLAD",161794,1,PART,PRCNCT,PRSD,PRSD_SV,"2025-05-18 22:32:36",1316,556,507,49,0,547,9,1400,844,224,323
39,VASLUI,"LICEUL TEHNOLOGIC ”PETRU RAREŞ”",110,"MUNICIPIUL BÂRLAD",161794,1,PART,PRCNCT,PRSD,PRSD_SV,"2025-05-18 21:53:52",998,491,457,34,0,483,8,1000,509,225,258
39,VASLUI,"LICEUL TEHNOLOGIC ”PETRU RAREŞ”",111,"MUNICIPIUL BÂRLAD",161794,1,PART,PRCNCT,PRSD,PRSD_SV,"2025-05-18 22:06:31",1339,698,636,61,1,692,6,1400,702,352,340
39,VASLUI,"LICEUL TEHNOLOGIC ”PETRU RAREŞ”",112,"MUNICIPIUL BÂRLAD",161794,1,PART,PRCNCT,PRSD,PRSD_SV,"2025-05-18 21:57:16",1438,620,593,26,1,613,7,1600,980,345,268
39,VASLUI,"ŞCOALA GIMNAZIALĂ ”VICTOR IOAN POPA”",113,"MUNICIPIUL BÂRLAD",161794,1,PART,PRCNCT,PRSD,PRSD_SV,"2025-05-18 22:01:06",1223,527,499,26,2,521,6,1300,773,312,209
39,VASLUI,"ŞCOALA GIMNAZIALĂ ”VICTOR IOAN POPA”",114,"MUNICIPIUL BÂRLAD",161794,1,PART,PRCNCT,PRSD,PRSD_SV,"2025-05-18 21:51:49",1362,651,626,24,1,642,9,1400,749,323,319
39,VASLUI,"ŞCOALA GIMNAZIALĂ ”VICTOR IOAN POPA”",115,"MUNICIPIUL BÂRLAD",161794,1,PART,PRCNCT,PRSD,PRSD_SV,"2025-05-18 21:41:32",1416,618,588,29,1,609,9,1600,982,341,268
39,VASLUI,"ȘCOALA GIMNAZIALĂ ”IORGU RADU”",116,"MUNICIPIUL BÂRLAD",161794,1,PART,PRCNCT,PRSD,PRSD_SV,"2025-05-18 21:55:13",1275,599,559,40,0,594,5,1300,701,215,379
39,VASLUI,"ȘCOALA GIMNAZIALĂ ”IORGU RADU”",117,"MUNICIPIUL BÂRLAD",161794,1,PART,PRCNCT,PRSD,PRSD_SV,"2025-05-18 21:43:03",1419,667,625,42,0,661,6,1600,933,201,460
39,VASLUI,"ŞCOALA GIMNAZIALĂ ”PRINCIPESA ELENA BIBESCU”",118,"MUNICIPIUL BÂRLAD",161794,1,PART,PRCNCT,PRSD,PRSD_SV,"2025-05-18 21:58:10",1341,707,633,74,0,699,8,1400,693,268,431
39,VASLUI,"ŞCOALA GIMNAZIALĂ ”PRINCIPESA ELENA BIBESCU”",119,"MUNICIPIUL BÂRLAD",161794,2,PART,PRCNCT,PRSD,PRSD_SV,"2025-05-19 02:18:44",1440,662,583,78,1,659,3,1600,938,311,348
39,VASLUI,"ŞCOALA GIMNAZIALĂ NR. 2",120,"MUNICIPIUL BÂRLAD",161794,1,PART,PRCNCT,PRSD,PRSD_SV,"2025-05-18 22:24:42",903,457,395,62,0,451,6,1000,543,208,243
39,VASLUI,"ŞCOALA GIMNAZIALĂ NR. 2",121,"MUNICIPIUL BÂRLAD",161794,1,PART,PRCNCT,PRSD,PRSD_SV,"2025-05-18 21:27:54",631,303,278,25,0,299,4,700,397,116,183
39,VASLUI,"ŞCOALA GIMNAZIALĂ NR. 2",122,"MUNICIPIUL BÂRLAD",161794,1,PART,PRCNCT,PRSD,PRSD_SV,"2025-05-18 21:38:19",960,436,416,20,0,431,5,1000,564,177,254
39,VASLUI,"ŞCOALA GIMNAZIALĂ NR. 2",123,"MUNICIPIUL BÂRLAD",161794,1,PART,PRCNCT,PRSD,PRSD_SV,"2025-05-18 22:00:28",846,383,339,44,0,378,5,900,517,164,214
39,VASLUI,"ŞCOALA GIMNAZIALĂ ”GEORGE TUTOVEANU”",124,"MUNICIPIUL BÂRLAD",161794,1,PART,PRCNCT,PRSD,PRSD_SV,"2025-05-18 21:53:17",1362,621,576,45,0,605,16,1400,779,260,345
39,VASLUI,"ŞCOALA GIMNAZIALĂ ”GEORGE TUTOVEANU”",125,"MUNICIPIUL BÂRLAD",161794,1,PART,PRCNCT,PRSD,PRSD_SV,"2025-05-18 21:49:22",1479,674,621,53,0,669,5,1600,926,299,370
39,VASLUI,"ŞCOALA GIMNAZIALĂ ”GEORGE TUTOVEANU”",126,"MUNICIPIUL BÂRLAD",161794,1,PART,PRCNCT,PRSD,PRSD_SV,"2025-05-18 22:37:10",1281,671,601,70,0,664,7,1300,629,304,360
39,VASLUI,"LICEUL PEDAGOGIC ”IOAN POPESCU”",127,"MUNICIPIUL BÂRLAD",161794,1,PART,PRCNCT,PRSD,PRSD_SV,"2025-05-18 22:11:35",1036,517,445,72,0,510,7,1200,683,214,296
39,VASLUI,"LICEUL PEDAGOGIC ”IOAN POPESCU”",128,"MUNICIPIUL BÂRLAD",161794,1,PART,PRCNCT,PRSD,PRSD_SV,"2025-05-18 22:16:53",1244,638,569,69,0,628,10,1300,662,258,370
39,VASLUI,"LICEUL PEDAGOGIC ”IOAN POPESCU”",129,"MUNICIPIUL BÂRLAD",161794,1,PART,PRCNCT,PRSD,PRSD_SV,"2025-05-18 21:52:01",1334,605,561,44,0,594,11,1400,795,270,324
39,VASLUI,"LICEUL PEDAGOGIC ”IOAN POPESCU”",130,"MUNICIPIUL BÂRLAD",161794,1,PART,PRCNCT,PRSD,PRSD_SV,"2025-05-18 21:53:56",1108,504,465,38,1,499,5,1200,696,221,278
39,VASLUI,"GRĂDINIȚA CU PROGRAM PRELUNGIT ”LICURICI”",131,"MUNICIPIUL BÂRLAD",161794,1,PART,PRCNCT,PRSD,PRSD_SV,"2025-05-18 21:40:05",1120,579,500,77,2,573,6,1200,621,202,371
39,VASLUI,"GRĂDINIȚA CU PROGRAM PRELUNGIT ”LICURICI”",132,"MUNICIPIUL BÂRLAD",161794,1,PART,PRCNCT,PRSD,PRSD_SV,"2025-05-18 22:08:27",1240,636,591,45,0,629,7,1300,664,192,437
39,VASLUI,"GRĂDINIȚA CU PROGRAM PRELUNGIT ”LICURICI”",133,"MUNICIPIUL BÂRLAD",161794,1,PART,PRCNCT,PRSD,PRSD_SV,"2025-05-18 21:34:35",816,411,378,33,0,410,1,900,489,156,254
39,VASLUI,"CENTRUL COMUNITAR INTEGRAT HUȘI",134,"MUNICIPIUL HUŞI",161829,1,PART,PRCNCT,PRSD,PRSD_SV,"2025-05-18 22:12:04",1091,525,484,40,1,518,7,1200,675,236,282
39,VASLUI,"SCOALA PROFESIONALA SPECIALĂ ”SF.ECATERINA”",135,"MUNICIPIUL HUŞI",161829,1,PART,PRCNCT,PRSD,PRSD_SV,"2025-05-18 21:52:36",1540,536,483,53,0,532,4,1600,1064,270,262
39,VASLUI,"CENTRUL CONSULTATIV HUȘI",136,"MUNICIPIUL HUŞI",161829,1,PART,PRCNCT,PRSD,PRSD_SV,"2025-05-18 23:36:11",1603,818,661,106,51,799,19,1700,882,345,454
39,VASLUI,"COLEGIUL NAȚIONAL ”CUZA VODA”",137,"MUNICIPIUL HUŞI",161829,1,PART,PRCNCT,PRSD,PRSD_SV,"2025-05-18 21:44:38",1723,452,412,40,0,446,6,2000,1548,195,251
39,VASLUI,"LICEUL TEHNOLOGIC ”IOAN CORIVAN”",138,"MUNICIPIUL HUŞI",161829,1,PART,PRCNCT,PRSD,PRSD_SV,"2025-05-18 21:46:12",1802,597,561,36,0,589,8,2000,1403,245,344
39,VASLUI,"COLEGIUL AGRICOL ”DIMITRIE CANTEMIR”",139,"MUNICIPIUL HUŞI",161829,1,PART,PRCNCT,PRSD,PRSD_SV,"2025-05-18 22:07:46",1004,512,421,47,44,508,4,1100,588,225,283
39,VASLUI,"SCOALA GIMNAZIALĂ ”ANASTASIE PANU”",140,"MUNICIPIUL HUŞI",161829,1,PART,PRCNCT,PRSD,PRSD_SV,"2025-05-18 21:50:00",1320,459,402,57,0,445,14,1400,941,181,264
39,VASLUI,"SCOALA GIMNAZIALĂ ”ANASTASIE PANU”",141,"MUNICIPIUL HUŞI",161829,2,PART,PRCNCT,PRSD,PRSD_SV,"2025-05-19 03:09:41",1195,410,366,42,2,402,8,1200,790,201,201
39,VASLUI,"SCOALA GIMNAZIALĂ ”ANASTASIE PANU”",142,"MUNICIPIUL HUŞI",161829,1,PART,PRCNCT,PRSD,PRSD_SV,"2025-05-18 21:43:47",1586,692,672,19,1,681,11,1600,908,355,326
39,VASLUI,"CASA DE CULTURA ”ALEXANDRU GIUGARU”",143,"MUNICIPIUL HUŞI",161829,1,PART,PRCNCT,PRSD,PRSD_SV,"2025-05-18 21:59:46",1573,564,459,104,1,562,2,1600,1036,204,358
39,VASLUI,"SCOALA GIMNAZIALĂ „MIHAIL SADOVEANU”",144,"MUNICIPIUL HUŞI",161829,1,PART,PRCNCT,PRSD,PRSD_SV,"2025-05-18 22:10:22",1624,745,679,66,0,729,16,1700,955,313,416
39,VASLUI,"SCOALA GIMNAZIALĂ „MIHAIL SADOVEANU”",145,"MUNICIPIUL HUŞI",161829,1,PART,PRCNCT,PRSD,PRSD_SV,"2025-05-18 21:59:55",1082,565,519,45,1,558,7,1200,635,206,352
39,VASLUI,"ŞCOALA GIMNAZIALĂ ”ION CREANGĂ”",146,"MUNICIPIUL HUŞI",161829,1,PART,PRCNCT,PRSD,PRSD_SV,"2025-05-18 21:52:10",1396,744,691,51,2,733,11,1400,656,269,464
39,VASLUI,"SCOALA GIMNAZIALA”ION CREANGA”",147,"MUNICIPIUL HUŞI",161829,1,PART,PRCNCT,PRSD,PRSD_SV,"2025-05-18 21:55:20",1687,486,442,44,0,481,5,1700,1214,218,263
39,VASLUI,"SCOALA GIMNAZIALĂ ”ION CREANGA”",148,"MUNICIPIUL HUŞI",161829,1,PART,PRCNCT,PRSD,PRSD_SV,"2025-05-18 21:44:16",1254,623,579,44,0,617,6,1300,677,322,295
39,VASLUI,"SCOALA GIMNAZIALĂ NR.5",149,"MUNICIPIUL HUŞI",161829,1,PART,PRCNCT,PRSD,PRSD_SV,"2025-05-18 21:43:54",1832,416,402,13,1,408,8,2000,1584,179,229
39,VASLUI,"SCOALA GIMNAZIALĂ NR.5",150,"MUNICIPIUL HUŞI",161829,1,PART,PRCNCT,PRSD,PRSD_SV,"2025-05-18 21:30:38",1423,315,298,17,0,310,5,1600,1285,173,137
39,VASLUI,"SCOALA GIMNAZIALĂ NR.4",151,"MUNICIPIUL HUŞI",161829,1,PART,PRCNCT,PRSD,PRSD_SV,"2025-05-18 22:12:09",1140,573,550,23,0,563,10,1200,627,259,304
39,VASLUI,"SCOALA GIMNAZIALĂ NR.4",152,"MUNICIPIUL HUŞI",161829,1,PART,PRCNCT,PRSD,PRSD_SV,"2025-05-18 21:50:14",1551,723,685,37,1,717,6,1600,877,387,330
39,VASLUI,"DIRECTIA AGRICOLA JUDETEANA VASLUI - UNITATEA FITOSANITARA HUSI",153,"MUNICIPIUL HUŞI",161829,1,PART,PRCNCT,PRSD,PRSD_SV,"2025-05-18 22:31:46",2125,903,850,53,0,890,13,2200,1297,499,391
39,VASLUI,"CASA DE CULTURA MURGENI",154,"ORAŞ MURGENI",164981,1,PART,PRCNCT,PRSD,PRSD_SV,"2025-05-18 22:26:53",1771,551,500,50,1,545,6,2000,1449,320,225
39,VASLUI,"SCOALA PRIMARA SAT NOU",155,"ORAŞ MURGENI",164981,1,PART,PRCNCT,PRSD,PRSD_SV,"2025-05-18 21:30:06",1186,255,241,14,0,248,7,1200,945,196,52
39,VASLUI,"ȘCOALA PRIMARĂ SAT CÂRJA",156,"ORAŞ MURGENI",164981,2,PART,PRCNCT,PRSD,PRSD_SV,"2025-05-19 02:32:11",742,409,304,104,1,406,3,800,391,250,156
39,VASLUI,"ȘCOALA GIMNAZIALĂ SAT FLORENI",157,"ORAŞ MURGENI",164981,1,PART,PRCNCT,PRSD,PRSD_SV,"2025-05-18 21:48:42",541,254,219,33,2,253,1,600,346,164,89
39,VASLUI,"ȘCOALA PRIMARĂ SAT LĂȚEȘTI",158,"ORAŞ MURGENI",164981,1,PART,PRCNCT,PRSD,PRSD_SV,"2025-05-18 21:18:10",252,111,78,33,0,109,2,300,189,65,44
39,VASLUI,"ȘCOALA PRIMARĂ SAT RAIU",159,"ORAŞ MURGENI",164981,1,PART,PRCNCT,PRSD,PRSD_SV,"2025-05-18 21:38:44",508,204,178,26,0,202,2,600,396,114,88
39,VASLUI,"ȘCOALA GIMNAZIALĂ EMIL JUVARA SAT SĂRĂȚENI",160,"ORAŞ MURGENI",164981,1,PART,PRCNCT,PRSD,PRSD_SV,"2025-05-18 21:33:29",272,118,93,25,0,118,0,300,182,70,48
39,VASLUI,"ȘCOALA PRIMARĂ SAT SCHINENI",161,"ORAŞ MURGENI",164981,1,PART,PRCNCT,PRSD,PRSD_SV,"2025-05-18 21:25:42",333,144,117,27,0,143,1,400,256,73,70
39,VASLUI,"CASA DE CULTURĂ",162,"ORAŞ NEGREŞTI",161856,1,PART,PRCNCT,PRSD,PRSD_SV,"2025-05-18 22:11:36",1493,669,623,46,0,658,11,1608,939,283,375
39,VASLUI,"CASA DE CULTURĂ",163,"ORAŞ NEGREŞTI",161856,1,PART,PRCNCT,PRSD,PRSD_SV,"2025-05-18 22:40:52",1397,609,559,50,0,600,9,1600,991,297,303
39,VASLUI,"SERVICIUL PUBLIC DE ASISTENȚĂ SOCIALĂ NEGREȘTI",164,"ORAŞ NEGREŞTI",161856,1,PART,PRCNCT,PRSD,PRSD_SV,"2025-05-18 22:21:18",1955,871,813,58,0,859,12,2000,1129,407,452
39,VASLUI,"GRĂDINIȚA CU PROGRAM NORMAL NR.2 NEGREȘTI",165,"ORAŞ NEGREŞTI",161856,1,PART,PRCNCT,PRSD,PRSD_SV,"2025-05-18 21:47:49",884,359,335,23,1,356,3,900,541,225,131
39,VASLUI,"ŞCOALA PRIMARĂ SAT CĂZĂNEȘTI",166,"ORAŞ NEGREŞTI",161856,1,PART,PRCNCT,PRSD,PRSD_SV,"2025-05-18 21:44:47",323,146,128,18,0,145,1,400,254,63,82
39,VASLUI,"ŞCOALA PRIMARĂ SAT CIOATELE",167,"ORAŞ NEGREŞTI",161856,1,PART,PRCNCT,PRSD,PRSD_SV,"2025-05-18 21:27:07",299,122,113,9,0,120,2,300,178,92,28
39,VASLUI,"SCOALA PRIMARĂ SAT GLODENI",168,"ORAŞ NEGREŞTI",161856,1,PART,PRCNCT,PRSD,PRSD_SV,"2025-05-18 21:32:02",216,111,90,21,0,110,1,300,189,53,57
39,VASLUI,"GRĂDINIȚA CU PROGRAM NORMAL SAT PARPANIȚA",169,"ORAŞ NEGREŞTI",161856,1,PART,PRCNCT,PRSD,PRSD_SV,"2025-05-18 21:38:48",457,193,175,18,0,192,1,500,307,105,87
39,VASLUI,"ȘCOALA PRIMARĂ SAT POIANA",170,"ORAŞ NEGREŞTI",161856,1,PART,PRCNCT,PRSD,PRSD_SV,"2025-05-18 21:23:45",201,124,101,23,0,122,2,300,176,58,64
39,VASLUI,"ŞCOALA GIMNAZIALĂ SAT VALEA MARE",171,"ORAŞ NEGREŞTI",161856,2,PART,PRCNCT,PRSD,PRSD_SV,"2025-05-19 01:47:45",657,304,274,30,0,300,4,700,396,178,122
39,VASLUI,"ŞCOALA GIMNAZIALA NR. 1 ALBESTI",172,ALBEŞTI,162014,1,PART,PRCNCT,PRSD,PRSD_SV,"2025-05-18 21:40:20",773,324,275,46,3,319,5,800,476,164,155
39,VASLUI,"ŞCOALA GIMNAZIALA CORNI-ALBESTI",173,ALBEŞTI,162014,1,PART,PRCNCT,PRSD,PRSD_SV,"2025-05-18 21:57:42",905,392,341,51,0,388,4,1000,608,196,192
39,VASLUI,"ȘCOALA PRIMARĂ CRASNA",174,ALBEŞTI,162014,1,PART,PRCNCT,PRSD,PRSD_SV,"2025-05-18 21:39:22",424,216,172,44,0,210,6,500,284,104,106
39,VASLUI,"ŞCOALA PRIMARA - GURA ALBEŞTI",175,ALBEŞTI,162014,1,PART,PRCNCT,PRSD,PRSD_SV,"2025-05-18 21:27:16",105,69,46,22,1,69,0,200,131,28,41
39,VASLUI,"ŞCOALA GIMNAZIALA, ALEXANDRU VLAHUŢĂ",176,"ALEXANDRU VLAHUŢĂ",162069,1,PART,PRCNCT,PRSD,PRSD_SV,"2025-05-18 21:40:52",630,262,236,26,0,260,2,700,438,161,99
39,VASLUI,"ȘCOALA PRIMARĂ BUDA",177,"ALEXANDRU VLAHUŢĂ",162069,1,PART,PRCNCT,PRSD,PRSD_SV,"2025-05-18 21:21:28",192,111,85,26,0,111,0,200,89,76,35
39,VASLUI,"ŞCOALA PRIMARA, GHICANI",178,"ALEXANDRU VLAHUŢĂ",162069,1,PART,PRCNCT,PRSD,PRSD_SV,"2025-05-18 21:29:42",130,77,53,24,0,77,0,200,123,50,27
39,VASLUI,"ȘCOALA PRIMARĂ MORĂRENI",179,"ALEXANDRU VLAHUŢĂ",162069,1,PART,PRCNCT,PRSD,PRSD_SV,"2025-05-18 21:28:42",188,107,85,22,0,107,0,200,93,80,27
39,VASLUI,"ŞCOALA PRIMARĂ ”NICOLAE GH. LUPU” ARSURA",180,ARSURA,162149,1,PART,PRCNCT,PRSD,PRSD_SV,"2025-05-18 21:42:51",624,223,181,40,2,219,4,700,477,111,108
39,VASLUI,"ŞCOALA PRIMARĂ ”ÎNV. ION BUSUIOC” FUNDĂTURA",181,ARSURA,162149,1,PART,PRCNCT,PRSD,PRSD_SV,"2025-05-18 21:28:34",312,138,111,27,0,138,0,400,262,79,59
39,VASLUI,"ŞCOALA PRIMARĂ MIHAIL KOGĂLNICEANU",182,ARSURA,162149,1,PART,PRCNCT,PRSD,PRSD_SV,"2025-05-18 21:12:17",75,39,18,21,0,37,2,100,61,20,17
39,VASLUI,"ŞCOALA PRIMARĂ PÎHNEŞTI",183,ARSURA,162149,1,PART,PRCNCT,PRSD,PRSD_SV,"2025-05-18 21:30:50",448,161,127,34,0,157,4,500,339,96,61
39,VASLUI,"ŞCOALA GIMNAZIALĂ NR. 1 GARA BANCA",184,BANCA,162194,1,PART,PRCNCT,PRSD,PRSD_SV,"2025-05-18 22:25:44",1132,562,506,56,0,561,1,1200,638,357,204
39,VASLUI,"ŞCOALA PRIMARĂ 1 DECEMBRIE",185,BANCA,162194,1,PART,PRCNCT,PRSD,PRSD_SV,"2025-05-18 21:25:38",327,195,157,38,0,193,2,400,205,103,90
39,VASLUI,"ŞCOALA GIMNAZIALĂ BANCA",186,BANCA,162194,1,PART,PRCNCT,PRSD,PRSD_SV,"2025-05-18 21:41:00",798,389,349,40,0,384,5,800,411,195,189
39,VASLUI,"ŞCOALA PRIMARĂ GHERMĂNEŞTI",187,BANCA,162194,1,PART,PRCNCT,PRSD,PRSD_SV,"2025-05-18 21:47:55",363,194,163,31,0,193,1,400,206,99,94
39,VASLUI,"ŞCOALA PRIMARA MICLEȘTI",188,BANCA,162194,1,PART,PRCNCT,PRSD,PRSD_SV,"2025-05-18 21:20:50",175,88,66,22,0,88,0,200,112,43,45
39,VASLUI,"GRĂDINIȚA MITOC",189,BANCA,162194,1,PART,PRCNCT,PRSD,PRSD_SV,"2025-05-18 21:28:13",335,174,148,26,0,173,1,400,226,130,43
39,VASLUI,"CAMINUL CULTURAL",190,BANCA,162194,1,PART,PRCNCT,PRSD,PRSD_SV,"2025-05-18 21:31:57",307,171,148,23,0,168,3,400,229,62,106
39,VASLUI,"ŞCOALA PRIMARĂ STOIŞEŞTI",191,BANCA,162194,1,PART,PRCNCT,PRSD,PRSD_SV,"2025-05-18 21:26:13",457,251,204,45,2,251,0,500,249,128,123
39,VASLUI,"GRĂDINIŢA STRÂMTURA-MITOC",192,BANCA,162194,1,PART,PRCNCT,PRSD,PRSD_SV,"2025-05-18 21:24:42",185,103,81,22,0,102,1,200,97,77,25
39,VASLUI,"CĂMINUL CULTURAL DIN SAT ȚIFU",193,BANCA,162194,1,PART,PRCNCT,PRSD,PRSD_SV,"2025-05-18 21:24:03",286,148,137,11,0,145,3,300,152,79,66
39,VASLUI,"ŞCOALA GIMNAZIALA NR. 1 SAT BĂCANI",194,BĂCANI,162327,1,PART,PRCNCT,PRSD,PRSD_SV,"2025-05-18 21:53:28",1059,448,412,36,0,441,7,1200,752,302,139
39,VASLUI,"ŞCOALA PRIMARĂ",195,BĂCANI,162327,1,PART,PRCNCT,PRSD,PRSD_SV,"2025-05-18 21:33:39",460,187,174,13,0,184,3,500,313,140,44
39,VASLUI,"ŞCOALA PRIMARA SAT DRUJEŞTI",196,BĂCANI,162327,1,PART,PRCNCT,PRSD,PRSD_SV,"2025-05-18 21:33:05",379,226,186,40,0,224,2,400,174,116,108
39,VASLUI,"SALA MULTIFUNCŢIONALĂ SAT SUSENI",197,BĂCANI,162327,1,PART,PRCNCT,PRSD,PRSD_SV,"2025-05-18 21:14:59",325,183,155,28,0,181,2,400,217,123,58
39,VASLUI,"SALA MULTIFUNCŢIONALĂ SAT VULPĂȘENI",198,BĂCANI,162327,1,PART,PRCNCT,PRSD,PRSD_SV,"2025-05-18 21:15:38",160,84,62,22,0,84,0,200,116,49,35
39,VASLUI,"ŞCOALA GIMNAZIALĂ NR.1 SAT BĂCEŞTI",199,BĂCEŞTI,162381,1,PART,PRCNCT,PRSD,PRSD_SV,"2025-05-18 22:45:23",1782,552,476,41,35,539,13,1800,1248,304,235
39,VASLUI,"ŞCOALA PRIMARĂ SAT ARMĂŞENI",200,BĂCEŞTI,162381,1,PART,PRCNCT,PRSD,PRSD_SV,"2025-05-18 21:30:05",311,169,144,25,0,168,1,400,231,88,80
39,VASLUI,"ŞCOALA PRIMARĂ SAT BĂBUŞA",201,BĂCEŞTI,162381,1,PART,PRCNCT,PRSD,PRSD_SV,"2025-05-18 21:25:11",319,141,123,18,0,140,1,400,259,92,48
39,VASLUI,"ŞCOALA PRIMARĂ SAT PĂLTINIŞ",202,BĂCEŞTI,162381,2,PART,PRCNCT,PRSD,PRSD_SV,"2025-05-19 02:18:00",283,75,62,13,0,70,5,300,225,38,32
39,VASLUI,"ŞCOALA PRIMARĂ SAT ŢIBĂNEŞTII BUHLII",203,BĂCEŞTI,162381,1,PART,PRCNCT,PRSD,PRSD_SV,"2025-05-18 21:33:55",168,77,56,21,0,77,0,200,123,34,43
39,VASLUI,"ŞCOALA PRIMARĂ SAT VOVRIEŞTI",204,BĂCEŞTI,162381,1,PART,PRCNCT,PRSD,PRSD_SV,"2025-05-18 21:22:41",225,112,81,31,0,109,3,300,188,55,54
39,VASLUI,"CENTRUL CULTURAL BĂLTENI",205,BĂLTENI,162452,2,PART,PRCNCT,PRSD,PRSD_SV,"2025-05-18 23:42:55",861,450,412,37,1,446,4,900,450,185,261
39,VASLUI,"ȘCOALA PRIMARĂ BĂLTENI DEAL",206,BĂLTENI,162452,1,PART,PRCNCT,PRSD,PRSD_SV,"2025-05-18 21:33:57",319,150,125,25,0,150,0,400,250,68,82
39,VASLUI,"ŞCOALA PRIMARA CHETREŞTI",207,BĂLTENI,162452,1,PART,PRCNCT,PRSD,PRSD_SV,"2025-05-18 21:27:38",94,73,54,19,0,72,1,100,27,29,43
39,VASLUI,"ŞCOALA GIMNAZIALĂ ”ANASTASIE FĂTU” BEREZENI- CORP 1",208,BEREZENI,162498,1,PART,PRCNCT,PRSD,PRSD_SV,"2025-05-18 21:53:44",1044,499,434,64,1,495,4,1100,601,280,215
39,VASLUI,"ŞCOALA GIMNAZIALĂ ”ANASTASIE FĂTU” BEREZENI- CORP 3",209,BEREZENI,162498,1,PART,PRCNCT,PRSD,PRSD_SV,"2025-05-18 21:35:33",695,322,288,34,0,321,1,800,478,145,176
39,VASLUI,"ŞCOALA PRIMARĂ MUŞATA",210,BEREZENI,162498,1,PART,PRCNCT,PRSD,PRSD_SV,"2025-05-18 21:19:11",346,158,135,23,0,157,1,400,242,110,47
39,VASLUI,"ŞCOALA GIMNAZIALĂ RÎNCENI",211,BEREZENI,162498,1,PART,PRCNCT,PRSD,PRSD_SV,"2025-05-18 21:20:06",397,159,133,26,0,156,3,400,241,99,57
39,VASLUI,"ȘCOALA GIMNAZIALĂ ”ANASTASIE FĂTU” BEREZENI-CORP 2 SATU NOU",212,BEREZENI,162498,1,PART,PRCNCT,PRSD,PRSD_SV,"2025-05-18 21:27:26",1144,473,423,50,0,468,5,1200,727,328,140
39,VASLUI,"ŞCOALA PRIMARĂ STUHULEŢ",213,BEREZENI,162498,1,PART,PRCNCT,PRSD,PRSD_SV,"2025-05-18 21:16:41",152,66,53,13,0,63,3,200,134,40,23
39,VASLUI,"CĂMINUL CULTURAL BLĂGEŞTI",214,BLĂGEŞTI,162559,1,PART,PRCNCT,PRSD,PRSD_SV,"2025-05-18 22:14:04",739,360,270,89,1,351,9,800,440,156,195
39,VASLUI,"ŞCOALA PRIMARA IGEŞTI",215,BLĂGEŞTI,162559,1,PART,PRCNCT,PRSD,PRSD_SV,"2025-05-18 21:41:41",172,85,56,29,0,84,1,200,115,47,37
39,VASLUI,"ŞCOALA PRIMARA SIPENI",216,BLĂGEŞTI,162559,1,PART,PRCNCT,PRSD,PRSD_SV,"2025-05-18 21:16:31",52,41,18,23,0,40,1,100,59,26,14
39,VASLUI,"ŞCOALA GIMNAZIALĂ NR. 1 BOGDANA",217,BOGDANA,162595,1,PART,PRCNCT,PRSD,PRSD_SV,"2025-05-18 21:45:16",652,213,165,48,0,209,4,700,487,90,119
39,VASLUI,"ŞCOALA PRIMARĂ GĂVANU (CORPUL ALĂTURAT)",218,BOGDANA,162595,1,PART,PRCNCT,PRSD,PRSD_SV,"2025-05-18 21:21:10",311,71,43,28,0,71,0,400,329,44,27
39,VASLUI,"ŞCOALA PRIMARĂ LACU BABEI",219,BOGDANA,162595,2,PART,PRCNCT,PRSD,PRSD_SV,"2025-05-18 23:55:12",1165,141,133,8,0,139,2,1200,1059,104,35
39,VASLUI,"ŞCOALA SUCEVENI",220,BOGDANA,162595,2,PART,PRCNCT,PRSD,PRSD_SV,"2025-05-18 23:53:55",216,71,49,22,0,71,0,300,229,45,26
39,VASLUI,"ŞCOALA VERDEŞ",221,BOGDANA,162595,1,PART,PRCNCT,PRSD,PRSD_SV,"2025-05-18 21:32:47",226,88,69,19,0,86,2,300,212,33,53
39,VASLUI,"ȘCOALA GIMNAZIALĂ ”HORIA STAMATIN”",222,BOGDĂNEŞTI,162693,1,PART,PRCNCT,PRSD,PRSD_SV,"2025-05-18 21:33:40",773,348,305,42,1,346,2,800,452,164,182
39,VASLUI,"ŞCOALA PRIMARĂ, SAT HOROIATA",223,BOGDĂNEŞTI,162693,1,PART,PRCNCT,PRSD,PRSD_SV,"2025-05-18 21:18:32",136,97,79,18,0,97,0,200,103,67,30
39,VASLUI,"ȘCOALA PRIMARĂ ”ACADEMICIAN RĂȘCANU C. VASILE”",224,BOGDĂNEŞTI,162693,1,PART,PRCNCT,PRSD,PRSD_SV,"2025-05-18 21:24:00",251,128,112,16,0,128,0,300,172,78,50
39,VASLUI,"ŞCOALA PRIMARĂ, SAT ULEA",225,BOGDĂNEŞTI,162693,1,PART,PRCNCT,PRSD,PRSD_SV,"2025-05-18 21:36:59",274,128,98,30,0,126,2,300,172,69,57
39,VASLUI,"ŞCOALA GIMNAZIALĂ, SAT UNȚEȘTI",226,BOGDĂNEŞTI,162693,1,PART,PRCNCT,PRSD,PRSD_SV,"2025-05-18 21:36:09",788,317,286,31,0,313,4,800,483,217,96
39,VASLUI,"ŞCOALA PRIMARĂ, SAT VIȘINARI",227,BOGDĂNEŞTI,162693,1,PART,PRCNCT,PRSD,PRSD_SV,"2025-05-18 21:23:29",159,64,42,22,0,63,1,200,136,46,17
39,VASLUI,"SEDIUL PRIMARIEI",228,BOGDĂNIŢA,162791,1,PART,PRCNCT,PRSD,PRSD_SV,"2025-05-18 21:24:52",153,102,70,32,0,100,2,200,98,63,37
39,VASLUI,"ŞCOALA GIMNAZIALA NR 1 CEPEŞTI",229,BOGDĂNIŢA,162791,1,PART,PRCNCT,PRSD,PRSD_SV,"2025-05-18 21:38:07",427,226,177,48,1,225,1,500,274,140,85
39,VASLUI,"ŞCOALA PRIMARA COROIEŞTI",230,BOGDĂNIŢA,162791,1,PART,PRCNCT,PRSD,PRSD_SV,"2025-05-18 21:17:53",340,137,116,20,1,136,1,400,263,92,44
39,VASLUI,"ŞCOALA PRIMARA TUNSEŞTI",231,BOGDĂNIŢA,162791,1,PART,PRCNCT,PRSD,PRSD_SV,"2025-05-18 21:20:32",227,94,87,7,0,93,1,300,206,50,43
39,VASLUI,"CĂMINUL CULTURAL BOȚEȘTI",232,BOŢEŞTI,162871,1,PART,PRCNCT,PRSD,PRSD_SV,"2025-05-18 21:41:11",687,317,267,50,0,315,2,800,483,162,153
39,VASLUI,"CĂMINUL CULTURAL GUGEȘTI",233,BOŢEŞTI,162871,1,PART,PRCNCT,PRSD,PRSD_SV,"2025-05-18 21:46:08",763,406,331,75,0,403,3,800,394,234,169
39,VASLUI,"ŞCOALA GIMNAZIALA NR. 1 SAT AVEREŞTI",234,BUNEŞTI-AVEREŞTI,162924,1,PART,PRCNCT,PRSD,PRSD_SV,"2025-05-18 21:46:47",199,112,89,21,2,111,1,200,88,69,42
39,VASLUI,"FOSTA ŞCOALA GENERALĂ ARMĂŞENI",235,BUNEŞTI-AVEREŞTI,162924,1,PART,PRCNCT,PRSD,PRSD_SV,"2025-05-18 21:26:11",251,121,83,38,0,120,1,300,179,68,52
39,VASLUI,"ŞCOALA GIMNAZIALĂ I-IV BUNEŞTI",236,BUNEŞTI-AVEREŞTI,162924,1,PART,PRCNCT,PRSD,PRSD_SV,"2025-05-18 22:04:51",909,393,364,29,0,391,2,1000,607,234,157
39,VASLUI,"ŞCOALA PRIMARĂ PLOPI",237,BUNEŞTI-AVEREŞTI,162924,1,PART,PRCNCT,PRSD,PRSD_SV,"2025-05-18 21:49:12",307,167,134,33,0,165,2,400,233,82,83
39,VASLUI,"ŞCOALA PRIMARĂ PODU-OPRII",238,BUNEŞTI-AVEREŞTI,162924,1,PART,PRCNCT,PRSD,PRSD_SV,"2025-05-18 21:26:36",191,122,90,32,0,121,1,200,78,68,53
39,VASLUI,"CĂMINUL CULTURAL CIOCANI",239,CIOCANI,167268,1,PART,PRCNCT,PRSD,PRSD_SV,"2025-05-18 21:46:54",913,328,292,36,0,324,4,1000,672,228,96
39,VASLUI,"ȘCOALA PRIMARĂ CRÂNG",240,CIOCANI,167268,1,PART,PRCNCT,PRSD,PRSD_SV,"2025-05-18 21:36:53",387,193,175,18,0,190,3,400,207,98,92
39,VASLUI,"ȘCOALA GIMNAZIALĂ CODĂEȘTI",241,CODĂEŞTI,163002,1,PART,PRCNCT,PRSD,PRSD_SV,"2025-05-18 21:36:32",840,384,322,59,3,382,2,900,516,199,183
39,VASLUI,"ȘCOALA GIMNAZIALĂ CODĂEȘTI",242,CODĂEŞTI,163002,1,PART,PRCNCT,PRSD,PRSD_SV,"2025-05-18 21:31:13",758,322,280,28,14,319,3,800,478,167,152
39,VASLUI,"ȘCOALA GENERALĂ GHERGHELEU",243,CODĂEŞTI,163002,1,PART,PRCNCT,PRSD,PRSD_SV,"2025-05-18 21:12:49",301,128,103,25,0,127,1,400,272,57,70
39,VASLUI,"ȘCOALA GIMNAZIALĂ PRIBEȘTI",244,CODĂEŞTI,163002,1,PART,PRCNCT,PRSD,PRSD_SV,"2025-05-18 21:33:13",941,381,330,51,0,377,4,1000,619,189,188
39,VASLUI,"CĂMINUL CULTURAL REDIU-GALIAN",245,CODĂEŞTI,163002,2,PART,PRCNCT,PRSD,PRSD_SV,"2025-05-18 23:15:10",438,201,178,23,0,201,0,500,299,144,57
39,VASLUI,"SCOALA GIMNAZIALA GEORGE C DRAGU SAT COROIESTI",246,COROIEŞTI,163057,1,PART,PRCNCT,PRSD,PRSD_SV,"2025-05-18 21:35:49",653,207,176,31,0,205,2,700,493,137,68
39,VASLUI,"DISPENSAR UMAN, SAT CHILIENI",247,COROIEŞTI,163057,1,PART,PRCNCT,PRSD,PRSD_SV,"2025-05-18 21:13:08",170,73,51,22,0,73,0,200,127,58,15
39,VASLUI,"SCOALA PRIMARA SAT HREASCA",248,COROIEŞTI,163057,1,PART,PRCNCT,PRSD,PRSD_SV,"2025-05-18 21:25:04",321,135,115,20,0,133,2,400,265,98,35
39,VASLUI,"SCOALA GIMNAZIALA SAT MIRENI",249,COROIEŞTI,163057,3,PART,PRCNCT,PRSD,PRSD_SV,"2025-05-19 01:23:55",343,169,133,36,0,167,2,400,231,102,65
39,VASLUI,"ŞCOALA GIMNAZIALĂ SFÂNTUL IERARH LUCA COSTEȘTI",250,COSTEŞTI,163137,1,PART,PRCNCT,PRSD,PRSD_SV,"2025-05-18 21:34:33",1400,652,540,112,0,642,10,1600,948,322,320
39,VASLUI,"ŞCOALA PRIMARĂ CHIŢCANI",251,COSTEŞTI,163137,1,PART,PRCNCT,PRSD,PRSD_SV,"2025-05-18 21:16:22",253,100,81,19,0,98,2,300,200,62,36
39,VASLUI,"ŞCOALA PRIMARĂ DINGA",252,COSTEŞTI,163137,1,PART,PRCNCT,PRSD,PRSD_SV,"2025-05-18 21:23:23",93,72,42,30,0,72,0,100,28,40,32
39,VASLUI,"ŞCOALA PRIMARĂ PÎRVEŞTI",253,COSTEŞTI,163137,1,PART,PRCNCT,PRSD,PRSD_SV,"2025-05-18 21:15:30",73,48,33,15,0,44,4,100,52,17,27
39,VASLUI,"ŞCOALA GIMNAZIALĂ PUNTIŞENI",254,COSTEŞTI,163137,1,PART,PRCNCT,PRSD,PRSD_SV,"2025-05-18 21:19:59",191,95,72,23,0,94,1,200,105,44,50
39,VASLUI,"ŞCOALA PRIMARĂ RĂDEŞTI",255,COSTEŞTI,163137,1,PART,PRCNCT,PRSD,PRSD_SV,"2025-05-18 21:15:04",98,79,45,34,0,77,2,100,21,34,43
39,VASLUI,"ŞCOALA PRIMARÃ BÃLEŞTI",256,COZMEŞTI,167277,1,PART,PRCNCT,PRSD,PRSD_SV,"2025-05-18 21:54:21",582,257,225,32,0,255,2,600,343,165,90
39,VASLUI,"CĂMIN CULTURAL COZMEȘTI",257,COZMEŞTI,167277,2,PART,PRCNCT,PRSD,PRSD_SV,"2025-05-19 02:58:32",218,119,87,32,0,119,0,300,181,65,54
39,VASLUI,"ŞCOALA GIMNAZIALÃ ” CEZAR BOTEZ ” FÂSTÂCI",258,COZMEŞTI,167277,1,PART,PRCNCT,PRSD,PRSD_SV,"2025-05-18 21:38:48",262,94,76,18,0,92,2,300,206,51,41
39,VASLUI,"ŞCOALA PRIMARÃ FÂSTÂCI",259,COZMEŞTI,167277,1,PART,PRCNCT,PRSD,PRSD_SV,"2025-05-18 21:56:16",599,215,199,16,0,212,3,600,385,165,47
39,VASLUI,"CĂMINUL CULTURAL ” VASILE FOLESCU” CREŢEŞTI",260,CREŢEŞTI,163208,1,PART,PRCNCT,PRSD,PRSD_SV,"2025-05-18 21:40:21",428,210,186,24,0,208,2,500,290,119,89
39,VASLUI,"ŞCOALA DEZAFECTATA BUDEŞTI",261,CREŢEŞTI,163208,1,PART,PRCNCT,PRSD,PRSD_SV,"2025-05-18 21:14:16",138,68,49,19,0,68,0,200,132,30,38
39,VASLUI,"ŞCOALA GIMNAZIALA NR.1 CRETESTII DE SUS",262,CREŢEŞTI,163208,2,PART,PRCNCT,PRSD,PRSD_SV,"2025-05-19 02:18:42",465,230,186,43,1,224,6,500,270,133,91
39,VASLUI,"ŞCOALA NOUA SATU NOU",263,CREŢEŞTI,163208,1,PART,PRCNCT,PRSD,PRSD_SV,"2025-05-18 21:33:33",243,124,105,19,0,123,1,300,176,70,53
39,VASLUI,"ȘCOALA GIMNAZIALĂ ”GRIGORE T POPA” DĂNEȘTI",264,DĂNEŞTI,163253,1,PART,PRCNCT,PRSD,PRSD_SV,"2025-05-18 21:21:22",440,182,150,32,0,181,1,500,318,99,82
39,VASLUI,"ŞCOALA PRIMARA BEREASA",265,DĂNEŞTI,163253,2,PART,PRCNCT,PRSD,PRSD_SV,"2025-05-18 23:23:55",281,118,96,22,0,118,0,300,182,87,31
39,VASLUI,"ŞCOALA GIMNAZIALA EMIL RACOVIŢĂ",266,DĂNEŞTI,163253,1,PART,PRCNCT,PRSD,PRSD_SV,"2025-05-18 21:30:12",633,240,221,19,0,231,9,700,460,140,91
39,VASLUI,"ŞCOALA PRIMARA TĂTĂRĂNI",267,DĂNEŞTI,163253,1,PART,PRCNCT,PRSD,PRSD_SV,"2025-05-18 21:16:05",145,86,51,35,0,85,1,200,114,23,62
39,VASLUI,"ŞCOALA GIMNAZIALA NR. 1 DELENI",268,DELENI,163324,1,PART,PRCNCT,PRSD,PRSD_SV,"2025-05-18 22:00:32",1357,687,564,91,32,680,7,1400,713,349,331
39,VASLUI,"GRADINITA CU PROGRAM NORMAL, SAT BULBOACA",269,DELENI,163324,1,PART,PRCNCT,PRSD,PRSD_SV,"2025-05-18 21:48:30",449,247,203,39,5,244,3,500,253,126,118
39,VASLUI,"ŞCOALA GIMNAZIALĂ NR. 1, DELEŞTI",270,DELEŞTI,163379,1,PART,PRCNCT,PRSD,PRSD_SV,"2025-05-18 21:50:12",574,248,205,43,0,247,1,600,352,111,136
39,VASLUI,"ŞCOALA PRIMARĂ, ALBEŞTI",271,DELEŞTI,163379,1,PART,PRCNCT,PRSD,PRSD_SV,"2025-05-18 21:17:06",138,54,40,14,0,54,0,200,146,27,27
39,VASLUI,"ŞCOALA PRIMARĂ, FUNDĂTURA",272,DELEŞTI,163379,1,PART,PRCNCT,PRSD,PRSD_SV,"2025-05-18 21:21:59",288,142,108,34,0,139,3,300,158,79,60
39,VASLUI,"ȘCOALA PRIMARĂ HÂRȘOVA",273,DELEŞTI,163379,1,PART,PRCNCT,PRSD,PRSD_SV,"2025-05-18 21:32:59",365,191,152,39,0,189,2,400,209,104,85
39,VASLUI,"ŞCOALA PRIMARĂ, MÎNĂSTIREA",274,DELEŞTI,163379,1,PART,PRCNCT,PRSD,PRSD_SV,"2025-05-18 21:11:11",127,72,54,18,0,70,2,200,128,22,48
39,VASLUI,"ŞCOALA PRIMARĂ, RĂDUIEȘTI",275,DELEŞTI,163379,1,PART,PRCNCT,PRSD,PRSD_SV,"2025-05-18 21:29:37",162,82,63,19,0,81,1,201,119,22,59
39,VASLUI,"ŞCOALA GIMNAZIALĂ NR.1 HURDUGI",276,"DIMITRIE CANTEMIR",164277,1,PART,PRCNCT,PRSD,PRSD_SV,"2025-05-18 21:21:59",489,203,180,23,0,202,1,500,297,115,87
39,VASLUI,"ȘCOALA PRIMARĂ GRUMEZOAIA",277,"DIMITRIE CANTEMIR",164277,1,PART,PRCNCT,PRSD,PRSD_SV,"2025-05-18 21:29:17",314,145,119,26,0,145,0,400,255,97,48
39,VASLUI,"ŞCOALA PRIMARĂ GUȘIȚEI",278,"DIMITRIE CANTEMIR",164277,1,PART,PRCNCT,PRSD,PRSD_SV,"2025-05-18 21:31:31",634,239,212,27,0,238,1,700,461,174,64
39,VASLUI,"ŞCOALA PRIMARĂ PLOTONEŞTI",279,"DIMITRIE CANTEMIR",164277,1,PART,PRCNCT,PRSD,PRSD_SV,"2025-05-18 21:17:56",247,96,83,13,0,96,0,400,304,43,53
39,VASLUI,"ŞCOALA PRIMARĂ URLAŢI",280,"DIMITRIE CANTEMIR",164277,1,PART,PRCNCT,PRSD,PRSD_SV,"2025-05-18 21:13:47",183,90,71,19,0,90,0,200,110,62,28
39,VASLUI,"ŞCOALA GIMNAZIALĂ ”V.I. POPA”",281,DODEŞTI,167286,1,PART,PRCNCT,PRSD,PRSD_SV,"2025-05-18 22:02:57",1101,546,472,60,14,542,4,1200,654,300,242
39,VASLUI,"ŞCOALA PRIMARĂ URDEŞTI",282,DODEŞTI,167286,1,PART,PRCNCT,PRSD,PRSD_SV,"2025-05-18 21:38:47",204,147,111,36,0,146,1,400,253,77,69
39,VASLUI,"CĂMINUL CULTURAL DRAGOMIREŞTI",283,DRAGOMIREŞTI,163486,1,PART,PRCNCT,PRSD,PRSD_SV,"2025-05-18 21:30:24",415,195,145,50,0,191,4,500,305,72,119
39,VASLUI,"ŞCOALA PRIMARĂ BĂBUŢA",284,DRAGOMIREŞTI,163486,1,PART,PRCNCT,PRSD,PRSD_SV,"2025-05-18 21:19:09",128,60,44,16,0,60,0,200,140,34,26
39,VASLUI,"ŞCOALA PRIMARĂ BELZENI",285,DRAGOMIREŞTI,163486,1,PART,PRCNCT,PRSD,PRSD_SV,"2025-05-18 21:24:52",222,79,64,15,0,79,0,400,321,61,18
39,VASLUI,"ŞCOALA GIMNAZIALĂ DOAGELE",286,DRAGOMIREŞTI,163486,1,PART,PRCNCT,PRSD,PRSD_SV,"2025-05-18 21:50:38",859,308,277,31,0,302,6,900,592,143,159
39,VASLUI,"LOCUINȚĂ PROPRIETATE PRIVATĂ VIERU MARIA",287,DRAGOMIREŞTI,163486,1,PART,PRCNCT,PRSD,PRSD_SV,"2025-05-18 21:44:28",220,96,75,21,0,95,1,400,304,56,39
39,VASLUI,"CĂMIN CULTURAL POPEŞTI",288,DRAGOMIREŞTI,163486,1,PART,PRCNCT,PRSD,PRSD_SV,"2025-05-18 21:34:37",328,154,134,20,0,153,1,400,246,114,39
39,VASLUI,"ŞCOALA GIMNAZIALĂ NR. 1 RĂDENI",289,DRAGOMIREŞTI,163486,1,PART,PRCNCT,PRSD,PRSD_SV,"2025-05-18 21:33:31",1016,373,323,50,0,372,1,1200,827,270,102
39,VASLUI,"ŞCOALA PRIMARĂ TULEŞTI",290,DRAGOMIREŞTI,163486,1,PART,PRCNCT,PRSD,PRSD_SV,"2025-05-18 21:36:46",143,71,46,25,0,69,2,200,129,37,32
39,VASLUI,"LICEUL TEHNOLOGIC VLADIA",291,DRAGOMIREŞTI,163486,2,PART,PRCNCT,PRSD,PRSD_SV,"2025-05-19 00:27:32",340,154,133,21,0,153,1,400,246,94,59
39,VASLUI,"SALA DE EDUCAŢIE FIZICĂ ŞCOLARĂ GHERMĂNEŞTI",292,DRÂNCENI,163618,1,PART,PRCNCT,PRSD,PRSD_SV,"2025-05-18 21:44:15",1548,651,595,56,0,648,3,1600,949,404,244
39,VASLUI,"ŞCOALA PRIMARĂ, SAT DRÎNCENI",293,DRÂNCENI,163618,1,PART,PRCNCT,PRSD,PRSD_SV,"2025-05-18 21:28:15",678,190,147,43,0,188,2,800,610,102,86
39,VASLUI,"ŞCOALA GIMNAZIALĂ, SAT RÎŞEŞTI",294,DRÂNCENI,163618,1,PART,PRCNCT,PRSD,PRSD_SV,"2025-05-18 21:58:29",1704,706,594,112,0,697,9,1800,1094,440,257
39,VASLUI,"ŞCOALA GIMNAZIALA CONSTANTIN ASIMINEI",295,DUDA-EPURENI,163681,1,PART,PRCNCT,PRSD,PRSD_SV,"2025-05-18 21:51:32",1105,505,451,54,0,503,2,1200,695,306,197
39,VASLUI,"FOSTA ŞCOALA CU CLASELE I-IV BOBEŞTI",296,DUDA-EPURENI,163681,1,PART,PRCNCT,PRSD,PRSD_SV,"2025-05-18 21:15:20",96,58,43,15,0,56,2,100,42,34,22
39,VASLUI,"ŞCOALA GIMNAZIALA IOAN GHE. PRICOP",297,DUDA-EPURENI,163681,1,PART,PRCNCT,PRSD,PRSD_SV,"2025-05-18 21:37:07",899,398,342,56,0,394,4,1000,602,255,139
39,VASLUI,"ŞCOALA GIMNAZIALA NICOLAE POPA",298,DUDA-EPURENI,163681,1,PART,PRCNCT,PRSD,PRSD_SV,"2025-05-18 21:46:18",1319,492,466,26,0,489,3,1400,908,357,132
39,VASLUI,"ŞCOALA GIMNAZIALĂ ”MAREȘAL C-TIN PREZAN” DUMEŞTI",299,DUMEŞTI,163734,1,PART,PRCNCT,PRSD,PRSD_SV,"2025-05-18 22:27:47",1002,388,332,56,0,380,8,1200,812,235,145
39,VASLUI,"GRĂDINIŢA NR. 1 DUMEŞTI",300,DUMEŞTI,163734,1,PART,PRCNCT,PRSD,PRSD_SV,"2025-05-18 21:39:30",717,323,290,31,2,320,3,800,477,175,145
39,VASLUI,"GRĂDINIȚA DUMEŞTII VECHI",301,DUMEŞTI,163734,1,PART,PRCNCT,PRSD,PRSD_SV,"2025-05-18 21:49:12",339,140,124,16,0,140,0,400,260,88,52
39,VASLUI,"ŞCOALA PRIMARĂ VALEA MARE",302,DUMEŞTI,163734,1,PART,PRCNCT,PRSD,PRSD_SV,"2025-05-18 21:42:48",693,285,266,19,0,281,4,800,515,199,82
39,VASLUI,"SCOALA GIMNAZIALA ” MANOLACHE COSTACHE EPUREANU” SAT EPURENI",303,EPURENI,163789,1,PART,PRCNCT,PRSD,PRSD_SV,"2025-05-18 21:49:26",726,330,270,59,1,328,2,800,470,168,160
39,VASLUI,"SCOALA PRIMARA .SAT BIRLALESTI",304,EPURENI,163789,2,PART,PRCNCT,PRSD,PRSD_SV,"2025-05-19 01:46:47",567,275,221,52,2,272,3,600,325,176,96
39,VASLUI,"ȘCOALA PRIMARĂ NR.2 BURSUCI",305,EPURENI,163789,1,PART,PRCNCT,PRSD,PRSD_SV,"2025-05-18 21:33:21",684,280,246,34,0,279,1,800,520,201,78
39,VASLUI,"SCOALA PRIMARA ,SAT HORGA",306,EPURENI,163789,1,PART,PRCNCT,PRSD,PRSD_SV,"2025-05-18 21:39:22",298,154,126,28,0,152,2,400,246,108,44
39,VASLUI,"LICEUL TEHNOLOGIC ”DIMITRIE CANTEMIR” SAT FĂLCIU",307,FĂLCIU,163832,1,PART,PRCNCT,PRSD,PRSD_SV,"2025-05-18 21:38:40",1055,425,376,49,0,423,2,1200,775,243,180
39,VASLUI,"CĂMINUL CULTURAL FĂLCIU",308,FĂLCIU,163832,1,PART,PRCNCT,PRSD,PRSD_SV,"2025-05-18 21:40:04",1033,399,354,45,0,393,6,1200,801,232,161
39,VASLUI,"ŞCOALA PRIMARĂ SAT BOGDĂNEŞTI",309,FĂLCIU,163832,1,PART,PRCNCT,PRSD,PRSD_SV,"2025-05-18 21:21:02",438,193,162,31,0,193,0,500,307,133,60
39,VASLUI,"ŞCOALA PRIMARĂ SAT BOZIA",310,FĂLCIU,163832,1,PART,PRCNCT,PRSD,PRSD_SV,"2025-05-18 21:27:50",267,139,120,19,0,135,4,300,161,80,55
39,VASLUI,"ŞCOALA PRIMARĂ SAT COPĂCEANA",311,FĂLCIU,163832,1,PART,PRCNCT,PRSD,PRSD_SV,"2025-05-18 21:31:22",399,153,135,18,0,151,2,400,247,108,43
39,VASLUI,"ŞCOALA PRIMARĂ SAT ODAIA BOGDANA",312,FĂLCIU,163832,1,PART,PRCNCT,PRSD,PRSD_SV,"2025-05-18 21:35:05",243,128,109,18,1,125,3,400,272,99,26
39,VASLUI,"ŞCOALA GIMNAZIALĂ SAT RÂNZEŞTI",313,FĂLCIU,163832,1,PART,PRCNCT,PRSD,PRSD_SV,"2025-05-18 21:26:48",794,356,296,60,0,351,5,800,444,233,118
39,VASLUI,"GRĂDINIȚA CU PROGRAM NORMAL ”PRICHINDEL”",314,FEREŞTI,167295,1,PART,PRCNCT,PRSD,PRSD_SV,"2025-05-18 21:48:38",1844,389,348,9,32,383,6,2000,1611,212,171
39,VASLUI,"CENTRUL CULTURAL ”SANDU TRIFAN”, FEREŞTI",315,FEREŞTI,167295,1,PART,PRCNCT,PRSD,PRSD_SV,"2025-05-18 22:06:33",1636,277,232,37,8,272,5,1700,1423,165,107
39,VASLUI,"ŞCOALA GIMNAZIALĂ ”GENERAL AVIATOR INGINER GHEORGHE NEGRESCU” FRUNTIŞENI",316,FRUNTIŞENI,167231,1,PART,PRCNCT,PRSD,PRSD_SV,"2025-05-18 21:37:35",770,334,299,35,0,329,5,800,466,220,109
39,VASLUI,"ŞCOALA GIMNAZIALĂ GRĂJDENI",317,FRUNTIŞENI,167231,2,PART,PRCNCT,PRSD,PRSD_SV,"2025-05-19 02:05:51",605,291,243,46,2,290,1,800,509,170,120
39,VASLUI,"ŞCOALA GIMNAZIALA ”ION ARTENE” GĂGEŞTI",318,GĂGEŞTI,163903,1,PART,PRCNCT,PRSD,PRSD_SV,"2025-05-18 21:26:41",371,190,160,30,0,188,2,400,210,129,59
39,VASLUI,"ȘCOALA GIMNAZIALĂ ”MIHAI IOAN BOTEZ” GIURCANI",319,GĂGEŞTI,163903,1,PART,PRCNCT,PRSD,PRSD_SV,"2025-05-18 21:51:23",451,199,157,42,0,198,1,500,301,99,99
39,VASLUI,"ŞCOALA PRIMARA ”DUMITRU MARIN” PEICANI",320,GĂGEŞTI,163903,1,PART,PRCNCT,PRSD,PRSD_SV,"2025-05-18 21:28:24",418,186,164,22,0,181,5,500,314,100,81
39,VASLUI,"SALĂ DE FESTIVITĂȚI TUPILAȚI",321,GĂGEŞTI,163903,1,PART,PRCNCT,PRSD,PRSD_SV,"2025-05-18 21:34:34",233,138,107,31,0,136,2,400,262,90,46
39,VASLUI,"ȘCOALA GIMNAZIALĂ NR. 1",322,GÂRCENI,164062,1,PART,PRCNCT,PRSD,PRSD_SV,"2025-05-18 21:30:48",626,276,230,46,0,272,4,800,524,118,154
39,VASLUI,"ŞCOALA PRIMARĂ, DUMBRĂVENI",323,GÂRCENI,164062,1,PART,PRCNCT,PRSD,PRSD_SV,"2025-05-18 21:38:23",163,100,71,29,0,100,0,200,100,50,50
39,VASLUI,"ŞCOALA GIMNAZIALĂ, RACOVA",324,GÂRCENI,164062,1,PART,PRCNCT,PRSD,PRSD_SV,"2025-05-18 21:24:01",148,86,69,17,0,86,0,200,114,44,42
39,VASLUI,"ŞCOALA PRIMARĂ, RACOVIŢA",325,GÂRCENI,164062,3,PART,PRCNCT,PRSD,PRSD_SV,"2025-05-19 00:25:27",213,137,125,12,0,135,2,400,263,58,77
39,VASLUI,"ŞCOALA PRIMARĂ, SLOBOZIA",326,GÂRCENI,164062,1,PART,PRCNCT,PRSD,PRSD_SV,"2025-05-18 21:28:09",375,207,188,19,0,204,3,400,193,102,102
39,VASLUI,"ŞCOALA PRIMARĂ, TROHAN",327,GÂRCENI,164062,1,PART,PRCNCT,PRSD,PRSD_SV,"2025-05-18 21:28:08",182,101,70,31,0,98,3,200,99,29,69
39,VASLUI,"CĂMINUL CULTURAL, GHERGHEŞTI",328,GHERGHEŞTI,163967,2,PART,PRCNCT,PRSD,PRSD_SV,"2025-05-19 02:16:07",854,400,325,74,1,395,5,900,500,266,129
39,VASLUI,"ŞCOALA GIMNAZIALA SAT CHETROSU",329,GHERGHEŞTI,163967,1,PART,PRCNCT,PRSD,PRSD_SV,"2025-05-18 21:26:27",377,184,150,34,0,181,3,400,216,92,89
39,VASLUI,"ŞCOALA PRIMARA SAT CORODESTI",330,GHERGHEŞTI,163967,1,PART,PRCNCT,PRSD,PRSD_SV,"2025-05-18 21:27:45",160,91,68,23,0,89,2,200,109,50,39
39,VASLUI,"ŞCOALA PRIMARĂ SAT DRAXENI (CONTAINER MODULAR)",331,GHERGHEŞTI,163967,1,PART,PRCNCT,PRSD,PRSD_SV,"2025-05-18 21:24:12",111,79,43,34,2,78,1,200,121,46,32
39,VASLUI,"CONTAINER MODULAR",332,GHERGHEŞTI,163967,1,PART,PRCNCT,PRSD,PRSD_SV,"2025-05-18 21:37:37",386,156,135,21,0,155,1,400,244,132,23
39,VASLUI,"CENTRUL CULTURAL STROE S. BELLOESCU GRIVIŢA",333,GRIVIŢA,164133,1,PART,PRCNCT,PRSD,PRSD_SV,"2025-05-18 21:46:49",1347,594,519,75,0,590,4,1400,806,334,256
39,VASLUI,"ŞCOALĂ PRIMARĂ STROE BELLOESCU CUPLATĂ CU GRĂDINIŢĂ – PROGRAM NORMAL",334,GRIVIŢA,164133,1,PART,PRCNCT,PRSD,PRSD_SV,"2025-05-18 21:36:13",420,171,127,44,0,167,4,500,329,91,76
39,VASLUI,"GRĂDINIŢA CU PROGRAM NORMAL",335,GRIVIŢA,164133,1,PART,PRCNCT,PRSD,PRSD_SV,"2025-05-18 22:00:03",1139,539,469,70,0,529,10,1200,661,268,261
39,VASLUI,"ȘCOALA GIMNAZIALĂ NR. 1 HOCENI",336,HOCENI,164197,1,PART,PRCNCT,PRSD,PRSD_SV,"2025-05-18 21:21:25",408,204,187,16,1,204,0,500,296,115,89
39,VASLUI,"GRĂDINIŢA CU PROGRAM NORMAL BARBOŞI",337,HOCENI,164197,1,PART,PRCNCT,PRSD,PRSD_SV,"2025-05-18 21:22:17",517,217,192,25,0,216,1,600,383,127,89
39,VASLUI,"ŞCOALA PRIMARĂ DELENI",338,HOCENI,164197,1,PART,PRCNCT,PRSD,PRSD_SV,"2025-05-18 21:23:27",338,202,164,37,1,200,2,400,198,105,95
39,VASLUI,"ŞCOALA PRIMARĂ ING. IOAN CIOMAGA",339,HOCENI,164197,1,PART,PRCNCT,PRSD,PRSD_SV,"2025-05-18 21:26:45",388,237,198,39,0,230,7,408,171,109,121
39,VASLUI,"ŞCOALA PRIMARĂ ”MIHAI CIOFU” ȘIȘCANI",340,HOCENI,164197,1,PART,PRCNCT,PRSD,PRSD_SV,"2025-05-18 21:19:22",225,118,92,26,0,111,7,400,282,66,45
39,VASLUI,"CENTRUL DE ZI TOMȘA",341,HOCENI,164197,1,PART,PRCNCT,PRSD,PRSD_SV,"2025-05-18 21:31:58",94,63,48,15,0,63,0,100,37,19,44
39,VASLUI,"ŞCOALA GIMNAZIALA NR.1 IANA CORP B",342,IANA,164339,1,PART,PRCNCT,PRSD,PRSD_SV,"2025-05-18 21:35:58",985,349,320,29,0,347,2,1000,651,249,98
39,VASLUI,"ŞCOALA PRIMARA HĂLĂREŞTI",343,IANA,164339,1,PART,PRCNCT,PRSD,PRSD_SV,"2025-05-18 21:38:15",805,334,310,24,0,327,7,900,566,220,107
39,VASLUI,"ŞCOALA GIMNAZIALA RECEA",344,IANA,164339,1,PART,PRCNCT,PRSD,PRSD_SV,"2025-05-18 21:19:51",436,173,155,18,0,170,3,500,327,124,46
39,VASLUI,"ȘCOALA CU CLASELE I-IV SILIȘTEA",345,IANA,164339,1,PART,PRCNCT,PRSD,PRSD_SV,"2025-05-18 21:37:11",789,354,332,22,0,350,4,800,446,241,109
39,VASLUI,"ȘCOALA PRIMARĂ VADURILE",346,IANA,164339,1,PART,PRCNCT,PRSD,PRSD_SV,"2025-05-18 21:18:22",234,98,75,23,0,96,2,400,302,55,41
39,VASLUI,"CĂMINUL CULTURAL IBĂNEŞTI",347,IBĂNEŞTI,167222,2,PART,PRCNCT,PRSD,PRSD_SV,"2025-05-19 01:12:08",517,297,228,58,11,296,1,600,303,130,166
39,VASLUI,"ŞCOALA PRIMARĂ SAT. MÎNZAŢI",348,IBĂNEŞTI,167222,2,PART,PRCNCT,PRSD,PRSD_SV,"2025-05-19 01:08:12",485,242,209,27,6,240,2,500,258,78,162
39,VASLUI,"FOSTA ŞCOALA CU CLASELE I-IV, PUŢU OLARULUI",349,IBĂNEŞTI,167222,1,PART,PRCNCT,PRSD,PRSD_SV,"2025-05-18 21:30:58",95,68,49,18,1,68,0,100,32,24,44
39,VASLUI,"ŞCOALA GIMNAZIALĂ ”IONEL MIRON” IVĂNEȘTI",350,IVĂNEŞTI,164393,1,PART,PRCNCT,PRSD,PRSD_SV,"2025-05-18 21:20:03",907,399,314,74,11,396,3,1000,601,160,236
39,VASLUI,"ŞCOALA BROŞTENI",351,IVĂNEŞTI,164393,2,PART,PRCNCT,PRSD,PRSD_SV,"2025-05-18 22:55:02",450,214,172,34,8,210,4,500,286,134,76
39,VASLUI,"ŞCOALA COȘEȘTI",352,IVĂNEŞTI,164393,1,PART,PRCNCT,PRSD,PRSD_SV,"2025-05-18 21:18:19",261,94,67,21,6,94,0,400,306,50,44
39,VASLUI,"ŞCOALA COŞEȘTI",353,IVĂNEŞTI,164393,1,PART,PRCNCT,PRSD,PRSD_SV,"2025-05-18 21:20:12",237,99,72,27,0,98,1,400,301,45,53
39,VASLUI,"GRĂDINIȚA CU PROGRAM NORMAL SAT URSOAIA",354,IVĂNEŞTI,164393,1,PART,PRCNCT,PRSD,PRSD_SV,"2025-05-18 21:33:20",361,172,144,28,0,166,6,400,228,103,63
39,VASLUI,"GRADINITA CU PROGRAM NORMAL SAT.URSOAIA",355,IVĂNEŞTI,164393,1,PART,PRCNCT,PRSD,PRSD_SV,"2025-05-18 21:26:50",362,155,119,36,0,152,3,400,245,86,66
39,VASLUI,"CENTRU DE ACTIVITĂȚI SOCIALE",356,IVĂNEŞTI,164393,1,PART,PRCNCT,PRSD,PRSD_SV,"2025-05-18 21:31:33",387,168,139,23,6,168,0,400,232,100,68
39,VASLUI,"ŞCOALA VALEA OANEI",357,IVĂNEŞTI,164393,1,PART,PRCNCT,PRSD,PRSD_SV,"2025-05-18 21:17:29",205,102,73,23,6,100,2,400,298,43,57
39,VASLUI,"ŞCOALA GIMNAZIALĂ NR. 1 IVEŞTI - CORP A",358,IVEŞTI,164543,1,PART,PRCNCT,PRSD,PRSD_SV,"2025-05-18 21:55:51",1104,531,435,96,0,530,1,1200,669,250,280
39,VASLUI,"ŞCOALA GIMNAZIALĂ NR. 1 IVEŞTI - CORP B",359,IVEŞTI,164543,1,PART,PRCNCT,PRSD,PRSD_SV,"2025-05-18 22:11:38",1075,467,414,53,0,466,1,1200,733,235,231
39,VASLUI,"ŞCOALA GIMNAZIALĂ ”MIHAI EMINESCU” LAZA",360,LAZA,164598,1,PART,PRCNCT,PRSD,PRSD_SV,"2025-05-18 22:05:06",1460,667,616,51,0,661,6,1600,933,310,351
39,VASLUI,"ŞCOALA PRIMARĂ, RÂŞNIŢA",361,LAZA,164598,1,PART,PRCNCT,PRSD,PRSD_SV,"2025-05-18 21:36:14",239,119,97,22,0,119,0,400,281,74,45
39,VASLUI,"ŞCOALA PRIMARA ,SAUCA",362,LAZA,164598,1,PART,PRCNCT,PRSD,PRSD_SV,"2025-05-18 22:05:33",855,397,354,43,0,395,2,900,503,181,214
39,VASLUI,"CENTRUL CULTURAL ”ȘTEFAN CIOBOTĂRAȘU” SAT LIPOVAȚ",363,LIPOVĂŢ,164687,1,PART,PRCNCT,PRSD,PRSD_SV,"2025-05-18 21:56:15",1335,638,588,50,0,627,11,1400,762,332,295
39,VASLUI,"ŞCOALA PRIMARĂ SAT CĂPUŞNENI",364,LIPOVĂŢ,164687,1,PART,PRCNCT,PRSD,PRSD_SV,"2025-05-18 21:41:48",195,112,90,22,0,111,1,200,88,66,45
39,VASLUI,"ŞCOALA GIMNAZIALĂ ”SPĂTAR ŞTEFAN ANGHELUȚĂ” SAT CHIŢOC",365,LIPOVĂŢ,164687,1,PART,PRCNCT,PRSD,PRSD_SV,"2025-05-18 21:35:12",828,403,360,43,0,398,5,900,497,216,182
39,VASLUI,"ŞCOALA PRIMARĂ SAT CORBU",366,LIPOVĂŢ,164687,1,PART,PRCNCT,PRSD,PRSD_SV,"2025-05-18 21:27:03",433,229,203,25,1,226,3,500,271,123,103
39,VASLUI,"CĂMIN CULTURAL",367,LIPOVĂŢ,164687,1,PART,PRCNCT,PRSD,PRSD_SV,"2025-05-18 21:33:58",481,165,149,16,0,161,4,500,335,109,52
39,VASLUI,"ŞCOALA GIMNAZIALĂ NR. 1 LUNCA BANULUI",368,"LUNCA BANULUI",164749,1,PART,PRCNCT,PRSD,PRSD_SV,"2025-05-18 22:08:26",1550,691,646,44,1,684,7,1600,909,438,246
39,VASLUI,"ŞCOALA PRIMARĂ SAT BROSCOŞEŞTI",369,"LUNCA BANULUI",164749,1,PART,PRCNCT,PRSD,PRSD_SV,"2025-05-18 21:35:18",333,156,136,20,0,154,2,400,244,106,48
39,VASLUI,"ŞCOALA PRIMARĂ SAT FOCŞA",370,"LUNCA BANULUI",164749,3,PART,PRCNCT,PRSD,PRSD_SV,"2025-05-19 01:50:08",145,86,78,8,0,86,0,200,114,56,30
39,VASLUI,"ŞCOALA PRIMARĂ SAT LUNCA VECHE",371,"LUNCA BANULUI",164749,1,PART,PRCNCT,PRSD,PRSD_SV,"2025-05-18 21:18:06",76,51,35,16,0,51,0,100,49,39,12
39,VASLUI,"ŞCOALA PRIMARĂ SAT OŢETOAIA",372,"LUNCA BANULUI",164749,1,PART,PRCNCT,PRSD,PRSD_SV,"2025-05-18 21:46:37",646,309,283,26,0,306,3,800,491,216,90
39,VASLUI,"ŞCOALA GIMNAZIALĂ NR.1,SAT MĂLUȘTENI",373,MĂLUŞTENI,164829,2,PART,PRCNCT,PRSD,PRSD_SV,"2025-05-19 03:05:28",448,201,177,24,0,198,3,500,299,137,61
39,VASLUI,"ŞCOALA GHIREASCA",374,MĂLUŞTENI,164829,1,PART,PRCNCT,PRSD,PRSD_SV,"2025-05-18 21:18:32",127,57,42,15,0,55,2,200,143,38,17
39,VASLUI,"SALA FESTIVITĂȚI LUPEȘTI",375,MĂLUŞTENI,164829,1,PART,PRCNCT,PRSD,PRSD_SV,"2025-05-18 21:23:11",297,123,99,24,0,120,3,400,277,72,48
39,VASLUI,"ŞCOALA MÎNĂSTIREA",376,MĂLUŞTENI,164829,1,PART,PRCNCT,PRSD,PRSD_SV,"2025-05-18 21:20:50",89,51,35,16,0,50,1,100,49,35,15
39,VASLUI,"SALA CULTURALĂ MÎNZĂTEȘTI",377,MĂLUŞTENI,164829,2,PART,PRCNCT,PRSD,PRSD_SV,"2025-05-19 03:08:49",227,125,96,29,0,124,1,400,275,66,58
39,VASLUI,"ŞCOALA CENTRU ȚUȚCANI",378,MĂLUŞTENI,164829,1,PART,PRCNCT,PRSD,PRSD_SV,"2025-05-18 21:28:08",376,152,125,27,0,152,0,400,248,73,79
39,VASLUI,"GRĂDINIȚA CU 3 SĂLI DE GRUPĂ",379,MICLEŞTI,164892,1,PART,PRCNCT,PRSD,PRSD_SV,"2025-05-18 21:31:29",727,315,259,56,0,310,5,800,485,158,152
39,VASLUI,"ŞCOALA GIMNAZIALĂ CHIRCEŞTI-DEAL",380,MICLEŞTI,164892,1,PART,PRCNCT,PRSD,PRSD_SV,"2025-05-18 21:31:17",499,264,227,37,0,260,4,500,236,129,131
39,VASLUI,"ŞCOALA DEZAFECTATĂ CHIRCEŞTI -VALE",381,MICLEŞTI,164892,1,PART,PRCNCT,PRSD,PRSD_SV,"2025-05-18 21:31:28",338,146,119,27,0,143,3,400,254,72,71
39,VASLUI,"ŞCOALA PRIMARĂ POPEŞTI",382,MICLEŞTI,164892,3,PART,PRCNCT,PRSD,PRSD_SV,"2025-05-19 03:15:33",341,129,107,22,0,128,1,400,271,84,44
39,VASLUI,"SALA DE EDUCAŢIE FIZICĂ ŞCOLARĂ MUNTENII DE JOS",383,"MUNTENII DE JOS",164936,1,PART,PRCNCT,PRSD,PRSD_SV,"2025-05-18 22:15:20",2432,983,890,91,2,976,7,2500,1517,418,558
39,VASLUI,"ŞCOALA PRIMARĂ SAT BĂCĂOANI",384,"MUNTENII DE JOS",164936,1,PART,PRCNCT,PRSD,PRSD_SV,"2025-05-18 21:54:10",1258,581,536,45,0,578,3,1300,719,279,299
39,VASLUI,"ŞCOALA PRIMARĂ SAT MÎNJEŞTI",385,"MUNTENII DE JOS",164936,1,PART,PRCNCT,PRSD,PRSD_SV,"2025-05-18 21:38:14",987,300,263,37,0,298,2,1000,700,145,153
39,VASLUI,"CĂMINUL CULTURAL MUNTENII DE SUS",386,"MUNTENII DE SUS",167302,1,PART,PRCNCT,PRSD,PRSD_SV,"2025-05-18 21:42:06",1195,436,396,40,0,429,7,1200,764,261,168
39,VASLUI,"ŞCOALA PRIMARĂ, SATU-NOU",387,"MUNTENII DE SUS",167302,1,PART,PRCNCT,PRSD,PRSD_SV,"2025-05-18 21:48:30",1179,464,442,22,0,460,4,1200,736,310,150
39,VASLUI,"SCOALA PRIMARA, SATU NOU",388,"MUNTENII DE SUS",167302,1,PART,PRCNCT,PRSD,PRSD_SV,"2025-05-18 21:53:36",1122,400,378,20,2,394,6,1200,800,231,163
39,VASLUI,"ŞCOALA PRIMARĂ OLTENEŞTI",389,OLTENEŞTI,165069,1,PART,PRCNCT,PRSD,PRSD_SV,"2025-05-18 21:27:00",366,138,113,25,0,135,3,400,262,78,57
39,VASLUI,"ŞCOALA PRIMARĂ CURTENI",390,OLTENEŞTI,165069,1,PART,PRCNCT,PRSD,PRSD_SV,"2025-05-18 21:19:38",157,90,68,22,0,90,0,200,110,60,30
39,VASLUI,"ŞCOALA PRIMARĂ PÎHNA",391,OLTENEŞTI,165069,1,PART,PRCNCT,PRSD,PRSD_SV,"2025-05-18 21:39:14",98,74,48,26,0,73,1,100,26,45,28
39,VASLUI,"ŞCOALA GIMNAZIALĂ CONSTANTIN ROTARU TÎRZII",392,OLTENEŞTI,165069,1,PART,PRCNCT,PRSD,PRSD_SV,"2025-05-18 21:28:17",878,333,294,39,0,329,4,900,567,207,122
39,VASLUI,"ŞCOALA GIMNAZIALA GRIGORE ŞT. RĂILEANU VINEŢEŞTI",393,OLTENEŞTI,165069,1,PART,PRCNCT,PRSD,PRSD_SV,"2025-05-18 21:27:42",524,225,189,36,0,219,6,600,375,125,94
39,VASLUI,"ŞCOALA PRIMARĂ ZGURA",394,OLTENEŞTI,165069,1,PART,PRCNCT,PRSD,PRSD_SV,"2025-05-18 21:15:12",57,30,20,10,0,29,1,100,70,13,16
39,VASLUI,"ŞCOALA GIMNAZIALĂ ”MIHAI EMINESCU” SAT OŞEŞTI",395,OŞEŞTI,165130,1,PART,PRCNCT,PRSD,PRSD_SV,"2025-05-18 21:44:17",990,395,350,41,4,385,10,1000,605,215,170
39,VASLUI,"ŞCOALA GIMNAZIALĂ ”LUIZA ZAVLOSCHI” SAT BUDA",396,OŞEŞTI,165130,2,PART,PRCNCT,PRSD,PRSD_SV,"2025-05-19 02:53:09",1104,416,377,39,0,409,7,1200,784,261,148
39,VASLUI,"ŞCOALA PRIMARĂ SAT PĂDURENI",397,OŞEŞTI,165130,1,PART,PRCNCT,PRSD,PRSD_SV,"2025-05-18 21:27:54",269,84,70,14,0,81,3,400,316,57,24
39,VASLUI,"ŞCOALA GIMNAZIALA NR.1 PĂDURENI",398,PĂDURENI,165185,1,PART,PRCNCT,PRSD,PRSD_SV,"2025-05-18 21:33:30",1090,356,315,41,0,355,1,1200,844,205,150
39,VASLUI,"ŞCOALA PRIMARA DAVIDEŞTI",399,PĂDURENI,165185,1,PART,PRCNCT,PRSD,PRSD_SV,"2025-05-18 21:28:00",397,175,148,27,0,173,2,400,225,91,82
39,VASLUI,"ŞCOALA PRIMARA IVĂNEŞTI",400,PĂDURENI,165185,1,PART,PRCNCT,PRSD,PRSD_SV,"2025-05-18 21:15:53",317,161,133,28,0,161,0,400,239,113,48
39,VASLUI,"ŞCOALA PRIMARA RUSCA",401,PĂDURENI,165185,1,PART,PRCNCT,PRSD,PRSD_SV,"2025-05-18 21:39:53",504,213,181,32,0,211,2,600,387,130,81
39,VASLUI,"ŞCOALA PRIMARA VĂLENI",402,PĂDURENI,165185,1,PART,PRCNCT,PRSD,PRSD_SV,"2025-05-18 21:21:07",801,341,300,41,0,340,1,900,559,225,115
39,VASLUI,"ŞCOALA GIMNAZIALĂ PERIENI - CENTRU",403,PERIENI,165274,1,PART,PRCNCT,PRSD,PRSD_SV,"2025-05-18 22:28:51",1266,589,554,35,0,581,8,1300,711,378,203
39,VASLUI,"ŞCOALA PRIMARĂ PERIENI - SATUL NOU",404,PERIENI,165274,1,PART,PRCNCT,PRSD,PRSD_SV,"2025-05-18 22:19:21",1420,634,584,50,0,627,7,1600,966,383,244
39,VASLUI,"ŞCOALA PRIMARĂ PERIENI - VALE",405,PERIENI,165274,1,PART,PRCNCT,PRSD,PRSD_SV,"2025-05-18 21:39:55",435,209,185,24,0,208,1,500,291,147,61
39,VASLUI,"ȘCOALA PRIMARĂ POCHIDIA",406,POCHIDIA,167311,2,PART,PRCNCT,PRSD,PRSD_SV,"2025-05-19 02:15:33",328,148,124,24,0,147,1,400,252,112,35
39,VASLUI,"DISPENSAR UMAN BORODEȘTI",407,POCHIDIA,167311,1,PART,PRCNCT,PRSD,PRSD_SV,"2025-05-18 21:33:43",232,131,90,41,0,127,4,400,269,80,47
39,VASLUI,"ŞCOALA GIMNAZIALĂ NR.1 , SĂLCENI",408,POCHIDIA,167311,1,PART,PRCNCT,PRSD,PRSD_SV,"2025-05-18 21:35:05",774,398,350,43,5,395,3,800,402,279,116
39,VASLUI,"CĂMIN CULTURAL",409,POGANA,165416,1,PART,PRCNCT,PRSD,PRSD_SV,"2025-05-18 21:51:13",668,282,254,28,0,279,3,800,518,184,95
39,VASLUI,"ŞCOALA GIMNAZIALA SAT BOGEŞTI",410,POGANA,165416,1,PART,PRCNCT,PRSD,PRSD_SV,"2025-05-18 21:31:31",561,239,196,23,20,236,3,600,361,144,92
39,VASLUI,"ŞCOALA GIMNAZIALA SAT MĂSCUREI",411,POGANA,165416,1,PART,PRCNCT,PRSD,PRSD_SV,"2025-05-18 21:40:30",511,229,203,26,0,225,4,600,371,143,82
39,VASLUI,"ŞCOALA GIMNAZIALA SAT TOMEŞTI",412,POGANA,165416,1,PART,PRCNCT,PRSD,PRSD_SV,"2025-05-18 21:21:31",716,253,230,23,0,252,1,800,547,159,93
39,VASLUI,"SCOALA GIMNAZIALA ”DIMITRIE NEGRUTIU”",413,POGONEŞTI,167259,1,PART,PRCNCT,PRSD,PRSD_SV,"2025-05-18 22:06:59",1212,495,452,41,2,493,2,1300,805,247,246
39,VASLUI,"”SALA TINERETULUI”",414,POGONEŞTI,167259,1,PART,PRCNCT,PRSD,PRSD_SV,"2025-05-18 21:51:32",161,92,73,19,0,91,1,200,108,58,33
39,VASLUI,"CENTRU SOCIAL POIENEȘTI",415,POIENEŞTI,165336,1,PART,PRCNCT,PRSD,PRSD_SV,"2025-05-18 21:46:44",759,281,253,28,0,276,5,800,519,167,109
39,VASLUI,"FOSTUL SEDIU PRIMĂRIE FLOREȘTI",416,POIENEŞTI,165336,1,PART,PRCNCT,PRSD,PRSD_SV,"2025-05-18 21:29:08",377,185,157,27,1,183,2,400,215,104,79
39,VASLUI,"ŞCOALA FRASINU",417,POIENEŞTI,165336,1,PART,PRCNCT,PRSD,PRSD_SV,"2025-05-18 21:21:06",330,117,97,20,0,117,0,400,283,87,30
39,VASLUI,"ŞCOALA FUNDU VĂII",418,POIENEŞTI,165336,2,PART,PRCNCT,PRSD,PRSD_SV,"2025-05-18 23:24:31",54,56,27,29,0,55,1,100,44,28,27
39,VASLUI,"ŞCOALA OPRIŞIŢA",419,POIENEŞTI,165336,1,PART,PRCNCT,PRSD,PRSD_SV,"2025-05-18 21:47:32",664,303,264,39,0,301,2,800,497,159,142
39,VASLUI,"ŞCOALA POIENEŞTI DEAL",420,POIENEŞTI,165336,1,PART,PRCNCT,PRSD,PRSD_SV,"2025-05-18 21:27:27",101,51,27,24,0,51,0,200,149,36,15
39,VASLUI,"LICEUL TEHNOLOGIC, SAT PUIEŞTI",421,PUIEŞTI,165470,1,PART,PRCNCT,PRSD,PRSD_SV,"2025-05-18 21:30:56",1103,465,409,56,0,462,3,1200,735,242,220
39,VASLUI,"ŞCOALA PRIMARĂ, SAT BĂRTĂLUŞ -MOCANI",422,PUIEŞTI,165470,2,PART,PRCNCT,PRSD,PRSD_SV,"2025-05-19 01:20:00",174,92,61,31,0,92,0,200,108,49,43
39,VASLUI,"ŞCOALA PRIMARĂ, SAT CĂLIMĂNEŞTI",423,PUIEŞTI,165470,2,PART,PRCNCT,PRSD,PRSD_SV,"2025-05-19 01:23:29",286,129,107,22,0,126,3,400,271,81,45
39,VASLUI,"ŞCOALA PRIMARĂ, SAT CETĂŢUIA",424,PUIEŞTI,165470,1,PART,PRCNCT,PRSD,PRSD_SV,"2025-05-18 21:52:54",313,164,144,20,0,161,3,400,236,69,92
39,VASLUI,"ŞCOALA PRIMARĂ, SAT CRISTEŞTI",425,PUIEŞTI,165470,1,PART,PRCNCT,PRSD,PRSD_SV,"2025-05-18 21:21:10",344,169,142,27,0,167,2,400,231,128,39
39,VASLUI,"ŞCOALA PRIMARĂ, SAT FÎNTÎNELE",426,PUIEŞTI,165470,2,PART,PRCNCT,PRSD,PRSD_SV,"2025-05-19 01:18:01",107,70,53,17,0,70,0,200,130,47,23
39,VASLUI,"ŞCOALA PRIMARĂ, SAT FULGU",427,PUIEŞTI,165470,1,PART,PRCNCT,PRSD,PRSD_SV,"2025-05-18 21:19:47",115,62,53,9,0,61,1,200,138,32,29
39,VASLUI,"ŞCOALA PRIMARĂ,SAT GÎLŢEŞTI",428,PUIEŞTI,165470,1,PART,PRCNCT,PRSD,PRSD_SV,"2025-05-18 21:23:17",108,71,53,18,0,69,2,200,129,42,27
39,VASLUI,"ŞCOALA PRIMARĂ,SAT IEZER",429,PUIEŞTI,165470,1,PART,PRCNCT,PRSD,PRSD_SV,"2025-05-18 21:22:29",219,107,86,21,0,107,0,400,293,61,46
39,VASLUI,"ŞCOALA GIMNAZIALĂ, SAT LĂLEŞTI",430,PUIEŞTI,165470,2,PART,PRCNCT,PRSD,PRSD_SV,"2025-05-19 01:31:39",363,164,153,11,0,162,2,400,236,114,48
39,VASLUI,"ŞCOALA PRIMARĂ, SAT ROTARI",431,PUIEŞTI,165470,1,PART,PRCNCT,PRSD,PRSD_SV,"2025-05-18 21:19:57",96,59,46,13,0,58,1,100,41,38,20
39,VASLUI,"ŞCOALA PRIMARĂ,SAT RUŞI",432,PUIEŞTI,165470,1,PART,PRCNCT,PRSD,PRSD_SV,"2025-05-18 21:25:01",278,149,127,22,0,148,1,400,251,109,39
39,VASLUI,"ŞCOALA GIMNAZIALA NR. 1 , SAT PUNGEŞTI",433,PUNGEŞTI,165611,1,PART,PRCNCT,PRSD,PRSD_SV,"2025-05-18 21:29:18",769,296,260,36,0,290,6,800,504,174,116
39,VASLUI,"ŞCOALA PRIMARA, SAT ARMÃŞOAIA",434,PUNGEŞTI,165611,1,PART,PRCNCT,PRSD,PRSD_SV,"2025-05-18 21:35:32",410,179,150,29,0,179,0,500,321,94,85
39,VASLUI,"ŞCOALA PRIMARA,SAT CURSEŞTI DEAL",435,PUNGEŞTI,165611,2,PART,PRCNCT,PRSD,PRSD_SV,"2025-05-19 00:12:08",167,90,77,13,0,87,3,200,110,45,42
39,VASLUI,"ŞCOALA PRIMARA, SAT CURSEŞTI VALE",436,PUNGEŞTI,165611,1,PART,PRCNCT,PRSD,PRSD_SV,"2025-05-18 21:28:46",192,82,61,21,0,81,1,200,118,44,37
39,VASLUI,"ŞCOALA PRIMARA,SAT SILIŞTEA",437,PUNGEŞTI,165611,1,PART,PRCNCT,PRSD,PRSD_SV,"2025-05-18 21:21:17",198,100,90,10,0,100,0,200,100,46,54
39,VASLUI,"ŞCOALA PRIMARA, SAT STEJARU",438,PUNGEŞTI,165611,1,PART,PRCNCT,PRSD,PRSD_SV,"2025-05-18 21:29:04",202,84,70,14,0,83,1,300,216,56,27
39,VASLUI,"ŞCOALA PRIMARA, SAT TOPORĂŞTI",439,PUNGEŞTI,165611,1,PART,PRCNCT,PRSD,PRSD_SV,"2025-05-18 21:43:02",504,210,182,28,0,210,0,600,390,121,89
39,VASLUI,"ŞCOALA GIMNAZIALA NR. 1 PUŞCAŞI CORP C1",440,PUŞCAŞI,167320,1,PART,PRCNCT,PRSD,PRSD_SV,"2025-05-18 21:30:49",1191,441,390,36,15,431,10,1200,759,272,159
39,VASLUI,"ŞCOALA GIMNAZIALA NR. 1 PUŞCAŞI CORP C1",441,PUŞCAŞI,167320,2,PART,PRCNCT,PRSD,PRSD_SV,"2025-05-18 22:24:42",1026,380,332,29,19,377,3,1200,820,235,142
39,VASLUI,"ŞCOALA PRIMARA POIANA LUI ALEXA",442,PUŞCAŞI,167320,1,PART,PRCNCT,PRSD,PRSD_SV,"2025-05-18 21:16:44",246,145,104,36,5,144,1,400,255,65,79
39,VASLUI,"SCOALA PRIMARA TEIŞORU",443,PUŞCAŞI,167320,1,PART,PRCNCT,PRSD,PRSD_SV,"2025-05-18 21:18:28",424,135,119,13,3,132,3,500,365,100,32
39,VASLUI,"IMOBIL FEDERALCOOP SAT VALEA TÂRGULUI",444,PUŞCAŞI,167320,1,PART,PRCNCT,PRSD,PRSD_SV,"2025-05-18 21:09:05",120,98,66,26,6,98,0,200,102,49,49
39,VASLUI,"GRĂDINIŢA CU PROGRAM NORMAL, RAFAILA",445,RAFAILA,167240,1,PART,PRCNCT,PRSD,PRSD_SV,"2025-05-18 21:25:38",1441,552,518,34,0,546,6,1600,1048,356,190
39,VASLUI,"ŞCOALA GIMNAZIALĂ REBRICEA",446,REBRICEA,165719,1,PART,PRCNCT,PRSD,PRSD_SV,"2025-05-18 21:21:21",441,213,151,60,2,213,0,500,287,118,95
39,VASLUI,"ŞCOALA PRIMARĂ BOLAŢI",447,REBRICEA,165719,1,PART,PRCNCT,PRSD,PRSD_SV,"2025-05-18 21:27:15",152,76,59,15,2,74,2,200,124,45,29
39,VASLUI,"ŞCOALA PRIMARĂ CRĂCIUNEŞTI",448,REBRICEA,165719,1,PART,PRCNCT,PRSD,PRSD_SV,"2025-05-18 21:27:47",233,140,111,29,0,139,1,400,260,48,91
39,VASLUI,"CĂMINUL CULTURAL, DRAXENI",449,REBRICEA,165719,2,PART,PRCNCT,PRSD,PRSD_SV,"2025-05-18 23:29:14",648,262,230,32,0,257,5,800,538,170,87
39,VASLUI,"ŞCOALA PRIMARĂ RATEŞU-CUZEI",450,REBRICEA,165719,1,PART,PRCNCT,PRSD,PRSD_SV,"2025-05-18 21:35:30",441,214,178,34,2,212,2,500,286,140,72
39,VASLUI,"ŞCOALA PRIMARĂ SASOVA",451,REBRICEA,165719,1,PART,PRCNCT,PRSD,PRSD_SV,"2025-05-18 21:29:25",239,123,111,12,0,122,1,400,277,89,33
39,VASLUI,"ŞCOALA PRIMARĂ TATOMIREŞTI",452,REBRICEA,165719,1,PART,PRCNCT,PRSD,PRSD_SV,"2025-05-18 21:22:34",251,102,83,19,0,102,0,400,298,58,44
39,VASLUI,"ŞCOALA PRIMARĂ TUFEŞTII DE JOS",453,REBRICEA,165719,1,PART,PRCNCT,PRSD,PRSD_SV,"2025-05-18 21:28:23",324,149,134,15,0,149,0,400,251,94,55
39,VASLUI,"ŞCOALA GIMNAZIALĂ ”VENIAMIN COSTACHI” , ROŞIEŞTI",454,ROŞIEŞTI,165817,1,PART,PRCNCT,PRSD,PRSD_SV,"2025-05-18 21:50:04",894,396,338,58,0,393,3,900,504,217,176
39,VASLUI,"CENTRUL DE ZI GARA ROŞIEŞTI",455,ROŞIEŞTI,165817,1,PART,PRCNCT,PRSD,PRSD_SV,"2025-05-18 21:32:07",305,165,145,20,0,159,6,400,235,87,72
39,VASLUI,"ŞCOALA PRIMARĂ GURA IDRICI",456,ROŞIEŞTI,165817,1,PART,PRCNCT,PRSD,PRSD_SV,"2025-05-18 21:21:53",338,152,123,29,0,152,0,400,248,72,80
39,VASLUI,"ŞCOALA PRIMARĂ IDRICI",457,ROŞIEŞTI,165817,1,PART,PRCNCT,PRSD,PRSD_SV,"2025-05-18 21:29:27",294,153,111,42,0,152,1,400,247,76,76
39,VASLUI,"ŞCOALA PRIMARĂ REDIU",458,ROŞIEŞTI,165817,1,PART,PRCNCT,PRSD,PRSD_SV,"2025-05-18 21:16:07",116,67,50,17,0,67,0,200,133,42,25
39,VASLUI,"ŞCOALA PRIMARĂ VALEA LUI DARIE",459,ROŞIEŞTI,165817,1,PART,PRCNCT,PRSD,PRSD_SV,"2025-05-18 21:29:31",444,227,188,39,0,221,6,500,273,127,94
39,VASLUI,"GRĂDINIȚA CU PROGRAM NORMAL",460,SOLEŞTI,165899,1,PART,PRCNCT,PRSD,PRSD_SV,"2025-05-18 21:24:30",924,373,346,27,0,369,4,1000,627,215,154
39,VASLUI,"FOSTA ŞCOALA CU CLASELE I-IV BOUȘORI",461,SOLEŞTI,165899,1,PART,PRCNCT,PRSD,PRSD_SV,"2025-05-18 21:23:09",188,123,77,46,0,123,0,200,77,61,62
39,VASLUI,"GRĂDINIȚA CU PROGRAM NORMAL IAZ",462,SOLEŞTI,165899,1,PART,PRCNCT,PRSD,PRSD_SV,"2025-05-18 21:14:17",313,109,97,12,0,105,4,400,291,76,29
39,VASLUI,"GRĂDINIȚA CU PROGRAM NORMAL SATU NOU",463,SOLEŞTI,165899,2,PART,PRCNCT,PRSD,PRSD_SV,"2025-05-18 23:11:04",327,139,121,18,0,139,0,400,261,78,61
39,VASLUI,"ŞCOALA GIMNAZIALĂ ȘERBOTEȘTI",464,SOLEŞTI,165899,1,PART,PRCNCT,PRSD,PRSD_SV,"2025-05-18 21:29:51",592,267,228,39,0,265,2,600,333,161,104
39,VASLUI,"GRĂDINIȚA CU PROGRAM NORMAL ȘTIOBORĂNI",465,SOLEŞTI,165899,1,PART,PRCNCT,PRSD,PRSD_SV,"2025-05-18 21:20:00",290,127,97,30,0,127,0,400,273,53,74
39,VASLUI,"FOSTA ŞCOALA CU CLASELE I-IV VALEA SILIȘTEI",466,SOLEŞTI,165899,1,PART,PRCNCT,PRSD,PRSD_SV,"2025-05-18 21:12:50",204,111,88,23,0,110,1,400,289,64,46
39,VASLUI,"ŞCOALA GIMNAZIALĂ NR. 1, CORP B",467,STĂNILEŞTI,165979,1,PART,PRCNCT,PRSD,PRSD_SV,"2025-05-18 21:55:47",1285,551,508,43,0,547,4,1300,749,313,234
39,VASLUI,"ŞCOALA GIMNAZIALĂ NR. 1, CORP B",468,STĂNILEŞTI,165979,1,PART,PRCNCT,PRSD,PRSD_SV,"2025-05-18 21:46:53",831,357,325,32,0,354,3,900,543,213,141
39,VASLUI,"ŞCOALA PRIMARĂ, BOGDANA - VOLOSENI",469,STĂNILEŞTI,165979,1,PART,PRCNCT,PRSD,PRSD_SV,"2025-05-18 21:30:19",112,62,45,17,0,62,0,200,138,45,17
39,VASLUI,"ŞCOALA PRIMARĂ, BUDU - CANTEMIR",470,STĂNILEŞTI,165979,1,PART,PRCNCT,PRSD,PRSD_SV,"2025-05-18 21:22:25",196,86,71,15,0,85,1,200,114,40,45
39,VASLUI,"ŞCOALA PRIMARĂ, CHERSĂCOSU",471,STĂNILEŞTI,165979,1,PART,PRCNCT,PRSD,PRSD_SV,"2025-05-18 21:36:33",416,181,156,25,0,177,4,500,319,127,50
39,VASLUI,"GRĂDINIŢA CU PROGRAM NORMAL, GURA VĂII",472,STĂNILEŞTI,165979,1,PART,PRCNCT,PRSD,PRSD_SV,"2025-05-18 21:42:47",362,164,136,28,0,163,1,400,236,108,55
39,VASLUI,"ŞCOALA GIMNAZIALĂ, POGĂNEŞTI",473,STĂNILEŞTI,165979,1,PART,PRCNCT,PRSD,PRSD_SV,"2025-05-18 21:48:00",905,410,349,61,0,409,1,1000,590,264,145
39,VASLUI,"CĂMINUL CULTURAL, ŞTEFAN CEL MARE",474,"ŞTEFAN CEL MARE",166057,1,PART,PRCNCT,PRSD,PRSD_SV,"2025-05-18 21:54:22",581,343,290,53,0,339,4,600,257,165,174
39,VASLUI,"CĂMINUL CULTURAL BÎRZEŞTI",475,"ŞTEFAN CEL MARE",166057,1,PART,PRCNCT,PRSD,PRSD_SV,"2025-05-18 21:43:59",970,463,417,46,0,456,7,1000,537,247,209
39,VASLUI,"ŞCOALA PRIMARA, BRĂHĂŞOAIA",476,"ŞTEFAN CEL MARE",166057,1,PART,PRCNCT,PRSD,PRSD_SV,"2025-05-18 21:55:40",391,200,156,44,0,199,1,400,200,106,93
39,VASLUI,"ŞCOALA PRIMARA ”CONSTANTIN MANOILESCU” MARASENI",477,"ŞTEFAN CEL MARE",166057,1,PART,PRCNCT,PRSD,PRSD_SV,"2025-05-18 21:57:32",798,432,384,48,0,423,9,800,368,184,239
39,VASLUI,"CĂMINUL CULTURAL ”VIRGIL CARAIVAN” ŞULETEA",478,ŞULETEA,166137,1,PART,PRCNCT,PRSD,PRSD_SV,"2025-05-18 21:47:07",884,413,350,58,5,406,7,900,487,190,216
39,VASLUI,"CREȘA FEDEȘTI",479,ŞULETEA,166137,1,PART,PRCNCT,PRSD,PRSD_SV,"2025-05-18 21:42:35",463,213,183,26,4,212,1,500,287,129,83
39,VASLUI,"ŞCOALA PRIMARĂ ”DUMITRU BAHRIM”",480,ŞULETEA,166137,1,PART,PRCNCT,PRSD,PRSD_SV,"2025-05-18 21:28:13",183,103,79,24,0,103,0,200,97,62,41
39,VASLUI,"ANEXA LA BISERICA „NAȘTEREA MAICII DOMNULUI” RĂŞCANI",481,ŞULETEA,166137,1,PART,PRCNCT,PRSD,PRSD_SV,"2025-05-18 21:30:54",206,104,80,16,8,102,2,400,296,59,43
39,VASLUI,"GRĂDINIȚA CU PROGRAM NORMAL NR.1",482,TANACU,166182,1,PART,PRCNCT,PRSD,PRSD_SV,"2025-05-18 22:33:08",1214,637,487,133,17,627,10,1300,663,283,344
39,VASLUI,"ŞCOALA PRIMARĂ SAT. BENEŞTI",483,TANACU,166182,1,PART,PRCNCT,PRSD,PRSD_SV,"2025-05-18 21:20:16",235,151,96,52,3,148,3,400,249,80,68
39,VASLUI,"CĂMINUL CULTURAL TĂCUTA",484,TĂCUTA,166235,1,PART,PRCNCT,PRSD,PRSD_SV,"2025-05-18 21:32:37",653,276,243,33,0,275,1,800,524,169,106
39,VASLUI,"ŞCOALA PRIMARĂ DUMASCA",485,TĂCUTA,166235,1,PART,PRCNCT,PRSD,PRSD_SV,"2025-05-18 21:11:43",221,93,70,23,0,92,1,400,307,54,38
39,VASLUI,"ŞCOALA GIMNAZIALĂ FOCŞEAŞCA",486,TĂCUTA,166235,2,PART,PRCNCT,PRSD,PRSD_SV,"2025-05-19 01:33:34",642,285,243,42,0,280,5,800,515,230,50
39,VASLUI,"ŞCOALA PRIMARĂ MIRCEŞTI",487,TĂCUTA,166235,1,PART,PRCNCT,PRSD,PRSD_SV,"2025-05-18 21:16:34",222,109,84,25,0,107,2,400,291,65,42
39,VASLUI,"ŞCOALA GIMNAZIALĂ PROTOPOPEŞTI",488,TĂCUTA,166235,1,PART,PRCNCT,PRSD,PRSD_SV,"2025-05-18 21:28:24",642,280,236,44,0,279,1,800,520,214,65
39,VASLUI,"ȘCOALA GIMNAZIALĂ NR.1",489,TĂTĂRĂNI,166315,1,PART,PRCNCT,PRSD,PRSD_SV,"2025-05-18 21:43:10",577,248,197,50,1,244,4,600,352,137,107
39,VASLUI,"ŞCOALA GIMNAZIALĂ ”ION ANGHELUȚĂ” ( ȘCOALA NOUĂ)",490,TĂTĂRĂNI,166315,1,PART,PRCNCT,PRSD,PRSD_SV,"2025-05-18 21:24:56",451,178,146,32,0,176,2,500,322,143,33
39,VASLUI,"CĂMINUL CULTURAL LEOȘTI",491,TĂTĂRĂNI,166315,1,PART,PRCNCT,PRSD,PRSD_SV,"2025-05-18 21:40:30",234,123,90,33,0,123,0,400,277,84,39
39,VASLUI,"SCOALA PRIMARA - SAT STROIESTI",492,TĂTĂRĂNI,166315,2,PART,PRCNCT,PRSD,PRSD_SV,"2025-05-19 03:06:54",245,101,71,30,0,101,0,400,299,60,41
39,VASLUI,"ŞCOALA GIMNAZIALA ”GH.CIOATĂ” TODIREŞTI",493,TODIREŞTI,166413,1,PART,PRCNCT,PRSD,PRSD_SV,"2025-05-18 21:55:07",735,324,277,47,0,321,3,800,476,183,138
39,VASLUI,"ȘCOALA PRIMARĂ COTIC",494,TODIREŞTI,166413,1,PART,PRCNCT,PRSD,PRSD_SV,"2025-05-18 21:24:30",238,98,76,22,0,96,2,400,302,54,42
39,VASLUI,"ŞCOALA PRIMARA SAT DRĂGEŞTI",495,TODIREŞTI,166413,1,PART,PRCNCT,PRSD,PRSD_SV,"2025-05-18 21:25:41",323,127,109,18,0,124,3,400,273,69,55
39,VASLUI,"ŞCOALA PRIMARA SAT HUC",496,TODIREŞTI,166413,1,PART,PRCNCT,PRSD,PRSD_SV,"2025-05-18 21:33:39",459,202,185,17,0,201,1,500,298,110,91
39,VASLUI,"ŞCOALA PRIMARA SAT PLOPOASA",497,TODIREŞTI,166413,1,PART,PRCNCT,PRSD,PRSD_SV,"2025-05-18 21:35:13",199,106,87,19,0,105,1,200,94,67,38
39,VASLUI,"ŞCOALA PRIMARA SAT SILIŞTEA",498,TODIREŞTI,166413,1,PART,PRCNCT,PRSD,PRSD_SV,"2025-05-18 21:36:51",309,152,127,25,0,149,3,400,248,84,65
39,VASLUI,"ŞCOALA PRIMARA SAT SOFRONEŞTI",499,TODIREŞTI,166413,1,PART,PRCNCT,PRSD,PRSD_SV,"2025-05-18 21:39:02",121,63,44,19,0,63,0,200,137,36,27
39,VASLUI,"ŞCOALA PRIMARA SAT VALEA -POPII",500,TODIREŞTI,166413,1,PART,PRCNCT,PRSD,PRSD_SV,"2025-05-18 21:20:31",77,48,34,14,0,48,0,100,52,26,22
39,VASLUI,"ŞCOALA PRIMARA SAT VIIŞOARA",501,TODIREŞTI,166413,1,PART,PRCNCT,PRSD,PRSD_SV,"2025-05-18 21:35:08",89,65,52,13,0,64,1,100,35,45,19
39,VASLUI,"CĂMINUL CULTURAL TUTOVA",502,TUTOVA,166529,1,PART,PRCNCT,PRSD,PRSD_SV,"2025-05-18 22:07:29",1102,585,479,105,1,580,5,1200,615,324,256
39,VASLUI,"ŞCOALA CU CLASELE I-VIII BĂDEANA",503,TUTOVA,166529,1,PART,PRCNCT,PRSD,PRSD_SV,"2025-05-18 21:38:48",1177,524,474,50,0,518,6,1200,676,342,176
39,VASLUI,"ŞCOALA CIORTOLOM",504,TUTOVA,166529,2,PART,PRCNCT,PRSD,PRSD_SV,"2025-05-19 02:50:11",144,82,63,19,0,81,1,200,118,35,46
39,VASLUI,"ŞCOALA COROIU",505,TUTOVA,166529,1,PART,PRCNCT,PRSD,PRSD_SV,"2025-05-18 21:32:46",172,104,79,25,0,104,0,200,96,70,34
39,VASLUI,"CĂMINUL CULTURAL CRIVESTI",506,TUTOVA,166529,1,PART,PRCNCT,PRSD,PRSD_SV,"2025-05-18 21:32:24",336,183,144,39,0,181,2,400,217,121,60
39,VASLUI,"ŞCOALA VIZURENI",507,TUTOVA,166529,1,PART,PRCNCT,PRSD,PRSD_SV,"2025-05-18 21:24:21",139,79,59,20,0,73,6,200,121,47,26
39,VASLUI,"ŞCOALA GIMNAZIALĂ NR. 1 SAT VĂLENI COM VĂLENI",508,VĂLENI,166636,1,PART,PRCNCT,PRSD,PRSD_SV,"2025-05-18 21:46:41",1483,463,433,30,0,456,7,1600,1137,308,148
39,VASLUI,"ŞCOALA GIMNAZIALĂ NR. 1 SAT VĂLENI COM. VĂLENI",509,VĂLENI,166636,2,PART,PRCNCT,PRSD,PRSD_SV,"2025-05-18 23:38:49",1630,498,482,16,0,488,10,1700,1202,311,177
39,VASLUI,"ŞCOALA PRIMARĂ SAT MOARA DOMNEASCĂ",510,VĂLENI,166636,1,PART,PRCNCT,PRSD,PRSD_SV,"2025-05-18 21:46:22",1305,497,446,51,0,490,7,1400,903,331,159
39,VASLUI,"LICEUL TEHNOLOGIC ”PETRU RARES” - CENTRU",511,VETRIŞOAIA,166672,1,PART,PRCNCT,PRSD,PRSD_SV,"2025-05-18 21:39:58",1421,634,558,50,26,628,6,1600,966,396,232
39,VASLUI,"LICEUL TEHNOLOGIC ”PETRU RAREȘ” VETRIȘOAIA",512,VETRIŞOAIA,166672,1,PART,PRCNCT,PRSD,PRSD_SV,"2025-05-18 21:40:44",804,402,351,29,22,398,4,900,498,245,153
39,VASLUI,"CENTRU SOCIAL BUMBĂTA",513,VETRIŞOAIA,166672,1,PART,PRCNCT,PRSD,PRSD_SV,"2025-05-18 21:24:34",85,71,37,34,0,69,2,100,29,35,34
39,VASLUI,"CAMIN CULTURAL, SAT VIIȘOARA",514,VIIŞOARA,166707,1,PART,PRCNCT,PRSD,PRSD_SV,"2025-05-18 21:37:31",858,431,339,59,33,429,2,900,469,253,176
39,VASLUI,"ȘCOALA PRIMARĂ HALTA DODEȘTI",515,VIIŞOARA,166707,1,PART,PRCNCT,PRSD,PRSD_SV,"2025-05-18 21:15:39",156,90,55,32,3,89,1,200,110,52,37
39,VASLUI,"ȘCOALA PRIMARĂ VĂLENI",516,VIIŞOARA,166707,1,PART,PRCNCT,PRSD,PRSD_SV,"2025-05-18 21:17:16",95,57,39,17,1,57,0,100,43,35,22
39,VASLUI,"ȘCOALA PRIMARĂ VILTOTEȘTI",517,VIIŞOARA,166707,1,PART,PRCNCT,PRSD,PRSD_SV,"2025-05-18 21:10:43",139,79,52,22,5,79,0,200,121,42,37
39,VASLUI,"ŞCOALA GIMNAZIALA NR.1, VINDEREI",518,VINDEREI,166770,1,PART,PRCNCT,PRSD,PRSD_SV,"2025-05-18 21:40:51",679,341,282,59,0,332,9,800,459,176,156
39,VASLUI,"ŞCOALA PRIMARA, BRADESTI",519,VINDEREI,166770,2,PART,PRCNCT,PRSD,PRSD_SV,"2025-05-19 02:02:49",387,154,122,32,0,149,5,400,246,89,60
39,VASLUI,"ŞCOALA GIMNAZIALA, DOCANI",520,VINDEREI,166770,1,PART,PRCNCT,PRSD,PRSD_SV,"2025-05-18 21:28:10",453,202,159,42,1,197,5,500,298,121,76
39,VASLUI,"ŞCOALA PRIMARA DOCANEASA",521,VINDEREI,166770,1,PART,PRCNCT,PRSD,PRSD_SV,"2025-05-18 21:21:38",359,157,134,23,0,157,0,400,243,121,36
39,VASLUI,"CASA ADMINISTRATIVĂ",522,VINDEREI,166770,1,PART,PRCNCT,PRSD,PRSD_SV,"2025-05-18 21:41:58",633,263,218,45,0,255,8,800,537,136,119
39,VASLUI,"ŞCOALA PRIMARA VALEA LUNGĂ",523,VINDEREI,166770,1,PART,PRCNCT,PRSD,PRSD_SV,"2025-05-18 21:29:40",386,125,112,13,0,124,1,400,275,85,39
39,VASLUI,"ȘCOALA GIMNAZIALĂ NR.1 VOINEȘTI",524,VOINEŞTI,166869,1,PART,PRCNCT,PRSD,PRSD_SV,"2025-05-18 21:27:50",303,134,116,18,0,134,0,400,266,90,44
39,VASLUI,"ȘCOALA PRIMARĂ SAT AVRĂMEȘTI",525,VOINEŞTI,166869,1,PART,PRCNCT,PRSD,PRSD_SV,"2025-05-18 21:45:37",483,173,132,41,0,170,3,600,427,70,100
39,VASLUI,"ȘCOALA PRIMARĂ BĂNCEȘTI",526,VOINEŞTI,166869,2,PART,PRCNCT,PRSD,PRSD_SV,"2025-05-19 02:09:58",163,100,83,17,0,100,0,200,100,42,58
39,VASLUI,"ȘCOALA GIMNAZIALĂ GÎRDEȘTI",527,VOINEŞTI,166869,1,PART,PRCNCT,PRSD,PRSD_SV,"2025-05-18 21:47:03",564,246,228,18,0,245,1,600,354,184,61
39,VASLUI,"ȘCOALA PRIMARĂ MĂRĂȘEȘTI",528,VOINEŞTI,166869,1,PART,PRCNCT,PRSD,PRSD_SV,"2025-05-18 21:32:14",174,75,64,11,0,74,1,200,125,35,39
39,VASLUI,"ȘCOALA PRIMARĂ OBÎRȘENI",529,VOINEŞTI,166869,1,PART,PRCNCT,PRSD,PRSD_SV,"2025-05-18 21:25:08",287,109,93,16,0,107,2,400,291,72,35
39,VASLUI,"ȘCOALA GIMNAZIALĂ OBÎRȘENII LINGURARI",530,VOINEŞTI,166869,2,PART,PRCNCT,PRSD,PRSD_SV,"2025-05-19 02:08:04",676,268,252,16,0,264,4,800,532,177,87
39,VASLUI,"CONTAINER MODULAR",531,VOINEŞTI,166869,1,PART,PRCNCT,PRSD,PRSD_SV,"2025-05-18 21:18:13",142,60,48,12,0,57,3,200,140,26,31
39,VASLUI,"CĂMIN CULTURAL VULTUREŞTI",532,VULTUREŞTI,166985,1,PART,PRCNCT,PRSD,PRSD_SV,"2025-05-18 21:30:32",817,404,354,50,0,398,6,900,496,191,207
39,VASLUI,"CENTRU DE ZI PENTRU COPII BUHĂIEŞTI",533,VULTUREŞTI,166985,1,PART,PRCNCT,PRSD,PRSD_SV,"2025-05-18 21:33:38",603,248,215,33,0,248,0,800,552,111,137
39,VASLUI,"GRADINITA CU PROGRAM NORMAL VOINEŞTI",534,VULTUREŞTI,166985,1,PART,PRCNCT,PRSD,PRSD_SV,"2025-05-18 21:40:19",323,172,138,34,0,168,4,400,228,87,81
39,VASLUI,"ŞCOALA GIMNAZIALĂ NR.1, VUTCANI",535,VUTCANI,167035,1,PART,PRCNCT,PRSD,PRSD_SV,"2025-05-18 21:42:36",1022,540,418,105,17,531,9,1200,660,261,270
39,VASLUI,"ŞCOALA PRIMARĂ MĂLĂIEŞTI",536,VUTCANI,167035,1,PART,PRCNCT,PRSD,PRSD_SV,"2025-05-18 21:25:35",242,146,105,34,7,144,2,400,254,61,83
39,VASLUI,"CONTAINER MODULAR TIP BIROU",537,VUTCANI,167035,1,PART,PRCNCT,PRSD,PRSD_SV,"2025-05-18 21:17:47",110,62,38,19,5,61,1,200,138,31,30
39,VASLUI,"CĂMINUL CULTURAL ZĂPODENI",538,ZĂPODENI,167071,2,PART,PRCNCT,PRSD,PRSD_SV,"2025-05-18 23:38:35",1568,605,477,102,26,594,11,1600,995,245,349
39,VASLUI,"ȘCOALA GIMNAZIALĂ, SAT BUTUCĂRIA",539,ZĂPODENI,167071,1,PART,PRCNCT,PRSD,PRSD_SV,"2025-05-18 21:20:44",106,73,48,25,0,70,3,200,127,28,42
39,VASLUI,"ȘCOALA PRIMARĂ,SAT CIOFENI",540,ZĂPODENI,167071,1,PART,PRCNCT,PRSD,PRSD_SV,"2025-05-18 21:18:19",137,66,40,26,0,65,1,200,134,40,25
39,VASLUI,"ȘCOALA PRIMARĂ, SAT DELEA",541,ZĂPODENI,167071,1,PART,PRCNCT,PRSD,PRSD_SV,"2025-05-18 21:30:29",174,101,76,25,0,101,0,200,99,40,61
39,VASLUI,"ȘCOALA PRIMARĂ, SAT DOBROSLOVEȘTI",542,ZĂPODENI,167071,2,PART,PRCNCT,PRSD,PRSD_SV,"2025-05-18 23:24:13",329,142,121,21,0,140,2,400,258,97,43
39,VASLUI,"ȘCOALA PRIMARĂ, SAT PORTARI",543,ZĂPODENI,167071,2,PART,PRCNCT,PRSD,PRSD_SV,"2025-05-18 23:36:19",1286,258,203,55,0,251,7,1300,1042,144,107
39,VASLUI,"ȘCOALA PRIMARĂ, SAT TELEJNA",544,ZĂPODENI,167071,1,PART,PRCNCT,PRSD,PRSD_SV,"2025-05-18 21:16:50",351,158,133,24,1,158,0,400,242,96,62
39,VASLUI,"ȘCOALA PRIMARĂ, SAT UNCEȘTI",545,ZĂPODENI,167071,1,PART,PRCNCT,PRSD,PRSD_SV,"2025-05-18 21:18:19",321,136,101,25,10,133,3,400,264,60,73
39,VASLUI,"ŞCOALA GIMNAZIALĂ NR. 1 ZORLENI",546,ZORLENI,167179,1,PART,PRCNCT,PRSD,PRSD_SV,"2025-05-18 21:39:00",1317,576,528,48,0,571,5,1400,824,381,190
39,VASLUI,"ŞCOALA GIMNAZIALĂ NR.1 ZORLENI",547,ZORLENI,167179,1,PART,PRCNCT,PRSD,PRSD_SV,"2025-05-18 21:39:18",1289,561,521,38,2,553,8,1300,739,326,227
39,VASLUI,"GRĂDINIȚA NR. 2 ZORLENI",548,ZORLENI,167179,2,PART,PRCNCT,PRSD,PRSD_SV,"2025-05-19 01:10:55",1494,592,549,43,0,587,5,1600,1008,437,150
39,VASLUI,"ȘCOALA PRIMARĂ SAT DEALU MARE",549,ZORLENI,167179,1,PART,PRCNCT,PRSD,PRSD_SV,"2025-05-18 21:52:37",207,124,94,30,0,122,2,400,276,80,42
39,VASLUI,"ŞCOALA GIMNAZIALĂ NR. 3 POPENI (CORP B)",550,ZORLENI,167179,1,PART,PRCNCT,PRSD,PRSD_SV,"2025-05-18 21:58:06",1074,453,401,52,0,446,7,1200,747,328,118
39,VASLUI,"ŞCOALA GIMNAZIALĂ NR. 3 POPENI (CORP B)",551,ZORLENI,167179,1,PART,PRCNCT,PRSD,PRSD_SV,"2025-05-18 21:56:37",1064,423,389,34,0,418,5,1200,777,281,137
39,VASLUI,"CENTRU DE TIP AFTERSCHOOL",552,ZORLENI,167179,1,PART,PRCNCT,PRSD,PRSD_SV,"2025-05-18 21:33:15",1181,555,481,74,0,550,5,1200,645,300,250
40,VÂLCEA,"COLEGIUL ENERGETIC",1,"MUNICIPIUL RÂMNICU VÂLCEA",167473,1,PART,PRCNCT,PRSD,PRSD_SV,"2025-05-18 22:13:21",1808,931,925,6,0,918,13,1990,1059,389,529
40,VÂLCEA,"COLEGIUL ENERGETIC",2,"MUNICIPIUL RÂMNICU VÂLCEA",167473,1,PART,PRCNCT,PRSD,PRSD_SV,"2025-05-18 21:35:53",860,610,447,163,0,602,8,950,340,227,375
40,VÂLCEA,"LICEUL SANITAR ”ANTIM IVIREANU”",3,"MUNICIPIUL RÂMNICU VÂLCEA",167473,1,PART,PRCNCT,PRSD,PRSD_SV,"2025-05-18 21:32:43",1218,644,578,66,0,639,5,1350,706,301,338
40,VÂLCEA,"LICEUL SANITAR ”ANTIM IVIREANU”",4,"MUNICIPIUL RÂMNICU VÂLCEA",167473,1,PART,PRCNCT,PRSD,PRSD_SV,"2025-05-18 21:54:25",1141,512,461,51,0,507,5,1250,738,262,245
40,VÂLCEA,"LICEUL SANITAR ”ANTIM IVIREANU”",5,"MUNICIPIUL RÂMNICU VÂLCEA",167473,1,PART,PRCNCT,PRSD,PRSD_SV,"2025-05-18 21:28:03",1115,641,560,81,0,629,12,1230,589,285,344
40,VÂLCEA,"GRĂDINIŢA CU PROGRAM PRELUNGIT NORD II",6,"MUNICIPIUL RÂMNICU VÂLCEA",167473,1,PART,PRCNCT,PRSD,PRSD_SV,"2025-05-18 21:35:30",927,476,426,50,0,466,10,1020,544,249,217
40,VÂLCEA,"GRĂDINIŢA CU PROGRAM PRELUNGIT NORD II",7,"MUNICIPIUL RÂMNICU VÂLCEA",167473,1,PART,PRCNCT,PRSD,PRSD_SV,"2025-05-18 21:50:37",932,458,434,24,0,453,5,1020,562,195,258
40,VÂLCEA,"GRĂDINIŢA CU PROGRAM PRELUNGIT NORD II",8,"MUNICIPIUL RÂMNICU VÂLCEA",167473,1,PART,PRCNCT,PRSD,PRSD_SV,"2025-05-18 21:31:31",887,514,470,44,0,505,9,980,466,149,356
40,VÂLCEA,"LICEUL DE ARTE VICTOR GIULEANU",9,"MUNICIPIUL RÂMNICU VÂLCEA",167473,1,PART,PRCNCT,PRSD,PRSD_SV,"2025-05-18 21:37:53",969,500,431,69,0,493,7,1060,560,209,284
40,VÂLCEA,"LICEUL DE ARTE VICTOR GIULEANU",10,"MUNICIPIUL RÂMNICU VÂLCEA",167473,1,PART,PRCNCT,PRSD,PRSD_SV,"2025-05-18 21:56:21",995,531,496,34,1,523,8,1100,569,249,274
40,VÂLCEA,"LICEUL DE ARTE VICTOR GIULEANU",11,"MUNICIPIUL RÂMNICU VÂLCEA",167473,1,PART,PRCNCT,PRSD,PRSD_SV,"2025-05-18 21:40:38",932,462,439,23,0,456,6,1020,558,180,276
40,VÂLCEA,"LICEUL DE ARTE VICTOR GIULEANU",12,"MUNICIPIUL RÂMNICU VÂLCEA",167473,1,PART,PRCNCT,PRSD,PRSD_SV,"2025-05-18 21:50:31",1169,627,586,41,0,611,16,1280,653,290,321
40,VÂLCEA,"LICEUL DE ARTE VICTOR GIULEANU",13,"MUNICIPIUL RÂMNICU VÂLCEA",167473,1,PART,PRCNCT,PRSD,PRSD_SV,"2025-05-18 21:43:30",751,404,340,64,0,404,0,820,416,164,240
40,VÂLCEA,"COLEGIUL NAŢIONAL DE INFORMATICĂ ”MATEI BASARAB”",14,"MUNICIPIUL RÂMNICU VÂLCEA",167473,1,PART,PRCNCT,PRSD,PRSD_SV,"2025-05-18 21:34:39",933,441,391,50,0,427,14,1015,574,198,229
40,VÂLCEA,"COLEGIUL NAŢIONAL DE INFORMATICĂ ”MATEI BASARAB”",15,"MUNICIPIUL RÂMNICU VÂLCEA",167473,2,PART,PRCNCT,PRSD,PRSD_SV,"2025-05-19 01:20:58",745,418,369,49,0,411,7,820,402,158,253
40,VÂLCEA,"COLEGIUL NAŢIONAL DE INFORMATICĂ ”MATEI BASARAB”",16,"MUNICIPIUL RÂMNICU VÂLCEA",167473,1,PART,PRCNCT,PRSD,PRSD_SV,"2025-05-18 21:48:20",950,453,430,23,0,443,10,1050,597,159,284
40,VÂLCEA,"COLEGIUL NAŢIONAL DE INFORMATICĂ ”MATEI BASARAB”",17,"MUNICIPIUL RÂMNICU VÂLCEA",167473,1,PART,PRCNCT,PRSD,PRSD_SV,"2025-05-18 22:02:18",1215,619,569,48,2,609,10,1340,721,233,376
40,VÂLCEA,"LICEUL TEHNOLOGIC FORESTIER",18,"MUNICIPIUL RÂMNICU VÂLCEA",167473,1,PART,PRCNCT,PRSD,PRSD_SV,"2025-05-18 21:51:04",912,644,514,64,66,628,16,1000,356,223,405
40,VÂLCEA,"LICEUL TEHNOLOGIC FORESTIER",19,"MUNICIPIUL RÂMNICU VÂLCEA",167473,1,PART,PRCNCT,PRSD,PRSD_SV,"2025-05-18 21:39:11",797,534,425,61,48,521,13,880,346,166,355
40,VÂLCEA,"LICEUL TEHNOLOGIC FORESTIER",20,"MUNICIPIUL RÂMNICU VÂLCEA",167473,1,PART,PRCNCT,PRSD,PRSD_SV,"2025-05-18 21:34:33",829,475,390,55,30,463,12,910,435,216,247
40,VÂLCEA,"ȘCOALA GIMNAZIALĂ ”IOAN GH. DUCA”",21,"MUNICIPIUL RÂMNICU VÂLCEA",167473,1,PART,PRCNCT,PRSD,PRSD_SV,"2025-05-18 21:53:07",931,496,427,68,1,488,8,1020,524,228,260
40,VÂLCEA,"ȘCOALA GIMNAZIALĂ ”IOAN GH. DUCA”",22,"MUNICIPIUL RÂMNICU VÂLCEA",167473,1,PART,PRCNCT,PRSD,PRSD_SV,"2025-05-18 21:36:17",893,541,445,96,0,535,6,980,439,207,328
40,VÂLCEA,"ȘCOALA GIMNAZIALĂ ”IOAN GH. DUCA”",23,"MUNICIPIUL RÂMNICU VÂLCEA",167473,1,PART,PRCNCT,PRSD,PRSD_SV,"2025-05-18 21:35:59",929,528,474,54,0,523,5,1020,492,191,332
40,VÂLCEA,"ȘCOALA GIMNAZIALĂ ”IOAN GH. DUCA”",24,"MUNICIPIUL RÂMNICU VÂLCEA",167473,1,PART,PRCNCT,PRSD,PRSD_SV,"2025-05-18 21:30:43",751,370,338,32,0,363,7,820,450,130,233
40,VÂLCEA,"ȘCOALA GIMNAZIALĂ ”IOAN GH. DUCA”",25,"MUNICIPIUL RÂMNICU VÂLCEA",167473,1,PART,PRCNCT,PRSD,PRSD_SV,"2025-05-18 21:49:19",809,466,422,44,0,461,5,890,424,184,277
40,VÂLCEA,"ȘCOALA GIMNAZIALĂ ”IOAN GH. DUCA”",26,"MUNICIPIUL RÂMNICU VÂLCEA",167473,1,PART,PRCNCT,PRSD,PRSD_SV,"2025-05-18 22:41:30",992,502,468,34,0,493,9,1090,588,195,298
40,VÂLCEA,"ȘCOALA GIMNAZIALĂ ”IOAN GH. DUCA”",27,"MUNICIPIUL RÂMNICU VÂLCEA",167473,1,PART,PRCNCT,PRSD,PRSD_SV,"2025-05-18 21:42:00",809,396,363,33,0,392,4,890,494,116,276
40,VÂLCEA,"ȘCOALA GIMNAZIALĂ TAKE IONESCU",28,"MUNICIPIUL RÂMNICU VÂLCEA",167473,1,PART,PRCNCT,PRSD,PRSD_SV,"2025-05-18 21:31:21",888,591,464,126,1,584,7,980,389,170,414
40,VÂLCEA,"COLEGIUL NAȚIONAL ALEXANDRU LAHOVARI",29,"MUNICIPIUL RÂMNICU VÂLCEA",167473,1,PART,PRCNCT,PRSD,PRSD_SV,"2025-05-18 22:12:15",977,636,499,136,1,630,6,1070,434,201,429
40,VÂLCEA,"COLEGIUL NAȚIONAL ALEXANDRU LAHOVARI",30,"MUNICIPIUL RÂMNICU VÂLCEA",167473,1,PART,PRCNCT,PRSD,PRSD_SV,"2025-05-18 22:12:14",1344,805,721,83,1,792,13,1480,675,253,539
40,VÂLCEA,"POLITEHNICA BUCUREȘTI",31,"MUNICIPIUL RÂMNICU VÂLCEA",167473,1,PART,PRCNCT,PRSD,PRSD_SV,"2025-05-18 21:42:05",1204,697,566,110,21,686,11,1320,623,332,354
40,VÂLCEA,"POLITEHNICA BUCUREȘTI",32,"MUNICIPIUL RÂMNICU VÂLCEA",167473,1,PART,PRCNCT,PRSD,PRSD_SV,"2025-05-18 21:52:30",1302,777,685,65,27,756,21,1430,653,289,467
40,VÂLCEA,"ŞCOALA GIMNAZIALĂ NR.5",33,"MUNICIPIUL RÂMNICU VÂLCEA",167473,1,PART,PRCNCT,PRSD,PRSD_SV,"2025-05-18 22:01:46",1106,740,609,131,0,728,12,1210,470,249,479
40,VÂLCEA,"DADP - SEDIU, BL A17",34,"MUNICIPIUL RÂMNICU VÂLCEA",167473,1,PART,PRCNCT,PRSD,PRSD_SV,"2025-05-18 22:08:01",1997,1174,1039,135,0,1164,10,2190,1016,473,691
40,VÂLCEA,"PASAJ PIETONAL",35,"MUNICIPIUL RÂMNICU VÂLCEA",167473,1,PART,PRCNCT,PRSD,PRSD_SV,"2025-05-18 21:39:22",787,559,405,154,0,552,7,870,311,148,404
40,VÂLCEA,"PASAJ PIETONAL",36,"MUNICIPIUL RÂMNICU VÂLCEA",167473,1,PART,PRCNCT,PRSD,PRSD_SV,"2025-05-18 21:53:48",636,421,277,121,23,413,8,700,279,154,259
40,VÂLCEA,"PASAJ PIETONAL",37,"MUNICIPIUL RÂMNICU VÂLCEA",167473,1,PART,PRCNCT,PRSD,PRSD_SV,"2025-05-18 21:37:25",862,543,440,91,12,538,5,950,407,185,353
40,VÂLCEA,"GRĂDINIȚA CU PROGRAM PRELUNGIT ”COZIA”",38,"MUNICIPIUL RÂMNICU VÂLCEA",167473,1,PART,PRCNCT,PRSD,PRSD_SV,"2025-05-18 22:02:35",1350,815,733,82,0,799,16,1480,665,276,523
40,VÂLCEA,"GRĂDINIŢA CU PROGRAM PRELUNGIT ”COZIA”",39,"MUNICIPIUL RÂMNICU VÂLCEA",167473,1,PART,PRCNCT,PRSD,PRSD_SV,"2025-05-18 21:54:31",1044,576,503,71,2,567,9,1150,574,196,371
40,VÂLCEA,"LICEUL TEHNOLOGIC ”CĂPITAN NICOLAE PLEŞOIANU”",40,"MUNICIPIUL RÂMNICU VÂLCEA",167473,2,PART,PRCNCT,PRSD,PRSD_SV,"2025-05-19 00:21:37",1039,585,519,65,1,581,4,1140,555,152,429
40,VÂLCEA,"LICEUL TEHNOLOGIC ”CĂPITAN NICOLAE PLEŞOIANU”",41,"MUNICIPIUL RÂMNICU VÂLCEA",167473,1,PART,PRCNCT,PRSD,PRSD_SV,"2025-05-18 21:30:23",895,503,474,29,0,497,6,980,477,136,361
40,VÂLCEA,"LICEUL TEHNOLOGIC ”CĂPITAN NICOLAE PLEŞOIANU”",42,"MUNICIPIUL RÂMNICU VÂLCEA",167473,1,PART,PRCNCT,PRSD,PRSD_SV,"2025-05-18 21:45:31",1101,614,573,41,0,599,15,1210,596,297,302
40,VÂLCEA,"LICEUL TEHNOLOGIC ”CĂPITAN NICOLAE PLEȘOIANU”",43,"MUNICIPIUL RÂMNICU VÂLCEA",167473,1,PART,PRCNCT,PRSD,PRSD_SV,"2025-05-18 21:48:55",908,494,446,48,0,485,9,1000,506,292,193
40,VÂLCEA,"ŞCOALA GIMNAZIALĂ ”SPIRU HARET” (FOSTĂ NR. 3)",44,"MUNICIPIUL RÂMNICU VÂLCEA",167473,1,PART,PRCNCT,PRSD,PRSD_SV,"2025-05-18 21:51:11",1637,1006,933,70,3,1002,4,1800,794,503,499
40,VÂLCEA,"ȘCOALA GIMNAZIALĂ GORANU",45,"MUNICIPIUL RÂMNICU VÂLCEA",167473,1,PART,PRCNCT,PRSD,PRSD_SV,"2025-05-18 21:57:52",1398,733,675,58,0,724,9,1540,807,364,360
40,VÂLCEA,"ŞCOALA GIMNAZIALĂ GORANU",46,"MUNICIPIUL RÂMNICU VÂLCEA",167473,1,PART,PRCNCT,PRSD,PRSD_SV,"2025-05-18 21:39:26",1026,558,520,37,1,547,11,1130,572,280,267
40,VÂLCEA,"ŞCOALA LESPEZI - ARHIVĂ",47,"MUNICIPIUL RÂMNICU VÂLCEA",167473,1,PART,PRCNCT,PRSD,PRSD_SV,"2025-05-18 22:20:51",1252,772,736,36,0,763,9,1380,608,317,446
40,VÂLCEA,"ŞCOALA FEŢENI",48,"MUNICIPIUL RÂMNICU VÂLCEA",167473,1,PART,PRCNCT,PRSD,PRSD_SV,"2025-05-18 21:19:21",193,106,92,14,0,104,2,210,104,50,54
40,VÂLCEA,"CARTIER PETRIŞOR - PT8",49,"MUNICIPIUL RÂMNICU VÂLCEA",167473,1,PART,PRCNCT,PRSD,PRSD_SV,"2025-05-18 21:47:18",1406,606,558,48,0,597,9,1540,934,335,262
40,VÂLCEA,"ŞCOALA GIMNAZIALĂ NR.4",50,"MUNICIPIUL RÂMNICU VÂLCEA",167473,1,PART,PRCNCT,PRSD,PRSD_SV,"2025-05-18 21:28:29",915,538,459,79,0,530,8,1010,472,202,328
40,VÂLCEA,"ŞCOALA GIMNAZIALĂ NR.4",51,"MUNICIPIUL RÂMNICU VÂLCEA",167473,1,PART,PRCNCT,PRSD,PRSD_SV,"2025-05-18 21:30:55",1198,685,625,59,1,675,10,1320,635,241,434
40,VÂLCEA,"ŞCOALA GIMNAZIALĂ NR.4",52,"MUNICIPIUL RÂMNICU VÂLCEA",167473,1,PART,PRCNCT,PRSD,PRSD_SV,"2025-05-18 21:33:29",918,566,509,57,0,557,9,1010,444,181,376
40,VÂLCEA,"COLEGIUL ECONOMIC",53,"MUNICIPIUL RÂMNICU VÂLCEA",167473,1,PART,PRCNCT,PRSD,PRSD_SV,"2025-05-18 21:53:24",1027,563,504,58,1,556,7,1130,567,211,345
40,VÂLCEA,"COLEGIUL ECONOMIC",54,"MUNICIPIUL RÂMNICU VÂLCEA",167473,1,PART,PRCNCT,PRSD,PRSD_SV,"2025-05-18 21:31:03",1013,553,498,55,0,543,10,1110,557,208,335
40,VÂLCEA,"COLEGIUL ECONOMIC",55,"MUNICIPIUL RÂMNICU VÂLCEA",167473,2,PART,PRCNCT,PRSD,PRSD_SV,"2025-05-19 01:25:12",1027,498,450,42,6,493,5,1130,632,220,273
40,VÂLCEA,"ȘCOALA GIMNAZIALĂ MIHAI EMINESCU",56,"MUNICIPIUL RÂMNICU VÂLCEA",167473,1,PART,PRCNCT,PRSD,PRSD_SV,"2025-05-18 21:32:51",1169,676,577,99,0,666,10,1290,614,279,387
40,VÂLCEA,"ȘCOALA GIMNAZIALĂ MIHAI EMINESCU",57,"MUNICIPIUL RÂMNICU VÂLCEA",167473,1,PART,PRCNCT,PRSD,PRSD_SV,"2025-05-18 22:26:28",1360,786,703,83,0,772,14,1493,707,321,451
40,VÂLCEA,"ȘCOALA GIMNAZIALĂ MIHAI EMINESCU",58,"MUNICIPIUL RÂMNICU VÂLCEA",167473,1,PART,PRCNCT,PRSD,PRSD_SV,"2025-05-18 21:59:46",1089,550,488,62,0,539,11,1200,650,256,283
40,VÂLCEA,"GRĂDINIȚA CU PROGRAM PRELUNGIT OSTROVENI I",59,"MUNICIPIUL RÂMNICU VÂLCEA",167473,1,PART,PRCNCT,PRSD,PRSD_SV,"2025-05-18 21:39:04",1199,640,561,79,0,628,12,1320,680,321,307
40,VÂLCEA,"LICEUL TEHNOLOGIC FERDINAND I",60,"MUNICIPIUL RÂMNICU VÂLCEA",167473,2,PART,PRCNCT,PRSD,PRSD_SV,"2025-05-19 01:01:07",799,431,371,60,0,426,5,880,449,172,254
40,VÂLCEA,"LICEUL TEHNOLOGIC FERDINAND I",61,"MUNICIPIUL RÂMNICU VÂLCEA",167473,1,PART,PRCNCT,PRSD,PRSD_SV,"2025-05-18 21:36:25",704,336,296,40,0,327,9,780,444,158,169
40,VÂLCEA,"LICEUL TEHNOLOGIC FERDINAND I",62,"MUNICIPIUL RÂMNICU VÂLCEA",167473,1,PART,PRCNCT,PRSD,PRSD_SV,"2025-05-18 21:17:22",794,401,357,43,1,395,6,870,469,202,193
40,VÂLCEA,"LICEUL TEHNOLOGIC FERDINAND I",63,"MUNICIPIUL RÂMNICU VÂLCEA",167473,1,PART,PRCNCT,PRSD,PRSD_SV,"2025-05-18 21:32:50",1111,550,522,28,0,540,10,1220,670,277,263
40,VÂLCEA,"LICEUL TEHNOLOGIC FERDINAND I",64,"MUNICIPIUL RÂMNICU VÂLCEA",167473,1,PART,PRCNCT,PRSD,PRSD_SV,"2025-05-18 21:17:50",733,385,363,22,0,379,6,800,415,174,205
40,VÂLCEA,"LICEUL TEHNOLOGIC FERDINAND I",65,"MUNICIPIUL RÂMNICU VÂLCEA",167473,1,PART,PRCNCT,PRSD,PRSD_SV,"2025-05-18 21:27:58",776,358,329,29,0,352,6,850,492,167,185
40,VÂLCEA,"GRĂDINIȚA CU PROGRAM PRELUNGIT OSTROVENI II",66,"MUNICIPIUL RÂMNICU VÂLCEA",167473,1,PART,PRCNCT,PRSD,PRSD_SV,"2025-05-18 21:39:00",1256,659,598,61,0,647,12,1380,721,306,341
40,VÂLCEA,"GRĂDINIȚA CU PROGRAM PRELUNGIT OSTROVENI II",67,"MUNICIPIUL RÂMNICU VÂLCEA",167473,1,PART,PRCNCT,PRSD,PRSD_SV,"2025-05-18 21:41:46",1330,701,629,72,0,692,9,1460,759,305,387
40,VÂLCEA,"GRĂDINIŢA CU PROGRAM PRELUNGIT OSTROVENI II",68,"MUNICIPIUL RÂMNICU VÂLCEA",167473,1,PART,PRCNCT,PRSD,PRSD_SV,"2025-05-18 21:30:09",956,452,408,44,0,447,5,1050,598,227,220
40,VÂLCEA,"GRĂDINIŢA CU PROGRAM PRELUNGIT OSTROVENI II",69,"MUNICIPIUL RÂMNICU VÂLCEA",167473,2,PART,PRCNCT,PRSD,PRSD_SV,"2025-05-19 01:28:01",1147,556,526,30,0,547,9,1260,704,267,280
40,VÂLCEA,"DIRECȚIA ADMINISTRĂRII DOMENIULUI PUBLIC",70,"MUNICIPIUL RÂMNICU VÂLCEA",167473,1,PART,PRCNCT,PRSD,PRSD_SV,"2025-05-18 21:41:20",1165,827,696,90,41,820,7,1280,453,346,474
40,VÂLCEA,"ŞCOALA GIMNAZIALĂ ”ANTON PANN”",71,"MUNICIPIUL RÂMNICU VÂLCEA",167473,1,PART,PRCNCT,PRSD,PRSD_SV,"2025-05-18 21:33:32",1465,800,708,92,0,787,13,1610,810,370,417
40,VÂLCEA,"ŞCOALA GIMNAZIALĂ ”ANTON PANN”",72,"MUNICIPIUL RÂMNICU VÂLCEA",167473,1,PART,PRCNCT,PRSD,PRSD_SV,"2025-05-18 21:29:36",910,504,392,112,0,495,9,1000,496,248,247
40,VÂLCEA,"ŞCOALA GIMNAZIALĂ ”ANTON PANN”",73,"MUNICIPIUL RÂMNICU VÂLCEA",167473,2,PART,PRCNCT,PRSD,PRSD_SV,"2025-05-19 01:33:06",1188,665,640,25,0,649,16,1310,645,238,411
40,VÂLCEA,"ŞCOALA GIMNAZIALĂ ”ANTON PANN”",74,"MUNICIPIUL RÂMNICU VÂLCEA",167473,1,PART,PRCNCT,PRSD,PRSD_SV,"2025-05-18 21:33:27",963,520,449,71,0,513,7,1060,540,219,294
40,VÂLCEA,"ŞCOALA GIMNAZIALĂ ”ANTON PANN”",75,"MUNICIPIUL RÂMNICU VÂLCEA",167473,1,PART,PRCNCT,PRSD,PRSD_SV,"2025-05-18 21:35:49",687,384,336,48,0,379,5,750,366,178,201
40,VÂLCEA,"ŞCOALA GIMNAZIALĂ ”ANTON PANN”",76,"MUNICIPIUL RÂMNICU VÂLCEA",167473,1,PART,PRCNCT,PRSD,PRSD_SV,"2025-05-18 21:29:36",1027,493,461,32,0,482,11,1130,637,236,246
40,VÂLCEA,"ŞCOALA GIMNAZIALĂ ”ANTON PANN”",77,"MUNICIPIUL RÂMNICU VÂLCEA",167473,1,PART,PRCNCT,PRSD,PRSD_SV,"2025-05-18 21:32:25",1245,623,592,31,0,613,10,1370,747,338,275
40,VÂLCEA,"ŞCOALA GIMNAZIALĂ NR. 13",78,"MUNICIPIUL RÂMNICU VÂLCEA",167473,1,PART,PRCNCT,PRSD,PRSD_SV,"2025-05-18 21:39:03",868,410,393,17,0,403,7,950,540,165,238
40,VÂLCEA,"ŞCOALA GIMNAZIALĂ NR. 13",79,"MUNICIPIUL RÂMNICU VÂLCEA",167473,1,PART,PRCNCT,PRSD,PRSD_SV,"2025-05-18 21:46:38",912,487,459,28,0,480,7,1000,513,225,255
40,VÂLCEA,"ŞCOALA GIMNAZIALĂ NR. 13",80,"MUNICIPIUL RÂMNICU VÂLCEA",167473,1,PART,PRCNCT,PRSD,PRSD_SV,"2025-05-18 21:28:24",891,505,420,85,0,493,12,980,475,234,259
40,VÂLCEA,"ŞCOALA GIMNAZIALĂ NR. 13",81,"MUNICIPIUL RÂMNICU VÂLCEA",167473,1,PART,PRCNCT,PRSD,PRSD_SV,"2025-05-18 21:40:14",961,442,403,38,1,431,11,1060,618,194,237
40,VÂLCEA,"ŞCOALA GIMNAZIALĂ NR. 13",82,"MUNICIPIUL RÂMNICU VÂLCEA",167473,1,PART,PRCNCT,PRSD,PRSD_SV,"2025-05-18 21:44:31",911,461,431,28,2,452,9,1000,539,180,272
40,VÂLCEA,"ŞCOALA GIMNAZIALĂ NR. 13",83,"MUNICIPIUL RÂMNICU VÂLCEA",167473,2,PART,PRCNCT,PRSD,PRSD_SV,"2025-05-19 01:05:14",1375,783,747,36,0,771,12,1510,727,365,406
40,VÂLCEA,"ŞCOALA GIMNAZIALĂ NR. 13",84,"MUNICIPIUL RÂMNICU VÂLCEA",167473,1,PART,PRCNCT,PRSD,PRSD_SV,"2025-05-18 21:29:45",1367,745,706,38,1,737,8,1500,755,376,361
40,VÂLCEA,"SECŢIA 1 DE POLIŢIE RURALĂ RÂMNICU VÂLCEA",85,"MUNICIPIUL RÂMNICU VÂLCEA",167473,1,PART,PRCNCT,PRSD,PRSD_SV,"2025-05-18 21:22:50",825,478,434,44,0,468,10,910,432,207,261
40,VÂLCEA,"ŞCOALA STOLNICENI",86,"MUNICIPIUL RÂMNICU VÂLCEA",167473,1,PART,PRCNCT,PRSD,PRSD_SV,"2025-05-18 21:24:08",519,271,239,32,0,271,0,570,299,156,115
40,VÂLCEA,"ŞCOALA GIMNAZIALĂ COLONIE",87,"MUNICIPIUL RÂMNICU VÂLCEA",167473,1,PART,PRCNCT,PRSD,PRSD_SV,"2025-05-18 21:22:15",1014,490,440,50,0,478,12,1110,620,373,105
40,VÂLCEA,"ŞCOALA COPĂCELU",88,"MUNICIPIUL RÂMNICU VÂLCEA",167473,1,PART,PRCNCT,PRSD,PRSD_SV,"2025-05-18 21:50:18",1615,940,851,88,1,919,21,1770,830,470,449
40,VÂLCEA,"GRĂDINIŢA CĂZĂNEŞTI",89,"MUNICIPIUL RÂMNICU VÂLCEA",167473,1,PART,PRCNCT,PRSD,PRSD_SV,"2025-05-18 22:02:24",997,578,520,58,0,568,10,1090,512,309,259
40,VÂLCEA,"GRADINITA CU PROGRAM PRELUNGIT OSTROVENI",90,"MUNICIPIUL RÂMNICU VÂLCEA",167473,1,PART,PRCNCT,PRSD,PRSD_SV,"2025-05-18 21:40:07",1501,916,808,80,28,896,20,1650,734,466,430
40,VÂLCEA,"SISTEMUL DE GOSPODĂRIRE A APELOR VÂLCEA-CONTAINER",91,"MUNICIPIUL RÂMNICU VÂLCEA",167473,2,PART,PRCNCT,PRSD,PRSD_SV,"2025-05-18 21:38:04",773,462,426,35,1,457,5,850,388,210,247
40,VÂLCEA,"ŞCOALA TUDOR VLADIMIRESCU",92,"MUNICIPIUL DRĂGĂŞANI",167981,1,PART,PRCNCT,PRSD,PRSD_SV,"2025-05-18 22:05:04",1240,690,601,88,1,679,11,1360,670,258,421
40,VÂLCEA,"ŞCOALA TUDOR VLADIMIRESCU",93,"MUNICIPIUL DRĂGĂŞANI",167981,1,PART,PRCNCT,PRSD,PRSD_SV,"2025-05-18 21:45:14",1152,607,521,85,1,604,3,1270,663,253,351
40,VÂLCEA,"LICEUL TEHNOLOGIC BRĂTIANU",94,"MUNICIPIUL DRĂGĂŞANI",167981,1,PART,PRCNCT,PRSD,PRSD_SV,"2025-05-18 21:34:32",1285,544,510,34,0,540,4,1410,866,269,271
40,VÂLCEA,"LICEUL TEHNOLOGIC BRĂTIANU",95,"MUNICIPIUL DRĂGĂŞANI",167981,2,PART,PRCNCT,PRSD,PRSD_SV,"2025-05-19 01:14:52",1186,493,439,52,2,489,4,1300,807,248,241
40,VÂLCEA,"GRĂDINIȚA CU PROGRAM PRELUNGIT NR. 2",96,"MUNICIPIUL DRĂGĂŞANI",167981,1,PART,PRCNCT,PRSD,PRSD_SV,"2025-05-18 22:03:53",1191,567,526,41,0,558,9,1310,743,270,288
40,VÂLCEA,"GRĂDINIŢA I.C. BRĂTIANU",97,"MUNICIPIUL DRĂGĂŞANI",167981,1,PART,PRCNCT,PRSD,PRSD_SV,"2025-05-18 21:35:06",856,407,353,54,0,395,12,940,533,263,132
40,VÂLCEA,"ȘCOALA NICOLAE BĂLCESCU",98,"MUNICIPIUL DRĂGĂŞANI",167981,1,PART,PRCNCT,PRSD,PRSD_SV,"2025-05-18 21:58:11",1146,590,511,76,3,585,5,1260,670,232,353
40,VÂLCEA,"ŞCOALA NICOLAE BĂLCESCU",99,"MUNICIPIUL DRĂGĂŞANI",167981,1,PART,PRCNCT,PRSD,PRSD_SV,"2025-05-18 22:04:19",1153,602,560,42,0,595,7,1270,668,232,363
40,VÂLCEA,"COLEGIUL NAȚIONAL GIB MIHĂESCU",100,"MUNICIPIUL DRĂGĂŞANI",167981,1,PART,PRCNCT,PRSD,PRSD_SV,"2025-05-18 22:23:11",1410,693,613,71,9,684,9,1550,857,308,376
40,VÂLCEA,"LICEUL TEHNOLOGIC BRĂTIANU - ȘCOALA PROFESIONALĂ",101,"MUNICIPIUL DRĂGĂŞANI",167981,1,PART,PRCNCT,PRSD,PRSD_SV,"2025-05-18 21:49:06",1202,546,485,59,2,539,7,1320,774,365,174
40,VÂLCEA,"ŞCOALA GIMNAZIALĂ NR. 8 (BÂRSANU)",102,"MUNICIPIUL DRĂGĂŞANI",167981,1,PART,PRCNCT,PRSD,PRSD_SV,"2025-05-18 21:37:07",812,430,394,36,0,421,9,890,460,210,211
40,VÂLCEA,"GRĂDINIŢA CU PROGRAM NORMAL NR. 8",103,"MUNICIPIUL DRĂGĂŞANI",167981,1,PART,PRCNCT,PRSD,PRSD_SV,"2025-05-18 21:22:33",581,227,201,26,0,224,3,640,413,193,31
40,VÂLCEA,"ŞCOALA GIMNAZIALĂ NR. 5",104,"MUNICIPIUL DRĂGĂŞANI",167981,1,PART,PRCNCT,PRSD,PRSD_SV,"2025-05-18 21:45:18",687,356,334,22,0,353,3,760,404,170,183
40,VÂLCEA,"GRĂDINIȚA CAPUL DEALULUI",105,"MUNICIPIUL DRĂGĂŞANI",167981,1,PART,PRCNCT,PRSD,PRSD_SV,"2025-05-18 21:45:44",746,382,343,36,3,378,4,820,438,186,192
40,VÂLCEA,"ȘCOALA ZLĂTĂREI",106,"MUNICIPIUL DRĂGĂŞANI",167981,1,PART,PRCNCT,PRSD,PRSD_SV,"2025-05-18 22:03:47",1150,608,563,45,0,605,3,1260,652,333,272
40,VÂLCEA,"PRIMĂRIA ORAŞULUI BĂBENI",107,"ORAŞ BĂBENI",168372,1,PART,PRCNCT,PRSD,PRSD_SV,"2025-05-18 22:24:32",1678,872,770,100,2,868,4,1850,978,521,347
40,VÂLCEA,"LICEUL ”GEORGE ŢĂRNEA”, ORAȘ BĂBENI",108,"ORAŞ BĂBENI",168372,1,PART,PRCNCT,PRSD,PRSD_SV,"2025-05-18 21:23:11",953,498,441,57,0,492,6,1050,552,302,190
40,VÂLCEA,"S.C. ALFA FARM S.R.L.",109,"ORAŞ BĂBENI",168372,1,PART,PRCNCT,PRSD,PRSD_SV,"2025-05-18 21:20:26",788,437,387,50,0,434,3,870,433,272,162
40,VÂLCEA,"FOSTUL SEDIU AL ȘCOLII GIMNAZIALE, SAT ROMÂNI, ORAȘ BĂBENI",110,"ORAŞ BĂBENI",168372,1,PART,PRCNCT,PRSD,PRSD_SV,"2025-05-18 21:37:39",1040,606,557,49,0,601,5,1140,534,340,261
40,VÂLCEA,"FOSTUL SEDIU AL ȘCOLII GIMNAZIALE, SAT ROMÂNI, ORAȘ BĂBENI",111,"ORAŞ BĂBENI",168372,1,PART,PRCNCT,PRSD,PRSD_SV,"2025-05-18 21:25:03",164,118,104,14,0,117,1,180,62,72,45
40,VÂLCEA,"GRĂDINIȚA CU PROGRAM PRELUNGIT, SAT TĂTĂRANI, ORAȘ BĂBENI",112,"ORAŞ BĂBENI",168372,1,PART,PRCNCT,PRSD,PRSD_SV,"2025-05-18 21:33:19",465,293,240,53,0,287,6,510,217,184,103
40,VÂLCEA,"ŞCOALA PIMARĂ, SAT VALEA MARE, ORAȘ BĂBENI",113,"ORAŞ BĂBENI",168372,1,PART,PRCNCT,PRSD,PRSD_SV,"2025-05-18 21:24:17",798,299,276,23,0,298,1,880,581,232,66
40,VÂLCEA,"ŞCOALA GIMNAZIALĂ, SAT VALEA MARE, ORAȘ BĂBENI",114,"ORAŞ BĂBENI",168372,1,PART,PRCNCT,PRSD,PRSD_SV,"2025-05-18 21:44:05",1409,575,518,57,0,567,8,1550,975,419,148
40,VÂLCEA,"AȘEZĂMÂNT CULTURAL BĂILE GOVORA ( FOST CINEMATOGRAF)",115,"ORAŞ BĂILE GOVORA",167641,1,PART,PRCNCT,PRSD,PRSD_SV,"2025-05-18 22:28:56",1090,899,540,356,3,887,12,1200,301,404,483
40,VÂLCEA,"LICEUL TEHNOLOGIC BĂILE GOVORA",116,"ORAŞ BĂILE GOVORA",167641,2,PART,PRCNCT,PRSD,PRSD_SV,"2025-05-19 01:42:53",766,464,384,78,2,454,10,840,376,190,264
40,VÂLCEA,"ȘCOALA GENERALĂ CU CLASELE I-IV GĂTEJEȘTI",117,"ORAŞ BĂILE GOVORA",167641,1,PART,PRCNCT,PRSD,PRSD_SV,"2025-05-18 21:32:58",305,193,151,42,0,190,3,330,137,121,69
40,VÂLCEA,"LICEUL TEHNOLOGIC JUSTINIAN MARINA",118,"ORAŞ BĂILE OLĂNEŞTI",167696,1,PART,PRCNCT,PRSD,PRSD_SV,"2025-05-18 22:32:43",1402,1710,752,957,1,1660,50,1940,230,733,927
40,VÂLCEA,"ȘCOALA GIMNAZIALĂ IONESCU CHEIANU",119,"ORAŞ BĂILE OLĂNEŞTI",167696,2,PART,PRCNCT,PRSD,PRSD_SV,"2025-05-19 01:23:06",882,555,452,103,0,539,16,970,415,313,226
40,VÂLCEA,"ȘCOALA GIMNAZIALĂ DUMITRU BĂDESCU",120,"ORAŞ BĂILE OLĂNEŞTI",167696,1,PART,PRCNCT,PRSD,PRSD_SV,"2025-05-18 22:03:09",1368,795,680,115,0,783,12,1100,305,447,336
40,VÂLCEA,"LICEUL TEHNOLOGIC PETRACHE POENARU",121,"ORAŞ BĂLCEŞTI",168452,1,PART,PRCNCT,PRSD,PRSD_SV,"2025-05-18 21:32:25",996,547,455,91,1,543,4,1100,553,284,259
40,VÂLCEA,"LICEUL TEHNOLOGIC PETRACHE POENARU",122,"ORAŞ BĂLCEŞTI",168452,1,PART,PRCNCT,PRSD,PRSD_SV,"2025-05-18 21:33:58",739,401,314,86,1,396,5,810,409,254,142
40,VÂLCEA,"ŞCOALA PRIMARĂ BENEŞTI",123,"ORAŞ BĂLCEŞTI",168452,1,PART,PRCNCT,PRSD,PRSD_SV,"2025-05-18 21:54:53",358,166,137,29,0,164,2,390,224,96,68
40,VÂLCEA,"SCOALA PRIMARĂ CÂRLOGANI",124,"ORAŞ BĂLCEŞTI",168452,1,PART,PRCNCT,PRSD,PRSD_SV,"2025-05-18 21:22:12",402,218,167,51,0,215,3,440,222,115,100
40,VÂLCEA,"ŞCOALA PRIMARĂ GORUNEŞTI",125,"ORAŞ BĂLCEŞTI",168452,1,PART,PRCNCT,PRSD,PRSD_SV,"2025-05-18 21:32:54",563,285,225,57,3,283,2,620,335,165,118
40,VÂLCEA,"ŞCOALA PRIMARĂ OTETELIŞU",126,"ORAŞ BĂLCEŞTI",168452,1,PART,PRCNCT,PRSD,PRSD_SV,"2025-05-18 21:31:32",801,419,345,74,0,418,1,880,461,232,186
40,VÂLCEA,"GRĂDINIȚA CU PROGRAM NORMAL NR.2 (GRĂDINIȚA CU PROGRAM NORMAL CU 4 GRUPE)",127,"ORAŞ BERBEŞTI",168602,1,PART,PRCNCT,PRSD,PRSD_SV,"2025-05-18 21:53:54",849,338,308,30,0,334,4,930,592,236,98
40,VÂLCEA,"GRĂDINIȚA CU PROGRAM NORMAL CU 4 GRUPE",128,"ORAŞ BERBEŞTI",168602,1,PART,PRCNCT,PRSD,PRSD_SV,"2025-05-18 22:22:36",1015,454,404,50,0,447,7,1110,656,294,153
40,VÂLCEA,"ȘCOALA GENERALĂ CU CLASELE I- VIII BERBEȘTI",129,"ORAŞ BERBEŞTI",168602,1,PART,PRCNCT,PRSD,PRSD_SV,"2025-05-18 22:13:17",1410,705,648,57,0,696,9,1550,845,470,226
40,VÂLCEA,"GRUP ȘCOLAR PREDA BUZESCU",130,"ORAŞ BERBEŞTI",168602,1,PART,PRCNCT,PRSD,PRSD_SV,"2025-05-18 21:50:45",852,431,386,45,0,429,2,940,509,292,137
40,VÂLCEA,"ȘCOALA CU CLASELE I-IV NR. 2 BREZOI",131,"ORAŞ BREZOI",167794,1,PART,PRCNCT,PRSD,PRSD_SV,"2025-05-18 21:53:11",1095,606,535,68,3,598,8,1200,594,283,315
40,VÂLCEA,"GRĂDINIȚA CU PROGRAM NORMAL NR.1- PARTER",132,"ORAŞ BREZOI",167794,1,PART,PRCNCT,PRSD,PRSD_SV,"2025-05-18 22:09:32",983,380,321,39,20,370,10,1080,700,208,162
40,VÂLCEA,"GRĂDINIȚA CU PROGRAM PRELUNGIT",133,"ORAŞ BREZOI",167794,1,PART,PRCNCT,PRSD,PRSD_SV,"2025-05-18 22:04:19",931,404,346,57,1,402,2,1020,616,242,160
40,VÂLCEA,"ȘCOALA CU CLASELE I-IV NR. 1 BREZOI",134,"ORAŞ BREZOI",167794,1,PART,PRCNCT,PRSD,PRSD_SV,"2025-05-18 21:50:44",1416,674,605,69,0,667,7,1544,870,365,302
40,VÂLCEA,"CĂMINUL CULTURAL CĂLINEŞTI",135,"ORAŞ BREZOI",167794,1,PART,PRCNCT,PRSD,PRSD_SV,"2025-05-18 21:45:17",535,356,245,111,0,349,7,590,234,204,145
40,VÂLCEA,"CĂMINUL CULTURAL PĂSCOAIA",136,"ORAŞ BREZOI",167794,1,PART,PRCNCT,PRSD,PRSD_SV,"2025-05-18 21:43:10",164,143,94,49,0,139,4,180,37,56,83
40,VÂLCEA,"ŞCOALA CU CLASELE I-VIII VALEA LUI STAN",137,"ORAŞ BREZOI",167794,2,PART,PRCNCT,PRSD,PRSD_SV,"2025-05-19 00:53:47",504,241,212,29,0,230,11,550,309,157,73
40,VÂLCEA,"BLOC B1 - LICEUL TEHNOLOGIC DE TURISM CĂLIMĂNEŞTI",138,"ORAŞ CĂLIMĂNEŞTI",167909,1,PART,PRCNCT,PRSD,PRSD_SV,"2025-05-18 21:44:48",881,593,414,179,0,591,2,820,227,271,320
40,VÂLCEA,"ŞCOALA GIMNAZIALĂ ”ŞERBAN VODĂ CANTACUZINO” CĂLIMĂNEŞTI",139,"ORAŞ CĂLIMĂNEŞTI",167909,1,PART,PRCNCT,PRSD,PRSD_SV,"2025-05-18 21:25:41",776,517,385,132,0,507,10,750,233,240,267
40,VÂLCEA,"ȘCOALA GIMNAZIALĂ ”ȘERBAN VODĂ CANTACUZINO” CĂLIMĂNEȘTI",140,"ORAŞ CĂLIMĂNEŞTI",167909,1,PART,PRCNCT,PRSD,PRSD_SV,"2025-05-18 22:05:42",980,546,499,47,0,540,6,880,334,291,249
40,VÂLCEA,"CENTRUL NAȚIONAL DE INFORMARE ȘI PROMOVARE TURISTICĂ CĂLIMĂNEŞTI",141,"ORAŞ CĂLIMĂNEŞTI",167909,1,PART,PRCNCT,PRSD,PRSD_SV,"2025-05-18 22:07:07",501,709,242,467,0,697,12,1000,291,316,381
40,VÂLCEA,"CENTRUL DE INFORMARE TURISTICA CACIULATA",142,"ORAŞ CĂLIMĂNEŞTI",167909,1,PART,PRCNCT,PRSD,PRSD_SV,"2025-05-18 21:53:12",657,1579,284,1295,0,1562,17,1920,341,676,886
40,VÂLCEA,"ŞCOALA PRIMARĂ JIBLEA NOUĂ",143,"ORAŞ CĂLIMĂNEŞTI",167909,1,PART,PRCNCT,PRSD,PRSD_SV,"2025-05-18 21:30:24",926,484,438,46,0,481,3,720,236,283,198
40,VÂLCEA,"ŞCOALA GIMNAZIALĂ JIBLEA VECHE",144,"ORAŞ CĂLIMĂNEŞTI",167909,1,PART,PRCNCT,PRSD,PRSD_SV,"2025-05-18 21:26:32",968,434,383,51,0,430,4,570,136,267,163
40,VÂLCEA,"ŞCOALA GIMNAZIALĂ JIBLEA VECHE",145,"ORAŞ CĂLIMĂNEŞTI",167909,1,PART,PRCNCT,PRSD,PRSD_SV,"2025-05-18 21:40:10",973,467,408,59,0,464,3,670,203,228,236
40,VÂLCEA,"ŞCOALA GENERALĂ SEACA",146,"ORAŞ CĂLIMĂNEŞTI",167909,1,PART,PRCNCT,PRSD,PRSD_SV,"2025-05-18 21:22:09",423,232,206,26,0,227,5,460,228,109,118
40,VÂLCEA,"LICEUL CONSTANTIN BRÂNCOVEANU",147,"ORAŞ HOREZU",168041,1,PART,PRCNCT,PRSD,PRSD_SV,"2025-05-18 22:24:35",1152,863,603,213,47,851,12,1270,407,327,524
40,VÂLCEA,"CLUBUL COPIILOR HOREZU",148,"ORAŞ HOREZU",168041,1,PART,PRCNCT,PRSD,PRSD_SV,"2025-05-18 22:07:23",1023,607,529,78,0,599,8,1120,513,256,343
40,VÂLCEA,"CASA DE CULTURĂ CONSTANTIN BRÂNCOVEANU",149,"ORAŞ HOREZU",168041,1,PART,PRCNCT,PRSD,PRSD_SV,"2025-05-18 21:59:50",1047,697,565,132,0,679,18,1141,444,346,333
40,VÂLCEA,"CĂMINUL CULTURAL RÂMEȘTI",150,"ORAŞ HOREZU",168041,1,PART,PRCNCT,PRSD,PRSD_SV,"2025-05-18 21:38:02",341,220,189,30,1,219,1,380,160,98,121
40,VÂLCEA,"ȘCOALA GENERALĂ CU CLASELE I - VIII ROMANII DE JOS",151,"ORAŞ HOREZU",168041,1,PART,PRCNCT,PRSD,PRSD_SV,"2025-05-18 21:33:47",642,365,318,47,0,359,6,710,345,213,146
40,VÂLCEA,"ȘCOALA GENERALĂ ROMANII DE SUS - SĂLIȘTEA",152,"ORAŞ HOREZU",168041,1,PART,PRCNCT,PRSD,PRSD_SV,"2025-05-18 21:37:32",621,283,264,19,0,277,6,680,397,255,22
40,VÂLCEA,"CĂMINUL CULTURAL ROMANII DE SUS",153,"ORAŞ HOREZU",168041,1,PART,PRCNCT,PRSD,PRSD_SV,"2025-05-18 21:25:31",258,150,130,20,0,147,3,280,130,84,63
40,VÂLCEA,"CĂMINUL CULTURAL TĂNĂSEȘTI",154,"ORAŞ HOREZU",168041,1,PART,PRCNCT,PRSD,PRSD_SV,"2025-05-18 21:21:22",125,76,58,18,0,75,1,140,64,40,35
40,VÂLCEA,"CĂMINUL CULTURAL URȘANI",155,"ORAŞ HOREZU",168041,1,PART,PRCNCT,PRSD,PRSD_SV,"2025-05-18 21:27:05",371,201,173,28,0,196,5,410,209,78,118
40,VÂLCEA,"ȘCOALA GIMNAZIALĂ COSTEA MARINOIU OCNELE MARI",156,"ORAŞ OCNELE MARI",168130,1,PART,PRCNCT,PRSD,PRSD_SV,"2025-05-18 21:47:00",1378,787,678,109,0,777,10,1520,733,470,307
40,VÂLCEA,"FOSTA ȘCOALA CU CLASELE I-VIII OCNIŢA",157,"ORAŞ OCNELE MARI",168130,1,PART,PRCNCT,PRSD,PRSD_SV,"2025-05-18 21:36:03",1362,763,680,83,0,746,17,1500,737,434,312
40,VÂLCEA,"ȘCOALA GIMNAZIALĂ SAT COLTEȘTI",158,ALUNU,168229,1,PART,PRCNCT,PRSD,PRSD_SV,"2025-05-18 21:29:29",1260,615,571,44,0,610,5,1380,765,496,114
40,VÂLCEA,"GRĂDINIȚA COLTEȘTI - SALĂ FESTIVITĂȚI",159,ALUNU,168229,1,PART,PRCNCT,PRSD,PRSD_SV,"2025-05-18 21:29:25",421,205,158,47,0,203,2,460,255,148,55
40,VÂLCEA,"ŞCOALA GIMNAZIALĂ, COMUNA ALUNU, SAT IGOIU",160,ALUNU,168229,1,PART,PRCNCT,PRSD,PRSD_SV,"2025-05-18 21:44:59",1412,641,582,57,2,634,7,1550,909,452,182
40,VÂLCEA,"CENTRUL PENTRU SERVICII SOCIALE",161,ALUNU,168229,1,PART,PRCNCT,PRSD,PRSD_SV,"2025-05-18 21:27:40",257,125,95,30,0,124,1,280,155,85,39
40,VÂLCEA,"ŞCOALA GIMNAZIALĂ AMĂRĂŞTI",162,AMĂRĂŞTI,168309,1,PART,PRCNCT,PRSD,PRSD_SV,"2025-05-18 21:50:12",777,419,322,92,5,413,6,850,431,199,214
40,VÂLCEA,"FOSTA ŞCOALĂ NEMOIU",163,AMĂRĂŞTI,168309,1,PART,PRCNCT,PRSD,PRSD_SV,"2025-05-18 21:35:49",595,318,260,56,2,314,4,650,332,145,169
40,VÂLCEA,"FOSTA ŞCOALĂ CU CLASELE I-IV BODEŞTI",164,BĂRBĂTEŞTI,168559,1,PART,PRCNCT,PRSD,PRSD_SV,"2025-05-18 21:29:36",717,416,336,80,0,409,7,790,374,228,181
40,VÂLCEA,"SCOALA GIMNAZIALĂ BODEȘTI",165,BĂRBĂTEŞTI,168559,1,PART,PRCNCT,PRSD,PRSD_SV,"2025-05-18 21:29:19",687,449,353,96,0,443,6,760,311,245,198
40,VÂLCEA,"CĂMINUL CULTURAL BĂRBĂTEŞTI",166,BĂRBĂTEŞTI,168559,1,PART,PRCNCT,PRSD,PRSD_SV,"2025-05-18 21:28:33",1144,643,543,100,0,636,7,1260,617,339,297
40,VÂLCEA,"CĂMINUL CULTURAL STOENEŞTI",167,BERISLĂVEŞTI,168675,1,PART,PRCNCT,PRSD,PRSD_SV,"2025-05-18 21:21:22",760,435,377,58,0,430,5,848,413,256,174
40,VÂLCEA,"CĂMINUL CULTURAL DÎNGEŞTI",168,BERISLĂVEŞTI,168675,1,PART,PRCNCT,PRSD,PRSD_SV,"2025-05-18 21:11:07",240,182,134,48,0,181,1,263,81,79,102
40,VÂLCEA,"CĂMINUL CULTURAL RĂDĂCINEŞTI",169,BERISLĂVEŞTI,168675,1,PART,PRCNCT,PRSD,PRSD_SV,"2025-05-18 21:13:08",500,280,232,48,0,278,2,550,270,182,96
40,VÂLCEA,"CĂMINUL CULTURAL ROBAIA",170,BERISLĂVEŞTI,168675,1,PART,PRCNCT,PRSD,PRSD_SV,"2025-05-18 21:15:00",172,99,84,15,0,94,5,190,91,62,32
40,VÂLCEA,"ŞCOALA CU CLASELE I-IV SCĂUENI",171,BERISLĂVEŞTI,168675,1,PART,PRCNCT,PRSD,PRSD_SV,"2025-05-18 21:12:51",355,231,193,38,0,226,5,372,141,142,84
40,VÂLCEA,"ŞCOALA CU CLASELE I-VIII BOIŞOARA",172,BOIŞOARA,168755,1,PART,PRCNCT,PRSD,PRSD_SV,"2025-05-18 21:45:13",847,373,293,80,0,368,5,930,557,228,140
40,VÂLCEA,"CASA CĂSĂTORIILOR DIN CADRUL CLĂDIRII BIBLIOTECII COMUNALE",173,BUDEŞTI,168791,1,PART,PRCNCT,PRSD,PRSD_SV,"2025-05-18 21:38:44",1413,948,776,172,0,942,6,1550,602,514,428
40,VÂLCEA,"ŞCOALA PRIMARĂ SAT BARZA",174,BUDEŞTI,168791,1,PART,PRCNCT,PRSD,PRSD_SV,"2025-05-18 21:41:03",900,549,494,55,0,545,4,990,441,312,233
40,VÂLCEA,"ŞCOALA PRIMARĂ SAT BÂRSEŞTI",175,BUDEŞTI,168791,1,PART,PRCNCT,PRSD,PRSD_SV,"2025-05-18 21:57:35",772,510,446,64,0,504,6,850,340,307,197
40,VÂLCEA,"GRĂDINIȚA CU PROGRAM NORMAL SAT BERCIOIU",176,BUDEŞTI,168791,1,PART,PRCNCT,PRSD,PRSD_SV,"2025-05-18 21:35:21",310,200,167,33,0,198,2,340,140,118,80
40,VÂLCEA,"GRĂDINIȚA CU PROGRAM NORMAL SAT LINIA",177,BUDEŞTI,168791,1,PART,PRCNCT,PRSD,PRSD_SV,"2025-05-18 21:25:01",554,356,236,120,0,352,4,605,249,186,166
40,VÂLCEA,"GRĂDINIȚA CU PROGROGRAM NORMAL SAT LINIA",178,BUDEŞTI,168791,1,PART,PRCNCT,PRSD,PRSD_SV,"2025-05-18 21:43:25",915,524,474,50,0,518,6,1010,486,288,230
40,VÂLCEA,"CĂMIN CULTURAL RUDA",179,BUDEŞTI,168791,1,PART,PRCNCT,PRSD,PRSD_SV,"2025-05-18 21:16:24",459,282,228,54,0,282,0,500,218,169,113
40,VÂLCEA,"ŞCOALA CU CLASELE I-VIII OLTENI",180,BUJORENI,168880,1,PART,PRCNCT,PRSD,PRSD_SV,"2025-05-18 22:01:28",1770,1169,912,256,1,1153,16,1950,781,501,652
40,VÂLCEA,"ŞCOALA CU CLASELE I-IV BOGDĂNEŞTI",181,BUJORENI,168880,1,PART,PRCNCT,PRSD,PRSD_SV,"2025-05-18 21:24:58",663,354,304,50,0,352,2,730,376,218,134
40,VÂLCEA,"CĂMINUL CULTURAL GURA VĂII",182,BUJORENI,168880,1,PART,PRCNCT,PRSD,PRSD_SV,"2025-05-18 21:30:59",1136,596,517,78,1,591,5,1250,654,329,262
40,VÂLCEA,"GRĂDINIȚA CU PROGRAM NORMAL, SAT LUNCA-SALA DE EVENIMENTE PARTER",183,BUJORENI,168880,1,PART,PRCNCT,PRSD,PRSD_SV,"2025-05-18 21:43:02",688,334,309,24,1,329,5,760,426,242,87
40,VÂLCEA,"ŞCOALA GIMNAZIALĂ BUNEŞTI",184,BUNEŞTI,168960,1,PART,PRCNCT,PRSD,PRSD_SV,"2025-05-18 21:25:23",877,488,408,80,0,481,7,960,472,283,198
40,VÂLCEA,"ŞCOALA GIMNAZIALĂ BUNEŞTI",185,BUNEŞTI,168960,1,PART,PRCNCT,PRSD,PRSD_SV,"2025-05-18 21:24:53",833,437,401,36,0,435,2,910,473,248,187
40,VÂLCEA,"ŞCOALA TEIUŞU, COMUNA BUNEŞTI",186,BUNEŞTI,168960,1,PART,PRCNCT,PRSD,PRSD_SV,"2025-05-18 21:15:45",394,187,158,29,0,184,3,430,243,145,39
40,VÂLCEA,"ŞCOALA PRIMARĂ CÎINENII MICI",187,CÂINENI,169119,1,PART,PRCNCT,PRSD,PRSD_SV,"2025-05-18 21:32:47",471,245,207,38,0,243,2,520,275,149,94
40,VÂLCEA,"ŞCOALA GIMNAZIALĂ CÎINENII MARI",188,CÂINENI,169119,1,PART,PRCNCT,PRSD,PRSD_SV,"2025-05-18 21:30:42",605,250,195,55,0,244,6,660,410,181,63
40,VÂLCEA,"CĂMIN CULTURAL GREBLEŞTI",189,CÂINENI,169119,1,PART,PRCNCT,PRSD,PRSD_SV,"2025-05-18 21:38:50",548,324,238,86,0,321,3,600,276,209,112
40,VÂLCEA,"CĂMINUL CULTURAL ROBEȘTI",190,CÂINENI,169119,1,PART,PRCNCT,PRSD,PRSD_SV,"2025-05-18 21:31:28",163,134,76,58,0,133,1,180,46,58,75
40,VÂLCEA,"ŞCOALA CU CLASELE I-VIII ARMĂŞEŞTI",191,CERNIŞOARA,169039,1,PART,PRCNCT,PRSD,PRSD_SV,"2025-05-18 21:48:57",477,221,189,32,0,216,5,520,299,139,77
40,VÂLCEA,"ŞCOALA CU CLASELE I-VIII CERNIŞOARA",192,CERNIŞOARA,169039,1,PART,PRCNCT,PRSD,PRSD_SV,"2025-05-18 21:35:17",639,332,274,58,0,327,5,700,368,240,87
40,VÂLCEA,"ŞCOALA CU CLASELE I-IV GROŞI",193,CERNIŞOARA,169039,1,PART,PRCNCT,PRSD,PRSD_SV,"2025-05-18 21:31:47",695,380,325,55,0,373,7,760,380,263,110
40,VÂLCEA,"ŞCOALA CU CLASELE I-VIII MĂDULARI",194,CERNIŞOARA,169039,1,PART,PRCNCT,PRSD,PRSD_SV,"2025-05-18 21:34:24",517,298,244,54,0,294,4,570,272,207,87
40,VÂLCEA,"ŞCOALA CU CLASELE I-IV OBÎRŞIA",195,CERNIŞOARA,169039,1,PART,PRCNCT,PRSD,PRSD_SV,"2025-05-18 21:28:42",422,212,184,28,0,203,9,460,248,140,63
40,VÂLCEA,"GRĂDINIŢA ULMETU",196,COPĂCENI,169182,1,PART,PRCNCT,PRSD,PRSD_SV,"2025-05-18 21:39:09",1056,528,462,66,0,524,4,1160,632,357,167
40,VÂLCEA,"ȘCOALA CU CLASELE I-IV BĂLTENI",197,COPĂCENI,169182,1,PART,PRCNCT,PRSD,PRSD_SV,"2025-05-18 21:42:59",284,161,141,20,0,160,1,310,149,113,47
40,VÂLCEA,"ȘCOALA CU CLASELE I-VIII - HOTĂRASA",198,COPĂCENI,169182,1,PART,PRCNCT,PRSD,PRSD_SV,"2025-05-18 21:36:35",279,178,144,34,0,176,2,310,132,124,52
40,VÂLCEA,"ŞCOALA CU CLASELE I-IV VEŢELU",199,COPĂCENI,169182,1,PART,PRCNCT,PRSD,PRSD_SV,"2025-05-18 21:36:01",421,254,207,47,0,252,2,460,206,177,75
40,VÂLCEA,"ŞCOALA CU CLASELE I-VIII COSTEŞTI",200,COSTEŞTI,169253,1,PART,PRCNCT,PRSD,PRSD_SV,"2025-05-18 21:55:28",1492,897,753,137,7,890,7,1640,743,481,409
40,VÂLCEA,"ŞCOALA CU CLASELE I-IV BISTRIŢA",201,COSTEŞTI,169253,1,PART,PRCNCT,PRSD,PRSD_SV,"2025-05-18 21:40:45",667,375,307,59,9,365,10,730,355,265,100
40,VÂLCEA,"ŞCOALA CU CLASELE I-IV PIETRENI",202,COSTEŞTI,169253,1,PART,PRCNCT,PRSD,PRSD_SV,"2025-05-18 21:19:17",398,256,204,51,1,254,2,440,184,151,103
40,VÂLCEA,"ȘCOALA GIMNAZIALĂ CREȚENI",203,CREŢENI,169306,1,PART,PRCNCT,PRSD,PRSD_SV,"2025-05-18 21:33:47",829,479,389,82,8,471,8,910,431,249,222
40,VÂLCEA,"GRĂDINIȚA CU PROGRAM NORMAL IZVORU",204,CREŢENI,169306,1,PART,PRCNCT,PRSD,PRSD_SV,"2025-05-18 21:28:57",429,278,210,67,1,275,3,470,192,147,128
40,VÂLCEA,"GRĂDINIȚA CU PROGRAM NORMAL STREMINOASA",205,CREŢENI,169306,1,PART,PRCNCT,PRSD,PRSD_SV,"2025-05-18 21:27:59",456,265,218,45,2,258,7,500,235,157,101
40,VÂLCEA,"ŞCOALA DĂEŞTI",206,DĂEŞTI,169351,1,PART,PRCNCT,PRSD,PRSD_SV,"2025-05-18 21:32:21",805,555,445,103,7,553,2,880,325,256,297
40,VÂLCEA,"ŞCOALA BĂBUEŞTI",207,DĂEŞTI,169351,1,PART,PRCNCT,PRSD,PRSD_SV,"2025-05-18 21:12:18",67,49,30,19,0,48,1,70,21,26,22
40,VÂLCEA,"ŞCOALA FEDELEŞOIU",208,DĂEŞTI,169351,1,PART,PRCNCT,PRSD,PRSD_SV,"2025-05-18 21:49:56",875,567,478,88,1,558,9,960,393,293,265
40,VÂLCEA,"CAMINUL CULTURAL DĂEŞTI",209,DĂEŞTI,169351,1,PART,PRCNCT,PRSD,PRSD_SV,"2025-05-18 21:19:46",737,442,384,58,0,439,3,810,368,264,175
40,VÂLCEA,"ȘCOALA PRIMARĂ CERETU",210,DĂNICEI,169404,1,PART,PRCNCT,PRSD,PRSD_SV,"2025-05-18 21:28:25",287,166,136,30,0,165,1,320,154,123,42
40,VÂLCEA,"ŞCOALA PRIMARĂ DEALU SCHEIULUI",211,DĂNICEI,169404,1,PART,PRCNCT,PRSD,PRSD_SV,"2025-05-18 21:24:02",193,161,105,56,0,160,1,210,49,116,44
40,VÂLCEA,"ŞCOALA GIMNAZIALĂ LĂUNELE DE JOS",212,DĂNICEI,169404,1,PART,PRCNCT,PRSD,PRSD_SV,"2025-05-18 21:15:14",328,212,148,64,0,211,1,360,148,132,79
40,VÂLCEA,"ŞCOALA GIMNAZIALĂ UDREŞTI",213,DĂNICEI,169404,1,PART,PRCNCT,PRSD,PRSD_SV,"2025-05-18 21:19:59",733,437,335,102,0,434,3,800,363,280,154
40,VÂLCEA,"ŞCOALA CU CLASELE I-VIII BĂBENI-OLTEŢU",214,DICULEŞTI,174502,1,PART,PRCNCT,PRSD,PRSD_SV,"2025-05-18 21:31:47",873,404,359,45,0,397,7,960,556,283,114
40,VÂLCEA,"ŞCOALA CU CLASELE I-IV BUDEŞTI",215,DICULEŞTI,174502,1,PART,PRCNCT,PRSD,PRSD_SV,"2025-05-18 21:46:45",624,327,287,40,0,324,3,690,363,215,109
40,VÂLCEA,"ŞCOALA CU CLASELE I-VIII DRĂGOEŞTI",216,DRĂGOEŞTI,169547,1,PART,PRCNCT,PRSD,PRSD_SV,"2025-05-18 21:38:32",565,343,259,84,0,340,3,620,277,198,142
40,VÂLCEA,"ȘCOALA CU CLASELE I- IV GEAMĂNA- BUCIUMENI",217,DRĂGOEŞTI,169547,1,PART,PRCNCT,PRSD,PRSD_SV,"2025-05-18 21:34:12",518,305,244,61,0,302,3,570,265,194,108
40,VÂLCEA,"ŞCOALA CU CLASELE I-IV BONCANI",218,DRĂGOEŞTI,169547,1,PART,PRCNCT,PRSD,PRSD_SV,"2025-05-18 21:18:57",418,241,184,57,0,240,1,460,219,137,103
40,VÂLCEA,"GRĂDINIŢA MILEŞTI",219,FĂUREŞTI,169583,1,PART,PRCNCT,PRSD,PRSD_SV,"2025-05-18 21:31:43",493,245,216,29,0,242,3,540,295,153,89
40,VÂLCEA,"ŞCOALA GIMNAZIALĂ FĂUREŞTI",220,FĂUREŞTI,169583,1,PART,PRCNCT,PRSD,PRSD_SV,"2025-05-18 21:35:29",639,350,299,50,1,349,1,700,350,198,151
40,VÂLCEA,"CĂMIN CULTURAL FÂRTĂŢEŞTI",221,FÂRTĂŢEŞTI,169681,1,PART,PRCNCT,PRSD,PRSD_SV,"2025-05-18 21:24:21",318,213,170,43,0,212,1,350,137,102,110
40,VÂLCEA,"CENTRUL DE ÎNGRIJIRE ȘI ASISTENȚĂ PENTRU PERSOANE VARSTNICE",222,FÂRTĂŢEŞTI,169681,1,PART,PRCNCT,PRSD,PRSD_SV,"2025-05-18 21:17:12",346,166,139,27,0,165,1,380,214,105,60
40,VÂLCEA,"ŞCOALA CU CLASELE I-IV DOZEŞTI",223,FÂRTĂŢEŞTI,169681,1,PART,PRCNCT,PRSD,PRSD_SV,"2025-05-18 21:20:42",930,450,349,100,1,448,2,1020,570,275,173
40,VÂLCEA,"ŞCOALA CU CLASELE I-VIII RUSĂNEŞTI",224,FÂRTĂŢEŞTI,169681,1,PART,PRCNCT,PRSD,PRSD_SV,"2025-05-18 21:18:52",686,355,292,62,1,352,3,750,395,232,120
40,VÂLCEA,"FOSTA ȘCOALA CU CLASELE I-IV GIULEȘTII DE SUS",225,FÂRTĂŢEŞTI,169681,1,PART,PRCNCT,PRSD,PRSD_SV,"2025-05-18 21:17:23",248,156,127,29,0,154,2,270,114,113,41
40,VÂLCEA,"CĂMIN CULTURAL ȘOTANI",226,FÂRTĂŢEŞTI,169681,1,PART,PRCNCT,PRSD,PRSD_SV,"2025-05-18 21:13:56",346,251,169,81,1,251,0,380,129,130,121
40,VÂLCEA,"ŞCOALA CU CLASELE I-VIII FRÎNCEŞTI",227,FRÂNCEŞTI,169896,1,PART,PRCNCT,PRSD,PRSD_SV,"2025-05-18 21:39:53",576,294,257,37,0,292,2,630,336,176,116
40,VÂLCEA,"ŞCOALA GENERALĂ CU CLASELE I-IV COŞANI",228,FRÂNCEŞTI,169896,1,PART,PRCNCT,PRSD,PRSD_SV,"2025-05-18 22:06:29",1106,374,328,46,0,371,3,1210,836,282,89
40,VÂLCEA,"GRĂDINIŢA DEZROBIŢI",229,FRÂNCEŞTI,169896,1,PART,PRCNCT,PRSD,PRSD_SV,"2025-05-18 21:34:50",543,296,263,33,0,290,6,600,304,211,79
40,VÂLCEA,"GRĂDINIŢA NEGRENI",230,FRÂNCEŞTI,169896,1,PART,PRCNCT,PRSD,PRSD_SV,"2025-05-18 21:36:09",358,209,177,32,0,205,4,392,183,136,69
40,VÂLCEA,"ȘCOALA GENERALĂ CU CLASELE I-VIII GENUNENI",231,FRÂNCEŞTI,169896,1,PART,PRCNCT,PRSD,PRSD_SV,"2025-05-18 21:41:22",599,340,276,64,0,340,0,660,320,203,137
40,VÂLCEA,"ŞCOALA GENERALĂ CU CLASELE I-IV SURPATE",232,FRÂNCEŞTI,169896,1,PART,PRCNCT,PRSD,PRSD_SV,"2025-05-18 21:42:48",633,311,266,45,0,306,5,700,389,174,132
40,VÂLCEA,"GRĂDINIŢA VIIŞOARA",233,FRÂNCEŞTI,169896,1,PART,PRCNCT,PRSD,PRSD_SV,"2025-05-18 21:17:53",218,154,128,26,0,153,1,240,86,105,48
40,VÂLCEA,"CĂMINUL CULTURAL GALICEA",234,GALICEA,169994,1,PART,PRCNCT,PRSD,PRSD_SV,"2025-05-18 22:04:55",897,507,431,75,1,506,1,980,473,286,220
40,VÂLCEA,"ŞCOALA BRATIA DIN DEAL",235,GALICEA,169994,1,PART,PRCNCT,PRSD,PRSD_SV,"2025-05-18 21:35:11",299,194,168,26,0,191,3,330,136,132,59
40,VÂLCEA,"ŞCOALA BRATIA DIN VALE",236,GALICEA,169994,1,PART,PRCNCT,PRSD,PRSD_SV,"2025-05-18 21:28:32",342,214,180,34,0,211,3,380,166,116,95
40,VÂLCEA,"ŞCOALA COCORU",237,GALICEA,169994,1,PART,PRCNCT,PRSD,PRSD_SV,"2025-05-18 21:19:40",500,264,205,59,0,261,3,550,286,150,111
40,VÂLCEA,"CĂMINUL CULTURAL CREMENARI",238,GALICEA,169994,1,PART,PRCNCT,PRSD,PRSD_SV,"2025-05-18 21:21:59",316,217,172,45,0,214,3,350,133,116,98
40,VÂLCEA,"ŞCOALA TEIU",239,GALICEA,169994,1,PART,PRCNCT,PRSD,PRSD_SV,"2025-05-18 21:12:23",333,193,154,39,0,188,5,370,177,105,83
40,VÂLCEA,"ŞCOALA VALEA RÎULUI",240,GALICEA,169994,1,PART,PRCNCT,PRSD,PRSD_SV,"2025-05-18 21:26:35",337,237,196,41,0,235,2,370,133,135,100
40,VÂLCEA,"CĂMINUL CULTURAL GHIOROIU",241,GHIOROIU,170097,1,PART,PRCNCT,PRSD,PRSD_SV,"2025-05-18 21:44:34",441,255,177,74,4,254,1,480,225,160,94
40,VÂLCEA,"ŞCOALA POIENARI",242,GHIOROIU,170097,1,PART,PRCNCT,PRSD,PRSD_SV,"2025-05-18 21:18:59",224,132,97,33,2,132,0,250,118,80,52
40,VÂLCEA,"ŞCOALA ŞTIRBEŞTI",243,GHIOROIU,170097,1,PART,PRCNCT,PRSD,PRSD_SV,"2025-05-18 21:46:36",413,259,176,81,2,258,1,450,191,142,116
40,VÂLCEA,"ŞCOALA GIMNAZIALĂ ”BARTOLOMEU VALERIU ANANIA”GLĂVILE",244,GLĂVILE,170168,1,PART,PRCNCT,PRSD,PRSD_SV,"2025-05-18 21:35:57",762,358,303,52,3,356,2,840,482,208,148
40,VÂLCEA,"ŞCOALA PRIMARĂ ANINOASA",245,GLĂVILE,170168,1,PART,PRCNCT,PRSD,PRSD_SV,"2025-05-18 21:35:13",111,95,61,34,0,93,2,119,24,47,46
40,VÂLCEA,"ŞCOALA PRIMARĂ OLTEANCA",246,GLĂVILE,170168,1,PART,PRCNCT,PRSD,PRSD_SV,"2025-05-18 21:28:11",505,322,224,94,4,320,2,560,238,176,144
40,VÂLCEA,"CĂMINUL CULTURAL POPEŞTI",247,GOLEŞTI,170220,1,PART,PRCNCT,PRSD,PRSD_SV,"2025-05-18 21:15:25",758,456,382,73,1,450,6,840,384,263,187
40,VÂLCEA,"CĂMINUL CULTURAL BLIDARI",248,GOLEŞTI,170220,1,PART,PRCNCT,PRSD,PRSD_SV,"2025-05-18 22:11:24",854,508,452,56,0,502,6,940,432,289,213
40,VÂLCEA,"ŞCOALA POENIŢA",249,GOLEŞTI,170220,1,PART,PRCNCT,PRSD,PRSD_SV,"2025-05-18 21:31:11",292,181,129,52,0,180,1,320,139,108,72
40,VÂLCEA,"ŞCOALA VĂTĂŞEŞTI",250,GOLEŞTI,170220,1,PART,PRCNCT,PRSD,PRSD_SV,"2025-05-18 21:12:27",195,123,96,27,0,122,1,220,97,79,43
40,VÂLCEA,"SALA DE SPORT DE LA LICEUL TEORETIC GRĂDIŞTEA",251,GRĂDIŞTEA,170346,1,PART,PRCNCT,PRSD,PRSD_SV,"2025-05-18 21:29:30",336,203,149,51,3,201,2,368,165,89,112
40,VÂLCEA,"ȘCOALA CU CLASELE I-VIII DOBRICEA",252,GRĂDIŞTEA,170346,1,PART,PRCNCT,PRSD,PRSD_SV,"2025-05-18 21:57:24",588,300,251,46,3,296,4,650,350,173,123
40,VÂLCEA,"GRĂDINIŢA CU PROGRAM NORMAL ŢUŢURU",253,GRĂDIŞTEA,170346,1,PART,PRCNCT,PRSD,PRSD_SV,"2025-05-18 21:46:41",944,520,432,79,9,516,4,1040,520,310,206
40,VÂLCEA,"ŞCOALA CU CLASELE I-IV VALEA GRĂDIŞTEA",254,GRĂDIŞTEA,170346,1,PART,PRCNCT,PRSD,PRSD_SV,"2025-05-18 21:14:47",102,85,53,30,2,85,0,108,23,45,40
40,VÂLCEA,"CĂMINUL CULTURAL GUŞOIANCA",255,GUŞOENI,170444,1,PART,PRCNCT,PRSD,PRSD_SV,"2025-05-18 21:24:40",390,257,200,42,15,252,5,430,173,132,120
40,VÂLCEA,"ŞCOALA GIMNAZIALĂ GUŞOENI",256,GUŞOENI,170444,1,PART,PRCNCT,PRSD,PRSD_SV,"2025-05-18 21:43:16",634,366,288,67,11,362,4,700,334,185,177
40,VÂLCEA,"ŞCOALA IONEŞTII GOVORII",257,IONEŞTI,170514,1,PART,PRCNCT,PRSD,PRSD_SV,"2025-05-18 21:49:22",1060,558,472,86,0,554,4,1160,602,367,187
40,VÂLCEA,"ŞCOALA FIŞCĂLIA",258,IONEŞTI,170514,1,PART,PRCNCT,PRSD,PRSD_SV,"2025-05-18 21:16:18",782,389,331,58,0,384,5,860,471,243,141
40,VÂLCEA,"ŞCOALA FOTEŞTI",259,IONEŞTI,170514,1,PART,PRCNCT,PRSD,PRSD_SV,"2025-05-18 21:32:01",657,322,287,35,0,318,4,720,398,222,96
40,VÂLCEA,"ŞCOALA MARCEA",260,IONEŞTI,170514,1,PART,PRCNCT,PRSD,PRSD_SV,"2025-05-18 21:20:22",646,391,305,86,0,385,6,710,319,227,158
40,VÂLCEA,"ŞCOALA PRIMARĂ LALOŞU",261,LALOŞU,170612,1,PART,PRCNCT,PRSD,PRSD_SV,"2025-05-18 21:34:05",846,279,251,27,1,274,5,930,651,210,64
40,VÂLCEA,"ŞCOALA PRIMARĂ BERBEŞTI",262,LALOŞU,170612,1,PART,PRCNCT,PRSD,PRSD_SV,"2025-05-18 21:22:19",358,175,152,23,0,173,2,390,215,109,64
40,VÂLCEA,"ŞCOALA GIMNAZIALĂ MOLOGEŞTI",263,LALOŞU,170612,2,PART,PRCNCT,PRSD,PRSD_SV,"2025-05-19 01:36:28",516,244,206,38,0,243,1,570,326,182,61
40,VÂLCEA,"ŞCOALA PRIMARĂ OLTEŢANI",264,LALOŞU,170612,1,PART,PRCNCT,PRSD,PRSD_SV,"2025-05-18 21:20:29",187,126,97,29,0,125,1,208,82,93,32
40,VÂLCEA,"ŞCOALA CU CLASELE V-VIII LĂCUSTENI",265,LĂCUSTENI,174511,1,PART,PRCNCT,PRSD,PRSD_SV,"2025-05-18 21:13:16",244,162,123,39,0,161,1,270,108,100,61
40,VÂLCEA,"ŞCOALA CU CLASELE I-IV GĂNEŞTI",266,LĂCUSTENI,174511,1,PART,PRCNCT,PRSD,PRSD_SV,"2025-05-18 21:19:18",430,199,177,22,0,195,4,470,271,129,66
40,VÂLCEA,"ŞCOALA CU CLASELE I-IV LĂCUSTENI",267,LĂCUSTENI,174511,1,PART,PRCNCT,PRSD,PRSD_SV,"2025-05-18 21:24:44",403,233,192,41,0,229,4,440,207,129,100
40,VÂLCEA,"LICEUL TEORETIC VIRGIL IERUNCA LĂDEȘTI",268,LĂDEŞTI,170685,1,PART,PRCNCT,PRSD,PRSD_SV,"2025-05-18 22:08:08",686,467,302,142,23,461,6,750,283,259,202
40,VÂLCEA,"ȘCOALA PRIMARĂ CHIRICEȘTI",269,LĂDEŞTI,170685,1,PART,PRCNCT,PRSD,PRSD_SV,"2025-05-18 21:39:38",352,232,167,65,0,228,4,390,158,145,83
40,VÂLCEA,"ȘCOALA PRIMARĂ GĂGENI",270,LĂDEŞTI,170685,1,PART,PRCNCT,PRSD,PRSD_SV,"2025-05-18 21:31:53",179,129,92,37,0,128,1,198,69,68,60
40,VÂLCEA,"ȘCOALA PRIMARĂ OLTEANCA",271,LĂDEŞTI,170685,1,PART,PRCNCT,PRSD,PRSD_SV,"2025-05-18 21:30:07",74,61,31,30,0,60,1,80,19,39,21
40,VÂLCEA,"ŞCOALA GIMNAZIALĂ SĂRULEŞTI",272,LĂPUŞATA,170792,1,PART,PRCNCT,PRSD,PRSD_SV,"2025-05-18 21:47:11",1039,646,498,148,0,644,2,1140,494,408,236
40,VÂLCEA,"ŞCOALA PRIMARĂ BROŞTENI",273,LĂPUŞATA,170792,1,PART,PRCNCT,PRSD,PRSD_SV,"2025-05-18 21:30:28",526,287,227,60,0,286,1,580,293,187,99
40,VÂLCEA,"CLĂDIRE ȘCOALĂ I-IV TINA",274,LIVEZI,170872,1,PART,PRCNCT,PRSD,PRSD_SV,"2025-05-18 21:32:25",528,281,227,52,2,281,0,580,299,176,105
40,VÂLCEA,"CLĂDIRE GRĂDINIȚĂ PÎRÎIENII DE JOS",275,LIVEZI,170872,1,PART,PRCNCT,PRSD,PRSD_SV,"2025-05-18 21:27:17",869,444,380,63,1,443,1,960,516,325,118
40,VÂLCEA,"ŞCOALA CU CLASELE I-IV PLEŞOIU",276,LIVEZI,170872,1,PART,PRCNCT,PRSD,PRSD_SV,"2025-05-18 21:22:11",265,185,138,39,8,185,0,290,105,108,77
40,VÂLCEA,"ŞCOALA LUNGEŞTI",277,LUNGEŞTI,170952,1,PART,PRCNCT,PRSD,PRSD_SV,"2025-05-18 21:26:11",786,370,276,78,16,364,6,870,500,161,203
40,VÂLCEA,"ŞCOALA CU CLASELE I-IV DUMBRAVA",278,LUNGEŞTI,170952,1,PART,PRCNCT,PRSD,PRSD_SV,"2025-05-18 21:24:20",291,154,114,38,2,152,2,320,166,94,58
40,VÂLCEA,"CĂMINUL CULTURAL FUMURENI",279,LUNGEŞTI,170952,1,PART,PRCNCT,PRSD,PRSD_SV,"2025-05-18 21:27:31",481,249,191,56,2,245,4,530,281,140,105
40,VÂLCEA,"ŞCOALA CU CLASELE I-IV STĂNEŞTI-LUNCA",280,LUNGEŞTI,170952,1,PART,PRCNCT,PRSD,PRSD_SV,"2025-05-18 21:33:53",744,378,328,42,8,375,3,820,442,196,179
40,VÂLCEA,"ŞCOALA GIMNAZIALĂ MALAIA",281,MALAIA,171021,1,PART,PRCNCT,PRSD,PRSD_SV,"2025-05-18 22:16:14",867,581,465,116,0,570,11,950,369,345,225
40,VÂLCEA,"ŞCOALA PRIMARĂ CIUNGET",282,MALAIA,171021,1,PART,PRCNCT,PRSD,PRSD_SV,"2025-05-18 21:45:30",363,246,193,52,1,245,1,400,154,127,118
40,VÂLCEA,"GRĂDINIŢA CU PROGRAM NORMAL SĂLIŞTE",283,MALAIA,171021,1,PART,PRCNCT,PRSD,PRSD_SV,"2025-05-18 21:21:22",228,202,142,60,0,198,4,250,48,107,91
40,VÂLCEA,"ŞCOALA GIMNAZIALĂ MATEEŞTI",284,MATEEŞTI,171067,1,PART,PRCNCT,PRSD,PRSD_SV,"2025-05-18 21:28:40",1063,568,498,69,1,564,4,1170,602,333,231
40,VÂLCEA,"GRĂDINIŢA GRECI",285,MATEEŞTI,171067,1,PART,PRCNCT,PRSD,PRSD_SV,"2025-05-18 21:32:07",445,260,217,43,0,257,3,490,230,146,111
40,VÂLCEA,"ŞCOALA GIMNAZIALĂ TURCEŞTI",286,MATEEŞTI,171067,1,PART,PRCNCT,PRSD,PRSD_SV,"2025-05-18 21:48:05",1004,526,456,70,0,522,4,1100,574,348,174
40,VÂLCEA,"LICEUL TEORETIC",287,MĂCIUCA,171101,1,PART,PRCNCT,PRSD,PRSD_SV,"2025-05-18 21:35:31",678,464,319,139,6,459,5,750,286,231,228
40,VÂLCEA,"ŞCOALA GENERALĂ POPEŞTI, COMUNA MĂCIUCA, SATUL POPEŞTI",288,MĂCIUCA,171101,1,PART,PRCNCT,PRSD,PRSD_SV,"2025-05-18 21:21:20",334,218,172,46,0,211,7,370,152,121,90
40,VÂLCEA,"ȘCOALA CU CLASELE I-IV ZĂVOIENI",289,MĂCIUCA,171101,1,PART,PRCNCT,PRSD,PRSD_SV,"2025-05-18 21:22:32",240,173,130,42,1,173,0,260,87,84,89
40,VÂLCEA,"ȘCOALA CU CLASELE . I-VIII MĂDULARI",290,MĂDULARI,171209,2,PART,PRCNCT,PRSD,PRSD_SV,"2025-05-19 01:02:58",554,355,290,62,3,350,5,606,251,179,171
40,VÂLCEA,"ŞCOALA CU CLASELE I-IV BĂLŞOARA",291,MĂDULARI,171209,1,PART,PRCNCT,PRSD,PRSD_SV,"2025-05-18 21:20:58",194,125,83,40,2,124,1,210,85,72,52
40,VÂLCEA,"ȘCOALA CU CLASELE. I-IV BĂNȚEȘTI",292,MĂDULARI,171209,1,PART,PRCNCT,PRSD,PRSD_SV,"2025-05-18 21:30:38",237,127,103,24,0,123,4,258,131,75,48
40,VÂLCEA,"ŞCOALA VECHE MĂLDĂREŞTI",293,MĂLDĂREŞTI,171272,1,PART,PRCNCT,PRSD,PRSD_SV,"2025-05-18 22:10:32",1422,808,688,118,2,804,4,1560,752,454,350
40,VÂLCEA,"ŞCOALA TELECHEŞTI",294,MĂLDĂREŞTI,171272,1,PART,PRCNCT,PRSD,PRSD_SV,"2025-05-18 21:24:53",132,98,67,31,0,98,0,140,42,71,27
40,VÂLCEA,"GRĂDINIȚA BULETA",295,MIHĂEŞTI,171325,1,PART,PRCNCT,PRSD,PRSD_SV,"2025-05-18 22:06:22",1270,754,625,129,0,749,5,1390,636,427,322
40,VÂLCEA,"ŞCOALA CU CLASELE I-IV BÎRSEŞTI",296,MIHĂEŞTI,171325,1,PART,PRCNCT,PRSD,PRSD_SV,"2025-05-18 22:11:06",705,380,317,61,2,377,3,777,397,241,136
40,VÂLCEA,"ȘCOALA GENERALĂ",297,MIHĂEŞTI,171325,1,PART,PRCNCT,PRSD,PRSD_SV,"2025-05-18 21:18:16",779,474,399,75,0,470,4,860,386,286,184
40,VÂLCEA,"CĂMINUL CULTURAL MĂGURA",298,MIHĂEŞTI,171325,1,PART,PRCNCT,PRSD,PRSD_SV,"2025-05-18 21:44:27",763,499,398,101,0,490,9,840,341,274,216
40,VÂLCEA,"GRĂDINIȚA MIHĂEȘTI",299,MIHĂEŞTI,171325,1,PART,PRCNCT,PRSD,PRSD_SV,"2025-05-18 21:39:00",933,571,472,45,54,558,13,1030,459,368,190
40,VÂLCEA,"GRĂDINIŢA STUPĂREI",300,MIHĂEŞTI,171325,1,PART,PRCNCT,PRSD,PRSD_SV,"2025-05-18 21:31:47",771,411,335,76,0,405,6,850,439,294,111
40,VÂLCEA,"CĂMINUL CULTURAL VULPUEŞTI",301,MIHĂEŞTI,171325,1,PART,PRCNCT,PRSD,PRSD_SV,"2025-05-18 21:41:54",613,327,294,33,0,324,3,670,343,230,94
40,VÂLCEA,"PRIMĂRIA MILCOIU",302,MILCOIU,171469,1,PART,PRCNCT,PRSD,PRSD_SV,"2025-05-18 21:34:31",287,189,148,41,0,185,4,320,131,89,96
40,VÂLCEA,"ANEXĂ PRIMĂRIE",303,MILCOIU,171469,1,PART,PRCNCT,PRSD,PRSD_SV,"2025-05-18 21:25:04",244,154,87,39,28,151,3,270,116,73,78
40,VÂLCEA,"GRĂDINIŢA IZBĂŞEŞTI",304,MILCOIU,171469,1,PART,PRCNCT,PRSD,PRSD_SV,"2025-05-18 21:26:37",169,129,82,47,0,125,4,190,61,80,45
40,VÂLCEA,"CENTRUL CULTURAL TEPŞENARI",305,MILCOIU,171469,1,PART,PRCNCT,PRSD,PRSD_SV,"2025-05-18 21:25:36",310,261,179,82,0,257,4,340,79,147,110
40,VÂLCEA,"SCOALA GIMNAZIALĂ COMUNA MITROFANI",306,MITROFANI,174520,1,PART,PRCNCT,PRSD,PRSD_SV,"2025-05-18 21:28:08",501,245,207,36,2,243,2,550,305,130,113
40,VÂLCEA,"FOSTA ŞCOALÃ RACU",307,MITROFANI,174520,1,PART,PRCNCT,PRSD,PRSD_SV,"2025-05-18 21:29:56",211,116,87,28,1,116,0,230,114,63,53
40,VÂLCEA,"ŞCOALA MUEREASCA DE JOS",308,MUEREASCA,171539,1,PART,PRCNCT,PRSD,PRSD_SV,"2025-05-18 21:37:08",905,431,379,52,0,425,6,990,559,282,143
40,VÂLCEA,"ŞCOALA MUEREASCA DE SUS",309,MUEREASCA,171539,1,PART,PRCNCT,PRSD,PRSD_SV,"2025-05-18 21:50:23",1117,527,474,52,1,521,6,1230,703,329,192
40,VÂLCEA,"ŞCOALA CU CLASELE I-VIII ROTĂRĂŞTI",310,"NICOLAE BĂLCESCU",171628,1,PART,PRCNCT,PRSD,PRSD_SV,"2025-05-18 21:35:26",873,541,406,135,0,536,5,960,419,309,227
40,VÂLCEA,"ŞCOALA CU CLASELE I-IV CORBI",311,"NICOLAE BĂLCESCU",171628,1,PART,PRCNCT,PRSD,PRSD_SV,"2025-05-18 21:13:43",307,220,149,71,0,219,1,340,120,131,88
40,VÂLCEA,"ŞCOALA CU CLASELE I-IV GÂLTOFANI",312,"NICOLAE BĂLCESCU",171628,1,PART,PRCNCT,PRSD,PRSD_SV,"2025-05-18 21:18:00",126,106,64,42,0,105,1,140,34,59,46
40,VÂLCEA,"ŞCOALA CU CLASELE I-IV ŞERBĂNEASA",313,"NICOLAE BĂLCESCU",171628,1,PART,PRCNCT,PRSD,PRSD_SV,"2025-05-18 21:40:50",696,365,325,40,0,362,3,760,395,203,159
40,VÂLCEA,"CAMIN CULTURAL",314,"NICOLAE BĂLCESCU",171628,1,PART,PRCNCT,PRSD,PRSD_SV,"2025-05-18 21:21:26",656,370,295,75,0,363,7,720,350,184,179
40,VÂLCEA,"ŞCOALA CU CLASELE I-IV PERETU",315,OLANU,171806,1,PART,PRCNCT,PRSD,PRSD_SV,"2025-05-18 21:27:27",441,242,202,40,0,242,0,490,248,108,134
40,VÂLCEA,"ŞCOALA CU CLASELE.I-IV CASA VECHE",316,OLANU,171806,1,PART,PRCNCT,PRSD,PRSD_SV,"2025-05-18 21:28:33",517,315,245,70,0,312,3,570,255,196,116
40,VÂLCEA,"ŞCOALA CU CLASELE I-IV CIOBOŢI",317,OLANU,171806,1,PART,PRCNCT,PRSD,PRSD_SV,"2025-05-18 21:48:16",556,296,251,45,0,285,11,610,314,179,106
40,VÂLCEA,"ŞCOALA CU CLASELE I-IV DRĂGIOIU",318,OLANU,171806,1,PART,PRCNCT,PRSD,PRSD_SV,"2025-05-18 21:13:53",441,286,229,57,0,284,2,480,194,169,115
40,VÂLCEA,"ŞCOALA CU CLASELE I-IV STOICĂNEŞTI",319,OLANU,171806,1,PART,PRCNCT,PRSD,PRSD_SV,"2025-05-18 21:31:42",316,226,172,54,0,222,4,350,124,141,81
40,VÂLCEA,"CĂMIN CULTURAL(FOSTUL CĂMIN CULTURAL DIN CURTEA PRIMĂRIEI)",320,ORLEŞTI,171879,1,PART,PRCNCT,PRSD,PRSD_SV,"2025-05-18 22:12:33",1386,870,682,144,44,853,17,1520,650,428,425
40,VÂLCEA,"GRĂDINIŢA SILEA",321,ORLEŞTI,171879,1,PART,PRCNCT,PRSD,PRSD_SV,"2025-05-18 21:58:54",814,548,422,116,10,542,6,890,342,316,226
40,VÂLCEA,"CĂMINUL CULTURAL OTEŞANI",322,OTEŞANI,171931,1,PART,PRCNCT,PRSD,PRSD_SV,"2025-05-18 21:46:02",992,504,446,55,3,499,5,1090,586,380,119
40,VÂLCEA,"ŞCOALA CÎRSTĂNEŞTI",323,OTEŞANI,171931,1,PART,PRCNCT,PRSD,PRSD_SV,"2025-05-18 21:22:25",1037,543,465,75,3,541,2,1140,597,351,190
40,VÂLCEA,"CĂMINUL CULTURAL PĂUŞEŞTI",324,PĂUŞEŞTI,171995,1,PART,PRCNCT,PRSD,PRSD_SV,"2025-05-18 21:30:33",682,450,367,83,0,446,4,750,300,254,192
40,VÂLCEA,"ŞCOALA PRIMARĂ BARCANELE",325,PĂUŞEŞTI,171995,1,PART,PRCNCT,PRSD,PRSD_SV,"2025-05-18 21:31:12",461,271,220,51,0,266,5,507,236,164,102
40,VÂLCEA,"ŞCOALA GIMNAZIALĂ ŞERBĂNEŞTI",326,PĂUŞEŞTI,171995,1,PART,PRCNCT,PRSD,PRSD_SV,"2025-05-18 21:18:04",363,209,186,23,0,206,3,400,191,144,62
40,VÂLCEA,"CĂMINUL CULTURAL ŞERBĂNEŞTI",327,PĂUŞEŞTI,171995,1,PART,PRCNCT,PRSD,PRSD_SV,"2025-05-18 21:17:37",480,290,236,54,0,286,4,530,240,170,116
40,VÂLCEA,"ŞCOALA GIMNAZIALĂ ACHIM POPESCU",328,PĂUŞEŞTI-MĂGLAŞI,172082,1,PART,PRCNCT,PRSD,PRSD_SV,"2025-05-18 21:31:43",1123,705,600,104,1,692,13,1230,525,388,304
40,VÂLCEA,"ŞCOALA GIMNAZIALĂ ACHIM POPESCU",329,PĂUŞEŞTI-MĂGLAŞI,172082,1,PART,PRCNCT,PRSD,PRSD_SV,"2025-05-18 21:37:51",1314,810,702,108,0,795,15,1440,630,434,361
40,VÂLCEA,"ŞCOALA PRIMARĂ VALEA CHEII",330,PĂUŞEŞTI-MĂGLAŞI,172082,1,PART,PRCNCT,PRSD,PRSD_SV,"2025-05-18 21:30:59",890,430,381,49,0,426,4,980,550,259,167
40,VÂLCEA,"CĂMINUL CULTURAL PERIŞANI",331,PERIŞANI,172153,1,PART,PRCNCT,PRSD,PRSD_SV,"2025-05-18 21:18:39",437,281,223,58,0,280,1,480,199,146,134
40,VÂLCEA,"CĂMINUL CULTURAL MLĂCENI",332,PERIŞANI,172153,1,PART,PRCNCT,PRSD,PRSD_SV,"2025-05-18 21:18:41",407,256,206,50,0,252,4,450,194,145,107
40,VÂLCEA,"ŞCOALA PODENI",333,PERIŞANI,172153,1,PART,PRCNCT,PRSD,PRSD_SV,"2025-05-18 21:21:46",51,36,23,13,0,36,0,60,24,25,11
40,VÂLCEA,"ŞCOALA CU CLASELE I-VIII POIANA",334,PERIŞANI,172153,1,PART,PRCNCT,PRSD,PRSD_SV,"2025-05-18 21:22:29",473,228,206,22,0,223,5,520,292,125,98
40,VÂLCEA,"CĂMINUL CULTURAL SPINU",335,PERIŞANI,172153,1,PART,PRCNCT,PRSD,PRSD_SV,"2025-05-18 21:13:45",268,141,117,24,0,136,5,300,159,88,48
40,VÂLCEA,"ŞCOALA GIMNAZIALĂ CU CLASELE I-VIII PESCEANA",336,PESCEANA,172279,1,PART,PRCNCT,PRSD,PRSD_SV,"2025-05-18 21:32:31",1171,620,508,112,0,613,7,1290,670,400,213
40,VÂLCEA,"ŞCOALĂ GIMNAZIALĂ PIETRARI",337,PIETRARI,172340,2,PART,PRCNCT,PRSD,PRSD_SV,"2025-05-19 01:16:58",1291,790,645,145,0,778,12,1420,630,471,307
40,VÂLCEA,"ŞCOALA PRIMARĂ PIETRARII DE SUS",338,PIETRARI,172340,1,PART,PRCNCT,PRSD,PRSD_SV,"2025-05-18 22:15:11",1076,578,524,52,2,569,9,1180,602,306,263
40,VÂLCEA,"ŞCOALA CU CLASELE I-IV POPEŞTI",339,POPEŞTI,172377,1,PART,PRCNCT,PRSD,PRSD_SV,"2025-05-18 21:18:40",500,301,254,47,0,296,5,550,249,174,122
40,VÂLCEA,"ŞCOALA CU CLASELE I-VIII DĂEŞTI",340,POPEŞTI,172377,1,PART,PRCNCT,PRSD,PRSD_SV,"2025-05-18 21:29:41",759,420,358,62,0,412,8,830,410,274,138
40,VÂLCEA,"CĂMINUL CULTURAL POPEŞTI",341,POPEŞTI,172377,1,PART,PRCNCT,PRSD,PRSD_SV,"2025-05-18 21:53:54",355,180,158,22,0,177,3,390,210,105,72
40,VÂLCEA,"ŞCOALA CU CLASELE I-VIII URŞI",342,POPEŞTI,172377,1,PART,PRCNCT,PRSD,PRSD_SV,"2025-05-18 21:30:35",797,465,383,82,0,461,4,880,415,275,186
40,VÂLCEA,"CĂMIN CULTURAL(ATENEU SĂTESC)",343,PRUNDENI,172457,1,PART,PRCNCT,PRSD,PRSD_SV,"2025-05-18 21:50:53",1139,637,501,136,0,632,5,1250,613,308,324
40,VÂLCEA,"ȘCOALA BĂRBUCENI",344,PRUNDENI,172457,1,PART,PRCNCT,PRSD,PRSD_SV,"2025-05-18 21:48:04",865,453,378,75,0,449,4,950,497,229,220
40,VÂLCEA,"ȘCOALA CĂLINA",345,PRUNDENI,172457,1,PART,PRCNCT,PRSD,PRSD_SV,"2025-05-18 21:42:52",1099,590,508,82,0,582,8,1210,620,316,266
40,VÂLCEA,"CĂMINUL CULTURAL RACOVIŢA",346,RACOVIŢA,172509,2,PART,PRCNCT,PRSD,PRSD_SV,"2025-05-18 23:35:52",757,465,344,121,0,457,8,830,365,331,126
40,VÂLCEA,"CĂMINUL CULTURAL BALOTA",347,RACOVIŢA,172509,1,PART,PRCNCT,PRSD,PRSD_SV,"2025-05-18 21:23:15",337,188,119,69,0,179,9,370,182,130,49
40,VÂLCEA,"ŞCOALA GRUIUL LUPULUI",348,RACOVIŢA,172509,1,PART,PRCNCT,PRSD,PRSD_SV,"2025-05-18 21:12:31",101,59,40,19,0,59,0,122,63,44,15
40,VÂLCEA,"OCOLUL SILVIC LOVIŞTEA",349,RACOVIŢA,172509,1,PART,PRCNCT,PRSD,PRSD_SV,"2025-05-18 21:12:50",134,104,85,19,0,103,1,150,46,50,53
40,VÂLCEA,"ŞCOALA CU CLASELE I-IV ROEŞTI",350,ROEŞTI,172581,1,PART,PRCNCT,PRSD,PRSD_SV,"2025-05-18 21:19:08",621,319,284,34,1,318,1,680,361,216,102
40,VÂLCEA,"ŞCOALA CU CLASELE I-IV BĂRBĂRIGENI",351,ROEŞTI,172581,1,PART,PRCNCT,PRSD,PRSD_SV,"2025-05-18 21:12:56",142,91,66,25,0,88,3,160,69,48,40
40,VÂLCEA,"ŞCOALA CU CLASELE I-VIII CIOCÎLTEI",352,ROEŞTI,172581,1,PART,PRCNCT,PRSD,PRSD_SV,"2025-05-18 21:16:30",497,290,243,47,0,287,3,550,260,215,72
40,VÂLCEA,"ŞCOALA CU CLASELE I-VIII CUENI",353,ROEŞTI,172581,1,PART,PRCNCT,PRSD,PRSD_SV,"2025-05-18 21:19:52",501,296,242,46,8,290,6,550,254,189,101
40,VÂLCEA,"ŞCOALA GIMNAZIALĂ ROŞIILE",354,ROŞIILE,172698,1,PART,PRCNCT,PRSD,PRSD_SV,"2025-05-18 22:02:28",795,454,336,118,0,450,4,870,416,283,167
40,VÂLCEA,"ŞCOALA PRIMARĂ ROMANEŞTI",355,ROŞIILE,172698,1,PART,PRCNCT,PRSD,PRSD_SV,"2025-05-18 21:48:36",767,299,254,45,0,294,5,840,541,203,91
40,VÂLCEA,"GRĂDINIŢA CU PROGRAM NORMAL ZGUBEA",356,ROŞIILE,172698,1,PART,PRCNCT,PRSD,PRSD_SV,"2025-05-18 21:28:12",258,168,127,41,0,168,0,280,112,121,47
40,VÂLCEA,"ŞCOALA GIMNAZIALĂ CU CLASELE I-VIII RUNCU",357,RUNCU,172812,1,PART,PRCNCT,PRSD,PRSD_SV,"2025-05-18 21:18:58",428,287,223,64,0,286,1,470,183,135,151
40,VÂLCEA,"ŞCOALA GENERALĂ CU CLASELE I-IV SURPAŢI",358,RUNCU,172812,1,PART,PRCNCT,PRSD,PRSD_SV,"2025-05-18 21:16:07",97,58,42,16,0,57,1,110,52,30,27
40,VÂLCEA,"ŞCOALA GENERALĂ CU CLASELE I-IV VALEA BABEI",359,RUNCU,172812,1,PART,PRCNCT,PRSD,PRSD_SV,"2025-05-18 21:22:12",191,128,90,38,0,128,0,210,82,59,69
40,VÂLCEA,"CĂMINUL CULTURAL SĂLĂTRUCEL",360,SĂLĂTRUCEL,172894,1,PART,PRCNCT,PRSD,PRSD_SV,"2025-05-18 21:59:20",1220,690,581,105,4,674,16,1340,650,417,257
40,VÂLCEA,"ŞCOALA PATEŞTI",361,SĂLĂTRUCEL,172894,1,PART,PRCNCT,PRSD,PRSD_SV,"2025-05-18 21:12:13",95,64,48,16,0,64,0,101,37,42,22
40,VÂLCEA,"ŞCOALA SEACA",362,SĂLĂTRUCEL,172894,1,PART,PRCNCT,PRSD,PRSD_SV,"2025-05-18 21:14:14",78,57,37,20,0,56,1,90,33,37,19
40,VÂLCEA,"ŞCOALA ŞERBĂNEŞTI",363,SĂLĂTRUCEL,172894,1,PART,PRCNCT,PRSD,PRSD_SV,"2025-05-18 21:29:09",375,176,149,27,0,173,3,410,234,123,50
40,VÂLCEA,"ȘCOALA CU CLASELE I-VIII SCUNDU",364,SCUNDU,172947,1,PART,PRCNCT,PRSD,PRSD_SV,"2025-05-18 22:07:11",815,490,388,61,41,485,5,900,410,261,224
40,VÂLCEA,"ȘCOALA CU CLASELE I-VIII AVRĂMEȘTI",365,SCUNDU,172947,1,PART,PRCNCT,PRSD,PRSD_SV,"2025-05-18 21:53:28",593,328,255,62,11,324,4,650,322,211,113
40,VÂLCEA,"SCOALA GIMNAZIALA COMUNA SINESTI",366,SINEŞTI,172992,1,PART,PRCNCT,PRSD,PRSD_SV,"2025-05-18 21:43:58",644,328,268,51,9,327,1,710,382,187,140
40,VÂLCEA,"ȘCOALA URZICA, SAT URZICA",367,SINEŞTI,172992,1,PART,PRCNCT,PRSD,PRSD_SV,"2025-05-18 21:39:34",764,373,317,56,0,369,4,840,467,230,139
40,VÂLCEA,"ȘCOALA PRIMARĂ, SAT POPEȘTI",368,SINEŞTI,172992,1,PART,PRCNCT,PRSD,PRSD_SV,"2025-05-18 21:29:07",509,270,237,33,0,270,0,560,290,208,62
40,VÂLCEA,"CASA DE CULTURĂ SLĂTIOARA",369,SLĂTIOARA,173061,1,PART,PRCNCT,PRSD,PRSD_SV,"2025-05-18 21:50:19",774,480,407,73,0,473,7,850,370,241,232
40,VÂLCEA,"ŞCOALA GENERALĂ GORUNEȘTI",370,SLĂTIOARA,173061,1,PART,PRCNCT,PRSD,PRSD_SV,"2025-05-18 21:19:58",353,220,178,42,0,218,2,390,170,123,95
40,VÂLCEA,"ȘCOALA CU CLASELE I-VIII MILOSTEA",371,SLĂTIOARA,173061,1,PART,PRCNCT,PRSD,PRSD_SV,"2025-05-18 21:21:10",613,359,291,68,0,356,3,670,311,168,188
40,VÂLCEA,"ȘCOALA CU CLASELE I-VIII RUGETU",372,SLĂTIOARA,173061,1,PART,PRCNCT,PRSD,PRSD_SV,"2025-05-18 21:30:01",529,327,284,43,0,324,3,590,263,195,129
40,VÂLCEA,"GRĂDINIŢA CUMPENE",373,SLĂTIOARA,173061,1,PART,PRCNCT,PRSD,PRSD_SV,"2025-05-18 21:28:25",399,217,189,28,0,210,7,440,223,128,82
40,VÂLCEA,"ŞCOALA CU CLASELE I-VIII STĂNEŞTI",374,STĂNEŞTI,173132,1,PART,PRCNCT,PRSD,PRSD_SV,"2025-05-18 21:28:06",390,209,163,46,0,207,2,430,221,119,88
40,VÂLCEA,"ŞCOALA CU CLASELE I-IV LINIA DEALULUI",375,STĂNEŞTI,173132,1,PART,PRCNCT,PRSD,PRSD_SV,"2025-05-18 21:19:08",108,77,55,22,0,77,0,120,43,49,28
40,VÂLCEA,"ŞCOALA CU CLASELE I-IV VÂRLENI",376,STĂNEŞTI,173132,1,PART,PRCNCT,PRSD,PRSD_SV,"2025-05-18 21:11:12",324,181,143,38,0,179,2,360,179,120,59
40,VÂLCEA,"CĂMINUL CULTURAL STOENESTI",377,STOENEŞTI,173230,1,PART,PRCNCT,PRSD,PRSD_SV,"2025-05-18 21:59:49",849,574,452,121,1,564,10,940,366,334,230
40,VÂLCEA,"CĂMINUL CULTURAL BÂRLOGU",378,STOENEŞTI,173230,1,PART,PRCNCT,PRSD,PRSD_SV,"2025-05-18 21:16:31",264,195,154,41,0,193,2,290,95,79,114
40,VÂLCEA,"CĂMINUL CULTURAL DOBRICENI",379,STOENEŞTI,173230,1,PART,PRCNCT,PRSD,PRSD_SV,"2025-05-18 21:51:36",975,573,508,64,1,563,10,1070,497,409,154
40,VÂLCEA,"CĂMINUL CULTURAL PISCU MARE",380,STOENEŞTI,173230,1,PART,PRCNCT,PRSD,PRSD_SV,"2025-05-18 21:42:21",482,289,221,68,0,285,4,530,241,170,115
40,VÂLCEA,"CĂMINUL CULTURAL ZMEURĂTU",381,STOENEŞTI,173230,1,PART,PRCNCT,PRSD,PRSD_SV,"2025-05-18 21:14:38",134,133,78,55,0,132,1,150,17,71,61
40,VÂLCEA,"ȘCOALA CU CLASELE I-VIII STOILEȘTI",382,STOILEŞTI,173374,1,PART,PRCNCT,PRSD,PRSD_SV,"2025-05-18 21:20:14",544,310,252,58,0,303,7,600,290,206,97
40,VÂLCEA,"ŞCOALA CU CLASELE I-IV BÎRSOIU",383,STOILEŞTI,173374,1,PART,PRCNCT,PRSD,PRSD_SV,"2025-05-18 21:24:42",465,295,219,76,0,290,5,510,215,141,149
40,VÂLCEA,"ŞCOALA CU CLASELE I-IV GEAMĂNA",384,STOILEŞTI,173374,1,PART,PRCNCT,PRSD,PRSD_SV,"2025-05-18 21:20:22",695,376,326,50,0,374,2,760,384,263,111
40,VÂLCEA,"ŞCOALA CU CLASELE I-VIII URŞI",385,STOILEŞTI,173374,1,PART,PRCNCT,PRSD,PRSD_SV,"2025-05-18 21:48:05",1123,597,534,63,0,588,9,1230,633,369,219
40,VÂLCEA,"ŞCOALA CU CLASELE I-VIII CĂPITAN MĂRĂŞANU STROEŞTI",386,STROEŞTI,173533,1,PART,PRCNCT,PRSD,PRSD_SV,"2025-05-18 21:33:31",720,405,344,61,0,399,6,790,385,233,166
40,VÂLCEA,"ŞCOALA CU CLASELE I-VIII CIREŞU",387,STROEŞTI,173533,1,PART,PRCNCT,PRSD,PRSD_SV,"2025-05-18 21:41:40",587,362,290,69,3,360,2,650,288,193,167
40,VÂLCEA,"CAMINUL CULTURAL DIANU",388,STROEŞTI,173533,1,PART,PRCNCT,PRSD,PRSD_SV,"2025-05-18 21:30:54",372,194,165,28,1,192,2,410,216,120,72
40,VÂLCEA,"CENTRUL SOCIAL OBROCEŞTI",389,STROEŞTI,173533,1,PART,PRCNCT,PRSD,PRSD_SV,"2025-05-18 21:21:37",253,130,103,27,0,129,1,280,150,87,42
40,VÂLCEA,"CĂMINUL CULTURAL POJOGI - CERNA",390,STROEŞTI,173533,1,PART,PRCNCT,PRSD,PRSD_SV,"2025-05-18 21:29:56",194,128,93,35,0,125,3,210,82,52,73
40,VÂLCEA,"ṢCOALA GIMNAZIALĂ SUTEŞTI",391,SUTEŞTI,173597,1,PART,PRCNCT,PRSD,PRSD_SV,"2025-05-18 22:20:30",1184,712,573,132,7,709,3,1300,588,326,383
40,VÂLCEA,"FOSTA ŞCOALA VERDEA",392,SUTEŞTI,173597,1,PART,PRCNCT,PRSD,PRSD_SV,"2025-05-18 21:35:58",416,272,223,43,6,272,0,460,188,158,114
40,VÂLCEA,"ŞCOALA GIMNAZIALĂ ŞIRINEASA",393,ŞIRINEASA,173686,1,PART,PRCNCT,PRSD,PRSD_SV,"2025-05-18 21:49:10",1158,563,495,68,0,555,8,1270,707,383,172
40,VÂLCEA,"ŞCOALA PRIMARĂ CIORĂŞTI",394,ŞIRINEASA,173686,1,PART,PRCNCT,PRSD,PRSD_SV,"2025-05-18 21:43:37",468,254,207,47,0,252,2,520,266,161,91
40,VÂLCEA,"ŞCOALA PRIMARĂ SLĂVITEŞTI",395,ŞIRINEASA,173686,1,PART,PRCNCT,PRSD,PRSD_SV,"2025-05-18 21:16:37",235,130,94,34,2,129,1,260,130,86,43
40,VÂLCEA,"ŞCOALA CU CLASELE I-VIII ŞTEFĂNEŞTI",396,ŞTEFĂNEŞTI,173748,1,PART,PRCNCT,PRSD,PRSD_SV,"2025-05-18 21:52:40",913,476,417,58,1,471,5,1000,524,301,170
40,VÂLCEA,"ŞCOALA GIMNAZIALĂ NR.1",397,ŞTEFĂNEŞTI,173748,1,PART,PRCNCT,PRSD,PRSD_SV,"2025-05-18 22:02:17",511,321,253,66,2,317,4,560,239,181,136
40,VÂLCEA,"GRĂDINIŢA DOBRUŞA DE SUS",398,ŞTEFĂNEŞTI,173748,1,PART,PRCNCT,PRSD,PRSD_SV,"2025-05-18 21:30:42",437,255,214,40,1,252,3,480,225,187,65
40,VÂLCEA,"GRĂDINIŢA ŞERBĂNEŞTI",399,ŞTEFĂNEŞTI,173748,1,PART,PRCNCT,PRSD,PRSD_SV,"2025-05-18 21:22:48",625,305,250,55,0,302,3,690,385,201,101
40,VÂLCEA,"ŞCOALA ŞUŞANII DE SUS",400,ŞUŞANI,173793,1,PART,PRCNCT,PRSD,PRSD_SV,"2025-05-18 21:23:06",459,230,186,44,0,229,1,510,280,140,89
40,VÂLCEA,"ŞCOALA ŞUŞANII DE JOS",401,ŞUŞANI,173793,1,PART,PRCNCT,PRSD,PRSD_SV,"2025-05-18 21:23:43",416,250,190,58,2,248,2,460,210,176,72
40,VÂLCEA,"ŞCOALA RÎMEŞTI",402,ŞUŞANI,173793,2,PART,PRCNCT,PRSD,PRSD_SV,"2025-05-19 01:38:23",777,418,334,83,1,414,4,850,432,219,195
40,VÂLCEA,"ŞCOALA STOICULEŞTI",403,ŞUŞANI,173793,1,PART,PRCNCT,PRSD,PRSD_SV,"2025-05-18 21:20:37",243,170,135,35,0,170,0,270,100,111,59
40,VÂLCEA,"CĂMINUL CULTURAL UŞUREI",404,ŞUŞANI,173793,1,PART,PRCNCT,PRSD,PRSD_SV,"2025-05-18 21:21:21",408,230,173,55,2,228,2,450,220,129,99
40,VÂLCEA,"CĂMINUL CULTURAL TETOIU",405,TETOIU,173855,1,PART,PRCNCT,PRSD,PRSD_SV,"2025-05-18 21:31:10",473,289,205,79,5,283,6,512,223,150,133
40,VÂLCEA,"ŞCOALA CU CLASELE I-IV BĂROIU",406,TETOIU,173855,1,PART,PRCNCT,PRSD,PRSD_SV,"2025-05-18 21:20:18",278,141,107,33,1,138,3,310,169,92,46
40,VÂLCEA,"SCOALA GENERALĂ CU CLASELE.I-IV BUDELE",407,TETOIU,173855,1,PART,PRCNCT,PRSD,PRSD_SV,"2025-05-18 21:20:29",139,98,69,28,1,98,0,148,50,49,49
40,VÂLCEA,"ŞCOALA GENERALĂ CU CLASELE.I-IV NENCIULEŞTI",408,TETOIU,173855,1,PART,PRCNCT,PRSD,PRSD_SV,"2025-05-18 21:35:53",250,137,95,40,2,135,2,269,132,80,55
40,VÂLCEA,"ŞCOALA GENERALĂ CU CLASELE.I-VIII ŢEPEŞTI",409,TETOIU,173855,1,PART,PRCNCT,PRSD,PRSD_SV,"2025-05-18 22:05:01",643,374,289,77,8,372,2,711,337,245,127
40,VÂLCEA,"ŞCOALA CU CLASELE I-VIII TITEŞTI (SALĂ DE FESTIVITĂȚI)",410,TITEŞTI,174496,1,PART,PRCNCT,PRSD,PRSD_SV,"2025-05-18 21:37:05",414,225,178,46,1,224,1,460,235,113,111
40,VÂLCEA,"ŞCOALA CU CLASELE I-IV BRATOVEŞTI",411,TITEŞTI,174496,2,PART,PRCNCT,PRSD,PRSD_SV,"2025-05-19 01:34:53",123,106,63,43,0,105,1,147,41,65,40
40,VÂLCEA,"CĂMINUL CULTURAL TOMŞANI",412,TOMŞANI,173935,1,PART,PRCNCT,PRSD,PRSD_SV,"2025-05-18 21:34:33",869,528,466,62,0,519,9,950,422,265,254
40,VÂLCEA,"CĂMINUL CULTURAL BOGDĂNEȘTI",413,TOMŞANI,173935,1,PART,PRCNCT,PRSD,PRSD_SV,"2025-05-18 21:35:51",552,323,298,25,0,319,4,610,287,142,177
40,VÂLCEA,"CĂMINUL CULTURAL FOLEȘTII DE JOS",414,TOMŞANI,173935,1,PART,PRCNCT,PRSD,PRSD_SV,"2025-05-18 21:44:56",618,397,325,72,0,394,3,680,283,218,176
40,VÂLCEA,"CĂMIN CULTURAL- SALĂ DE EVENIMENTE",415,TOMŞANI,173935,1,PART,PRCNCT,PRSD,PRSD_SV,"2025-05-18 21:55:46",877,499,413,86,0,495,4,960,461,306,189
40,VÂLCEA,"CĂMINUL CULTURAL VAIDEENI",416,VAIDEENI,174021,1,PART,PRCNCT,PRSD,PRSD_SV,"2025-05-18 21:33:04",887,517,409,80,28,506,11,970,453,245,261
40,VÂLCEA,"CĂMINUL CULTURAL VAIDEENI",417,VAIDEENI,174021,1,PART,PRCNCT,PRSD,PRSD_SV,"2025-05-18 21:22:15",1170,641,566,60,15,635,6,1290,649,438,197
40,VÂLCEA,"CĂMINUL CULTURAL IZVORU RECE",418,VAIDEENI,174021,1,PART,PRCNCT,PRSD,PRSD_SV,"2025-05-18 21:26:51",587,345,283,55,7,340,5,640,295,220,120
40,VÂLCEA,"CĂMINUL CULTURAL MARIŢA",419,VAIDEENI,174021,1,PART,PRCNCT,PRSD,PRSD_SV,"2025-05-18 21:24:17",457,292,228,50,14,289,3,500,208,179,110
40,VÂLCEA,"GRĂDINIŢA VALEA MARE",420,"VALEA MARE",174085,1,PART,PRCNCT,PRSD,PRSD_SV,"2025-05-18 21:27:29",477,289,219,59,11,284,5,520,231,108,176
40,VÂLCEA,"PRIMĂRIA COMUNEI VALEA MARE",421,"VALEA MARE",174085,1,PART,PRCNCT,PRSD,PRSD_SV,"2025-05-18 21:20:43",373,194,164,30,0,194,0,410,216,106,88
40,VÂLCEA,"ŞCOALA CU CLASELE I-IV DELURENI",422,"VALEA MARE",174085,1,PART,PRCNCT,PRSD,PRSD_SV,"2025-05-18 21:20:50",380,184,152,22,10,183,1,420,236,75,108
40,VÂLCEA,"CĂMINUL CULTURAL DRĂGANI",423,"VALEA MARE",174085,1,PART,PRCNCT,PRSD,PRSD_SV,"2025-05-18 21:35:38",395,252,184,65,3,251,1,430,178,111,140
40,VÂLCEA,"ŞCOALA MĂRGINENI",424,"VALEA MARE",174085,1,PART,PRCNCT,PRSD,PRSD_SV,"2025-05-18 21:22:20",284,172,131,41,0,170,2,310,138,99,71
40,VÂLCEA,"ŞCOALA GIMNAZIALĂ ”GRIGORE MIHĂESCU”",425,VLĂDEŞTI,174156,1,PART,PRCNCT,PRSD,PRSD_SV,"2025-05-18 21:55:33",1628,982,859,121,2,964,18,1790,808,479,485
40,VÂLCEA,"ŞCOALA GIMNAZIALĂ ”GRIGORE MIHĂESCU”",426,VLĂDEŞTI,174156,1,PART,PRCNCT,PRSD,PRSD_SV,"2025-05-18 21:53:28",1279,812,684,128,0,801,11,1410,598,432,369
40,VÂLCEA,"CĂMIN CULTURAL VOICEŞTI",427,VOICEŞTI,174218,1,PART,PRCNCT,PRSD,PRSD_SV,"2025-05-18 21:33:26",1164,708,618,86,4,697,11,1280,572,446,251
40,VÂLCEA,"LOCALUL PRIMĂRIEI VOINEASA",428,VOINEASA,174254,1,PART,PRCNCT,PRSD,PRSD_SV,"2025-05-18 21:45:20",609,357,287,67,3,352,5,670,313,198,154
40,VÂLCEA,"ŞCOALA CU CLASELE I-VIII VOINEASA",429,VOINEASA,174254,2,PART,PRCNCT,PRSD,PRSD_SV,"2025-05-19 02:03:05",583,333,284,48,1,331,2,642,309,184,147
40,VÂLCEA,"ŞCOALA GIMNAZIALĂ ZĂTRENI",430,ZĂTRENI,174290,1,PART,PRCNCT,PRSD,PRSD_SV,"2025-05-18 21:30:06",480,243,197,43,3,239,4,530,287,173,66
40,VÂLCEA,"ŞCOALA DEALUL VĂLENI",431,ZĂTRENI,174290,1,PART,PRCNCT,PRSD,PRSD_SV,"2025-05-18 21:29:06",165,121,58,63,0,120,1,180,59,76,44
40,VÂLCEA,"ŞCOALA PRIMARĂ SĂSCIOARA",432,ZĂTRENI,174290,2,PART,PRCNCT,PRSD,PRSD_SV,"2025-05-19 02:00:00",296,189,133,56,0,185,4,323,134,116,69
40,VÂLCEA,"ŞCOALA PRIMARĂ STANOMIRU",433,ZĂTRENI,174290,1,PART,PRCNCT,PRSD,PRSD_SV,"2025-05-18 21:27:57",348,193,135,58,0,189,4,380,187,119,70
40,VÂLCEA,"ŞCOALA PRIMARĂ VĂLENI",434,ZĂTRENI,174290,1,PART,PRCNCT,PRSD,PRSD_SV,"2025-05-18 21:28:46",334,200,141,59,0,198,2,370,170,140,58
41,VRANCEA,"DIRECTIA SILVICĂ VRANCEA",1,"MUNICIPIUL FOCŞANI",174744,1,PART,PRCNCT,PRSD,PRSD_SV,"2025-05-18 22:10:14",1291,760,608,152,0,752,8,1415,655,314,438
41,VRANCEA,"TEATRUL MUNICIPAL „MAIOR GHEORGHE PASTIA” FOCŞANI",2,"MUNICIPIUL FOCŞANI",174744,1,PART,PRCNCT,PRSD,PRSD_SV,"2025-05-18 22:15:39",1495,939,775,164,0,922,17,1635,696,304,618
41,VRANCEA,"ATENEUL POPULAR „MAIOR GHEORGHE PASTIA” FOCȘANI",3,"MUNICIPIUL FOCŞANI",174744,2,PART,PRCNCT,PRSD,PRSD_SV,"2025-05-18 22:39:48",1386,891,704,185,2,881,10,1525,634,298,583
41,VRANCEA,"ȘCOALA GIMNAZIALĂ „ȘTEFAN CEL MARE” FOCȘANI",4,"MUNICIPIUL FOCŞANI",174744,1,PART,PRCNCT,PRSD,PRSD_SV,"2025-05-18 21:48:23",1225,656,559,96,1,650,6,1350,694,276,374
41,VRANCEA,"ŞCOALA GIMNAZIALĂ „ŞTEFAN CEL MARE” FOCȘANI",5,"MUNICIPIUL FOCŞANI",174744,2,PART,PRCNCT,PRSD,PRSD_SV,"2025-05-18 22:35:08",1053,585,491,94,0,582,3,1150,565,214,368
41,VRANCEA,"ŞCOALA GIMNAZIALĂ „ŞTEFAN CEL MARE” FOCȘANI",6,"MUNICIPIUL FOCŞANI",174744,1,PART,PRCNCT,PRSD,PRSD_SV,"2025-05-18 22:17:51",1101,566,522,43,1,559,7,1200,634,166,393
41,VRANCEA,"ŞCOALA GIMNAZIALĂ „ŞTEFAN CEL MARE” FOCȘANI",7,"MUNICIPIUL FOCŞANI",174744,1,PART,PRCNCT,PRSD,PRSD_SV,"2025-05-18 22:39:58",783,500,424,76,0,491,9,850,350,153,338
41,VRANCEA,"COLEGIUL TEHNIC AUTO „TRAIAN VUIA”",8,"MUNICIPIUL FOCŞANI",174744,5,PART,PRCNCT,PRSD,PRSD_SV,"2025-05-18 23:03:45",674,416,371,44,1,413,3,740,324,139,274
41,VRANCEA,"COLEGIUL TEHNIC AUTO „TRAIAN VUIA”",9,"MUNICIPIUL FOCŞANI",174744,1,PART,PRCNCT,PRSD,PRSD_SV,"2025-05-18 21:49:57",1042,593,541,52,0,588,5,1145,552,235,353
41,VRANCEA,"ȘCOALA GIMNAZIALĂ „ADRIAN PĂUNESCU” FOCȘANI",10,"MUNICIPIUL FOCŞANI",174744,1,PART,PRCNCT,PRSD,PRSD_SV,"2025-05-18 22:40:51",1532,890,722,167,1,881,9,1675,785,332,549
41,VRANCEA,"ȘCOALA GIMNAZIALĂ „ADRIAN PĂUNESCU” FOCȘANI",11,"MUNICIPIUL FOCŞANI",174744,1,PART,PRCNCT,PRSD,PRSD_SV,"2025-05-18 22:11:06",1605,864,780,84,0,855,9,1755,891,326,529
41,VRANCEA,"ȘCOALA GIMNAZIALĂ „ADRIAN PĂUNESCU” FOCȘANI",12,"MUNICIPIUL FOCŞANI",174744,1,PART,PRCNCT,PRSD,PRSD_SV,"2025-05-18 22:06:33",1499,644,608,36,0,633,11,1640,996,234,399
41,VRANCEA,"ŞCOALA GIMNAZIALĂ „ADRIAN PĂUNESCU” FOCȘANI",13,"MUNICIPIUL FOCŞANI",174744,1,PART,PRCNCT,PRSD,PRSD_SV,"2025-05-18 22:14:48",1131,556,503,53,0,549,7,1235,679,252,297
41,VRANCEA,"GRĂDINIȚA CU PROGRAM PRELUNGIT NR. 15 FOCȘANI",14,"MUNICIPIUL FOCŞANI",174744,1,PART,PRCNCT,PRSD,PRSD_SV,"2025-05-18 21:45:05",1422,673,629,44,0,661,12,1555,882,248,413
41,VRANCEA,"GRĂDINIŢA CU PROGRAM PRELUNGIT NR. 15",15,"MUNICIPIUL FOCŞANI",174744,1,PART,PRCNCT,PRSD,PRSD_SV,"2025-05-18 21:59:13",851,473,389,84,0,471,2,935,462,214,257
41,VRANCEA,"GRĂDINIŢA CU PROGRAM PRELUNGIT NR. 15",16,"MUNICIPIUL FOCŞANI",174744,1,PART,PRCNCT,PRSD,PRSD_SV,"2025-05-18 21:46:59",1669,941,855,86,0,923,18,1830,889,348,575
41,VRANCEA,"LICEUL TEHNOLOGIC ”G.G.LONGINESCU”",17,"MUNICIPIUL FOCŞANI",174744,1,PART,PRCNCT,PRSD,PRSD_SV,"2025-05-18 22:26:19",737,529,409,119,1,525,4,800,271,205,320
41,VRANCEA,"LICEUL TEHNOLOGIC ”G.G.LONGINESCU”",18,"MUNICIPIUL FOCŞANI",174744,1,PART,PRCNCT,PRSD,PRSD_SV,"2025-05-18 22:28:43",1397,716,639,77,0,705,11,1525,809,367,338
41,VRANCEA,"ȘCOALA GIMNAZIALĂ „ION BASGAN” FOCȘANI",19,"MUNICIPIUL FOCŞANI",174744,1,PART,PRCNCT,PRSD,PRSD_SV,"2025-05-18 22:36:16",1609,923,789,134,0,901,22,1770,847,343,558
41,VRANCEA,"ȘCOALA GIMNAZIALĂ „ION BASGAN” FOCȘANI",20,"MUNICIPIUL FOCŞANI",174744,1,PART,PRCNCT,PRSD,PRSD_SV,"2025-05-18 22:25:38",1801,1070,922,146,2,1058,12,1980,910,371,687
41,VRANCEA,"COLEGIUL TEHNIC ”VALERIU D. COTEA”",21,"MUNICIPIUL FOCŞANI",174744,1,PART,PRCNCT,PRSD,PRSD_SV,"2025-05-18 22:13:40",1290,816,629,95,92,807,9,1420,604,314,493
41,VRANCEA,"COLEGIUL NAŢIONAL ”AL. I. CUZA”",22,"MUNICIPIUL FOCŞANI",174744,1,PART,PRCNCT,PRSD,PRSD_SV,"2025-05-18 22:36:19",840,548,399,70,79,539,9,925,377,191,348
41,VRANCEA,"COLEGIUL TEHNIC „GHEORGHE ASACHI” FOCȘANI",23,"MUNICIPIUL FOCŞANI",174744,1,PART,PRCNCT,PRSD,PRSD_SV,"2025-05-18 22:23:08",1325,742,656,85,1,733,9,1450,708,303,430
41,VRANCEA,"COLEGIUL TEHNIC „GHEORGHE ASACHI” FOCȘANI",24,"MUNICIPIUL FOCŞANI",174744,1,PART,PRCNCT,PRSD,PRSD_SV,"2025-05-18 22:30:54",1559,743,697,46,0,729,14,1705,962,290,439
41,VRANCEA,"COLEGIUL TEHNIC „ION MINCU” FOCȘANI",25,"MUNICIPIUL FOCŞANI",174744,1,PART,PRCNCT,PRSD,PRSD_SV,"2025-05-18 21:43:12",969,486,427,59,0,480,6,1055,569,210,270
41,VRANCEA,"COLEGIUL TEHNIC „ION MINCU” FOCȘANI",26,"MUNICIPIUL FOCŞANI",174744,1,PART,PRCNCT,PRSD,PRSD_SV,"2025-05-18 21:45:10",934,492,436,56,0,485,7,1015,523,165,320
41,VRANCEA,"COLEGIUL TEHNIC „ION MINCU” FOCȘANI",27,"MUNICIPIUL FOCŞANI",174744,1,PART,PRCNCT,PRSD,PRSD_SV,"2025-05-18 21:51:32",829,425,370,55,0,419,6,900,475,186,233
41,VRANCEA,"GRĂDINIŢA CU PROGRAM PRELUNGIT NR. 16",28,"MUNICIPIUL FOCŞANI",174744,1,PART,PRCNCT,PRSD,PRSD_SV,"2025-05-18 22:29:35",1238,611,526,85,0,603,8,1355,744,239,364
41,VRANCEA,"GRĂDINIŢA CU PROGRAM PRELUNGIT NR. 16",29,"MUNICIPIUL FOCŞANI",174744,1,PART,PRCNCT,PRSD,PRSD_SV,"2025-05-18 21:53:38",1519,728,631,97,0,716,12,1670,942,346,370
41,VRANCEA,"COLEGIUL NAŢIONAL ”UNIREA”",30,"MUNICIPIUL FOCŞANI",174744,1,PART,PRCNCT,PRSD,PRSD_SV,"2025-05-18 22:21:31",1050,588,455,106,27,579,9,1145,557,230,349
41,VRANCEA,"ȘCOALA GIMNAZIALĂ „OANA-DIANA RENEA” FOCȘANI",31,"MUNICIPIUL FOCŞANI",174744,1,PART,PRCNCT,PRSD,PRSD_SV,"2025-05-18 21:45:06",1136,643,543,99,1,630,13,1250,607,246,384
41,VRANCEA,"ȘCOALA GIMNAZIALĂ „OANA-DIANA RENEA” FOCȘANI",32,"MUNICIPIUL FOCŞANI",174744,2,PART,PRCNCT,PRSD,PRSD_SV,"2025-05-18 22:26:54",1189,662,599,63,0,652,10,1300,638,234,418
41,VRANCEA,"ȘCOALA GIMNAZIALĂ „OANA-DIANA RENEA” FOCȘANI",33,"MUNICIPIUL FOCŞANI",174744,1,PART,PRCNCT,PRSD,PRSD_SV,"2025-05-18 22:23:41",638,337,282,55,0,336,1,705,368,127,209
41,VRANCEA,"AGENŢIA JUDEŢEANĂ PENTRU PLĂŢI ŞI INSPECŢIE SOCIALĂ",34,"MUNICIPIUL FOCŞANI",174744,1,PART,PRCNCT,PRSD,PRSD_SV,"2025-05-18 22:24:17",1390,700,612,88,0,689,11,1530,830,254,435
41,VRANCEA,"COLEGIUL TEHNIC ”EDMOND NICOLAU”",35,"MUNICIPIUL FOCŞANI",174744,1,PART,PRCNCT,PRSD,PRSD_SV,"2025-05-18 22:03:30",1118,590,525,65,0,578,12,1220,630,193,385
41,VRANCEA,"GRĂDINIȚA CU PROGRAM PRELUNGIT NR. 7 FOCȘANI",36,"MUNICIPIUL FOCŞANI",174744,1,PART,PRCNCT,PRSD,PRSD_SV,"2025-05-18 22:32:16",1165,610,556,54,0,606,4,1280,670,217,389
41,VRANCEA,"DIRECŢIA JUDEŢEANĂ A SPORTURILOR VRANCEA",37,"MUNICIPIUL FOCŞANI",174744,1,PART,PRCNCT,PRSD,PRSD_SV,"2025-05-18 22:19:48",1320,662,611,51,0,652,10,1445,783,255,397
41,VRANCEA,"ȘCOALA GIMNAZIALĂ „DUILIU ZAMFIRESCU” FOCȘANI",38,"MUNICIPIUL FOCŞANI",174744,1,PART,PRCNCT,PRSD,PRSD_SV,"2025-05-18 21:30:37",795,444,343,99,2,437,7,875,431,174,263
41,VRANCEA,"ȘCOALA GIMNAZIALĂ „DUILIU ZAMFIRESCU” FOCȘANI",39,"MUNICIPIUL FOCŞANI",174744,1,PART,PRCNCT,PRSD,PRSD_SV,"2025-05-18 22:04:17",1317,752,598,154,0,743,9,1450,698,276,467
41,VRANCEA,"ȘCOALA GIMNAZIALĂ „DUILIU ZAMFIRESCU” FOCȘANI",40,"MUNICIPIUL FOCŞANI",174744,1,PART,PRCNCT,PRSD,PRSD_SV,"2025-05-18 22:11:38",1570,840,780,60,0,829,11,1720,880,304,525
41,VRANCEA,"COLEGIUL NAȚIONAL PEDAGOGIC „SPIRU HARET” FOCȘANI",41,"MUNICIPIUL FOCŞANI",174744,1,PART,PRCNCT,PRSD,PRSD_SV,"2025-05-18 21:48:08",1615,926,828,96,2,908,18,1770,844,318,590
41,VRANCEA,"GRĂDINIȚA CU PROGRAM PRELUNGIT NR. 18 FOCȘANI",42,"MUNICIPIUL FOCŞANI",174744,1,PART,PRCNCT,PRSD,PRSD_SV,"2025-05-18 22:08:08",1375,738,654,82,2,727,11,1505,767,284,443
41,VRANCEA,"GRĂDINIŢA CU PROGRAM PRELUNGIT NR. 18",43,"MUNICIPIUL FOCŞANI",174744,1,PART,PRCNCT,PRSD,PRSD_SV,"2025-05-18 22:08:42",984,544,480,64,0,533,11,1075,531,182,351
41,VRANCEA,"CREȘA NR. 1",44,"MUNICIPIUL FOCŞANI",174744,1,PART,PRCNCT,PRSD,PRSD_SV,"2025-05-18 22:02:20",1338,620,550,70,0,614,6,1460,840,265,349
41,VRANCEA,"CREȘA NR. 1",45,"MUNICIPIUL FOCŞANI",174744,1,PART,PRCNCT,PRSD,PRSD_SV,"2025-05-18 22:01:35",1386,681,604,77,0,673,8,1515,834,305,368
41,VRANCEA,"GRĂDINIȚA CU PROGRAM PRELUNGIT NR. 1 FOCȘANI",46,"MUNICIPIUL FOCŞANI",174744,1,PART,PRCNCT,PRSD,PRSD_SV,"2025-05-18 21:35:31",1389,606,586,20,0,599,7,1520,914,275,324
41,VRANCEA,"GRĂDINIȚA CU PROGRAM PRELUNGIT NR. 1 FOCȘANI",47,"MUNICIPIUL FOCŞANI",174744,1,PART,PRCNCT,PRSD,PRSD_SV,"2025-05-18 22:02:25",878,490,412,78,0,482,8,955,465,186,296
41,VRANCEA,"GRĂDINIȚA CU PROGRAM PRELUNGIT NR. 1 FOCȘANI",48,"MUNICIPIUL FOCŞANI",174744,1,PART,PRCNCT,PRSD,PRSD_SV,"2025-05-18 21:56:31",1270,824,781,43,0,809,15,1395,571,333,476
41,VRANCEA,"GRĂDINIȚA CU PROGRAM PRELUNGIT NR. 1 FOCȘANI",49,"MUNICIPIUL FOCŞANI",174744,1,PART,PRCNCT,PRSD,PRSD_SV,"2025-05-18 22:09:20",1521,727,671,56,0,711,16,1665,938,282,429
41,VRANCEA,"GRĂDINIȚA CU PROGRAM PRELUNGIT NR. 13 FOCȘANI",50,"MUNICIPIUL FOCŞANI",174744,1,PART,PRCNCT,PRSD,PRSD_SV,"2025-05-18 21:39:06",821,423,350,73,0,415,8,905,482,165,250
41,VRANCEA,"GRĂDINIȚA CU PROGRAM PRELUNGIT NR. 13 FOCȘANI",51,"MUNICIPIUL FOCŞANI",174744,1,PART,PRCNCT,PRSD,PRSD_SV,"2025-05-18 22:18:31",1353,642,589,52,1,634,8,1480,838,252,382
41,VRANCEA,"GRĂDINIȚA CU PROGRAM PRELUNGIT NR. 13 FOCȘANI",52,"MUNICIPIUL FOCŞANI",174744,1,PART,PRCNCT,PRSD,PRSD_SV,"2025-05-18 21:40:31",833,460,405,55,0,454,6,915,455,190,264
41,VRANCEA,"GRĂDINIŢA CU PROGRAM PRELUNGIT NR. 13 FOCȘANI",53,"MUNICIPIUL FOCŞANI",174744,1,PART,PRCNCT,PRSD,PRSD_SV,"2025-05-18 22:22:38",1617,798,748,50,0,784,13,1780,982,320,464
41,VRANCEA,"GRĂDINIŢA CU PROGRAM PRELUNGIT NR. 13 FOCȘANI",54,"MUNICIPIUL FOCŞANI",174744,1,PART,PRCNCT,PRSD,PRSD_SV,"2025-05-18 22:26:00",1739,936,868,67,1,924,12,1905,969,356,568
41,VRANCEA,"DIRECŢIA SANITAR-VETERINARĂ",55,"MUNICIPIUL FOCŞANI",174744,1,PART,PRCNCT,PRSD,PRSD_SV,"2025-05-18 22:55:18",1841,1266,965,132,169,1247,19,2015,749,601,646
41,VRANCEA,"GRĂDINIŢA CU PROGRAM PRELUNGIT NR. 8",56,"MUNICIPIUL FOCŞANI",174744,1,PART,PRCNCT,PRSD,PRSD_SV,"2025-05-18 21:59:22",885,474,424,50,0,466,8,965,491,185,281
41,VRANCEA,"GRĂDINIŢA CU PROGRAM NORMAL NR. 4 FOCȘANI",57,"MUNICIPIUL FOCŞANI",174744,1,PART,PRCNCT,PRSD,PRSD_SV,"2025-05-18 22:19:39",1560,820,735,85,0,803,17,1705,885,324,479
41,VRANCEA,"GRĂDINIŢA CU PROGRAM PRELUNGIT NR. 17",58,"MUNICIPIUL FOCŞANI",174744,1,PART,PRCNCT,PRSD,PRSD_SV,"2025-05-18 21:41:41",990,506,453,52,1,493,13,1080,574,193,300
41,VRANCEA,"SC FREEDOM CAFE-BAR S.R.L.",59,"MUNICIPIUL FOCŞANI",174744,1,PART,PRCNCT,PRSD,PRSD_SV,"2025-05-18 22:32:41",1374,896,672,48,176,886,10,1500,604,537,349
41,VRANCEA,"CASA DE CULTURĂ „TUDOR VORNICU”",60,"MUNICIPIUL ADJUD",174860,1,PART,PRCNCT,PRSD,PRSD_SV,"2025-05-18 21:40:33",841,409,313,95,1,400,9,930,521,194,206
41,VRANCEA,"SCOALĂ GIMNAZIALĂ ”MIHAIL ARMENCEA”",61,"MUNICIPIUL ADJUD",174860,1,PART,PRCNCT,PRSD,PRSD_SV,"2025-05-18 21:51:19",976,450,427,23,0,447,3,1075,625,199,248
41,VRANCEA,"SCOALĂ GIMNAZIALĂ ”MAREȘAL ALEXANDRU AVERESCU”",62,"MUNICIPIUL ADJUD",174860,2,PART,PRCNCT,PRSD,PRSD_SV,"2025-05-19 02:04:05",1325,472,434,36,2,466,6,1455,983,291,175
41,VRANCEA,"SCOALĂ GIMNAZIALĂ ”PRINCIPELE RADU” A",63,"MUNICIPIUL ADJUD",174860,2,PART,PRCNCT,PRSD,PRSD_SV,"2025-05-19 02:15:55",1173,492,457,35,0,481,11,1290,798,202,279
41,VRANCEA,"SCOALĂ GIMNAZIALĂ ”PRINCIPELE RADU” B",64,"MUNICIPIUL ADJUD",174860,1,PART,PRCNCT,PRSD,PRSD_SV,"2025-05-18 21:52:57",1146,504,469,35,0,496,8,1260,756,240,256
41,VRANCEA,"SCOALĂ GIMNAZIALĂ ”PRINCIPELE RADU” C",65,"MUNICIPIUL ADJUD",174860,1,PART,PRCNCT,PRSD,PRSD_SV,"2025-05-18 21:53:48",1160,468,446,22,0,459,9,1275,807,249,210
41,VRANCEA,"ȘCOALA GIMNAZIALĂ „PRINCIPELE RADU”",66,"MUNICIPIUL ADJUD",174860,1,PART,PRCNCT,PRSD,PRSD_SV,"2025-05-18 21:50:31",1365,631,566,65,0,626,5,1500,869,342,284
41,VRANCEA,"SALA DE SPORT",67,"MUNICIPIUL ADJUD",174860,1,PART,PRCNCT,PRSD,PRSD_SV,"2025-05-18 22:20:47",1170,656,521,108,27,642,14,1285,629,283,359
41,VRANCEA,"SCOALĂ GIMNAZIALĂ ”ANGELA GHEORGHIU”",68,"MUNICIPIUL ADJUD",174860,1,PART,PRCNCT,PRSD,PRSD_SV,"2025-05-18 22:10:36",1555,850,679,170,1,835,15,1710,860,374,461
41,VRANCEA,"COLEGIUL TEHNIC ”GHEORGHE BALŞ” A",69,"MUNICIPIUL ADJUD",174860,1,PART,PRCNCT,PRSD,PRSD_SV,"2025-05-18 21:54:16",1397,695,640,55,0,681,14,1535,840,349,332
41,VRANCEA,"COLEGIUL TEHNIC ”GHEORGHE BALŞ” B",70,"MUNICIPIUL ADJUD",174860,1,PART,PRCNCT,PRSD,PRSD_SV,"2025-05-18 22:11:01",1218,569,498,71,0,562,7,1340,771,320,242
41,VRANCEA,"SCOALĂ PRIMARA BURCIOAIA",71,"MUNICIPIUL ADJUD",174860,1,PART,PRCNCT,PRSD,PRSD_SV,"2025-05-18 21:36:38",421,203,179,24,0,197,6,465,262,133,64
41,VRANCEA,"SCOALĂ GENERALA ADJUDU VECHI",72,"MUNICIPIUL ADJUD",174860,1,PART,PRCNCT,PRSD,PRSD_SV,"2025-05-18 22:00:43",1387,633,574,59,0,625,8,1525,892,341,284
41,VRANCEA,"SCOALĂ PRIMARA SISCANI",73,"MUNICIPIUL ADJUD",174860,1,PART,PRCNCT,PRSD,PRSD_SV,"2025-05-18 21:44:27",706,313,294,19,0,307,6,775,462,222,85
41,VRANCEA,"ŞCOALA GIMNAZIALĂ ”ECATERINA TEODOROIU”",74,"ORAŞ MĂRĂŞEŞTI",174922,1,PART,PRCNCT,PRSD,PRSD_SV,"2025-05-18 21:58:17",1322,600,572,28,0,594,6,1455,855,336,258
41,VRANCEA,"ŞCOALA GIMNAZIALĂ ”ECATERINA TEODOROIU”",75,"ORAŞ MĂRĂŞEŞTI",174922,1,PART,PRCNCT,PRSD,PRSD_SV,"2025-05-18 21:43:04",753,314,267,47,0,311,3,830,516,181,130
41,VRANCEA,"ŞCOALA PRIMARĂ ”SIRETU”",76,"ORAŞ MĂRĂŞEŞTI",174922,1,PART,PRCNCT,PRSD,PRSD_SV,"2025-05-18 22:19:03",1920,601,572,29,0,588,13,2110,1509,512,76
41,VRANCEA,"LICEUL TEHNOLOGIC ”EREMIA GRIGORESCU”",77,"ORAŞ MĂRĂŞEŞTI",174922,1,PART,PRCNCT,PRSD,PRSD_SV,"2025-05-18 21:44:03",1558,600,566,34,0,593,7,1715,1115,282,311
41,VRANCEA,"LICEUL TEHNOLOGIC ”EREMIA GRIGORESCU”",78,"ORAŞ MĂRĂŞEŞTI",174922,1,PART,PRCNCT,PRSD,PRSD_SV,"2025-05-18 21:58:40",1385,535,503,31,1,527,8,1525,990,244,283
41,VRANCEA,"ŞCOALA GIMNAZIALĂ NR.2",79,"ORAŞ MĂRĂŞEŞTI",174922,1,PART,PRCNCT,PRSD,PRSD_SV,"2025-05-18 21:47:39",1163,454,432,21,1,445,9,1280,826,242,203
41,VRANCEA,"ŞCOALA GIMNAZIALĂ NR.2",80,"ORAŞ MĂRĂŞEŞTI",174922,1,PART,PRCNCT,PRSD,PRSD_SV,"2025-05-18 21:30:23",298,130,98,32,0,128,2,330,200,71,57
41,VRANCEA,"ŞCOALA DOAGA",81,"ORAŞ MĂRĂŞEŞTI",174922,1,PART,PRCNCT,PRSD,PRSD_SV,"2025-05-18 21:46:07",211,86,72,14,0,86,0,228,142,60,26
41,VRANCEA,"ŞCOALA PRIMARĂ CĂLIMĂNEŞTI",82,"ORAŞ MĂRĂŞEŞTI",174922,1,PART,PRCNCT,PRSD,PRSD_SV,"2025-05-18 21:43:16",464,213,183,30,0,209,4,510,297,154,55
41,VRANCEA,"ŞCOALA PRIMARĂ HARET",83,"ORAŞ MĂRĂŞEŞTI",174922,1,PART,PRCNCT,PRSD,PRSD_SV,"2025-05-18 21:51:56",523,275,237,38,0,267,8,577,302,161,106
41,VRANCEA,"ŞCOALA PĂDURENI",84,"ORAŞ MĂRĂŞEŞTI",174922,1,PART,PRCNCT,PRSD,PRSD_SV,"2025-05-18 21:36:41",398,179,154,25,0,178,1,440,261,118,60
41,VRANCEA,"BIBLIOTECA ORĂȘENEASCĂ ”ANA GEORGESCU”",85,"ORAŞ ODOBEŞTI",175019,1,PART,PRCNCT,PRSD,PRSD_SV,"2025-05-18 21:46:30",1442,813,702,110,1,797,16,1585,772,446,351
41,VRANCEA,"LICEUL TEORETIC ”DUILIU ZAMFIRESCU” ODOBEȘTI",86,"ORAŞ ODOBEŞTI",175019,1,PART,PRCNCT,PRSD,PRSD_SV,"2025-05-18 21:50:35",1512,785,700,85,0,770,15,1665,880,395,375
41,VRANCEA,"LICEUL DE AGRICULTURĂ ȘI INDUSTRIE ALIMENTARĂ",87,"ORAŞ ODOBEŞTI",175019,1,PART,PRCNCT,PRSD,PRSD_SV,"2025-05-18 22:24:38",1570,888,782,106,0,874,14,1725,837,496,378
41,VRANCEA,"GRĂDINIȚA CU PROGRAM NORMAL NR.3 (STRUCTURA CARAGEA)",88,"ORAŞ ODOBEŞTI",175019,1,PART,PRCNCT,PRSD,PRSD_SV,"2025-05-18 21:38:41",908,521,474,46,1,515,6,980,459,298,217
41,VRANCEA,"CENTRU PENTRU EDUCAȚIE TIMPURIE ”LUMEA COPIILOR”",89,"ORAŞ ODOBEŞTI",175019,1,PART,PRCNCT,PRSD,PRSD_SV,"2025-05-18 22:07:36",810,548,452,96,0,538,10,890,342,324,214
41,VRANCEA,"GRĂDINIȚA CU PROGRAM NORMAL NR. 4 (STRUCTURA UNIREA)",90,"ORAŞ ODOBEŞTI",175019,1,PART,PRCNCT,PRSD,PRSD_SV,"2025-05-18 22:16:39",1609,846,751,93,2,835,11,1765,919,473,362
41,VRANCEA,"LICEUL TEORETIC ”IOAN SLAVICI”",91,"ORAŞ PANCIU",175055,2,PART,PRCNCT,PRSD,PRSD_SV,"2025-05-19 01:48:28",1301,610,558,52,0,606,4,1430,820,249,357
41,VRANCEA,"LICEUL TEORETIC ”IOAN SLAVICI”",92,"ORAŞ PANCIU",175055,1,PART,PRCNCT,PRSD,PRSD_SV,"2025-05-18 22:22:26",1039,482,409,63,10,474,8,1145,663,193,281
41,VRANCEA,"LICEUL TEHNOLOGIC ”ALEXANDRU IOAN CUZA” PANCIU",93,"ORAŞ PANCIU",175055,1,PART,PRCNCT,PRSD,PRSD_SV,"2025-05-18 22:14:14",1259,720,594,126,0,708,12,1385,665,353,355
41,VRANCEA,"SPAȚII BIROURI JANDARMI",94,"ORAŞ PANCIU",175055,1,PART,PRCNCT,PRSD,PRSD_SV,"2025-05-18 22:55:19",945,449,397,35,17,439,10,1040,591,215,224
41,VRANCEA,"GRĂDINIȚA CU PROGRAM NORMAL SATU NOU",95,"ORAŞ PANCIU",175055,1,PART,PRCNCT,PRSD,PRSD_SV,"2025-05-18 22:13:36",761,400,350,48,2,398,2,835,435,200,198
41,VRANCEA,"CENTRUL DE RECUPERARE PENTRU PERSOANE CU HANDICAP",96,"ORAŞ PANCIU",175055,1,PART,PRCNCT,PRSD,PRSD_SV,"2025-05-18 22:04:14",403,266,219,47,0,265,1,445,179,143,122
41,VRANCEA,"GRĂDINIȚA CU PROGRAM NORMAL DUMBRAVA",97,"ORAŞ PANCIU",175055,1,PART,PRCNCT,PRSD,PRSD_SV,"2025-05-18 22:13:37",391,213,168,44,1,210,3,430,217,118,92
41,VRANCEA,"GRĂDINIȚA CU PROGRAM NORMAL NR.1",98,"ORAŞ PANCIU",175055,1,PART,PRCNCT,PRSD,PRSD_SV,"2025-05-18 22:07:54",680,354,314,40,0,350,4,750,396,148,202
41,VRANCEA,"CĂMIN CULTURAL NEICU",99,"ORAŞ PANCIU",175055,1,PART,PRCNCT,PRSD,PRSD_SV,"2025-05-18 22:05:34",491,272,239,32,1,269,3,540,268,147,122
41,VRANCEA,"ȘCOALA GIMNAZIALĂ ANDREIAȘU DE JOS",100,"ANDREIAŞU DE JOS",175126,1,PART,PRCNCT,PRSD,PRSD_SV,"2025-05-18 21:28:51",437,225,184,39,2,222,3,480,255,133,89
41,VRANCEA,"ȘCOALA GIMNAZIALĂ ANDREIAȘU DE SUS",101,"ANDREIAŞU DE JOS",175126,1,PART,PRCNCT,PRSD,PRSD_SV,"2025-05-18 21:35:57",348,156,139,17,0,153,3,385,229,126,27
41,VRANCEA,"ȘCOALA PRIMARĂ NR.1 RĂCHITAȘU",102,"ANDREIAŞU DE JOS",175126,1,PART,PRCNCT,PRSD,PRSD_SV,"2025-05-18 21:41:25",504,223,199,24,0,219,4,555,332,155,64
41,VRANCEA,"SCOALA GIMNAZIALA CU CLASELE I-VIII BALESTI",103,BĂLEŞTI,175206,1,PART,PRCNCT,PRSD,PRSD_SV,"2025-05-18 22:00:05",812,545,402,100,43,539,6,895,350,199,340
41,VRANCEA,"SCOALA GIMNAZIALA CU CLASELE I-VIII BALESTI",104,BĂLEŞTI,175206,1,PART,PRCNCT,PRSD,PRSD_SV,"2025-05-18 22:16:55",695,429,347,45,37,424,5,765,336,151,273
41,VRANCEA,"CAMIN CULTURAL(SALA FESTIVITATI)",105,BÂRSEŞTI,175224,1,PART,PRCNCT,PRSD,PRSD_SV,"2025-05-18 23:18:49",1097,600,504,65,31,598,2,1205,605,294,304
41,VRANCEA,"CĂMIN CULTURAL",106,BILIEŞTI,178929,1,PART,PRCNCT,PRSD,PRSD_SV,"2025-05-18 21:59:41",1004,594,473,121,0,584,10,1110,516,272,312
41,VRANCEA,"CĂMIN CULTURAL",107,BILIEŞTI,178929,1,PART,PRCNCT,PRSD,PRSD_SV,"2025-05-18 21:44:18",1064,562,508,54,0,558,4,1170,608,340,218
41,VRANCEA,"ȘCOALA GIMNAZIALĂ BOGHEȘTI",108,BOGHEŞTI,175260,1,PART,PRCNCT,PRSD,PRSD_SV,"2025-05-18 21:55:03",571,259,199,57,3,256,3,630,371,171,85
41,VRANCEA,"CLĂDIRE ȘCOALĂ 4 CLASE",109,BOGHEŞTI,175260,1,PART,PRCNCT,PRSD,PRSD_SV,"2025-05-18 21:27:54",152,118,81,37,0,116,2,165,47,74,42
41,VRANCEA,SCOALA,110,BOGHEŞTI,175260,1,PART,PRCNCT,PRSD,PRSD_SV,"2025-05-18 21:39:07",385,220,175,44,1,215,5,425,205,135,80
41,VRANCEA,"CĂMINUL CULTURAL VASILE ȚIROIU BOLOTEȘTI",111,BOLOTEŞTI,175368,1,PART,PRCNCT,PRSD,PRSD_SV,"2025-05-18 21:38:38",596,371,275,96,0,368,3,655,284,173,195
41,VRANCEA,"SCOALA GIMNAZIALA GAGESTI",112,BOLOTEŞTI,175368,1,PART,PRCNCT,PRSD,PRSD_SV,"2025-05-18 21:39:09",1205,646,586,59,1,632,14,1325,679,350,282
41,VRANCEA,"SCOALA GIMNAZIALA GAGESTI",113,BOLOTEŞTI,175368,1,PART,PRCNCT,PRSD,PRSD_SV,"2025-05-18 21:30:51",520,329,271,58,0,326,3,570,241,151,175
41,VRANCEA,"ŞCOALA PRIMARĂ IVĂNCEŞTI",114,BOLOTEŞTI,175368,1,PART,PRCNCT,PRSD,PRSD_SV,"2025-05-18 21:46:01",366,168,143,25,0,166,2,405,237,127,39
41,VRANCEA,"SCOALA GIMNAZIALA PUTNA",115,BOLOTEŞTI,175368,1,PART,PRCNCT,PRSD,PRSD_SV,"2025-05-18 21:51:09",534,337,273,64,0,332,5,585,248,199,133
41,VRANCEA,"SCOALA CU CLASELE I - IV VITANESTII DE SUB MAGURA",116,BOLOTEŞTI,175368,1,PART,PRCNCT,PRSD,PRSD_SV,"2025-05-18 21:28:05",603,316,256,60,0,313,3,665,349,183,130
41,VRANCEA,"CAMINUL CULTURAL",117,BORDEŞTI,175439,1,PART,PRCNCT,PRSD,PRSD_SV,"2025-05-18 22:11:15",960,501,404,66,31,496,5,1055,554,259,237
41,VRANCEA,"GRĂDINIŢA CU PROGRAM NORMAL BORDEŞTII DE JOS",118,BORDEŞTI,175439,1,PART,PRCNCT,PRSD,PRSD_SV,"2025-05-18 21:43:37",419,216,168,37,11,216,0,460,244,131,85
41,VRANCEA,"CAMIN CULTURAL",119,BROŞTENI,175466,1,PART,PRCNCT,PRSD,PRSD_SV,"2025-05-18 22:02:00",1359,697,609,87,1,689,8,1495,798,395,294
41,VRANCEA,"GRĂDINIȚA DE COPII - SALA II",120,BROŞTENI,175466,1,PART,PRCNCT,PRSD,PRSD_SV,"2025-05-18 22:00:14",516,262,242,20,0,259,3,570,308,160,99
41,VRANCEA,"ȘCOALA GIMNAZIALĂ „IOAN CÂMPINEANU”",121,CÂMPINEANCA,174780,1,PART,PRCNCT,PRSD,PRSD_SV,"2025-05-18 22:27:23",1779,1022,904,117,1,1014,8,1960,938,453,561
41,VRANCEA,"ȘCOALA GIMNAZIALĂ „IOAN CÂMPINEANU”",122,CÂMPINEANCA,174780,1,PART,PRCNCT,PRSD,PRSD_SV,"2025-05-18 21:49:11",1639,865,839,25,1,854,11,1805,940,390,464
41,VRANCEA,"ȘCOALA GIMNAZIALĂ „IOAN CÂMPINEANU”",123,CÂMPINEANCA,174780,1,PART,PRCNCT,PRSD,PRSD_SV,"2025-05-18 21:44:53",552,421,266,155,0,415,6,605,184,244,171
41,VRANCEA,"SCOALA PRIMARA CÎMPURI",124,CÂMPURI,175670,1,PART,PRCNCT,PRSD,PRSD_SV,"2025-05-18 21:43:47",767,377,331,43,3,376,1,850,473,233,143
41,VRANCEA,"ŞCOALA GIMNAZIALA CÎMPURI",125,CÂMPURI,175670,1,PART,PRCNCT,PRSD,PRSD_SV,"2025-05-18 21:42:29",857,366,319,45,2,365,1,940,574,207,158
41,VRANCEA,"SCOALA PRIMARA FETESTI",126,CÂMPURI,175670,1,PART,PRCNCT,PRSD,PRSD_SV,"2025-05-18 21:40:34",732,301,262,39,0,300,1,800,499,239,61
41,VRANCEA,"SCOALA GIMNAZIALA ROTILESTII MICI",127,CÂMPURI,175670,1,PART,PRCNCT,PRSD,PRSD_SV,"2025-05-18 21:33:46",514,243,198,45,0,240,3,570,327,135,105
41,VRANCEA,"CĂMIN CULTURAL",128,CÂRLIGELE,175732,1,PART,PRCNCT,PRSD,PRSD_SV,"2025-05-18 22:13:34",1115,592,509,80,3,586,6,1225,633,339,247
41,VRANCEA,"SCOALA BLIDARI",129,CÂRLIGELE,175732,1,PART,PRCNCT,PRSD,PRSD_SV,"2025-05-18 21:34:39",464,256,218,38,0,254,2,510,254,171,83
41,VRANCEA,"ȘCOALA GIMNAZIALĂ CU CLASELE I-IV ” EPISCOP MITROFAN ”",130,CÂRLIGELE,175732,1,PART,PRCNCT,PRSD,PRSD_SV,"2025-05-18 22:16:10",389,193,164,29,0,193,0,430,237,125,68
41,VRANCEA,GRĂDINIȚĂ,131,CÂRLIGELE,175732,1,PART,PRCNCT,PRSD,PRSD_SV,"2025-05-18 22:02:32",545,316,273,43,0,308,8,600,284,180,128
41,VRANCEA,"GRĂDINIȚA CU PROGRAM NORMAL CHIOJDENI",132,CHIOJDENI,175509,1,PART,PRCNCT,PRSD,PRSD_SV,"2025-05-18 21:39:00",489,248,209,39,0,247,1,540,292,169,78
41,VRANCEA,"ȘCOALA PRIMARĂ CĂTĂUȚI",133,CHIOJDENI,175509,1,PART,PRCNCT,PRSD,PRSD_SV,"2025-05-18 21:29:30",225,116,81,35,0,115,1,250,134,61,54
41,VRANCEA,"ȘCOALA PRIMARĂ LUNCILE",134,CHIOJDENI,175509,1,PART,PRCNCT,PRSD,PRSD_SV,"2025-05-18 21:38:27",765,340,314,26,0,335,5,840,500,290,45
41,VRANCEA,"ȘCOALA PRIMARĂ TULBUREA",135,CHIOJDENI,175509,1,PART,PRCNCT,PRSD,PRSD_SV,"2025-05-18 21:26:01",258,154,133,21,0,153,1,284,130,109,44
41,VRANCEA,"CAMIN CULTURAL CIORASTI",136,CIORĂŞTI,175590,1,PART,PRCNCT,PRSD,PRSD_SV,"2025-05-18 21:44:39",649,374,296,73,5,369,5,705,331,163,206
41,VRANCEA,"ȘCOALA GIMNAZIALĂ „IONEL SÎRBU” CIORĂȘTI",137,CIORĂŞTI,175590,1,PART,PRCNCT,PRSD,PRSD_SV,"2025-05-18 21:29:10",148,114,75,39,0,114,0,165,51,53,61
41,VRANCEA,"ŞCOALA CODREŞTI",138,CIORĂŞTI,175590,1,PART,PRCNCT,PRSD,PRSD_SV,"2025-05-18 21:19:39",158,120,75,45,0,119,1,175,55,50,69
41,VRANCEA,"IMOBIL BIROURI",139,CIORĂŞTI,175590,1,PART,PRCNCT,PRSD,PRSD_SV,"2025-05-18 21:38:52",470,270,208,61,1,263,7,515,245,116,147
41,VRANCEA,"CENTRU DE ZI, CANTINĂ SOCIALĂ ȘI ÎNGRIJIRE LA DOMICILIU PENTRU PERSOANE VÂRSTNICE",140,CIORĂŞTI,175590,1,PART,PRCNCT,PRSD,PRSD_SV,"2025-05-18 21:46:49",270,194,142,46,6,190,4,295,101,81,109
41,VRANCEA,"SCOALA SALCIA VECHE",141,CIORĂŞTI,175590,1,PART,PRCNCT,PRSD,PRSD_SV,"2025-05-18 21:29:49",223,135,100,35,0,135,0,245,110,65,70
41,VRANCEA,"SCOALA SATU NOU",142,CIORĂŞTI,175590,1,PART,PRCNCT,PRSD,PRSD_SV,"2025-05-18 21:28:18",178,110,80,30,0,110,0,195,85,51,59
41,VRANCEA,PRIMARIE,143,CORBIŢA,175787,1,PART,PRCNCT,PRSD,PRSD_SV,"2025-05-18 21:25:00",335,193,155,38,0,189,4,370,177,110,79
41,VRANCEA,"SCOALA PRIMARA BUDA",144,CORBIŢA,175787,1,PART,PRCNCT,PRSD,PRSD_SV,"2025-05-18 21:29:52",385,240,202,38,0,236,4,425,185,133,103
41,VRANCEA,"CENTRU COMUNITAR MULTIFUNCȚIONAL CORBIȚA",145,CORBIŢA,175787,1,PART,PRCNCT,PRSD,PRSD_SV,"2025-05-18 21:23:46",254,148,124,24,0,144,4,280,132,82,62
41,VRANCEA,"SCOALA RADACINESTI",146,CORBIŢA,175787,1,PART,PRCNCT,PRSD,PRSD_SV,"2025-05-18 21:46:54",345,201,166,35,0,199,2,380,179,130,69
41,VRANCEA,"ȘCOALA GIMNAZIALĂ „VICTOR SLĂVESCU” COTEȘTI",147,COTEŞTI,175885,1,PART,PRCNCT,PRSD,PRSD_SV,"2025-05-18 22:13:30",1118,572,492,78,2,569,3,1230,658,378,191
41,VRANCEA,"SCOALA PRIMARA COTESTI",148,COTEŞTI,175885,1,PART,PRCNCT,PRSD,PRSD_SV,"2025-05-18 21:31:32",457,233,201,32,0,232,1,500,267,163,69
41,VRANCEA,"ȘCOALA GIMNAZIALĂ „NICOLAE RĂDULESCU”",149,COTEŞTI,175885,1,PART,PRCNCT,PRSD,PRSD_SV,"2025-05-18 21:36:39",1475,818,695,123,0,810,8,1630,812,445,365
41,VRANCEA,"GRADINITA GOLESTII DE SUS",150,COTEŞTI,175885,1,PART,PRCNCT,PRSD,PRSD_SV,"2025-05-18 21:34:17",349,242,187,55,0,236,6,385,143,131,105
41,VRANCEA,"SCOALA VALEA COTESTI",151,COTEŞTI,175885,1,PART,PRCNCT,PRSD,PRSD_SV,"2025-05-18 21:44:06",627,345,303,42,0,344,1,690,345,222,122
41,VRANCEA,"CAMIN CULTURAL DUMBRAVENI",152,DUMBRĂVENI,175938,1,PART,PRCNCT,PRSD,PRSD_SV,"2025-05-18 21:53:26",1666,944,778,166,0,934,10,1835,891,567,367
41,VRANCEA,"CĂMINUL CULTURAL CÂNDEȘTI",153,DUMBRĂVENI,175938,1,PART,PRCNCT,PRSD,PRSD_SV,"2025-05-18 22:07:38",1119,646,518,127,1,642,4,1230,584,418,224
41,VRANCEA,"ȘCOALA PRIMARĂ ALEXANDRU VLAHUȚĂ DRAGOSLOVENI",154,DUMBRĂVENI,175938,1,PART,PRCNCT,PRSD,PRSD_SV,"2025-05-18 21:35:09",911,509,437,70,2,499,10,1000,491,272,227
41,VRANCEA,"LICEUL TEORETIC ”GRIGORE GHEBA” DUMITREȘTI",155,DUMITREŞTI,175983,2,PART,PRCNCT,PRSD,PRSD_SV,"2025-05-19 00:58:09",595,325,269,53,3,315,10,655,330,153,162
41,VRANCEA,"ȘCOALA PRIMARĂ BICEȘTII DE JOS",156,DUMITREŞTI,175983,1,PART,PRCNCT,PRSD,PRSD_SV,"2025-05-18 21:59:46",528,228,203,25,0,225,3,580,352,161,64
41,VRANCEA,"ȘCOALA PRIMARĂ BICEȘTII DE SUS",157,DUMITREŞTI,175983,1,PART,PRCNCT,PRSD,PRSD_SV,"2025-05-18 21:52:31",544,330,286,44,0,325,5,600,270,226,99
41,VRANCEA,"ȘCOALA PRIMARĂ DUMITREȘTII DE SUS",158,DUMITREŞTI,175983,1,PART,PRCNCT,PRSD,PRSD_SV,"2025-05-18 21:34:52",217,126,111,14,1,126,0,240,114,78,48
41,VRANCEA,"ȘCOALA PRIMARĂ DUMITREȘTII - FAȚĂ",159,DUMITREŞTI,175983,1,PART,PRCNCT,PRSD,PRSD_SV,"2025-05-18 21:24:31",152,74,58,14,2,72,2,170,96,52,20
41,VRANCEA,"ȘCOALA PRIMARĂ GĂLOIEȘTI",160,DUMITREŞTI,175983,1,PART,PRCNCT,PRSD,PRSD_SV,"2025-05-18 21:33:26",450,226,190,36,0,224,2,495,269,156,68
41,VRANCEA,"ȘCOALA GIMNAZIALĂ LĂSTUNI",161,DUMITREŞTI,175983,1,PART,PRCNCT,PRSD,PRSD_SV,"2025-05-18 21:28:16",240,133,110,20,3,130,3,265,132,91,39
41,VRANCEA,"ȘCOALA PRIMARĂ MOTNĂU",162,DUMITREŞTI,175983,1,PART,PRCNCT,PRSD,PRSD_SV,"2025-05-18 21:38:56",230,133,105,27,1,131,2,255,122,79,52
41,VRANCEA,"ȘCOALA PRIMARĂ POIENIȚA",163,DUMITREŞTI,175983,1,PART,PRCNCT,PRSD,PRSD_SV,"2025-05-18 21:20:00",166,100,83,17,0,97,3,185,85,56,41
41,VRANCEA,"ȘCOALA PRIMARĂ TINOASA",164,DUMITREŞTI,175983,1,PART,PRCNCT,PRSD,PRSD_SV,"2025-05-18 21:21:37",103,82,65,17,0,80,2,115,33,47,33
41,VRANCEA,"ȘCOALA PRIMARĂ TRESTIA",165,DUMITREŞTI,175983,1,PART,PRCNCT,PRSD,PRSD_SV,"2025-05-18 21:21:49",110,48,37,11,0,48,0,120,72,44,4
41,VRANCEA,"ȘCOALA GIMNAZIALĂ FITIONEȘTI (CORP BIBLIOTECĂ)",166,FITIONEŞTI,176150,1,PART,PRCNCT,PRSD,PRSD_SV,"2025-05-18 21:55:52",629,307,274,33,0,305,2,695,388,194,111
41,VRANCEA,"GRĂDINIȚA CU PROGRAM NORMAL NR.1 FITIONEȘTI",167,FITIONEŞTI,176150,1,PART,PRCNCT,PRSD,PRSD_SV,"2025-05-18 21:37:14",497,257,229,27,1,255,2,540,283,175,80
41,VRANCEA,"CASA PRAZNICALĂ CIOLĂNEȘTI",168,FITIONEŞTI,176150,1,PART,PRCNCT,PRSD,PRSD_SV,"2025-05-18 21:30:28",128,66,49,17,0,66,0,140,74,36,30
41,VRANCEA,"ȘCOALA PRIMARĂ MĂNĂSTIOARA",169,FITIONEŞTI,176150,1,PART,PRCNCT,PRSD,PRSD_SV,"2025-05-18 21:38:47",292,158,127,30,1,155,3,320,162,89,66
41,VRANCEA,"ȘCOALA PRIMARĂ MĂNASTIOARA",170,FITIONEŞTI,176150,1,PART,PRCNCT,PRSD,PRSD_SV,"2025-05-18 21:47:40",467,231,200,30,1,230,1,515,284,132,98
41,VRANCEA,"ȘCOALA GIMNAZIALĂ „EMIL ATANASIU” GAROAFA",171,GAROAFA,176212,1,PART,PRCNCT,PRSD,PRSD_SV,"2025-05-18 21:58:22",1645,822,701,121,0,816,6,1810,988,495,321
41,VRANCEA,CREȘĂ,172,GAROAFA,176212,1,PART,PRCNCT,PRSD,PRSD_SV,"2025-05-18 21:35:00",578,307,267,40,0,303,4,635,328,189,114
41,VRANCEA,"ŞCOALA GIMNAZIALĂ ”PETRACHE BLÎNDU”",173,GAROAFA,176212,1,PART,PRCNCT,PRSD,PRSD_SV,"2025-05-18 22:22:54",1340,743,645,98,0,733,10,1469,726,513,220
41,VRANCEA,"ŞCOALA CU CLASELE I-IV DOAGA",174,GAROAFA,176212,1,PART,PRCNCT,PRSD,PRSD_SV,"2025-05-18 21:24:49",356,216,168,48,0,214,2,400,184,158,56
41,VRANCEA,"ŞCOALA GIMNAZIALĂ GOLEŞTI",175,GOLEŞTI,174824,1,PART,PRCNCT,PRSD,PRSD_SV,"2025-05-18 22:13:59",1443,859,733,126,0,845,14,1590,731,424,421
41,VRANCEA,"CĂMIN CULTURAL GOLEŞTI",176,GOLEŞTI,174824,1,PART,PRCNCT,PRSD,PRSD_SV,"2025-05-18 22:15:15",1641,917,828,89,0,905,12,1805,888,473,432
41,VRANCEA,"GRĂDINIŢA CU PROGRAM PRELUNGIT GOLEŞTI",177,GOLEŞTI,174824,1,PART,PRCNCT,PRSD,PRSD_SV,"2025-05-18 21:50:39",986,570,509,61,0,566,4,1085,515,273,293
41,VRANCEA,"GRĂDINIȚA CU PROGRAM NORMAL GOLOGANU",178,GOLOGANU,178938,1,PART,PRCNCT,PRSD,PRSD_SV,"2025-05-18 22:01:45",1122,598,540,54,4,588,10,1235,637,292,296
41,VRANCEA,"ȘCOALA GIMNAZIALĂ ”PROFESOR GENERAL GHEORGHE GHEORGHIU” GOLOGANU",179,GOLOGANU,178938,1,PART,PRCNCT,PRSD,PRSD_SV,"2025-05-18 21:58:32",1365,771,701,70,0,766,5,1505,734,385,381
41,VRANCEA,"CĂMINUL CULTURAL „NICOLAE CIORĂSCU” GUGEŞTI",180,GUGEŞTI,176301,1,PART,PRCNCT,PRSD,PRSD_SV,"2025-05-18 22:11:52",1566,756,682,67,7,746,10,1725,969,468,278
41,VRANCEA,"ŞCOALA GIMNAZIALĂ NR.2 GUGEŞTI",181,GUGEŞTI,176301,1,PART,PRCNCT,PRSD,PRSD_SV,"2025-05-18 22:53:19",1435,757,701,50,6,745,12,1580,823,414,331
41,VRANCEA,"GRĂDINIȚA CU PROGRAM NORMAL NR.3 GUGEŞTI",182,GUGEŞTI,176301,1,PART,PRCNCT,PRSD,PRSD_SV,"2025-05-18 21:44:52",867,420,384,33,3,412,8,955,535,260,152
41,VRANCEA,"ŞCOALA GIMNAZIALĂ ”ALEXANDRU VLAHUȚĂ” GUGEŞTI",183,GUGEŞTI,176301,1,PART,PRCNCT,PRSD,PRSD_SV,"2025-05-18 22:07:11",977,486,424,56,6,480,6,1075,589,270,210
41,VRANCEA,"ŞCOALA GIMNAZIALĂ NR.4 OREAVU",184,GUGEŞTI,176301,1,PART,PRCNCT,PRSD,PRSD_SV,"2025-05-18 21:37:48",443,230,182,45,3,229,1,485,255,117,112
41,VRANCEA,"ȘCOALA GIMNAZIALĂ GURA CALIȚEI",185,"GURA CALIŢEI",176338,1,PART,PRCNCT,PRSD,PRSD_SV,"2025-05-18 21:39:00",794,379,327,52,0,375,4,875,496,261,114
41,VRANCEA,"ȘCOALA PRIMARĂ DEALU LUNG",186,"GURA CALIŢEI",176338,1,PART,PRCNCT,PRSD,PRSD_SV,"2025-05-18 21:27:50",302,128,112,16,0,126,2,330,202,87,39
41,VRANCEA,"ȘCOALA PRIMARĂ ”NICOLAE V. BĂLAN” LACU LUI BABAN",187,"GURA CALIŢEI",176338,1,PART,PRCNCT,PRSD,PRSD_SV,"2025-05-18 21:50:19",338,167,126,41,0,164,3,370,203,114,50
41,VRANCEA,"ȘCOALA PRIMARĂ PLOPU",188,"GURA CALIŢEI",176338,1,PART,PRCNCT,PRSD,PRSD_SV,"2025-05-18 21:28:39",272,127,104,23,0,126,1,300,173,89,37
41,VRANCEA,"SCOALA GENERALA POIENILE",189,"GURA CALIŢEI",176338,1,PART,PRCNCT,PRSD,PRSD_SV,"2025-05-18 21:35:24",257,116,101,13,2,115,1,285,169,62,53
41,VRANCEA,"CAMINUL CULTURAL",190,HOMOCEA,176445,1,PART,PRCNCT,PRSD,PRSD_SV,"2025-05-18 21:51:06",1673,409,357,43,9,405,4,1840,1431,297,108
41,VRANCEA,"GRADINITA NR. 1 CENTRU HOMOCEA",191,HOMOCEA,176445,1,PART,PRCNCT,PRSD,PRSD_SV,"2025-05-18 21:25:56",1729,450,411,26,13,448,2,1905,1455,307,141
41,VRANCEA,"SCOALA CU CLASELE I-VIII",192,HOMOCEA,176445,1,PART,PRCNCT,PRSD,PRSD_SV,"2025-05-18 21:48:54",1270,417,378,27,12,411,6,1395,978,259,152
41,VRANCEA,"ȘCOALA VECHE SAT COSTIȘA",193,HOMOCEA,176445,1,PART,PRCNCT,PRSD,PRSD_SV,"2025-05-18 21:26:42",297,159,134,25,0,156,3,330,171,81,75
41,VRANCEA,"CAMINUL CULTURAL",194,HOMOCEA,176445,1,PART,PRCNCT,PRSD,PRSD_SV,"2025-05-18 21:47:19",994,481,409,69,3,477,4,1095,614,296,181
41,VRANCEA,"SCOALA GIMNAZIALA JARISTEA",195,JARIŞTEA,176506,1,PART,PRCNCT,PRSD,PRSD_SV,"2025-05-18 22:17:48",1629,832,719,112,1,819,13,1790,958,482,337
41,VRANCEA,"SCOALA PRIMARA NR 2 MARGINEA",196,JARIŞTEA,176506,1,PART,PRCNCT,PRSD,PRSD_SV,"2025-05-18 21:55:08",747,422,351,70,1,419,3,825,403,250,169
41,VRANCEA,"SCOALA PRIMARA PADURENI",197,JARIŞTEA,176506,1,PART,PRCNCT,PRSD,PRSD_SV,"2025-05-18 21:38:30",381,216,169,47,0,213,3,420,204,124,89
41,VRANCEA,"SCOALA PRIMARA SCINTEIA",198,JARIŞTEA,176506,1,PART,PRCNCT,PRSD,PRSD_SV,"2025-05-18 21:32:14",162,105,81,24,0,105,0,180,75,51,54
41,VRANCEA,"SCOALA PRIMARA VARSATURA",199,JARIŞTEA,176506,1,PART,PRCNCT,PRSD,PRSD_SV,"2025-05-18 21:33:48",474,231,170,61,0,230,1,520,289,139,91
41,VRANCEA,"SCOALA CU CLASELE I-IV JITIA",200,JITIA,176551,1,PART,PRCNCT,PRSD,PRSD_SV,"2025-05-18 21:27:40",571,284,242,42,0,281,3,630,346,196,85
41,VRANCEA,"ȘCOALA PRIMARĂ CERBU",201,JITIA,176551,1,PART,PRCNCT,PRSD,PRSD_SV,"2025-05-18 21:31:29",179,112,96,16,0,112,0,195,83,61,51
41,VRANCEA,"ȘCOALA PRIMARĂ DEALU SĂRII",202,JITIA,176551,1,PART,PRCNCT,PRSD,PRSD_SV,"2025-05-18 21:35:45",136,81,65,16,0,81,0,150,69,30,51
41,VRANCEA,"SALA DE ȘEDINȚE",203,JITIA,176551,1,PART,PRCNCT,PRSD,PRSD_SV,"2025-05-18 21:46:00",339,162,150,12,0,158,4,375,213,119,39
41,VRANCEA,"SCOALA GIMNAZIALA MAICANESTI",204,MĂICĂNEŞTI,176613,1,PART,PRCNCT,PRSD,PRSD_SV,"2025-05-18 22:22:33",1052,524,419,90,15,515,9,1160,636,278,237
41,VRANCEA,"SCOALA GIMNAZIALA RIMNICENI",205,MĂICĂNEŞTI,176613,1,PART,PRCNCT,PRSD,PRSD_SV,"2025-05-18 22:13:35",1124,585,459,110,16,583,2,1235,650,255,328
41,VRANCEA,"CᾸMIN CULTURAL SLOBOZIA BOTEṢTI",206,MĂICĂNEŞTI,176613,1,PART,PRCNCT,PRSD,PRSD_SV,"2025-05-18 21:40:19",200,128,81,47,0,126,2,220,92,59,67
41,VRANCEA,"SCOALA GENERALA SATU-NOU",207,MĂICĂNEŞTI,176613,1,PART,PRCNCT,PRSD,PRSD_SV,"2025-05-18 21:38:01",187,118,87,31,0,117,1,205,87,59,58
41,VRANCEA,"GRADINITA CU PROGRAM NORMAL STUPINA",208,MĂICĂNEŞTI,176613,1,PART,PRCNCT,PRSD,PRSD_SV,"2025-05-18 21:30:10",259,151,128,22,1,149,2,285,134,78,71
41,VRANCEA,"SCOALA GENERALA TATARU",209,MĂICĂNEŞTI,176613,1,PART,PRCNCT,PRSD,PRSD_SV,"2025-05-18 22:17:18",640,312,254,56,2,312,0,705,393,151,161
41,VRANCEA,"CĂMINUL CULTURAL ”DIMITRIE CANTEMIR”",210,MERA,176686,1,PART,PRCNCT,PRSD,PRSD_SV,"2025-05-18 22:17:45",1414,711,641,57,13,705,6,1560,849,495,210
41,VRANCEA,"ȘOALA GIMNAZIALĂ PETRE MIRONESCU -MERA",211,MERA,176686,1,PART,PRCNCT,PRSD,PRSD_SV,"2025-05-18 22:18:19",549,262,237,25,0,257,5,605,343,146,111
41,VRANCEA,"ȘCOALA GIMNAZIALĂ NR.1- CORP A",212,MERA,176686,1,PART,PRCNCT,PRSD,PRSD_SV,"2025-05-18 22:32:16",1157,569,509,47,13,564,5,1275,706,444,120
41,VRANCEA,"GRĂDINIȚA CU PROGRAM NORMAL MILCOVUL",213,MILCOVUL,176748,1,PART,PRCNCT,PRSD,PRSD_SV,"2025-05-18 21:50:39",989,560,505,55,0,554,6,1090,530,278,276
41,VRANCEA,"GRĂDINIȚA CU PROGRAM NORMAL MILCOVUL",214,MILCOVUL,176748,1,PART,PRCNCT,PRSD,PRSD_SV,"2025-05-18 21:59:35",1038,580,512,66,2,573,7,1140,560,274,299
41,VRANCEA,"GRĂDINIȚA CU PROGRAM NORMAL LĂMOTEȘTI",215,MILCOVUL,176748,2,PART,PRCNCT,PRSD,PRSD_SV,"2025-05-18 23:28:51",884,494,437,57,0,492,2,970,476,271,221
41,VRANCEA,"GRADINITA SPERIETI",216,MOVILIŢA,176793,1,PART,PRCNCT,PRSD,PRSD_SV,"2025-05-18 21:40:25",386,185,156,29,0,182,3,425,240,123,59
41,VRANCEA,"SCOALA NR.2",217,MOVILIŢA,176793,1,PART,PRCNCT,PRSD,PRSD_SV,"2025-05-18 21:42:17",627,301,278,23,0,297,4,685,384,147,150
41,VRANCEA,"SCOALA NR.1",218,MOVILIŢA,176793,1,PART,PRCNCT,PRSD,PRSD_SV,"2025-05-18 21:27:21",698,350,300,50,0,346,4,770,420,204,142
41,VRANCEA,"SCOALA PRIMARA DIOCHETI-REDIU",219,MOVILIŢA,176793,1,PART,PRCNCT,PRSD,PRSD_SV,"2025-05-18 21:33:43",564,295,249,46,0,294,1,625,330,151,143
41,VRANCEA,"SCOALA PRIMARA FRECATEI",220,MOVILIŢA,176793,1,PART,PRCNCT,PRSD,PRSD_SV,"2025-05-18 21:39:46",402,163,142,21,0,159,4,440,277,108,51
41,VRANCEA,"SCOALA PRIMARA TROTUSANU",221,MOVILIŢA,176793,1,PART,PRCNCT,PRSD,PRSD_SV,"2025-05-18 21:31:02",370,229,166,63,0,225,4,410,181,147,78
41,VRANCEA,"CAMIN CULTURAL NANESTI",222,NĂNEŞTI,176855,1,PART,PRCNCT,PRSD,PRSD_SV,"2025-05-18 22:10:27",978,512,402,92,18,506,6,1075,563,287,219
41,VRANCEA,"SCOALA CALIENII-NOI",223,NĂNEŞTI,176855,1,PART,PRCNCT,PRSD,PRSD_SV,"2025-05-18 21:41:13",263,157,106,50,1,157,0,290,133,79,78
41,VRANCEA,"CAMIN CULTURAL CALIENII-VECHI",224,NĂNEŞTI,176855,1,PART,PRCNCT,PRSD,PRSD_SV,"2025-05-18 21:58:32",496,262,189,71,2,259,3,545,283,135,124
41,VRANCEA,"GRĂDINIȚA CU PROGRAM NORMAL NR.1 NĂRUJA",225,NĂRUJA,176891,1,PART,PRCNCT,PRSD,PRSD_SV,"2025-05-18 22:27:47",954,477,435,41,1,474,3,1050,573,237,237
41,VRANCEA,"ŞCOALA CU CLASELE I-IV",226,NĂRUJA,176891,1,PART,PRCNCT,PRSD,PRSD_SV,"2025-05-18 21:54:02",537,280,246,34,0,275,5,590,310,165,110
41,VRANCEA,"ȘCOALA GIMNAZIALĂ ”DUMITRU PRICOP”",227,NEGRILEŞTI,178885,1,PART,PRCNCT,PRSD,PRSD_SV,"2025-05-18 21:38:02",1329,504,462,42,0,494,10,1465,961,262,232
41,VRANCEA,"SCOALA ” DIMITRIE GUSTI” NEREJU",228,NEREJU,176944,1,PART,PRCNCT,PRSD,PRSD_SV,"2025-05-18 21:54:55",1379,640,612,28,0,631,9,1520,880,411,220
41,VRANCEA,"SCOALA GIMNAZIALA NEREJU-MIC",229,NEREJU,176944,1,PART,PRCNCT,PRSD,PRSD_SV,"2025-05-18 21:58:36",1530,710,675,35,0,703,7,1685,975,519,184
41,VRANCEA,"INTERNAT SCOLAR",230,NEREJU,176944,1,PART,PRCNCT,PRSD,PRSD_SV,"2025-05-18 21:44:56",565,234,220,14,0,231,3,620,386,202,29
41,VRANCEA,"ȘCOALA GIMNAZIALĂ NISTOREȘTI",231,NISTOREŞTI,177003,1,PART,PRCNCT,PRSD,PRSD_SV,"2025-05-18 21:23:48",817,348,310,35,3,340,8,900,552,230,110
41,VRANCEA,"GRĂDINIȚA, SAT VETREȘTI-HERĂSTRĂU",232,NISTOREŞTI,177003,1,PART,PRCNCT,PRSD,PRSD_SV,"2025-05-18 21:33:29",777,380,343,35,2,369,11,855,475,257,112
41,VRANCEA,"SCOALA GIMNAZIALĂ OBREJIŢA",233,OBREJIŢA,178947,1,PART,PRCNCT,PRSD,PRSD_SV,"2025-05-18 22:12:14",1288,616,556,60,0,608,8,1415,799,388,220
41,VRANCEA,"GRĂDINIȚA CU PROGRAM NORMAL PALTIN",234,PALTIN,177101,1,PART,PRCNCT,PRSD,PRSD_SV,"2025-05-18 22:44:16",1066,507,467,37,3,495,12,1175,668,322,173
41,VRANCEA,"CAMIN CULTURAL PRAHUDA",235,PALTIN,177101,1,PART,PRCNCT,PRSD,PRSD_SV,"2025-05-18 21:45:03",407,215,186,27,2,214,1,455,240,133,81
41,VRANCEA,"CAMIN CULTURAL PĂULEȘTI",236,PĂULEŞTI,178910,1,PART,PRCNCT,PRSD,PRSD_SV,"2025-05-18 21:34:27",581,282,254,28,0,279,3,640,358,119,160
41,VRANCEA,"ŞCOALA CU CLASELE I-IV FUNDATURA",237,PĂULEŞTI,178910,1,PART,PRCNCT,PRSD,PRSD_SV,"2025-05-18 21:29:04",432,217,199,18,0,216,1,475,258,152,64
41,VRANCEA,"CĂMINUL CULTURAL HĂULIȘCA",238,PĂULEŞTI,178910,1,PART,PRCNCT,PRSD,PRSD_SV,"2025-05-18 21:33:19",522,268,236,32,0,266,2,575,307,132,134
41,VRANCEA,"SCOALA PRIMARA SURLEA",239,PĂUNEŞTI,177236,1,PART,PRCNCT,PRSD,PRSD_SV,"2025-05-18 21:31:11",1047,445,405,40,0,439,6,1155,710,284,155
41,VRANCEA,"SCOALA PRIMARA NOVACESTI",240,PĂUNEŞTI,177236,1,PART,PRCNCT,PRSD,PRSD_SV,"2025-05-18 21:49:29",1455,566,510,56,0,558,8,1600,1034,371,187
41,VRANCEA,"SCOALA PRIMARA BOSTANESTI",241,PĂUNEŞTI,177236,1,PART,PRCNCT,PRSD,PRSD_SV,"2025-05-18 21:34:52",887,324,312,12,0,319,5,975,651,178,141
41,VRANCEA,"CAMIN CULTURAL PAUNESTI",242,PĂUNEŞTI,177236,1,PART,PRCNCT,PRSD,PRSD_SV,"2025-05-18 21:45:00",1082,496,410,86,0,490,6,1190,694,285,205
41,VRANCEA,"GRADINITA CU PROGRAM NORMAL VIISOARA",243,PĂUNEŞTI,177236,1,PART,PRCNCT,PRSD,PRSD_SV,"2025-05-18 21:29:28",769,341,290,51,0,335,6,845,504,209,126
41,VRANCEA,"SCOALA GENERALA NR.1, CORP A",244,PLOSCUŢENI,178894,1,PART,PRCNCT,PRSD,PRSD_SV,"2025-05-18 21:26:52",999,375,333,41,1,372,3,1100,725,186,186
41,VRANCEA,"SCOALA GENERALA NR.1, CORP B",245,PLOSCUŢENI,178894,1,PART,PRCNCT,PRSD,PRSD_SV,"2025-05-18 21:35:50",1124,452,406,46,0,450,2,1235,783,257,193
41,VRANCEA,"SCOALA PRIMARA SAT ARGEA",246,PLOSCUŢENI,178894,1,PART,PRCNCT,PRSD,PRSD_SV,"2025-05-18 21:14:19",381,153,134,19,0,153,0,420,267,140,13
41,VRANCEA,"CAMIN CULTURAL POIANA CRISTEI, PRIMARIA COMUNEI POIANA CRISTEI",247,"POIANA CRISTEI",177263,1,PART,PRCNCT,PRSD,PRSD_SV,"2025-05-18 21:48:11",920,486,439,47,0,480,6,1010,524,339,141
41,VRANCEA,"SCOALA CU CLASELE I-IV SAT MAHRIU, SCOALA COORDONATORARE POIANA CRISTEI",248,"POIANA CRISTEI",177263,1,PART,PRCNCT,PRSD,PRSD_SV,"2025-05-18 21:19:08",273,133,119,14,0,129,4,300,167,105,24
41,VRANCEA,"SCOALA CU CLASELE I-IV SAT PETREANU. SCOALA COORDONATOARE POIANA CRISTEI",249,"POIANA CRISTEI",177263,1,PART,PRCNCT,PRSD,PRSD_SV,"2025-05-18 21:09:52",116,69,54,15,0,69,0,130,61,54,15
41,VRANCEA,"SCOALA CU CLASELE I-IV SAT PODU LACULUI, SCOALA COORDONATOARE POIANA CRISTEI",250,"POIANA CRISTEI",177263,1,PART,PRCNCT,PRSD,PRSD_SV,"2025-05-18 21:22:37",482,234,211,23,0,229,5,530,296,146,83
41,VRANCEA,"SCOALA CU CLASELE I-VIII SAT TIRITU, SCOALA COORDONATOARE POIANA CRISTEI",251,"POIANA CRISTEI",177263,1,PART,PRCNCT,PRSD,PRSD_SV,"2025-05-18 21:32:11",223,105,96,9,0,105,0,245,140,91,14
41,VRANCEA,"SCOALA GIMNAZIALA PROFESOR DOCTOR GENERAL GHEORGHE V. ZAHARIA",252,POPEŞTI,178901,1,PART,PRCNCT,PRSD,PRSD_SV,"2025-05-18 21:37:13",1076,593,494,99,0,589,4,1185,592,366,223
41,VRANCEA,"GRĂDINIȚA CU PROGRAM NORMAL NR.2 POPEȘTI",253,POPEŞTI,178901,1,PART,PRCNCT,PRSD,PRSD_SV,"2025-05-18 21:39:31",889,465,417,48,0,460,5,975,510,307,153
41,VRANCEA,"SCOALA PRIMARA TERCHESTI",254,POPEŞTI,178901,1,PART,PRCNCT,PRSD,PRSD_SV,"2025-05-18 21:35:08",451,204,175,29,0,204,0,495,291,147,57
41,VRANCEA,"ŞCOALA GIMNAZIALĂ PUFEŞTI",255,PUFEŞTI,177352,1,PART,PRCNCT,PRSD,PRSD_SV,"2025-05-18 22:07:01",1263,610,548,62,0,603,7,1390,780,371,232
41,VRANCEA,"GRĂDINIŢA CIORANI",256,PUFEŞTI,177352,2,PART,PRCNCT,PRSD,PRSD_SV,"2025-05-19 00:37:31",791,394,352,42,0,387,7,870,476,264,123
41,VRANCEA,"ŞCOALA GIMNAZIALĂ DOMNEŞTI-TÂRG",257,PUFEŞTI,177352,1,PART,PRCNCT,PRSD,PRSD_SV,"2025-05-18 22:01:49",1236,596,548,47,1,592,4,1360,764,368,224
41,VRANCEA,"CĂMINUL CULTURAL RĂCOASA",258,RĂCOASA,177405,1,PART,PRCNCT,PRSD,PRSD_SV,"2025-05-18 22:00:56",895,391,343,46,2,386,5,985,594,210,176
41,VRANCEA,"SCOALA GOGOIU",259,RĂCOASA,177405,1,PART,PRCNCT,PRSD,PRSD_SV,"2025-05-18 21:30:31",183,108,81,24,3,108,0,200,92,63,45
41,VRANCEA,"SALA DE ȘEDINȚE MĂRĂȘTI",260,RĂCOASA,177405,1,PART,PRCNCT,PRSD,PRSD_SV,"2025-05-18 21:42:57",375,174,143,30,1,169,5,415,241,108,61
41,VRANCEA,"GRĂDINIȚA CU PROGRAM NORMAL VARNIȚA",261,RĂCOASA,177405,1,PART,PRCNCT,PRSD,PRSD_SV,"2025-05-18 21:38:37",441,218,179,38,1,218,0,485,267,138,80
41,VRANCEA,"CĂMIN CULTURAL VERDEA",262,RĂCOASA,177405,1,PART,PRCNCT,PRSD,PRSD_SV,"2025-05-18 21:55:47",551,297,250,47,0,293,4,605,308,215,78
41,VRANCEA,"ŞCOALA GIMNAZIALĂ CU CLASELE I-VIII RĂSTOACA",263,RĂSTOACA,178956,1,PART,PRCNCT,PRSD,PRSD_SV,"2025-05-18 21:54:01",1188,600,531,65,4,588,12,1305,705,289,299
41,VRANCEA,"ŞCOALA GIMNAZIALĂ CU CLASELE I-VIII RĂSTOACA",264,RĂSTOACA,178956,1,PART,PRCNCT,PRSD,PRSD_SV,"2025-05-18 21:57:38",820,425,373,47,5,416,9,900,475,213,203
41,VRANCEA,"ȘCOALA PRIMARĂ RĂIUȚI",265,REGHIU,177469,1,PART,PRCNCT,PRSD,PRSD_SV,"2025-05-18 21:22:48",232,129,111,18,0,127,2,255,126,61,66
41,VRANCEA,"ȘCOALA GIMNAZIALĂ NR.1 ȘINDRILARI",266,REGHIU,177469,1,PART,PRCNCT,PRSD,PRSD_SV,"2025-05-18 21:47:23",928,433,398,34,1,430,3,1025,592,268,162
41,VRANCEA,"ȘCOALA GIMNAZIALĂ NR.1 ȘINDRILARI",267,REGHIU,177469,1,PART,PRCNCT,PRSD,PRSD_SV,"2025-05-18 21:29:35",490,220,203,17,0,219,1,540,320,128,91
41,VRANCEA,"ȘCOALA GIMNAZIALĂ RUGINEȘTI",268,RUGINEŞTI,177557,1,PART,PRCNCT,PRSD,PRSD_SV,"2025-05-18 21:29:10",789,351,309,42,0,347,4,870,519,213,134
41,VRANCEA,"ȘCOALA GIMNAZIALĂ RUGINEȘTI",269,RUGINEŞTI,177557,1,PART,PRCNCT,PRSD,PRSD_SV,"2025-05-18 21:51:21",751,360,326,34,0,353,7,830,470,209,144
41,VRANCEA,"SCOALA GIMNAZIALA ANGHELESTI",270,RUGINEŞTI,177557,1,PART,PRCNCT,PRSD,PRSD_SV,"2025-05-18 21:37:11",1014,443,403,40,0,437,6,1115,672,282,155
41,VRANCEA,"SCOALA GENERALA",271,RUGINEŞTI,177557,1,PART,PRCNCT,PRSD,PRSD_SV,"2025-05-18 21:28:04",545,251,214,37,0,244,7,600,349,154,90
41,VRANCEA,"SCOALA GENERALA",272,RUGINEŞTI,177557,1,PART,PRCNCT,PRSD,PRSD_SV,"2025-05-18 21:30:56",244,132,110,22,0,131,1,270,138,69,62
41,VRANCEA,"PRIMARIA COMUNEI SIHLEA",273,SIHLEA,177600,1,PART,PRCNCT,PRSD,PRSD_SV,"2025-05-18 22:00:10",1887,815,736,75,4,803,12,2075,1260,509,294
41,VRANCEA,"CĂMINUL CULTURAL BOGZA",274,SIHLEA,177600,1,PART,PRCNCT,PRSD,PRSD_SV,"2025-05-18 22:03:21",654,329,249,78,2,322,7,720,391,201,121
41,VRANCEA,"ȘCOALA PRIMARĂ CĂIATA",275,SIHLEA,177600,1,PART,PRCNCT,PRSD,PRSD_SV,"2025-05-18 21:35:12",600,316,255,61,0,310,6,660,344,210,100
41,VRANCEA,"ȘCOALA GIMNAZIALĂ VOETIN",276,SIHLEA,177600,1,PART,PRCNCT,PRSD,PRSD_SV,"2025-05-18 21:35:05",839,383,298,74,11,379,4,925,542,256,123
41,VRANCEA,"ŞCOALA GIMNAZIALĂ SLOBOZIA BRADULUI SALA A",277,"SLOBOZIA BRADULUI",177655,1,PART,PRCNCT,PRSD,PRSD_SV,"2025-05-18 21:50:58",878,364,348,16,0,358,6,965,601,266,92
41,VRANCEA,"ŞCOALA GIMNAZIALĂ SLOBOZIA BRADULUI SALA B",278,"SLOBOZIA BRADULUI",177655,1,PART,PRCNCT,PRSD,PRSD_SV,"2025-05-18 21:53:24",1031,408,394,14,0,401,7,1135,727,292,109
41,VRANCEA,"ŞCOALA GIMNAZIALĂ SLOBOZIA BRADULUI SALA C",279,"SLOBOZIA BRADULUI",177655,1,PART,PRCNCT,PRSD,PRSD_SV,"2025-05-18 21:49:05",1344,440,424,16,0,434,6,1480,1040,243,191
41,VRANCEA,"ŞCOALA PRIMARĂ CORNETU SALA A",280,"SLOBOZIA BRADULUI",177655,1,PART,PRCNCT,PRSD,PRSD_SV,"2025-05-18 21:29:15",557,231,215,16,0,231,0,615,384,90,141
41,VRANCEA,"ŞCOALA PRIMARĂ CORNETU SALA B",281,"SLOBOZIA BRADULUI",177655,2,PART,PRCNCT,PRSD,PRSD_SV,"2025-05-19 00:34:08",607,269,261,8,0,261,8,670,401,104,157
41,VRANCEA,"ŞCOALA GIMNAZIALĂ COROTENI",282,"SLOBOZIA BRADULUI",177655,1,PART,PRCNCT,PRSD,PRSD_SV,"2025-05-18 21:37:18",765,395,332,63,0,391,4,840,445,244,147
41,VRANCEA,"CĂMINUL CULTURAL",283,"SLOBOZIA CIORĂŞTI",177726,1,PART,PRCNCT,PRSD,PRSD_SV,"2025-05-18 21:45:22",1071,557,476,81,0,552,5,1180,623,352,200
41,VRANCEA,"GRĂDINIȚA CU PROGRAM NORMAL JILIȘTE",284,"SLOBOZIA CIORĂŞTI",177726,1,PART,PRCNCT,PRSD,PRSD_SV,"2025-05-18 21:35:48",576,326,289,35,2,324,2,635,309,217,107
41,VRANCEA,"SCOALA GENERAL[ SIMION MEHEDINTI",285,SOVEJA,177762,1,PART,PRCNCT,PRSD,PRSD_SV,"2025-05-18 21:43:05",961,644,467,171,6,634,10,1055,411,255,379
41,VRANCEA,"GRĂDINIŢA CU PROGRAM NORMAL RUCĂRENI",286,SOVEJA,177762,1,PART,PRCNCT,PRSD,PRSD_SV,"2025-05-18 21:36:44",665,387,306,63,18,383,4,730,343,160,223
41,VRANCEA,"ȘCOALA GIMNAZIALĂ SPULBER",287,SPULBER,178965,1,PART,PRCNCT,PRSD,PRSD_SV,"2025-05-18 22:22:10",907,493,427,28,38,490,3,1000,507,227,263
41,VRANCEA,"ȘCOALA PRIMARĂ PĂVĂLARI",288,SPULBER,178965,1,PART,PRCNCT,PRSD,PRSD_SV,"2025-05-18 21:38:43",99,57,45,12,0,57,0,111,54,30,27
41,VRANCEA,"CAMINUL CULTURAL STRAOANE DE JOS",289,STRĂOANE,177799,2,PART,PRCNCT,PRSD,PRSD_SV,"2025-05-19 00:46:45",1092,558,489,69,0,553,5,1200,642,301,252
41,VRANCEA,"CAMINUL CULTURAL STRAOANE DE SUS",290,STRĂOANE,177799,1,PART,PRCNCT,PRSD,PRSD_SV,"2025-05-18 21:57:55",707,353,305,48,0,347,6,775,422,184,163
41,VRANCEA,"CAMIN CULTURAL",291,STRĂOANE,177799,1,PART,PRCNCT,PRSD,PRSD_SV,"2025-05-18 21:44:20",753,401,352,48,1,400,1,830,429,218,182
41,VRANCEA,"SCOALA GENERALA REPEDEA",292,STRĂOANE,177799,1,PART,PRCNCT,PRSD,PRSD_SV,"2025-05-18 21:23:26",295,150,123,27,0,148,2,330,180,91,57
41,VRANCEA,"SCOALA GIMNAZIALA SURAIA",293,SURAIA,177842,1,PART,PRCNCT,PRSD,PRSD_SV,"2025-05-18 21:57:15",1726,736,637,98,1,730,6,1900,1164,420,310
41,VRANCEA,"MUZEUL SATULUI",294,SURAIA,177842,1,PART,PRCNCT,PRSD,PRSD_SV,"2025-05-18 22:07:59",1536,699,618,80,1,691,8,1690,991,359,332
41,VRANCEA,"GRĂDINIȚA CU PROGRAM NORMAL NR. 2 SURAIA",295,SURAIA,177842,1,PART,PRCNCT,PRSD,PRSD_SV,"2025-05-18 22:16:23",1575,685,614,69,2,675,10,1730,1045,404,271
41,VRANCEA,"CONSILIUL LOCAL TĂNĂSOAIA",296,TĂNĂSOAIA,177879,1,PART,PRCNCT,PRSD,PRSD_SV,"2025-05-18 21:39:27",696,383,319,46,18,379,4,765,382,214,165
41,VRANCEA,"ȘCOALA PRIMARĂ COSTIȘA",297,TĂNĂSOAIA,177879,1,PART,PRCNCT,PRSD,PRSD_SV,"2025-05-18 21:17:22",177,115,77,26,12,115,0,195,80,53,62
41,VRANCEA,"ȘCOALA GIMNAZIALĂ FELDIOARA",298,TĂNĂSOAIA,177879,1,PART,PRCNCT,PRSD,PRSD_SV,"2025-05-18 21:33:34",529,269,225,32,12,266,3,580,311,191,75
41,VRANCEA,"ȘCOALA PRIMARĂ VLADNICU DE SUS",299,TĂNĂSOAIA,177879,1,PART,PRCNCT,PRSD,PRSD_SV,"2025-05-18 21:27:38",186,131,91,30,10,131,0,205,74,78,53
41,VRANCEA,"CĂMIN CULTURAL TĂTĂRANU",300,TĂTĂRANU,177986,1,PART,PRCNCT,PRSD,PRSD_SV,"2025-05-18 22:09:38",1099,535,446,89,0,529,6,1210,675,302,227
41,VRANCEA,"FOSTA SCOALA GENERALA BORDEASCA NOUA",301,TĂTĂRANU,177986,1,PART,PRCNCT,PRSD,PRSD_SV,"2025-05-18 21:26:32",314,179,126,53,0,175,4,345,166,100,75
41,VRANCEA,"SCOALA GIMNAZIALA NR. 2 BORDEASCA VECHE",302,TĂTĂRANU,177986,1,PART,PRCNCT,PRSD,PRSD_SV,"2025-05-18 21:51:59",577,308,245,63,0,299,9,635,327,185,114
41,VRANCEA,"FOSTA SCOALA GENERALA NR. 1 BORDEASCA VECHE",303,TĂTĂRANU,177986,1,PART,PRCNCT,PRSD,PRSD_SV,"2025-05-18 21:51:23",834,391,319,72,0,385,6,915,524,218,167
41,VRANCEA,"FOSTA SCOALA GENERALA MARTINESTI",304,TĂTĂRANU,177986,1,PART,PRCNCT,PRSD,PRSD_SV,"2025-05-18 21:37:54",484,253,205,48,0,247,6,535,282,140,107
41,VRANCEA,"FOSTA SCOALA PRIMARA VIJIITOAREA",305,TĂTĂRANU,177986,1,PART,PRCNCT,PRSD,PRSD_SV,"2025-05-18 22:03:48",171,107,72,35,0,107,0,190,83,61,46
41,VRANCEA,PRIMARIE,306,TÂMBOEŞTI,178046,2,PART,PRCNCT,PRSD,PRSD_SV,"2025-05-19 00:29:42",1195,702,609,80,13,692,10,1315,613,397,295
41,VRANCEA,"SCOALA SLIMNIC",307,TÂMBOEŞTI,178046,1,PART,PRCNCT,PRSD,PRSD_SV,"2025-05-18 22:01:20",971,580,460,103,17,569,11,1070,490,333,236
41,VRANCEA,"SCOALA TRESTIENI",308,TÂMBOEŞTI,178046,1,PART,PRCNCT,PRSD,PRSD_SV,"2025-05-18 21:27:54",126,89,66,21,2,88,1,140,51,53,35
41,VRANCEA,"CASA OBŞTII TULNICI",309,TULNICI,178117,1,PART,PRCNCT,PRSD,PRSD_SV,"2025-05-18 21:42:23",1147,549,493,56,0,539,10,1260,711,233,306
41,VRANCEA,"CASA OBŞTII TULNICI",310,TULNICI,178117,1,PART,PRCNCT,PRSD,PRSD_SV,"2025-05-18 21:42:35",1122,500,460,39,1,495,5,1035,535,260,235
41,VRANCEA,"ŞCOALA GIMNAZIALĂ COZA - SALA 1",311,TULNICI,178117,1,PART,PRCNCT,PRSD,PRSD_SV,"2025-05-18 21:47:33",634,286,256,30,0,282,4,695,409,133,149
41,VRANCEA,"ŞCOALA LEPŞA",312,TULNICI,178117,1,PART,PRCNCT,PRSD,PRSD_SV,"2025-05-18 21:58:36",414,432,179,253,0,423,9,654,222,201,222
41,VRANCEA,"ȘCOALA GIMNAZIALĂ ȚIFEȘTI",313,ŢIFEŞTI,178180,1,PART,PRCNCT,PRSD,PRSD_SV,"2025-05-18 21:45:08",831,472,397,75,0,466,6,915,443,238,228
41,VRANCEA,"ȘCOALA GIMNAZIALĂ BĂTINEȘTI",314,ŢIFEŞTI,178180,1,PART,PRCNCT,PRSD,PRSD_SV,"2025-05-18 21:29:46",1341,688,593,95,0,680,8,1475,787,415,265
41,VRANCEA,"ȘCOALA GIMNAZIALĂ CLIPICEȘTI",315,ŢIFEŞTI,178180,1,PART,PRCNCT,PRSD,PRSD_SV,"2025-05-18 21:29:46",650,304,261,43,0,304,0,715,411,197,107
41,VRANCEA,"ȘCOALA CU CLASELE I-IV OLEȘEȘTI",316,ŢIFEŞTI,178180,1,PART,PRCNCT,PRSD,PRSD_SV,"2025-05-18 21:35:18",700,376,338,38,0,375,1,770,394,211,164
41,VRANCEA,"GRĂDINIȚA CU PROGRAM NORNAL SÎRBI",317,ŢIFEŞTI,178180,1,PART,PRCNCT,PRSD,PRSD_SV,"2025-05-18 21:29:47",588,307,249,58,0,304,3,645,338,148,156
41,VRANCEA,"CONSILIUL LOCAL URECHEŞTI",318,URECHEŞTI,178279,1,PART,PRCNCT,PRSD,PRSD_SV,"2025-05-18 21:46:26",1731,911,763,148,0,903,8,1905,994,582,321
41,VRANCEA,"ŞCOALA PRIMARĂ URECHEŞTI",319,URECHEŞTI,178279,1,PART,PRCNCT,PRSD,PRSD_SV,"2025-05-18 21:30:01",458,299,223,76,0,299,0,505,206,166,133
41,VRANCEA,"SCOALA GIMNAZIALĂ ” VASILE IFTIMESCU ” VALEA SARII",320,"VALEA SĂRII",178313,1,PART,PRCNCT,PRSD,PRSD_SV,"2025-05-18 21:50:32",646,289,255,31,3,285,4,710,421,178,107
41,VRANCEA,"SALĂ FESTIVITĂŢI",321,"VALEA SĂRII",178313,1,PART,PRCNCT,PRSD,PRSD_SV,"2025-05-18 21:46:05",602,290,246,41,3,287,3,665,375,155,132
41,VRANCEA,"SCOALA GENERALA PODURI",322,"VALEA SĂRII",178313,1,PART,PRCNCT,PRSD,PRSD_SV,"2025-05-18 21:21:28",216,118,101,17,0,117,1,240,122,64,53
41,VRANCEA,"OBŞTEA PRISACA",323,"VALEA SĂRII",178313,1,PART,PRCNCT,PRSD,PRSD_SV,"2025-05-18 21:17:39",137,86,67,19,0,84,2,150,64,53,31
41,VRANCEA,"ŞCOALA GIMNAZIALĂ VÎNĂTORI",324,VÂNĂTORI,178607,1,PART,PRCNCT,PRSD,PRSD_SV,"2025-05-18 22:11:32",1433,906,767,136,3,895,11,1575,669,348,547
41,VRANCEA,"ŞCOALA PRIMARĂ BALTA RAŢEI",325,VÂNĂTORI,178607,1,PART,PRCNCT,PRSD,PRSD_SV,"2025-05-18 21:26:31",240,125,92,33,0,125,0,265,140,70,55
41,VRANCEA,"GRĂDINIŢA CU PROGRAM NORMAL JORĂŞTI",326,VÂNĂTORI,178607,1,PART,PRCNCT,PRSD,PRSD_SV,"2025-05-18 22:15:26",1288,722,635,86,1,714,8,1420,698,406,308
41,VRANCEA,"ŞCOALA GIMNAZIALĂ MIRCEŞTII NOI",327,VÂNĂTORI,178607,1,PART,PRCNCT,PRSD,PRSD_SV,"2025-05-18 21:56:01",775,501,385,113,3,493,8,855,354,258,235
41,VRANCEA,"DISPENSARUL UMAN MIRCEŞTII VECHI",328,VÂNĂTORI,178607,1,PART,PRCNCT,PRSD,PRSD_SV,"2025-05-18 21:32:37",275,182,133,49,0,180,2,305,123,92,88
41,VRANCEA,"GRĂDINIŢA CU PROGRAM PRELUNGIT PETREŞTI",329,VÂNĂTORI,178607,3,PART,PRCNCT,PRSD,PRSD_SV,"2025-05-19 00:57:43",1289,783,647,136,0,775,8,1420,637,370,405
41,VRANCEA,"GRĂDINIŢA CU PROGRAM NORMAL RĂDULEŞTI",330,VÂNĂTORI,178607,1,PART,PRCNCT,PRSD,PRSD_SV,"2025-05-18 21:56:09",693,411,329,82,0,408,3,760,349,269,139
41,VRANCEA,"CAMIN CULTURAL VIRTESCOIU",331,VÂRTEŞCOIU,178689,1,PART,PRCNCT,PRSD,PRSD_SV,"2025-05-18 22:20:58",1280,671,577,89,5,661,10,1410,739,432,229
41,VRANCEA,"SCOALA BECIU",332,VÂRTEŞCOIU,178689,1,PART,PRCNCT,PRSD,PRSD_SV,"2025-05-18 21:41:39",365,214,179,34,1,212,2,400,186,143,69
41,VRANCEA,"CĂMIN CULTURAL FARAOANELE",333,VÂRTEŞCOIU,178689,1,PART,PRCNCT,PRSD,PRSD_SV,"2025-05-18 21:44:04",962,520,462,57,1,512,8,1060,540,322,190
41,VRANCEA,"SCOALA PRIMARA RIMNICEANCA",334,VÂRTEŞCOIU,178689,1,PART,PRCNCT,PRSD,PRSD_SV,"2025-05-18 21:32:13",247,149,126,23,0,147,2,275,126,103,44
41,VRANCEA,"SALA DE SPORT VIDRA",335,VIDRA,178377,1,PART,PRCNCT,PRSD,PRSD_SV,"2025-05-18 23:03:52",1446,759,598,146,15,742,17,1590,831,370,372
41,VRANCEA,"SCOALA GENERALA",336,VIDRA,178377,1,PART,PRCNCT,PRSD,PRSD_SV,"2025-05-18 21:42:34",635,309,272,37,0,307,2,700,391,225,82
41,VRANCEA,"SCOALA GENERALA",337,VIDRA,178377,1,PART,PRCNCT,PRSD,PRSD_SV,"2025-05-18 21:53:49",726,304,283,21,0,298,6,800,496,243,55
41,VRANCEA,"SCOALA GENERALA",338,VIDRA,178377,1,PART,PRCNCT,PRSD,PRSD_SV,"2025-05-18 22:03:42",692,343,267,74,2,339,4,759,416,187,152
41,VRANCEA,"SCOALA GENERALA",339,VIDRA,178377,1,PART,PRCNCT,PRSD,PRSD_SV,"2025-05-18 22:14:10",343,168,151,17,0,168,0,375,207,116,52
41,VRANCEA,"SCOALA GENERALA",340,VIDRA,178377,1,PART,PRCNCT,PRSD,PRSD_SV,"2025-05-18 21:37:01",439,211,175,35,1,209,2,485,274,123,86
41,VRANCEA,"ȘCOALA GENERALĂ TICHIRIȘ - ȘCOALA NOUĂ",341,VIDRA,178377,1,PART,PRCNCT,PRSD,PRSD_SV,"2025-05-18 22:04:27",589,287,263,23,1,281,6,650,363,173,108
41,VRANCEA,"SCOALA GENERALA",342,VIDRA,178377,1,PART,PRCNCT,PRSD,PRSD_SV,"2025-05-18 21:51:26",530,218,202,16,0,214,4,585,367,138,76
41,VRANCEA,"SCOALA GENERALA",343,VIDRA,178377,1,PART,PRCNCT,PRSD,PRSD_SV,"2025-05-18 21:39:46",262,136,116,20,0,130,6,290,154,80,50
41,VRANCEA,"AȘEZĂMÂNT CULTURAL",344,VINTILEASCA,178475,1,PART,PRCNCT,PRSD,PRSD_SV,"2025-05-18 21:20:59",594,239,221,18,0,231,8,655,416,152,79
41,VRANCEA,"SCOALA GIMNAZIALA „ PICTOR MIHAIL BALASESCU” BAHNELE",345,VINTILEASCA,178475,1,PART,PRCNCT,PRSD,PRSD_SV,"2025-05-18 21:21:48",452,177,158,19,0,176,1,495,318,143,33
41,VRANCEA,"SCOALA ION CREANGA DUPA MAGURA",346,VINTILEASCA,178475,1,PART,PRCNCT,PRSD,PRSD_SV,"2025-05-18 21:12:10",59,41,27,14,0,41,0,65,24,32,9
41,VRANCEA,"GRADINITA „VOINICELUL” NECULELE",347,VINTILEASCA,178475,1,PART,PRCNCT,PRSD,PRSD_SV,"2025-05-18 21:26:24",356,159,133,26,0,158,1,390,231,120,38
41,VRANCEA,"STAȚIE DE AȘTEPTARE MICROBUZ",348,VINTILEASCA,178475,1,PART,PRCNCT,PRSD,PRSD_SV,"2025-05-18 21:13:57",54,38,27,11,0,38,0,60,22,31,7
41,VRANCEA,"SCOALA DIN LIVEZILE",349,VIZANTEA-LIVEZI,178545,1,PART,PRCNCT,PRSD,PRSD_SV,"2025-05-18 22:13:06",569,296,252,32,12,291,5,625,329,158,133
41,VRANCEA,"SCOALA DIN MESTEACANU",350,VIZANTEA-LIVEZI,178545,1,PART,PRCNCT,PRSD,PRSD_SV,"2025-05-18 21:39:56",278,121,108,13,0,120,1,305,184,84,36
41,VRANCEA,"SOALA DIN PIISCU-RADULUI",351,VIZANTEA-LIVEZI,178545,1,PART,PRCNCT,PRSD,PRSD_SV,"2025-05-18 21:24:53",330,156,132,22,2,156,0,365,209,102,54
41,VRANCEA,"SCOALA DIN VIZANTEA MANASTIREASCA",352,VIZANTEA-LIVEZI,178545,1,PART,PRCNCT,PRSD,PRSD_SV,"2025-05-18 21:40:53",1338,574,482,51,41,570,4,1470,896,206,364
41,VRANCEA,"SCOALA DIN VIZANTEA RAZASEASCA",353,VIZANTEA-LIVEZI,178545,1,PART,PRCNCT,PRSD,PRSD_SV,"2025-05-18 21:35:49",557,254,209,39,6,252,2,615,361,103,149
41,VRANCEA,"SALA DE ŞEDINŢE ŞI WORKSHOP",354,VRÂNCIOAIA,178750,1,PART,PRCNCT,PRSD,PRSD_SV,"2025-05-18 21:42:29",474,187,172,14,1,187,0,520,333,100,87
41,VRANCEA,"SALA DE FESTIVITĂŢI MUNCEI",355,VRÂNCIOAIA,178750,1,PART,PRCNCT,PRSD,PRSD_SV,"2025-05-18 21:48:21",521,186,171,15,0,185,1,575,389,111,74
41,VRANCEA,"ŞCOALA PRIMARĂ POIANA - SALA GRĂDINIȚEI",356,VRÂNCIOAIA,178750,1,PART,PRCNCT,PRSD,PRSD_SV,"2025-05-18 21:45:07",546,207,180,24,3,203,4,600,393,128,75
41,VRANCEA,"CĂMIN CULTURAL SAT SPINEȘTI",357,VRÂNCIOAIA,178750,1,PART,PRCNCT,PRSD,PRSD_SV,"2025-05-18 21:43:12",592,223,206,17,0,219,4,650,427,117,102
41,VRANCEA,"SCOALA GENERALA VULTURU",358,VULTURU,178821,2,PART,PRCNCT,PRSD,PRSD_SV,"2025-05-19 01:05:02",1276,555,448,106,1,546,9,1305,750,282,264
41,VRANCEA,"SCOALA GENERALA VULTURU",359,VULTURU,178821,1,PART,PRCNCT,PRSD,PRSD_SV,"2025-05-18 21:44:42",1250,487,430,56,1,481,6,1375,888,260,221
41,VRANCEA,"GRADINITA NR 1",360,VULTURU,178821,1,PART,PRCNCT,PRSD,PRSD_SV,"2025-05-18 21:47:47",1265,495,441,54,0,491,4,1390,895,264,227
41,VRANCEA,"SCOALA BOTARLAU",361,VULTURU,178821,1,PART,PRCNCT,PRSD,PRSD_SV,"2025-05-18 21:58:24",1226,531,422,109,0,528,3,1350,819,299,229
41,VRANCEA,"SCOALA HANGULESTI",362,VULTURU,178821,1,PART,PRCNCT,PRSD,PRSD_SV,"2025-05-18 22:01:33",888,446,340,106,0,444,2,975,529,208,236
41,VRANCEA,"SCOALA MALURI",363,VULTURU,178821,1,PART,PRCNCT,PRSD,PRSD_SV,"2025-05-18 21:48:25",395,226,157,69,0,225,1,435,209,106,119
41,VRANCEA,"SCOALA VADU ROSCA",364,VULTURU,178821,2,PART,PRCNCT,PRSD,PRSD_SV,"2025-05-19 01:05:44",526,193,151,42,0,193,0,580,387,122,71
43,STRĂINĂTATE,PRETORIA,1,"AFRICA DE SUD",9999,1,PART,PRCNCT,PRSD,PRSD_SV_D,"2025-05-18 21:46:06",0,104,0,104,0,104,0,400,296,31,73
43,STRĂINĂTATE,"CAPE TOWN",2,"AFRICA DE SUD",9999,1,PART,PRCNCT,PRSD,PRSD_SV_D,"2025-05-18 22:15:31",0,104,0,104,0,103,1,392,288,27,76
43,STRĂINĂTATE,TIRANA,3,"REPUBLICA ALBANIA",9999,1,PART,PRCNCT,PRSD,PRSD_SV_D,"2025-05-18 21:44:58",0,251,0,251,0,247,4,1600,1349,58,189
43,STRĂINĂTATE,ALGER,4,ALGERIA,9999,1,PART,PRCNCT,PRSD,PRSD_SV_D,"2025-05-18 22:01:15",0,36,0,36,0,34,2,400,364,6,28
43,STRĂINĂTATE,LUANDA,5,ANGOLA,9999,1,PART,PRCNCT,PRSD,PRSD_SV_D,"2025-05-18 21:53:49",0,21,0,21,0,18,3,400,379,3,15
43,STRĂINĂTATE,RIYADH,6,"REGATUL ARABIEI SAUDITE",9999,1,PART,PRCNCT,PRSD,PRSD_SV_D,"2025-05-18 21:51:01",0,235,0,235,0,235,0,400,165,21,214
43,STRĂINĂTATE,"BUENOS AIRES",7,ARGENTINA,9999,1,PART,PRCNCT,PRSD,PRSD_SV_D,"2025-05-18 21:56:14",0,66,0,66,0,66,0,400,334,12,54
43,STRĂINĂTATE,EREVAN,8,ARMENIA,9999,1,PART,PRCNCT,PRSD,PRSD_SV_D,"2025-05-18 20:37:18",0,58,0,58,0,56,2,400,342,10,46
43,STRĂINĂTATE,CANBERRA,9,AUSTRALIA,9999,1,PART,PRCNCT,PRSD,PRSD_SV_D,"2025-05-18 14:48:03",0,48,0,48,0,46,2,400,352,10,36
43,STRĂINĂTATE,MELBOURNE,10,AUSTRALIA,9999,1,PART,PRCNCT,PRSD,PRSD_SV_D,"2025-05-18 15:40:30",0,641,0,641,0,637,4,1600,959,196,441
43,STRĂINĂTATE,ADELAIDE,11,AUSTRALIA,9999,2,PART,PRCNCT,PRSD,PRSD_SV_D,"2025-05-18 16:31:56",0,144,0,144,0,143,1,800,656,30,113
43,STRĂINĂTATE,PERTH,12,AUSTRALIA,9999,1,PART,PRCNCT,PRSD,PRSD_SV_D,"2025-05-18 17:44:25",0,313,0,313,0,311,2,800,487,89,222
43,STRĂINĂTATE,AUCKLAND,13,"NOUA ZEELANDĂ",9999,1,PART,PRCNCT,PRSD,PRSD_SV_D,"2025-05-18 13:44:01",0,302,0,302,0,301,1,800,498,37,264
43,STRĂINĂTATE,SYDNEY,14,AUSTRALIA,9999,2,PART,PRCNCT,PRSD,PRSD_SV_D,"2025-05-18 18:12:37",0,451,0,451,0,450,1,1200,749,77,373
43,STRĂINĂTATE,"SURFERS PARADISE",15,AUSTRALIA,9999,1,PART,PRCNCT,PRSD,PRSD_SV_D,"2025-05-18 15:24:07",0,345,0,345,0,345,0,1600,1255,117,228
43,STRĂINĂTATE,"VIENA 1",16,AUSTRIA,9999,1,PART,PRCNCT,PRSD,PRSD_SV_D,"2025-05-19 01:05:26",0,5101,0,5101,0,5084,17,6398,1297,2802,2282
43,STRĂINĂTATE,"VIENA 2",17,AUSTRIA,9999,1,PART,PRCNCT,PRSD,PRSD_SV_D,"2025-05-19 01:46:00",0,5041,0,5041,0,5017,24,6400,1359,2960,2057
43,STRĂINĂTATE,"VIENA 3",18,AUSTRIA,9999,2,PART,PRCNCT,PRSD,PRSD_SV_D,"2025-05-19 03:50:38",0,3481,0,3481,0,3461,20,5600,2119,1877,1584
43,STRĂINĂTATE,"VIENA 4",19,AUSTRIA,9999,1,PART,PRCNCT,PRSD,PRSD_SV_D,"2025-05-18 23:22:46",0,1281,0,1281,0,1275,6,4000,2719,567,708
43,STRĂINĂTATE,"VIENA 5",20,AUSTRIA,9999,1,PART,PRCNCT,PRSD,PRSD_SV_D,"2025-05-18 23:57:43",0,1292,0,1292,0,1285,7,4000,2708,484,801
43,STRĂINĂTATE,"VIENA 6",21,AUSTRIA,9999,1,PART,PRCNCT,PRSD,PRSD_SV_D,"2025-05-19 00:35:46",0,3098,0,3098,0,3082,16,4808,1710,1870,1212
43,STRĂINĂTATE,EISENSTADT,22,AUSTRIA,9999,1,PART,PRCNCT,PRSD,PRSD_SV_D,"2025-05-18 23:31:59",0,3173,0,3173,0,3159,14,4800,1627,2358,801
43,STRĂINĂTATE,"GRAZ 1",23,AUSTRIA,9999,1,PART,PRCNCT,PRSD,PRSD_SV_D,"2025-05-19 01:04:07",0,3793,0,3793,0,3773,20,5600,1807,2745,1028
43,STRĂINĂTATE,"GRAZ 2",24,AUSTRIA,9999,1,PART,PRCNCT,PRSD,PRSD_SV_D,"2025-05-19 00:58:10",0,3791,0,3791,0,3777,14,5607,1816,2921,856
43,STRĂINĂTATE,"SANKT PÖLTEN",25,AUSTRIA,9999,1,PART,PRCNCT,PRSD,PRSD_SV_D,"2025-05-19 00:52:24",0,3221,0,3221,0,3209,12,4799,1578,2485,724
43,STRĂINĂTATE,"SALZBURG 1",26,AUSTRIA,9999,1,PART,PRCNCT,PRSD,PRSD_SV_D,"2025-05-18 23:43:16",0,2300,0,2300,0,2289,11,5600,3300,1521,768
43,STRĂINĂTATE,"SALZBURG 2",27,AUSTRIA,9999,1,PART,PRCNCT,PRSD,PRSD_SV_D,"2025-05-18 23:56:52",0,2318,0,2318,0,2296,22,5600,3282,1545,751
43,STRĂINĂTATE,BREGENZ,28,AUSTRIA,9999,1,PART,PRCNCT,PRSD,PRSD_SV_D,"2025-05-19 01:26:17",0,2806,0,2806,0,2791,15,5600,2794,1745,1046
43,STRĂINĂTATE,INNSBRUCK,29,AUSTRIA,9999,1,PART,PRCNCT,PRSD,PRSD_SV_D,"2025-05-19 00:25:49",0,2304,0,2304,0,2294,10,5600,3296,1582,712
43,STRĂINĂTATE,KLAGENFURT,30,AUSTRIA,9999,1,PART,PRCNCT,PRSD,PRSD_SV_D,"2025-05-18 23:05:10",0,2103,0,2103,0,2091,12,5600,3497,1540,551
43,STRĂINĂTATE,"LINZ 1",31,AUSTRIA,9999,1,PART,PRCNCT,PRSD,PRSD_SV_D,"2025-05-19 00:31:35",0,3973,0,3973,0,3959,14,7200,3227,2993,966
43,STRĂINĂTATE,"LINZ 2",32,AUSTRIA,9999,1,PART,PRCNCT,PRSD,PRSD_SV_D,"2025-05-19 00:04:21",0,4107,0,4107,0,4085,22,7182,3075,2984,1101
43,STRĂINĂTATE,BAKU,33,AZERBAIDJAN,9999,1,PART,PRCNCT,PRSD,PRSD_SV_D,"2025-05-18 20:36:50",0,57,0,57,0,57,0,400,343,14,43
43,STRĂINĂTATE,MINSK,34,"REPUBLICA BELARUS",9999,1,PART,PRCNCT,PRSD,PRSD_SV_D,"2025-05-18 21:42:52",0,22,0,22,0,22,0,400,378,4,18
43,STRĂINĂTATE,"BRUXELLES 1",35,BELGIA,9999,1,PART,PRCNCT,PRSD,PRSD_SV_D,"2025-05-18 23:29:12",0,3933,0,3933,0,3910,23,6800,2867,2462,1448
43,STRĂINĂTATE,"BRUXELLES 2",36,BELGIA,9999,1,PART,PRCNCT,PRSD,PRSD_SV_D,"2025-05-19 00:24:47",0,3473,0,3473,0,3448,25,5600,2127,1737,1711
43,STRĂINĂTATE,"BRUXELLES 3",37,BELGIA,9999,1,PART,PRCNCT,PRSD,PRSD_SV_D,"2025-05-18 23:59:18",0,3430,0,3430,0,3406,24,5600,2170,1536,1870
43,STRĂINĂTATE,"BRUXELLES 4",38,BELGIA,9999,1,PART,PRCNCT,PRSD,PRSD_SV_D,"2025-05-18 23:56:22",0,3291,0,3291,0,3279,12,6400,3109,1169,2110
43,STRĂINĂTATE,"BRUXELLES 5",39,BELGIA,9999,1,PART,PRCNCT,PRSD,PRSD_SV_D,"2025-05-18 23:02:53",0,2579,0,2579,0,2568,11,5600,3021,1524,1044
43,STRĂINĂTATE,"BRUXELLES 6",40,BELGIA,9999,1,PART,PRCNCT,PRSD,PRSD_SV_D,"2025-05-19 00:27:52",0,2823,0,2823,0,2813,10,5600,2777,2063,750
43,STRĂINĂTATE,"BRUXELLES 7",41,BELGIA,9999,1,PART,PRCNCT,PRSD,PRSD_SV_D,"2025-05-19 00:00:43",0,2860,0,2860,0,2851,9,5600,2740,2030,821
43,STRĂINĂTATE,"BRUXELLES 8",42,BELGIA,9999,1,PART,PRCNCT,PRSD,PRSD_SV_D,"2025-05-19 01:02:07",0,2834,0,2834,0,2823,11,5600,2766,2142,681
43,STRĂINĂTATE,"BRUXELLES 9",43,BELGIA,9999,2,PART,PRCNCT,PRSD,PRSD_SV_D,"2025-05-19 02:46:26",0,2825,0,2825,0,2812,13,5592,2767,2159,653
43,STRĂINĂTATE,"BRUXELLES 10",44,BELGIA,9999,1,PART,PRCNCT,PRSD,PRSD_SV_D,"2025-05-18 23:08:42",0,915,0,915,0,907,8,5600,4685,572,335
43,STRĂINĂTATE,"BRUXELLES 11",45,BELGIA,9999,1,PART,PRCNCT,PRSD,PRSD_SV_D,"2025-05-18 23:09:03",0,915,0,915,0,909,6,4400,3485,604,305
43,STRĂINĂTATE,"ANTWERPEN 1",46,BELGIA,9999,1,PART,PRCNCT,PRSD,PRSD_SV_D,"2025-05-18 23:37:07",0,3074,0,3074,0,3050,24,5600,2526,2059,991
43,STRĂINĂTATE,"ANTWERPEN 2",47,BELGIA,9999,1,PART,PRCNCT,PRSD,PRSD_SV_D,"2025-05-18 23:51:52",0,3077,0,3077,0,3065,12,5600,2523,2055,1010
43,STRĂINĂTATE,ARLON,48,BELGIA,9999,1,PART,PRCNCT,PRSD,PRSD_SV_D,"2025-05-18 23:09:18",0,1173,0,1173,0,1168,5,3200,2027,725,443
43,STRĂINĂTATE,"BRUGES 1",49,BELGIA,9999,2,PART,PRCNCT,PRSD,PRSD_SV_D,"2025-05-19 03:36:41",0,1490,0,1490,0,1488,2,5600,4110,1049,439
43,STRĂINĂTATE,"BRUGES 2",50,BELGIA,9999,1,PART,PRCNCT,PRSD,PRSD_SV_D,"2025-05-18 23:18:54",0,1497,0,1497,0,1491,6,5600,4103,1063,428
43,STRĂINĂTATE,CHARLEROI,51,BELGIA,9999,1,PART,PRCNCT,PRSD,PRSD_SV_D,"2025-05-19 00:02:28",0,2293,0,2293,0,2281,12,3216,923,1657,624
43,STRĂINĂTATE,GEEL,52,BELGIA,9999,1,PART,PRCNCT,PRSD,PRSD_SV_D,"2025-05-18 22:34:31",0,1941,0,1941,0,1932,9,3200,1259,1431,501
43,STRĂINĂTATE,GHENT,53,BELGIA,9999,1,PART,PRCNCT,PRSD,PRSD_SV_D,"2025-05-19 00:22:32",0,3014,0,3014,0,3000,12,4000,988,1850,1150
43,STRĂINĂTATE,HASSELT,54,BELGIA,9999,2,PART,PRCNCT,PRSD,PRSD_SV_D,"2025-05-19 05:28:49",0,2053,0,2053,0,2045,8,3208,1155,1443,602
43,STRĂINĂTATE,"LIÈGE 1",55,BELGIA,9999,1,PART,PRCNCT,PRSD,PRSD_SV_D,"2025-05-19 00:14:06",0,1444,0,1444,0,1438,6,3200,1756,964,474
43,STRĂINĂTATE,"LIÈGE 2",56,BELGIA,9999,2,PART,PRCNCT,PRSD,PRSD_SV_D,"2025-05-19 02:41:52",0,1427,0,1427,0,1421,6,3200,1773,1009,412
43,STRĂINĂTATE,MONS,57,BELGIA,9999,1,PART,PRCNCT,PRSD,PRSD_SV_D,"2025-05-18 23:40:18",0,1814,0,1814,0,1809,5,3200,1386,871,938
43,STRĂINĂTATE,NAMUR,58,BELGIA,9999,1,PART,PRCNCT,PRSD,PRSD_SV_D,"2025-05-18 22:41:00",0,1094,0,1094,0,1089,5,3200,2106,594,495
43,STRĂINĂTATE,"ROESELARE 1",59,BELGIA,9999,1,PART,PRCNCT,PRSD,PRSD_SV_D,"2025-05-19 00:17:16",0,2687,0,2687,0,2663,24,5600,2913,1809,854
43,STRĂINĂTATE,"ROESELARE 2",60,BELGIA,9999,1,PART,PRCNCT,PRSD,PRSD_SV_D,"2025-05-18 23:38:51",0,2669,0,2669,0,2645,24,5600,2931,1854,791
43,STRĂINĂTATE,SINT-NIKLAAS,61,BELGIA,9999,2,PART,PRCNCT,PRSD,PRSD_SV_D,"2025-05-19 02:00:09",0,1690,0,1690,0,1677,13,2406,716,1171,506
43,STRĂINĂTATE,"TURNHOUT 1",62,BELGIA,9999,1,PART,PRCNCT,PRSD,PRSD_SV_D,"2025-05-18 23:35:05",0,2635,0,2635,0,2615,20,5600,2965,2160,455
43,STRĂINĂTATE,"TURNHOUT 2",63,BELGIA,9999,1,PART,PRCNCT,PRSD,PRSD_SV_D,"2025-05-19 00:22:01",0,2719,0,2719,0,2700,19,5600,2881,2262,438
43,STRĂINĂTATE,SARAJEVO,64,"BOSNIA ȘI HERȚEGOVINA",9999,1,PART,PRCNCT,PRSD,PRSD_SV_D,"2025-05-18 23:38:02",0,852,0,852,0,844,8,2400,1548,288,556
43,STRĂINĂTATE,BRASILIA,65,BRAZILIA,9999,1,PART,PRCNCT,PRSD,PRSD_SV_D,"2025-05-18 21:20:43",0,7,0,7,0,7,0,400,393,0,7
43,STRĂINĂTATE,CHAPECO,66,BRAZILIA,9999,2,PART,PRCNCT,PRSD,PRSD_SV_D,"2025-05-18 22:28:31",0,34,0,34,0,34,0,400,366,8,26
43,STRĂINĂTATE,"RIO DE JANEIRO",67,BRAZILIA,9999,1,PART,PRCNCT,PRSD,PRSD_SV_D,"2025-05-18 21:44:16",0,102,0,102,0,99,3,400,298,17,82
43,STRĂINĂTATE,"SÃO PAULO",68,BRAZILIA,9999,1,PART,PRCNCT,PRSD,PRSD_SV_D,"2025-05-18 21:28:11",0,93,0,93,0,93,0,400,307,6,87
43,STRĂINĂTATE,SOFIA,69,BULGARIA,9999,1,PART,PRCNCT,PRSD,PRSD_SV_D,"2025-05-18 22:03:48",0,829,0,829,0,826,3,3200,2371,193,633
43,STRĂINĂTATE,OTTAWA,70,CANADA,9999,1,PART,PRCNCT,PRSD,PRSD_SV_D,"2025-05-18 23:08:01",0,916,0,916,0,916,0,1600,684,218,698
43,STRĂINĂTATE,CALGARY,71,CANADA,9999,1,PART,PRCNCT,PRSD,PRSD_SV_D,"2025-05-18 23:15:00",0,924,0,924,0,920,4,1600,676,332,588
43,STRĂINĂTATE,MONCTON,72,CANADA,9999,1,PART,PRCNCT,PRSD,PRSD_SV_D,"2025-05-18 21:52:57",0,129,0,129,0,128,1,1600,1471,46,82
43,STRĂINĂTATE,QUEBEC,73,CANADA,9999,1,PART,PRCNCT,PRSD,PRSD_SV_D,"2025-05-18 22:27:52",0,164,0,164,0,164,0,1600,1436,46,118
43,STRĂINĂTATE,TORONTO,74,CANADA,9999,1,PART,PRCNCT,PRSD,PRSD_SV_D,"2025-05-18 23:45:51",0,3966,0,3966,0,3956,10,6392,2426,1092,2864
43,STRĂINĂTATE,HAMILTON,75,CANADA,9999,1,PART,PRCNCT,PRSD,PRSD_SV_D,"2025-05-18 22:45:36",0,924,0,924,0,922,2,4000,3076,225,697
43,STRĂINĂTATE,KITCHENER,76,CANADA,9999,1,PART,PRCNCT,PRSD,PRSD_SV_D,"2025-05-19 00:31:50",0,1124,0,1124,0,1119,5,4000,2876,486,633
43,STRĂINĂTATE,WINDSOR,77,CANADA,9999,1,PART,PRCNCT,PRSD,PRSD_SV_D,"2025-05-18 22:24:03",0,508,0,508,0,505,3,3184,2676,216,289
43,STRĂINĂTATE,WINNIPEG,78,CANADA,9999,1,PART,PRCNCT,PRSD,PRSD_SV_D,"2025-05-18 21:47:33",0,76,0,76,0,76,0,1600,1524,31,45
43,STRĂINĂTATE,"MONTREAL 1",79,CANADA,9999,1,PART,PRCNCT,PRSD,PRSD_SV_D,"2025-05-19 01:31:51",0,2304,0,2304,0,2287,17,5200,2896,678,1609
43,STRĂINĂTATE,"MONTREAL 2",80,CANADA,9999,1,PART,PRCNCT,PRSD,PRSD_SV_D,"2025-05-19 00:25:52",0,2316,0,2316,0,2301,15,5200,2884,692,1609
43,STRĂINĂTATE,VANCOUVER,81,CANADA,9999,1,PART,PRCNCT,PRSD,PRSD_SV_D,"2025-05-18 23:07:38",0,1381,0,1381,0,1374,7,2400,1019,440,934
43,STRĂINĂTATE,EDMONTON,82,CANADA,9999,3,PART,PRCNCT,PRSD,PRSD_SV_D,"2025-05-19 01:07:27",0,490,0,490,0,490,0,2400,1910,202,288
43,STRĂINĂTATE,"PRAGA 1",83,"REPUBLICA CEHĂ",9999,2,PART,PRCNCT,PRSD,PRSD_SV_D,"2025-05-19 01:45:33",0,1404,0,1404,0,1400,4,4000,2596,470,930
43,STRĂINĂTATE,"PRAGA 2",84,"REPUBLICA CEHĂ",9999,1,PART,PRCNCT,PRSD,PRSD_SV_D,"2025-05-18 23:12:59",0,1345,0,1345,0,1341,4,4000,2655,373,968
43,STRĂINĂTATE,"PRAGA 3",85,"REPUBLICA CEHĂ",9999,1,PART,PRCNCT,PRSD,PRSD_SV_D,"2025-05-18 22:17:16",0,186,0,186,0,185,1,4000,3814,40,145
43,STRĂINĂTATE,"SANTIAGO DE CHILE",86,"REPUBLICA CHILE",9999,1,PART,PRCNCT,PRSD,PRSD_SV_D,"2025-05-18 21:55:33",0,84,0,84,0,82,2,400,316,8,74
43,STRĂINĂTATE,BEIJING,87,"REPUBLICA POPULARĂ CHINEZĂ",9999,1,PART,PRCNCT,PRSD,PRSD_SV_D,"2025-05-18 16:52:20",0,311,0,311,0,307,4,800,489,65,242
43,STRĂINĂTATE,"HONG KONG",88,"REPUBLICA POPULARĂ CHINEZĂ",9999,1,PART,PRCNCT,PRSD,PRSD_SV_D,"2025-05-18 16:29:32",0,218,0,218,0,215,3,800,582,28,187
43,STRĂINĂTATE,SHANGHAI,89,"REPUBLICA POPULARĂ CHINEZĂ",9999,1,PART,PRCNCT,PRSD,PRSD_SV_D,"2025-05-18 17:13:17",0,350,0,350,0,347,3,800,450,44,303
43,STRĂINĂTATE,"NICOSIA 1",90,"REPUBLICA CIPRU",9999,1,PART,PRCNCT,PRSD,PRSD_SV_D,"2025-05-18 23:17:58",0,1519,0,1519,0,1512,7,2400,881,1123,389
43,STRĂINĂTATE,"NICOSIA 2",91,"REPUBLICA CIPRU",9999,1,PART,PRCNCT,PRSD,PRSD_SV_D,"2025-05-18 22:56:12",0,1215,0,1215,0,1207,8,2400,1185,911,296
43,STRĂINĂTATE,LARNACA,92,"REPUBLICA CIPRU",9999,1,PART,PRCNCT,PRSD,PRSD_SV_D,"2025-05-18 22:04:25",0,1613,0,1613,0,1604,9,2400,787,1023,581
43,STRĂINĂTATE,LIMASSOL,93,"REPUBLICA CIPRU",9999,1,PART,PRCNCT,PRSD,PRSD_SV_D,"2025-05-18 22:54:52",0,2130,0,2130,0,2122,8,2400,270,1461,661
43,STRĂINĂTATE,PAFOS,94,"REPUBLICA CIPRU",9999,1,PART,PRCNCT,PRSD,PRSD_SV_D,"2025-05-18 22:13:08",0,1154,0,1154,0,1144,10,2400,1246,752,392
43,STRĂINĂTATE,"POLI CHRYSOCHOUS",95,"REPUBLICA CIPRU",9999,1,PART,PRCNCT,PRSD,PRSD_SV_D,"2025-05-18 21:36:41",0,190,0,190,0,189,1,2400,2210,130,59
43,STRĂINĂTATE,AGROS,96,"REPUBLICA CIPRU",9999,2,PART,PRCNCT,PRSD,PRSD_SV_D,"2025-05-19 05:40:16",0,105,0,105,0,101,4,2400,2295,76,25
43,STRĂINĂTATE,DERYNEIA,97,"REPUBLICA CIPRU",9999,1,PART,PRCNCT,PRSD,PRSD_SV_D,"2025-05-18 22:21:16",0,640,0,640,0,638,2,2400,1760,285,353
43,STRĂINĂTATE,BOGOTA,98,"REPUBLICA COLUMBIA",9999,1,PART,PRCNCT,PRSD,PRSD_SV_D,"2025-05-18 22:10:33",0,55,0,55,0,54,1,400,345,4,50
43,STRĂINĂTATE,SEOUL,99,"REPUBLICA COREEA",9999,1,PART,PRCNCT,PRSD,PRSD_SV_D,"2025-05-18 16:04:27",0,281,0,281,0,279,2,800,519,13,266
43,STRĂINĂTATE,ZAGREB,100,"REPUBLICA CROAȚIA",9999,1,PART,PRCNCT,PRSD,PRSD_SV_D,"2025-05-18 21:49:16",0,370,0,370,0,368,2,800,430,78,290
43,STRĂINĂTATE,HAVANA,101,CUBA,9999,1,PART,PRCNCT,PRSD,PRSD_SV_D,"2025-05-18 21:45:18",0,32,0,32,0,32,0,400,368,8,24
43,STRĂINĂTATE,"COPENHAGA 1",102,DANEMARCA,9999,1,PART,PRCNCT,PRSD,PRSD_SV_D,"2025-05-18 23:20:36",0,1555,0,1555,0,1546,9,2000,445,344,1202
43,STRĂINĂTATE,"COPENHAGA 2",103,DANEMARCA,9999,1,PART,PRCNCT,PRSD,PRSD_SV_D,"2025-05-18 23:19:27",0,1576,0,1576,0,1571,5,2200,624,340,1231
43,STRĂINĂTATE,TAASTRUP,104,DANEMARCA,9999,1,PART,PRCNCT,PRSD,PRSD_SV_D,"2025-05-18 22:43:19",0,2126,0,2126,0,2115,11,2800,674,1168,947
43,STRĂINĂTATE,LYNGBY,105,DANEMARCA,9999,1,PART,PRCNCT,PRSD,PRSD_SV_D,"2025-05-18 23:01:07",0,1116,0,1116,0,1106,10,1400,284,586,520
43,STRĂINĂTATE,RINGSTED,106,DANEMARCA,9999,1,PART,PRCNCT,PRSD,PRSD_SV_D,"2025-05-19 00:03:23",0,1312,0,1312,0,1302,10,1600,288,819,483
43,STRĂINĂTATE,ODENSE,107,DANEMARCA,9999,1,PART,PRCNCT,PRSD,PRSD_SV_D,"2025-05-18 22:37:25",0,1486,0,1486,0,1483,3,2000,514,798,685
43,STRĂINĂTATE,AABENRAA,108,DANEMARCA,9999,1,PART,PRCNCT,PRSD,PRSD_SV_D,"2025-05-19 00:15:11",0,1093,0,1093,0,1086,7,1600,507,466,620
43,STRĂINĂTATE,ESBJERG,109,DANEMARCA,9999,1,PART,PRCNCT,PRSD,PRSD_SV_D,"2025-05-18 22:49:26",0,981,0,981,0,979,2,1100,119,508,471
43,STRĂINĂTATE,VEJLE,110,DANEMARCA,9999,1,PART,PRCNCT,PRSD,PRSD_SV_D,"2025-05-18 23:30:50",0,2253,0,2253,0,2244,9,2400,147,1005,1239
43,STRĂINĂTATE,RINGKØBING,111,DANEMARCA,9999,1,PART,PRCNCT,PRSD,PRSD_SV_D,"2025-05-18 23:02:15",0,587,0,587,0,585,2,700,113,294,291
43,STRĂINĂTATE,AARHUS,112,DANEMARCA,9999,1,PART,PRCNCT,PRSD,PRSD_SV_D,"2025-05-19 01:34:45",0,2629,0,2629,0,2597,32,2800,171,1094,1503
43,STRĂINĂTATE,SKIVE,113,DANEMARCA,9999,1,PART,PRCNCT,PRSD,PRSD_SV_D,"2025-05-18 22:01:32",0,578,0,578,0,576,2,792,214,282,294
43,STRĂINĂTATE,AALBORG,114,DANEMARCA,9999,1,PART,PRCNCT,PRSD,PRSD_SV_D,"2025-05-18 23:35:46",0,1837,0,1837,0,1824,13,2400,563,927,897
43,STRĂINĂTATE,HERNING,115,DANEMARCA,9999,1,PART,PRCNCT,PRSD,PRSD_SV_D,"2025-05-18 23:09:42",0,1158,0,1158,0,1148,10,1400,242,607,541
43,STRĂINĂTATE,REYKJAVIK,116,ISLANDA,9999,1,PART,PRCNCT,PRSD,PRSD_SV_D,"2025-05-18 23:00:54",0,1293,0,1293,0,1285,8,2400,1107,681,604
43,STRĂINĂTATE,CAIRO,117,EGIPT,9999,1,PART,PRCNCT,PRSD,PRSD_SV_D,"2025-05-18 21:50:04",0,332,0,332,0,327,5,800,468,76,251
43,STRĂINĂTATE,GENEVA,118,ELVEȚIA,9999,1,PART,PRCNCT,PRSD,PRSD_SV_D,"2025-05-18 23:49:32",0,1675,0,1675,0,1669,6,3200,1525,483,1186
43,STRĂINĂTATE,COLOGNY,119,ELVEȚIA,9999,1,PART,PRCNCT,PRSD,PRSD_SV_D,"2025-05-18 22:53:58",0,433,0,433,0,428,5,3200,2767,112,316
43,STRĂINĂTATE,BERNA,120,ELVEȚIA,9999,1,PART,PRCNCT,PRSD,PRSD_SV_D,"2025-05-19 01:37:05",0,2400,0,2400,0,2385,15,4800,2400,1127,1258
43,STRĂINĂTATE,BASEL,121,ELVEȚIA,9999,1,PART,PRCNCT,PRSD,PRSD_SV_D,"2025-05-19 00:12:33",0,2619,0,2619,0,2607,12,4800,2181,1117,1490
43,STRĂINĂTATE,BELLINZONA,122,ELVEȚIA,9999,2,PART,PRCNCT,PRSD,PRSD_SV_D,"2025-05-19 02:47:16",0,713,0,713,0,710,3,2400,1687,395,315
43,STRĂINĂTATE,LAUSANNE,123,ELVEȚIA,9999,3,PART,PRCNCT,PRSD,PRSD_SV_D,"2025-05-19 03:53:51",0,2534,0,2534,0,2527,7,4800,2266,1015,1512
43,STRĂINĂTATE,"ZÜRICH 1",124,ELVEȚIA,9999,2,PART,PRCNCT,PRSD,PRSD_SV_D,"2025-05-19 03:23:20",0,4157,0,4157,0,4144,13,7200,3043,952,3192
43,STRĂINĂTATE,"ZÜRICH 2",125,ELVEȚIA,9999,1,PART,PRCNCT,PRSD,PRSD_SV_D,"2025-05-19 00:07:06",0,4448,0,4448,0,4432,16,7200,2752,2017,2415
43,STRĂINĂTATE,"ABU DHABI",126,"EMIRATELE ARABE UNITE",9999,1,PART,PRCNCT,PRSD,PRSD_SV_D,"2025-05-18 22:03:06",0,943,0,943,0,935,8,4000,3057,142,793
43,STRĂINĂTATE,"DUBAI 1",127,"EMIRATELE ARABE UNITE",9999,1,PART,PRCNCT,PRSD,PRSD_SV_D,"2025-05-18 22:16:26",0,2538,0,2538,0,2525,13,3600,1062,543,1982
43,STRĂINĂTATE,"DUBAI 2",128,"EMIRATELE ARABE UNITE",9999,1,PART,PRCNCT,PRSD,PRSD_SV_D,"2025-05-18 21:09:56",0,652,0,652,0,647,5,3600,2948,107,540
43,STRĂINĂTATE,TALLINN,129,ESTONIA,9999,1,PART,PRCNCT,PRSD,PRSD_SV_D,"2025-05-18 21:54:56",0,237,0,237,0,237,0,800,563,29,208
43,STRĂINĂTATE,"ADDIS ABEBA",130,ETIOPIA,9999,1,PART,PRCNCT,PRSD,PRSD_SV_D,"2025-05-18 21:24:07",0,19,0,19,0,19,0,400,381,4,15
43,STRĂINĂTATE,MANILA,131,FILIPINE,9999,1,PART,PRCNCT,PRSD,PRSD_SV_D,"2025-05-18 16:54:50",0,84,0,84,0,84,0,400,316,12,72
43,STRĂINĂTATE,HELSINKI,132,FINLANDA,9999,1,PART,PRCNCT,PRSD,PRSD_SV_D,"2025-05-18 23:57:01",0,1293,0,1293,0,1285,8,2400,1107,479,806
43,STRĂINĂTATE,MARIEHAMN,133,FINLANDA,9999,1,PART,PRCNCT,PRSD,PRSD_SV_D,"2025-05-18 23:32:35",0,169,0,169,0,167,2,1600,1431,93,74
43,STRĂINĂTATE,TAMPERE,134,FINLANDA,9999,1,PART,PRCNCT,PRSD,PRSD_SV_D,"2025-05-18 22:58:04",0,210,0,210,0,209,1,1600,1390,85,124
43,STRĂINĂTATE,TURKU,135,FINLANDA,9999,1,PART,PRCNCT,PRSD,PRSD_SV_D,"2025-05-18 22:04:11",0,718,0,718,0,718,0,1600,882,449,269
43,STRĂINĂTATE,"PARIS 1",136,FRANȚA,9999,1,PART,PRCNCT,PRSD,PRSD_SV_D,"2025-05-19 00:05:47",0,2293,0,2293,0,2279,14,6000,3707,459,1820
43,STRĂINĂTATE,"PARIS 2",137,FRANȚA,9999,1,PART,PRCNCT,PRSD,PRSD_SV_D,"2025-05-18 23:10:39",0,2001,0,2001,0,1987,14,4800,2799,471,1516
43,STRĂINĂTATE,"PARIS 3",138,FRANȚA,9999,1,PART,PRCNCT,PRSD,PRSD_SV_D,"2025-05-18 23:34:59",0,1933,0,1933,0,1915,18,6000,4067,523,1392
43,STRĂINĂTATE,"PARIS 4",139,FRANȚA,9999,2,PART,PRCNCT,PRSD,PRSD_SV_D,"2025-05-19 02:11:47",0,1091,0,1091,0,1083,8,4800,3709,299,784
43,STRĂINĂTATE,"PARIS 5",140,FRANȚA,9999,2,PART,PRCNCT,PRSD,PRSD_SV_D,"2025-05-19 00:26:59",0,889,0,889,0,882,7,4800,3911,236,646
43,STRĂINĂTATE,RUNGIS,141,FRANȚA,9999,2,PART,PRCNCT,PRSD,PRSD_SV_D,"2025-05-19 03:24:56",0,2570,0,2570,0,2557,13,4000,1430,1401,1156
43,STRĂINĂTATE,ISSY-LES-MOULINEAUX,142,FRANȚA,9999,1,PART,PRCNCT,PRSD,PRSD_SV_D,"2025-05-19 00:45:04",0,1226,0,1226,0,1218,8,4000,2774,422,796
43,STRĂINĂTATE,RUEIL-MALMAISON,143,FRANȚA,9999,1,PART,PRCNCT,PRSD,PRSD_SV_D,"2025-05-19 00:07:05",0,1935,0,1935,0,1930,5,4000,2065,841,1089
43,STRĂINĂTATE,DRANCY,144,FRANȚA,9999,1,PART,PRCNCT,PRSD,PRSD_SV_D,"2025-05-18 23:33:05",0,1745,0,1745,0,1739,6,4000,2255,1269,470
43,STRĂINĂTATE,"LA COURNEUVE",145,FRANȚA,9999,2,PART,PRCNCT,PRSD,PRSD_SV_D,"2025-05-19 03:43:20",0,2357,0,2357,0,2347,10,4000,1643,1838,509
43,STRĂINĂTATE,"LE BLANC-MESNIL 1",146,FRANȚA,9999,1,PART,PRCNCT,PRSD,PRSD_SV_D,"2025-05-18 22:39:50",0,1170,0,1170,0,1166,4,4000,2830,854,312
43,STRĂINĂTATE,"LE BLANC-MESNIL 2",147,FRANȚA,9999,1,PART,PRCNCT,PRSD,PRSD_SV_D,"2025-05-18 22:31:53",0,1160,0,1160,0,1157,3,4000,2840,856,301
43,STRĂINĂTATE,"LE BLANC-MESNIL 3",148,FRANȚA,9999,3,PART,PRCNCT,PRSD,PRSD_SV_D,"2025-05-19 01:25:33",0,1160,0,1160,0,1155,5,4000,2840,861,294
43,STRĂINĂTATE,"MONTREUIL 1",149,FRANȚA,9999,1,PART,PRCNCT,PRSD,PRSD_SV_D,"2025-05-18 23:08:35",0,874,0,874,0,863,11,4000,3126,555,308
43,STRĂINĂTATE,"MONTREUIL 2",150,FRANȚA,9999,2,PART,PRCNCT,PRSD,PRSD_SV_D,"2025-05-19 03:26:24",0,757,0,757,0,753,4,4000,3243,352,401
43,STRĂINĂTATE,PANTIN,151,FRANȚA,9999,1,PART,PRCNCT,PRSD,PRSD_SV_D,"2025-05-18 22:54:34",0,660,0,660,0,657,3,4000,3340,368,289
43,STRĂINĂTATE,BRY-SUR-MARNE,152,FRANȚA,9999,2,PART,PRCNCT,PRSD,PRSD_SV_D,"2025-05-19 00:38:37",0,1628,0,1628,0,1620,8,4000,2372,861,759
43,STRĂINĂTATE,MELUN,153,FRANȚA,9999,1,PART,PRCNCT,PRSD,PRSD_SV_D,"2025-05-18 22:28:48",0,1456,0,1456,0,1453,3,4000,2544,895,558
43,STRĂINĂTATE,BREST,154,FRANȚA,9999,1,PART,PRCNCT,PRSD,PRSD_SV_D,"2025-05-18 23:03:22",0,973,0,973,0,967,6,4000,3027,742,225
43,STRĂINĂTATE,TRAPPES,155,FRANȚA,9999,1,PART,PRCNCT,PRSD,PRSD_SV_D,"2025-05-19 00:20:07",0,1334,0,1334,0,1329,5,4000,2666,684,645
43,STRĂINĂTATE,"LE MANS",156,FRANȚA,9999,1,PART,PRCNCT,PRSD,PRSD_SV_D,"2025-05-18 22:29:16",0,529,0,529,0,525,4,4000,3471,277,248
43,STRĂINĂTATE,CALAIS,157,FRANȚA,9999,1,PART,PRCNCT,PRSD,PRSD_SV_D,"2025-05-18 22:35:28",0,1034,0,1034,0,1030,4,4000,2966,862,168
43,STRĂINĂTATE,BORDEAUX,158,FRANȚA,9999,1,PART,PRCNCT,PRSD,PRSD_SV_D,"2025-05-19 00:04:20",0,1776,0,1776,0,1766,10,4000,2224,1078,688
43,STRĂINĂTATE,PESSAC,159,FRANȚA,9999,1,PART,PRCNCT,PRSD,PRSD_SV_D,"2025-05-18 23:58:26",0,1529,0,1529,0,1521,8,4000,2471,1084,437
43,STRĂINĂTATE,CAEN,160,FRANȚA,9999,2,PART,PRCNCT,PRSD,PRSD_SV_D,"2025-05-19 02:09:43",0,679,0,679,0,673,6,4000,3321,311,362
43,STRĂINĂTATE,"LILLE 1",161,FRANȚA,9999,1,PART,PRCNCT,PRSD,PRSD_SV_D,"2025-05-18 22:30:57",0,986,0,986,0,975,11,4000,3014,699,276
43,STRĂINĂTATE,"LILLE 2",162,FRANȚA,9999,1,PART,PRCNCT,PRSD,PRSD_SV_D,"2025-05-18 22:35:12",0,1000,0,1000,0,996,4,4000,3000,584,412
43,STRĂINĂTATE,LOUDÉAC,163,FRANȚA,9999,1,PART,PRCNCT,PRSD,PRSD_SV_D,"2025-05-18 23:11:27",0,2005,0,2005,0,1994,11,4000,1995,1546,448
43,STRĂINĂTATE,RENNES,164,FRANȚA,9999,1,PART,PRCNCT,PRSD,PRSD_SV_D,"2025-05-18 23:27:39",0,1548,0,1548,0,1544,4,4000,2452,1033,511
43,STRĂINĂTATE,NANTES,165,FRANȚA,9999,2,PART,PRCNCT,PRSD,PRSD_SV_D,"2025-05-19 04:04:50",0,2929,0,2929,0,2907,22,5200,2271,2212,695
43,STRĂINĂTATE,SAINT-HERBLAIN,166,FRANȚA,9999,1,PART,PRCNCT,PRSD,PRSD_SV_D,"2025-05-18 22:47:18",0,1156,0,1156,0,1149,7,3200,2044,868,281
43,STRĂINĂTATE,TROYES,167,FRANȚA,9999,1,PART,PRCNCT,PRSD,PRSD_SV_D,"2025-05-18 22:57:32",0,508,0,508,0,505,3,3200,2692,214,291
43,STRĂINĂTATE,"AULNAY-SOUS-BOIS 1",168,FRANȚA,9999,1,PART,PRCNCT,PRSD,PRSD_SV_D,"2025-05-19 00:16:22",0,1498,0,1498,0,1490,8,4000,2502,1131,359
43,STRĂINĂTATE,"AULNAY-SOUS-BOIS 2",169,FRANȚA,9999,1,PART,PRCNCT,PRSD,PRSD_SV_D,"2025-05-19 00:05:35",0,1159,0,1159,0,1151,8,4000,2841,874,277
43,STRĂINĂTATE,GAGNY,170,FRANȚA,9999,1,PART,PRCNCT,PRSD,PRSD_SV_D,"2025-05-18 23:57:07",0,1409,0,1409,0,1404,5,4000,2591,987,417
43,STRĂINĂTATE,VILLENEUVE-SAINT-GEORGES,171,FRANȚA,9999,1,PART,PRCNCT,PRSD,PRSD_SV_D,"2025-05-18 23:19:58",0,1721,0,1721,0,1712,9,4000,2279,935,777
43,STRĂINĂTATE,CHAMPIGNY-SUR-MARNE,172,FRANȚA,9999,1,PART,PRCNCT,PRSD,PRSD_SV_D,"2025-05-19 00:15:07",0,1134,0,1134,0,1116,18,4000,2866,701,415
43,STRĂINĂTATE,VILLEMOMBLE,173,FRANȚA,9999,1,PART,PRCNCT,PRSD,PRSD_SV_D,"2025-05-18 22:59:24",0,1608,0,1608,0,1595,13,4000,2392,1107,488
43,STRĂINĂTATE,TOURS,174,FRANȚA,9999,1,PART,PRCNCT,PRSD,PRSD_SV_D,"2025-05-18 22:50:02",0,681,0,681,0,679,2,4000,3319,338,341
43,STRĂINĂTATE,SARAN,175,FRANȚA,9999,1,PART,PRCNCT,PRSD,PRSD_SV_D,"2025-05-18 23:08:10",0,846,0,846,0,844,2,4000,3154,392,452
43,STRĂINĂTATE,IVRY-SUR-SEINE,176,FRANȚA,9999,2,PART,PRCNCT,PRSD,PRSD_SV_D,"2025-05-18 23:44:06",0,1256,0,1256,0,1254,2,4000,2744,821,433
43,STRĂINĂTATE,ROUEN,177,FRANȚA,9999,1,PART,PRCNCT,PRSD,PRSD_SV_D,"2025-05-18 23:05:13",0,1038,0,1038,0,1033,5,4000,2962,630,403
43,STRĂINĂTATE,"LA FERTÉ-SOUS-JOUARRE",178,FRANȚA,9999,1,PART,PRCNCT,PRSD,PRSD_SV_D,"2025-05-18 22:43:15",0,812,0,812,0,810,2,4000,3188,510,300
43,STRĂINĂTATE,BEAUVAIS,179,FRANȚA,9999,1,PART,PRCNCT,PRSD,PRSD_SV_D,"2025-05-18 22:25:27",0,644,0,644,0,640,4,3200,2556,300,340
43,STRĂINĂTATE,POISSY,180,FRANȚA,9999,1,PART,PRCNCT,PRSD,PRSD_SV_D,"2025-05-18 23:09:30",0,1121,0,1121,0,1116,5,4000,2879,561,555
43,STRĂINĂTATE,POITIERS,181,FRANȚA,9999,1,PART,PRCNCT,PRSD,PRSD_SV_D,"2025-05-19 00:24:39",0,817,0,817,0,813,4,4000,3183,484,329
43,STRĂINĂTATE,MONACO,182,"PRINCIPATUL MONACO",9999,1,PART,PRCNCT,PRSD,PRSD_SV_D,"2025-05-18 22:19:18",0,716,0,716,0,711,5,4000,3284,273,438
43,STRĂINĂTATE,"LYON 1",183,FRANȚA,9999,1,PART,PRCNCT,PRSD,PRSD_SV_D,"2025-05-19 01:23:44",0,2286,0,2286,0,2274,12,3208,922,1085,1189
43,STRĂINĂTATE,"LYON 2",184,FRANȚA,9999,1,PART,PRCNCT,PRSD,PRSD_SV_D,"2025-05-18 22:24:06",0,609,0,609,0,605,4,3200,2591,251,354
43,STRĂINĂTATE,"SAINT GENIS LAVAL",185,FRANȚA,9999,1,PART,PRCNCT,PRSD,PRSD_SV_D,"2025-05-18 22:21:02",0,591,0,591,0,590,1,3200,2609,376,214
43,STRĂINĂTATE,"SAINT ETIENNE",186,FRANȚA,9999,1,PART,PRCNCT,PRSD,PRSD_SV_D,"2025-05-18 22:49:33",0,455,0,455,0,453,2,3200,2745,252,201
43,STRĂINĂTATE,DIJON,187,FRANȚA,9999,1,PART,PRCNCT,PRSD,PRSD_SV_D,"2025-05-18 22:46:05",0,840,0,840,0,839,1,3200,2360,494,345
43,STRĂINĂTATE,"CLERMONT FERRAND",188,FRANȚA,9999,1,PART,PRCNCT,PRSD,PRSD_SV_D,"2025-05-18 23:38:35",0,772,0,772,0,766,6,3200,2428,317,449
43,STRĂINĂTATE,AMBILLY/ANNEMASSE,189,FRANȚA,9999,1,PART,PRCNCT,PRSD,PRSD_SV_D,"2025-05-18 23:44:39",0,1531,0,1531,0,1528,3,3198,1667,966,562
43,STRĂINĂTATE,SAINT-MARTIN-D'HÉRES/GRENOBLE,190,FRANȚA,9999,1,PART,PRCNCT,PRSD,PRSD_SV_D,"2025-05-19 00:05:54",0,1478,0,1478,0,1466,12,3200,1722,840,626
43,STRĂINĂTATE,"MARSILIA 1",191,FRANȚA,9999,1,PART,PRCNCT,PRSD,PRSD_SV_D,"2025-05-18 22:55:41",0,1120,0,1120,0,1116,4,3192,2072,732,384
43,STRĂINĂTATE,"MARSILIA 2",192,FRANȚA,9999,1,PART,PRCNCT,PRSD,PRSD_SV_D,"2025-05-18 23:01:21",0,1160,0,1160,0,1150,10,3200,2040,657,493
43,STRĂINĂTATE,MARIGNANE,193,FRANȚA,9999,1,PART,PRCNCT,PRSD,PRSD_SV_D,"2025-05-18 22:57:33",0,1890,0,1890,0,1886,4,3200,1310,1215,671
43,STRĂINĂTATE,ANTIBES,194,FRANȚA,9999,1,PART,PRCNCT,PRSD,PRSD_SV_D,"2025-05-19 01:05:04",0,2085,0,2085,0,2074,11,3200,1115,973,1101
43,STRĂINĂTATE,"NISA 1",195,FRANȚA,9999,1,PART,PRCNCT,PRSD,PRSD_SV_D,"2025-05-18 22:26:48",0,1671,0,1671,0,1659,12,3200,1529,786,873
43,STRĂINĂTATE,"NISA 2",196,FRANȚA,9999,1,PART,PRCNCT,PRSD,PRSD_SV_D,"2025-05-18 22:19:08",0,1605,0,1605,0,1594,11,3200,1595,796,798
43,STRĂINĂTATE,MONTPELLIER,197,FRANȚA,9999,1,PART,PRCNCT,PRSD,PRSD_SV_D,"2025-05-18 23:31:40",0,1674,0,1674,0,1663,11,2700,1026,862,801
43,STRĂINĂTATE,TOULOUSE,198,FRANȚA,9999,1,PART,PRCNCT,PRSD,PRSD_SV_D,"2025-05-19 02:11:25",0,2753,0,2753,0,2742,11,3700,947,1646,1096
43,STRĂINĂTATE,"BASTIA (CORSICA)",199,FRANȚA,9999,1,PART,PRCNCT,PRSD,PRSD_SV_D,"2025-05-18 23:44:38",0,1117,0,1117,0,1115,2,3200,2083,862,253
43,STRĂINĂTATE,"AJACCIO (CORSICA)",200,FRANȚA,9999,1,PART,PRCNCT,PRSD,PRSD_SV_D,"2025-05-18 22:42:17",0,731,0,731,0,728,3,3159,2428,537,191
43,STRĂINĂTATE,"STRASBOURG 1",201,FRANȚA,9999,1,PART,PRCNCT,PRSD,PRSD_SV_D,"2025-05-18 23:44:24",0,1829,0,1829,0,1826,3,3208,1379,799,1027
43,STRĂINĂTATE,"STRASBOURG 2",202,FRANȚA,9999,1,PART,PRCNCT,PRSD,PRSD_SV_D,"2025-05-18 23:33:06",0,1639,0,1639,0,1633,6,3200,1561,833,800
43,STRĂINĂTATE,COLMAR,203,FRANȚA,9999,1,PART,PRCNCT,PRSD,PRSD_SV_D,"2025-05-18 22:57:36",0,1001,0,1001,0,999,2,2400,1399,373,626
43,STRĂINĂTATE,NANCY,204,FRANȚA,9999,1,PART,PRCNCT,PRSD,PRSD_SV_D,"2025-05-18 23:18:51",0,791,0,791,0,785,6,2400,1609,431,354
43,STRĂINĂTATE,TBILISI,205,GEORGIA,9999,1,PART,PRCNCT,PRSD,PRSD_SV_D,"2025-05-18 20:31:26",0,148,0,148,0,146,2,800,652,26,120
43,STRĂINĂTATE,"BERLIN 1",206,GERMANIA,9999,1,PART,PRCNCT,PRSD,PRSD_SV_D,"2025-05-19 00:44:28",0,3311,0,3311,0,3299,12,4000,689,1740,1559
43,STRĂINĂTATE,"BERLIN 2",207,GERMANIA,9999,1,PART,PRCNCT,PRSD,PRSD_SV_D,"2025-05-19 02:45:28",0,3305,0,3305,0,3285,20,4000,695,1685,1600
43,STRĂINĂTATE,"BERLIN 3",208,GERMANIA,9999,1,PART,PRCNCT,PRSD,PRSD_SV_D,"2025-05-19 00:31:47",0,3331,0,3331,0,3314,17,4000,669,1524,1790
43,STRĂINĂTATE,BRAUNSCHWEIG,209,GERMANIA,9999,1,PART,PRCNCT,PRSD,PRSD_SV_D,"2025-05-18 23:17:48",0,2485,0,2485,0,2476,9,4000,1515,1759,717
43,STRĂINĂTATE,BREMEN,210,GERMANIA,9999,1,PART,PRCNCT,PRSD,PRSD_SV_D,"2025-05-19 00:18:08",0,3522,0,3522,0,3507,15,4800,1278,2254,1253
43,STRĂINĂTATE,DRESDEN,211,GERMANIA,9999,1,PART,PRCNCT,PRSD,PRSD_SV_D,"2025-05-19 00:40:58",0,1929,0,1929,0,1921,8,3200,1271,1250,671
43,STRĂINĂTATE,ERFURT,212,GERMANIA,9999,1,PART,PRCNCT,PRSD,PRSD_SV_D,"2025-05-18 23:52:46",0,3260,0,3260,0,3243,17,4000,740,2234,1009
43,STRĂINĂTATE,FLENSBURG,213,GERMANIA,9999,1,PART,PRCNCT,PRSD,PRSD_SV_D,"2025-05-18 23:42:21",0,1848,0,1848,0,1841,7,3600,1752,1412,429
43,STRĂINĂTATE,"HAMBURG 1",214,GERMANIA,9999,1,PART,PRCNCT,PRSD,PRSD_SV_D,"2025-05-19 00:27:15",0,3633,0,3633,0,3608,25,5200,1567,2594,1014
43,STRĂINĂTATE,"HAMBURG 2",215,GERMANIA,9999,1,PART,PRCNCT,PRSD,PRSD_SV_D,"2025-05-19 01:07:52",0,4438,0,4438,0,4424,14,5200,762,2773,1651
43,STRĂINĂTATE,"HANOVRA 1",216,GERMANIA,9999,1,PART,PRCNCT,PRSD,PRSD_SV_D,"2025-05-18 23:42:39",0,2017,0,2017,0,2007,10,4000,1983,1321,686
43,STRĂINĂTATE,"HANOVRA 2",217,GERMANIA,9999,1,PART,PRCNCT,PRSD,PRSD_SV_D,"2025-05-18 23:14:43",0,2172,0,2172,0,2162,10,4000,1828,1427,735
43,STRĂINĂTATE,KIEL,218,GERMANIA,9999,1,PART,PRCNCT,PRSD,PRSD_SV_D,"2025-05-18 23:36:17",0,1099,0,1099,0,1093,6,4000,2901,756,337
43,STRĂINĂTATE,LEIPZIG,219,GERMANIA,9999,1,PART,PRCNCT,PRSD,PRSD_SV_D,"2025-05-19 02:26:36",0,3775,0,3775,0,3766,9,4800,1025,2676,1090
43,STRĂINĂTATE,ROSTOCK,220,GERMANIA,9999,1,PART,PRCNCT,PRSD,PRSD_SV_D,"2025-05-18 22:50:06",0,1148,0,1148,0,1143,5,4000,2852,793,350
43,STRĂINĂTATE,QUAKENBRÜCK,221,GERMANIA,9999,1,PART,PRCNCT,PRSD,PRSD_SV_D,"2025-05-19 01:28:59",0,4275,0,4275,0,4250,25,5200,925,3546,704
43,STRĂINĂTATE,"ESSEN (OLDENBURG)",222,GERMANIA,9999,1,PART,PRCNCT,PRSD,PRSD_SV_D,"2025-05-19 01:14:36",0,2676,0,2676,0,2660,16,4400,1724,2188,472
43,STRĂINĂTATE,SÖGEL,223,GERMANIA,9999,2,PART,PRCNCT,PRSD,PRSD_SV_D,"2025-05-19 03:32:34",0,3741,0,3741,0,3725,16,5200,1459,3013,712
43,STRĂINĂTATE,"BONN 1",224,GERMANIA,9999,1,PART,PRCNCT,PRSD,PRSD_SV_D,"2025-05-18 23:46:03",0,2726,0,2726,0,2712,14,3200,474,1842,870
43,STRĂINĂTATE,"BONN 2",225,GERMANIA,9999,1,PART,PRCNCT,PRSD,PRSD_SV_D,"2025-05-18 23:25:12",0,2730,0,2730,0,2721,9,3200,470,1873,848
43,STRĂINĂTATE,BECKUM,226,GERMANIA,9999,1,PART,PRCNCT,PRSD,PRSD_SV_D,"2025-05-18 23:58:39",0,1935,0,1935,0,1925,10,2400,465,1441,484
43,STRĂINĂTATE,DORTMUND,227,GERMANIA,9999,1,PART,PRCNCT,PRSD,PRSD_SV_D,"2025-05-19 02:37:20",0,6860,0,6860,0,6828,32,8000,1140,5171,1657
43,STRĂINĂTATE,DUISBURG,228,GERMANIA,9999,1,PART,PRCNCT,PRSD,PRSD_SV_D,"2025-05-19 04:01:43",0,5900,0,5900,0,5886,14,6000,100,4559,1327
43,STRĂINĂTATE,DÜSSELDORF,229,GERMANIA,9999,1,PART,PRCNCT,PRSD,PRSD_SV_D,"2025-05-19 00:27:08",0,5976,0,5976,0,5957,19,6400,424,3442,2515
43,STRĂINĂTATE,FÖHREN,230,GERMANIA,9999,1,PART,PRCNCT,PRSD,PRSD_SV_D,"2025-05-19 00:28:02",0,3576,0,3576,0,3564,12,4000,424,2506,1058
43,STRĂINĂTATE,FRANKFURT,231,GERMANIA,9999,1,PART,PRCNCT,PRSD,PRSD_SV_D,"2025-05-19 00:54:53",0,5723,0,5723,0,5694,29,6000,277,3112,2582
43,STRĂINĂTATE,GÜTERSLOH,232,GERMANIA,9999,1,PART,PRCNCT,PRSD,PRSD_SV_D,"2025-05-18 23:54:17",0,4685,0,4685,0,4660,25,4797,112,3616,1044
43,STRĂINĂTATE,KASSEL,233,GERMANIA,9999,2,PART,PRCNCT,PRSD,PRSD_SV_D,"2025-05-19 05:44:45",0,3620,0,3620,0,3610,10,3998,378,2496,1114
43,STRĂINĂTATE,"KÖLN 1",234,GERMANIA,9999,1,PART,PRCNCT,PRSD,PRSD_SV_D,"2025-05-18 23:54:53",0,2480,0,2480,0,2474,6,4000,1520,1508,966
43,STRĂINĂTATE,"KÖLN 2",235,GERMANIA,9999,1,PART,PRCNCT,PRSD,PRSD_SV_D,"2025-05-18 23:32:21",0,3974,0,3974,0,3950,24,4800,826,2680,1270
43,STRĂINĂTATE,LANGENSELBOLD,236,GERMANIA,9999,1,PART,PRCNCT,PRSD,PRSD_SV_D,"2025-05-18 22:35:37",0,2913,0,2913,0,2906,7,3600,687,2095,811
43,STRĂINĂTATE,MAINZ,237,GERMANIA,9999,1,PART,PRCNCT,PRSD,PRSD_SV_D,"2025-05-19 00:17:03",0,4163,0,4163,0,4152,11,5000,837,2823,1329
43,STRĂINĂTATE,"NEUSTADT AN DER WEINSTRAßE",238,GERMANIA,9999,1,PART,PRCNCT,PRSD,PRSD_SV_D,"2025-05-19 00:15:30",0,4792,0,4792,0,4765,27,5200,408,3634,1131
43,STRĂINĂTATE,"OFFENBACH 1",239,GERMANIA,9999,1,PART,PRCNCT,PRSD,PRSD_SV_D,"2025-05-19 00:40:45",0,4684,0,4684,0,4664,20,4800,116,3187,1477
43,STRĂINĂTATE,"OFFENBACH 2",240,GERMANIA,9999,1,PART,PRCNCT,PRSD,PRSD_SV_D,"2025-05-18 23:36:01",0,2787,0,2787,0,2780,7,3200,413,1929,851
43,STRĂINĂTATE,PADERBORN,241,GERMANIA,9999,1,PART,PRCNCT,PRSD,PRSD_SV_D,"2025-05-18 23:36:41",0,1584,0,1584,0,1573,11,3200,1616,1096,477
43,STRĂINĂTATE,RHEDA-WIEDENBRÜCK,242,GERMANIA,9999,3,PART,PRCNCT,PRSD,PRSD_SV_D,"2025-05-19 05:41:40",0,3636,0,3636,0,3625,11,4000,364,3055,570
43,STRĂINĂTATE,WADGASSEN,243,GERMANIA,9999,1,PART,PRCNCT,PRSD,PRSD_SV_D,"2025-05-18 22:25:21",0,3106,0,3106,0,3096,10,4000,894,2333,763
43,STRĂINĂTATE,WIESBADEN,244,GERMANIA,9999,1,PART,PRCNCT,PRSD,PRSD_SV_D,"2025-05-19 00:06:49",0,2069,0,2069,0,2065,4,3000,931,1307,758
43,STRĂINĂTATE,"MÜNCHEN 1",245,GERMANIA,9999,1,PART,PRCNCT,PRSD,PRSD_SV_D,"2025-05-19 00:19:31",0,2373,0,2373,0,2367,6,3608,1235,1026,1341
43,STRĂINĂTATE,"MÜNCHEN 2",246,GERMANIA,9999,1,PART,PRCNCT,PRSD,PRSD_SV_D,"2025-05-19 00:19:40",0,2437,0,2437,0,2419,18,3608,1171,1141,1278
43,STRĂINĂTATE,"MÜNCHEN 3",247,GERMANIA,9999,1,PART,PRCNCT,PRSD,PRSD_SV_D,"2025-05-18 23:53:04",0,2312,0,2312,0,2301,11,4000,1688,1234,1067
43,STRĂINĂTATE,"MÜNCHEN 4",248,GERMANIA,9999,1,PART,PRCNCT,PRSD,PRSD_SV_D,"2025-05-19 00:02:46",0,2386,0,2386,0,2374,12,4025,1639,1233,1141
43,STRĂINĂTATE,"MÜNCHEN 5",249,GERMANIA,9999,1,PART,PRCNCT,PRSD,PRSD_SV_D,"2025-05-19 00:12:29",0,2304,0,2304,0,2299,5,4000,1696,1299,1000
43,STRĂINĂTATE,ASCHAFFENBURG,250,GERMANIA,9999,1,PART,PRCNCT,PRSD,PRSD_SV_D,"2025-05-19 01:07:41",0,2773,0,2773,0,2758,15,4000,1227,1998,760
43,STRĂINĂTATE,"AUGSBURG 1",251,GERMANIA,9999,1,PART,PRCNCT,PRSD,PRSD_SV_D,"2025-05-18 23:28:04",0,2025,0,2025,0,2014,11,4000,1975,1418,596
43,STRĂINĂTATE,"AUGSBURG 2",252,GERMANIA,9999,1,PART,PRCNCT,PRSD,PRSD_SV_D,"2025-05-18 22:37:47",0,2055,0,2055,0,2041,14,4000,1945,1339,702
43,STRĂINĂTATE,"AUGSBURG 3",253,GERMANIA,9999,1,PART,PRCNCT,PRSD,PRSD_SV_D,"2025-05-18 22:41:17",0,2036,0,2036,0,2026,10,4000,1964,1425,601
43,STRĂINĂTATE,"AUGSBURG 4",254,GERMANIA,9999,1,PART,PRCNCT,PRSD,PRSD_SV_D,"2025-05-18 22:26:09",0,2066,0,2066,0,2058,8,4000,1934,1425,633
43,STRĂINĂTATE,BAYREUTH,255,GERMANIA,9999,1,PART,PRCNCT,PRSD,PRSD_SV_D,"2025-05-18 22:11:12",0,2290,0,2290,0,2286,4,4000,1710,1632,654
43,STRĂINĂTATE,DACHAU,256,GERMANIA,9999,1,PART,PRCNCT,PRSD,PRSD_SV_D,"2025-05-18 23:23:03",0,2527,0,2527,0,2512,15,4000,1473,1608,904
43,STRĂINĂTATE,ERDING,257,GERMANIA,9999,1,PART,PRCNCT,PRSD,PRSD_SV_D,"2025-05-18 22:33:00",0,3051,0,3051,0,3040,11,4000,949,1961,1079
43,STRĂINĂTATE,"INGOLSTADT 1",258,GERMANIA,9999,1,PART,PRCNCT,PRSD,PRSD_SV_D,"2025-05-18 23:28:22",0,2304,0,2304,0,2296,8,4000,1696,1516,780
43,STRĂINĂTATE,"INGOLSTADT 2",259,GERMANIA,9999,1,PART,PRCNCT,PRSD,PRSD_SV_D,"2025-05-18 23:25:19",0,2302,0,2302,0,2294,8,4000,1698,1475,819
43,STRĂINĂTATE,KEMPTEN,260,GERMANIA,9999,1,PART,PRCNCT,PRSD,PRSD_SV_D,"2025-05-18 23:19:27",0,2926,0,2926,0,2909,17,4000,1074,1984,925
43,STRĂINĂTATE,LANDSHUT,261,GERMANIA,9999,1,PART,PRCNCT,PRSD,PRSD_SV_D,"2025-05-18 23:12:17",0,3552,0,3552,0,3535,17,4800,1248,2475,1060
43,STRĂINĂTATE,"NÜRNBERG 1",262,GERMANIA,9999,1,PART,PRCNCT,PRSD,PRSD_SV_D,"2025-05-18 23:04:55",0,3240,0,3240,0,3222,18,4000,760,2256,966
43,STRĂINĂTATE,"NÜRNBERG 2",263,GERMANIA,9999,1,PART,PRCNCT,PRSD,PRSD_SV_D,"2025-05-18 23:12:11",0,3172,0,3172,0,3161,11,4000,828,2151,1010
43,STRĂINĂTATE,"NÜRNBERG 3",264,GERMANIA,9999,1,PART,PRCNCT,PRSD,PRSD_SV_D,"2025-05-18 23:15:30",0,3392,0,3392,0,3370,22,4000,608,2447,923
43,STRĂINĂTATE,"NÜRNBERG 4",265,GERMANIA,9999,1,PART,PRCNCT,PRSD,PRSD_SV_D,"2025-05-18 22:34:40",0,1646,0,1646,0,1634,12,3600,1954,1119,515
43,STRĂINĂTATE,"NÜRNBERG 5",266,GERMANIA,9999,1,PART,PRCNCT,PRSD,PRSD_SV_D,"2025-05-18 22:39:49",0,1700,0,1700,0,1692,8,4000,2300,1053,639
43,STRĂINĂTATE,"NÜRNBERG 6",267,GERMANIA,9999,1,PART,PRCNCT,PRSD,PRSD_SV_D,"2025-05-18 22:58:44",0,1518,0,1518,0,1507,11,3600,2082,941,566
43,STRĂINĂTATE,REGENSBURG,268,GERMANIA,9999,1,PART,PRCNCT,PRSD,PRSD_SV_D,"2025-05-19 01:59:02",0,4298,0,4298,0,4279,19,5600,1302,2789,1490
43,STRĂINĂTATE,ROSENHEIM,269,GERMANIA,9999,2,PART,PRCNCT,PRSD,PRSD_SV_D,"2025-05-19 02:36:33",0,2450,0,2450,0,2439,11,4000,1550,1639,800
43,STRĂINĂTATE,"STRAUBING 1",270,GERMANIA,9999,1,PART,PRCNCT,PRSD,PRSD_SV_D,"2025-05-19 00:18:57",0,2423,0,2423,0,2415,8,3599,1176,1833,582
43,STRĂINĂTATE,"STRAUBING 2",271,GERMANIA,9999,1,PART,PRCNCT,PRSD,PRSD_SV_D,"2025-05-18 23:39:36",0,2107,0,2107,0,2090,17,3600,1493,1609,481
43,STRĂINĂTATE,TRAUNREUT,272,GERMANIA,9999,1,PART,PRCNCT,PRSD,PRSD_SV_D,"2025-05-19 00:41:51",0,3093,0,3093,0,3078,15,4000,907,2261,817
43,STRĂINĂTATE,"VILSHOFEN AN DER DONAU",273,GERMANIA,9999,1,PART,PRCNCT,PRSD,PRSD_SV_D,"2025-05-18 22:28:10",0,2701,0,2701,0,2686,15,4000,1299,1950,736
43,STRĂINĂTATE,WÜRZBURG,274,GERMANIA,9999,1,PART,PRCNCT,PRSD,PRSD_SV_D,"2025-05-19 02:19:13",0,4737,0,4737,0,4715,22,5596,859,3252,1463
43,STRĂINĂTATE,"STUTTGART 1",275,GERMANIA,9999,2,PART,PRCNCT,PRSD,PRSD_SV_D,"2025-05-19 02:10:30",0,2904,0,2904,0,2893,11,5600,2696,1589,1304
43,STRĂINĂTATE,"STUTTGART 2",276,GERMANIA,9999,1,PART,PRCNCT,PRSD,PRSD_SV_D,"2025-05-18 22:38:44",0,2901,0,2901,0,2890,11,5600,2699,1710,1180
43,STRĂINĂTATE,BADEN-BADEN,277,GERMANIA,9999,1,PART,PRCNCT,PRSD,PRSD_SV_D,"2025-05-19 02:19:56",0,3473,0,3473,0,3450,23,4800,1327,2471,979
43,STRĂINĂTATE,"ESSLINGEN AM NECKAR",278,GERMANIA,9999,2,PART,PRCNCT,PRSD,PRSD_SV_D,"2025-05-19 04:31:06",0,3699,0,3699,0,3679,20,4800,1101,2555,1124
43,STRĂINĂTATE,"FREIBURG IM BREISGAU 1",279,GERMANIA,9999,1,PART,PRCNCT,PRSD,PRSD_SV_D,"2025-05-19 01:21:31",0,2515,0,2515,0,2502,13,4800,2285,1731,771
43,STRĂINĂTATE,"FREIBURG IM BREISGAU 2",280,GERMANIA,9999,1,PART,PRCNCT,PRSD,PRSD_SV_D,"2025-05-18 23:42:30",0,2228,0,2228,0,2222,6,4800,2572,1481,741
43,STRĂINĂTATE,HEILBRONN,281,GERMANIA,9999,2,PART,PRCNCT,PRSD,PRSD_SV_D,"2025-05-19 03:35:48",0,6346,0,6346,0,6314,32,7200,854,4735,1579
43,STRĂINĂTATE,"KARLSRUHE 1",282,GERMANIA,9999,1,PART,PRCNCT,PRSD,PRSD_SV_D,"2025-05-19 01:13:26",0,2890,0,2890,0,2880,10,3600,710,1997,883
43,STRĂINĂTATE,"KARLSRUHE 2",283,GERMANIA,9999,1,PART,PRCNCT,PRSD,PRSD_SV_D,"2025-05-19 00:41:55",0,3108,0,3108,0,3091,17,4000,892,2058,1033
43,STRĂINĂTATE,LUDWIGSBURG,284,GERMANIA,9999,3,PART,PRCNCT,PRSD,PRSD_SV_D,"2025-05-19 02:55:32",0,2315,0,2315,0,2301,14,3000,685,1526,775
43,STRĂINĂTATE,MANNHEIM,285,GERMANIA,9999,2,PART,PRCNCT,PRSD,PRSD_SV_D,"2025-05-19 03:29:25",0,6718,0,6718,0,6684,34,8000,1282,4638,2046
43,STRĂINĂTATE,PFORZHEIM,286,GERMANIA,9999,1,PART,PRCNCT,PRSD,PRSD_SV_D,"2025-05-18 23:54:18",0,4095,0,4095,0,4074,21,4800,705,2909,1165
43,STRĂINĂTATE,RAVENSBURG,287,GERMANIA,9999,1,PART,PRCNCT,PRSD,PRSD_SV_D,"2025-05-19 00:36:37",0,2717,0,2717,0,2709,8,4800,2083,1909,800
43,STRĂINĂTATE,REUTLINGEN,288,GERMANIA,9999,1,PART,PRCNCT,PRSD,PRSD_SV_D,"2025-05-19 00:21:18",0,3557,0,3557,0,3540,17,4800,1243,2400,1140
43,STRĂINĂTATE,"SCHWÄBISCH HALL",289,GERMANIA,9999,1,PART,PRCNCT,PRSD,PRSD_SV_D,"2025-05-19 01:19:54",0,4431,0,4431,0,4411,20,5800,1369,3256,1155
43,STRĂINĂTATE,SIGMARINGEN,290,GERMANIA,9999,1,PART,PRCNCT,PRSD,PRSD_SV_D,"2025-05-18 23:32:14",0,2325,0,2325,0,2313,12,4400,2075,1638,675
43,STRĂINĂTATE,"ULM 1",291,GERMANIA,9999,2,PART,PRCNCT,PRSD,PRSD_SV_D,"2025-05-19 04:01:44",0,3383,0,3383,0,3369,14,4808,1425,2277,1092
43,STRĂINĂTATE,"ULM 2",292,GERMANIA,9999,1,PART,PRCNCT,PRSD,PRSD_SV_D,"2025-05-18 23:02:52",0,3327,0,3327,0,3313,14,4820,1493,2436,877
43,STRĂINĂTATE,"VILLINGEN SCHWENNINGEN",293,GERMANIA,9999,1,PART,PRCNCT,PRSD,PRSD_SV_D,"2025-05-18 23:44:39",0,6555,0,6555,0,6508,47,7600,1045,4644,1864
43,STRĂINĂTATE,"ATENA 1",294,"REPUBLICA ELENĂ",9999,1,PART,PRCNCT,PRSD,PRSD_SV_D,"2025-05-18 22:54:52",0,1403,0,1403,0,1394,9,3200,1797,530,864
43,STRĂINĂTATE,"ATENA 2",295,"REPUBLICA ELENĂ",9999,1,PART,PRCNCT,PRSD,PRSD_SV_D,"2025-05-18 22:45:01",0,2995,0,2995,0,2977,18,3200,205,1911,1066
43,STRĂINĂTATE,"ATENA 3",296,"REPUBLICA ELENĂ",9999,1,PART,PRCNCT,PRSD,PRSD_SV_D,"2025-05-18 22:32:06",0,615,0,615,0,614,1,3200,2585,261,353
43,STRĂINĂTATE,ASPROPYRGOS,297,"REPUBLICA ELENĂ",9999,1,PART,PRCNCT,PRSD,PRSD_SV_D,"2025-05-18 22:14:00",0,365,0,365,0,364,1,3200,2835,253,111
43,STRĂINĂTATE,CHANIA,298,"REPUBLICA ELENĂ",9999,1,PART,PRCNCT,PRSD,PRSD_SV_D,"2025-05-18 22:10:50",0,366,0,366,0,361,5,3200,2834,160,201
43,STRĂINĂTATE,IRAKLIO,299,"REPUBLICA ELENĂ",9999,1,PART,PRCNCT,PRSD,PRSD_SV_D,"2025-05-18 22:02:50",0,548,0,548,0,545,3,3208,2660,255,290
43,STRĂINĂTATE,PATRA,300,"REPUBLICA ELENĂ",9999,1,PART,PRCNCT,PRSD,PRSD_SV_D,"2025-05-18 21:59:03",0,191,0,191,0,190,1,1600,1409,110,80
43,STRĂINĂTATE,PREVEZA,301,"REPUBLICA ELENĂ",9999,1,PART,PRCNCT,PRSD,PRSD_SV_D,"2025-05-18 22:09:30",0,232,0,232,0,230,2,1600,1368,80,150
43,STRĂINĂTATE,SPARTA,302,"REPUBLICA ELENĂ",9999,2,PART,PRCNCT,PRSD,PRSD_SV_D,"2025-05-19 05:02:55",0,443,0,443,0,441,2,2400,1957,313,128
43,STRĂINĂTATE,SALONIC,303,"REPUBLICA ELENĂ",9999,1,PART,PRCNCT,PRSD,PRSD_SV_D,"2025-05-18 23:29:44",0,1791,0,1791,0,1781,10,4000,2209,556,1225
43,STRĂINĂTATE,LARISA,304,"REPUBLICA ELENĂ",9999,1,PART,PRCNCT,PRSD,PRSD_SV_D,"2025-05-18 22:08:50",0,313,0,313,0,313,0,3200,2887,159,154
43,STRĂINĂTATE,"NEW DELHI",305,"REPUBLICA INDIA",9999,1,PART,PRCNCT,PRSD,PRSD_SV_D,"2025-05-18 19:26:27",0,53,0,53,0,53,0,400,347,10,43
43,STRĂINĂTATE,JAKARTA,306,"REPUBLICA INDONEZIA",9999,1,PART,PRCNCT,PRSD,PRSD_SV_D,"2025-05-18 17:34:23",0,52,0,52,0,52,0,397,345,6,46
43,STRĂINĂTATE,AMMAN,307,"REGATUL HAȘEMIT AL IORDANIEI",9999,1,PART,PRCNCT,PRSD,PRSD_SV_D,"2025-05-18 22:21:02",0,379,0,379,0,370,9,1600,1221,134,236
43,STRĂINĂTATE,BAGDAD,308,IRAK,9999,1,PART,PRCNCT,PRSD,PRSD_SV_D,"2025-05-18 21:32:05",0,48,0,48,0,48,0,400,352,14,34
43,STRĂINĂTATE,ERBIL,309,IRAK,9999,1,PART,PRCNCT,PRSD,PRSD_SV_D,"2025-05-18 21:26:57",0,30,0,30,0,29,1,400,370,10,19
43,STRĂINĂTATE,TEHERAN,310,"REPUBLICA ISLAMICĂ IRAN",9999,1,PART,PRCNCT,PRSD,PRSD_SV_D,"2025-05-18 20:49:26",0,46,0,46,0,46,0,400,354,12,34
43,STRĂINĂTATE,"DUBLIN 1",311,IRLANDA,9999,1,PART,PRCNCT,PRSD,PRSD_SV_D,"2025-05-18 23:06:47",0,1871,0,1871,0,1861,10,4800,2929,878,983
43,STRĂINĂTATE,"DUBLIN 2",312,IRLANDA,9999,1,PART,PRCNCT,PRSD,PRSD_SV_D,"2025-05-18 22:44:06",0,1863,0,1863,0,1853,10,4800,2937,950,903
43,STRĂINĂTATE,"DUBLIN 3",313,IRLANDA,9999,1,PART,PRCNCT,PRSD,PRSD_SV_D,"2025-05-18 23:41:42",0,1867,0,1867,0,1858,9,4800,2933,988,870
43,STRĂINĂTATE,"DUBLIN 4",314,IRLANDA,9999,2,PART,PRCNCT,PRSD,PRSD_SV_D,"2025-05-19 03:52:15",0,1867,0,1867,0,1862,5,4800,2933,931,931
43,STRĂINĂTATE,"DUBLIN 5",315,IRLANDA,9999,1,PART,PRCNCT,PRSD,PRSD_SV_D,"2025-05-18 22:46:31",0,2082,0,2082,0,2074,8,4800,2718,1203,871
43,STRĂINĂTATE,"DUBLIN 6",316,IRLANDA,9999,1,PART,PRCNCT,PRSD,PRSD_SV_D,"2025-05-18 22:50:58",0,2153,0,2153,0,2147,6,4800,2647,1217,930
43,STRĂINĂTATE,"DUBLIN 7",317,IRLANDA,9999,1,PART,PRCNCT,PRSD,PRSD_SV_D,"2025-05-18 22:14:37",0,2144,0,2144,0,2128,16,4800,2656,1197,931
43,STRĂINĂTATE,"DUBLIN 8",318,IRLANDA,9999,1,PART,PRCNCT,PRSD,PRSD_SV_D,"2025-05-18 23:20:48",0,2023,0,2023,0,2009,14,4800,2777,1050,959
43,STRĂINĂTATE,"DUBLIN 9",319,IRLANDA,9999,1,PART,PRCNCT,PRSD,PRSD_SV_D,"2025-05-18 23:33:50",0,2124,0,2124,0,2117,7,4800,2676,1179,938
43,STRĂINĂTATE,"DUBLIN 10",320,IRLANDA,9999,1,PART,PRCNCT,PRSD,PRSD_SV_D,"2025-05-18 22:16:34",0,2153,0,2153,0,2144,9,4800,2647,1161,983
43,STRĂINĂTATE,CORK,321,IRLANDA,9999,2,PART,PRCNCT,PRSD,PRSD_SV_D,"2025-05-19 02:33:32",0,1315,0,1315,0,1304,11,3200,1885,642,662
43,STRĂINĂTATE,DROGHEDA,322,IRLANDA,9999,1,PART,PRCNCT,PRSD,PRSD_SV_D,"2025-05-19 02:25:12",0,1965,0,1965,0,1949,16,3208,1243,1101,848
43,STRĂINĂTATE,GALWAY,323,IRLANDA,9999,1,PART,PRCNCT,PRSD,PRSD_SV_D,"2025-05-18 22:09:39",0,944,0,944,0,941,3,3208,2264,508,433
43,STRĂINĂTATE,KILKENNY,324,IRLANDA,9999,1,PART,PRCNCT,PRSD,PRSD_SV_D,"2025-05-18 23:10:35",0,1030,0,1030,0,1024,6,3200,2170,485,539
43,STRĂINĂTATE,LIMERICK,325,IRLANDA,9999,1,PART,PRCNCT,PRSD,PRSD_SV_D,"2025-05-18 22:45:59",0,816,0,816,0,811,5,3200,2384,379,432
43,STRĂINĂTATE,WATERFORD,326,IRLANDA,9999,1,PART,PRCNCT,PRSD,PRSD_SV_D,"2025-05-18 23:00:19",0,536,0,536,0,531,5,3200,2664,315,216
43,STRĂINĂTATE,"TEL AVIV 1",327,"STATUL ISRAEL",9999,1,PART,PRCNCT,PRSD,PRSD_SV_D,"2025-05-18 22:19:01",0,1109,0,1109,0,1104,5,1400,291,185,919
43,STRĂINĂTATE,"TEL AVIV 2",328,"STATUL ISRAEL",9999,3,PART,PRCNCT,PRSD,PRSD_SV_D,"2025-05-19 06:04:32",0,832,0,832,0,829,3,1000,168,130,699
43,STRĂINĂTATE,HAIFA,329,"STATUL ISRAEL",9999,1,PART,PRCNCT,PRSD,PRSD_SV_D,"2025-05-18 22:42:18",0,923,0,923,0,900,23,1200,277,116,784
43,STRĂINĂTATE,"ROMA 1",330,ITALIA,9999,1,PART,PRCNCT,PRSD,PRSD_SV_D,"2025-05-18 22:43:31",0,789,0,789,0,781,8,7200,6411,372,409
43,STRĂINĂTATE,"ROMA 2",331,ITALIA,9999,1,PART,PRCNCT,PRSD,PRSD_SV_D,"2025-05-18 23:09:46",0,794,0,794,0,787,7,6800,6006,354,433
43,STRĂINĂTATE,"ROMA 3",332,ITALIA,9999,2,PART,PRCNCT,PRSD,PRSD_SV_D,"2025-05-19 04:28:49",0,2421,0,2421,0,2399,22,8000,5579,1064,1335
43,STRĂINĂTATE,"ROMA 4",333,ITALIA,9999,2,PART,PRCNCT,PRSD,PRSD_SV_D,"2025-05-19 03:30:29",0,2910,0,2910,0,2888,22,8000,5090,1256,1632
43,STRĂINĂTATE,"ROMA 5",334,ITALIA,9999,2,PART,PRCNCT,PRSD,PRSD_SV_D,"2025-05-19 04:38:35",0,3293,0,3293,0,3268,25,8000,4707,2214,1054
43,STRĂINĂTATE,"ROMA 6",335,ITALIA,9999,1,PART,PRCNCT,PRSD,PRSD_SV_D,"2025-05-19 00:18:36",0,3321,0,3321,0,3305,16,8000,4679,2264,1041
43,STRĂINĂTATE,"ROMA 7",336,ITALIA,9999,1,PART,PRCNCT,PRSD,PRSD_SV_D,"2025-05-18 23:59:58",0,3300,0,3300,0,3273,27,8000,4700,2285,988
43,STRĂINĂTATE,OSTIA,337,ITALIA,9999,1,PART,PRCNCT,PRSD,PRSD_SV_D,"2025-05-18 22:50:23",0,3343,0,3343,0,3332,11,8000,4657,2388,944
43,STRĂINĂTATE,MONTEROTONDO,338,ITALIA,9999,1,PART,PRCNCT,PRSD,PRSD_SV_D,"2025-05-18 23:21:12",0,3867,0,3867,0,3849,18,8000,4133,2869,980
43,STRĂINĂTATE,"GUIDONIA MONTECELIO",339,ITALIA,9999,1,PART,PRCNCT,PRSD,PRSD_SV_D,"2025-05-19 00:12:50",0,4824,0,4824,0,4804,20,8000,3176,3505,1299
43,STRĂINĂTATE,PALESTRINA,340,ITALIA,9999,1,PART,PRCNCT,PRSD,PRSD_SV_D,"2025-05-19 00:20:02",0,3340,0,3340,0,3322,18,6800,3460,2588,734
43,STRĂINĂTATE,TIVOLI,341,ITALIA,9999,1,PART,PRCNCT,PRSD,PRSD_SV_D,"2025-05-18 23:03:52",0,1481,0,1481,0,1478,3,6000,4519,1053,425
43,STRĂINĂTATE,"RIGNANO FLAMINIO",342,ITALIA,9999,1,PART,PRCNCT,PRSD,PRSD_SV_D,"2025-05-18 23:45:41",0,1932,0,1932,0,1918,14,6000,4068,1431,487
43,STRĂINĂTATE,"ALBANO LAZIALE",343,ITALIA,9999,1,PART,PRCNCT,PRSD,PRSD_SV_D,"2025-05-18 23:43:53",0,3923,0,3923,0,3906,17,8000,4077,2893,1013
43,STRĂINĂTATE,LADISPOLI,344,ITALIA,9999,2,PART,PRCNCT,PRSD,PRSD_SV_D,"2025-05-19 02:44:47",0,3639,0,3639,0,3617,22,8000,4361,2645,972
43,STRĂINĂTATE,FROSINONE,345,ITALIA,9999,1,PART,PRCNCT,PRSD,PRSD_SV_D,"2025-05-18 23:34:05",0,1382,0,1382,0,1379,3,6000,4618,1102,277
43,STRĂINĂTATE,LATINA,346,ITALIA,9999,1,PART,PRCNCT,PRSD,PRSD_SV_D,"2025-05-19 00:59:02",0,3748,0,3748,0,3731,17,8000,4252,2920,811
43,STRĂINĂTATE,VITERBO,347,ITALIA,9999,1,PART,PRCNCT,PRSD,PRSD_SV_D,"2025-05-18 23:11:33",0,2061,0,2061,0,2049,12,6000,3939,1478,571
43,STRĂINĂTATE,TERNI,348,ITALIA,9999,1,PART,PRCNCT,PRSD,PRSD_SV_D,"2025-05-18 22:33:47",0,2110,0,2110,0,2099,11,6000,3890,1583,516
43,STRĂINĂTATE,PERUGIA,349,ITALIA,9999,1,PART,PRCNCT,PRSD,PRSD_SV_D,"2025-05-18 22:33:44",0,3067,0,3067,0,3049,18,6000,2933,2101,948
43,STRĂINĂTATE,PESCARA,350,ITALIA,9999,1,PART,PRCNCT,PRSD,PRSD_SV_D,"2025-05-19 00:04:59",0,2737,0,2737,0,2721,16,6000,3263,1933,788
43,STRĂINĂTATE,OLBIA,351,ITALIA,9999,1,PART,PRCNCT,PRSD,PRSD_SV_D,"2025-05-18 22:20:26",0,1631,0,1631,0,1621,10,4000,2369,1189,432
43,STRĂINĂTATE,CAGLIARI,352,ITALIA,9999,1,PART,PRCNCT,PRSD,PRSD_SV_D,"2025-05-18 22:27:55",0,746,0,746,0,738,8,4000,3254,396,342
43,STRĂINĂTATE,NAPOLI,353,ITALIA,9999,1,PART,PRCNCT,PRSD,PRSD_SV_D,"2025-05-18 23:04:25",0,3086,0,3086,0,3068,18,5600,2514,2045,1023
43,STRĂINĂTATE,"LA VALLETTA",354,MALTA,9999,1,PART,PRCNCT,PRSD,PRSD_SV_D,"2025-05-19 00:13:09",0,1642,0,1642,0,1624,18,4000,2358,484,1140
43,STRĂINĂTATE,"BARI 1",355,ITALIA,9999,1,PART,PRCNCT,PRSD,PRSD_SV_D,"2025-05-18 23:01:44",0,782,0,782,0,771,11,3200,2418,437,334
43,STRĂINĂTATE,"BARI 2",356,ITALIA,9999,1,PART,PRCNCT,PRSD,PRSD_SV_D,"2025-05-18 22:03:19",0,901,0,901,0,895,6,3200,2299,253,642
43,STRĂINĂTATE,TRANI,357,ITALIA,9999,1,PART,PRCNCT,PRSD,PRSD_SV_D,"2025-05-18 22:25:41",0,767,0,767,0,764,3,3200,2433,662,102
43,STRĂINĂTATE,FOGGIA,358,ITALIA,9999,1,PART,PRCNCT,PRSD,PRSD_SV_D,"2025-05-18 23:26:33",0,1245,0,1245,0,1230,15,3200,1955,1061,169
43,STRĂINĂTATE,LECCE,359,ITALIA,9999,1,PART,PRCNCT,PRSD,PRSD_SV_D,"2025-05-18 22:57:13",0,652,0,652,0,647,5,3200,2548,438,209
43,STRĂINĂTATE,TARANTO,360,ITALIA,9999,1,PART,PRCNCT,PRSD,PRSD_SV_D,"2025-05-18 23:13:50",0,541,0,541,0,540,1,3200,2659,434,106
43,STRĂINĂTATE,GINOSA,361,ITALIA,9999,1,PART,PRCNCT,PRSD,PRSD_SV_D,"2025-05-18 22:06:04",0,478,0,478,0,475,3,3200,2722,409,66
43,STRĂINĂTATE,COSENZA,362,ITALIA,9999,1,PART,PRCNCT,PRSD,PRSD_SV_D,"2025-05-18 22:42:07",0,559,0,559,0,554,5,3200,2641,444,110
43,STRĂINĂTATE,"REGGIO CALABRIA",363,ITALIA,9999,1,PART,PRCNCT,PRSD,PRSD_SV_D,"2025-05-18 22:58:03",0,724,0,724,0,718,6,3200,2476,536,182
43,STRĂINĂTATE,CROTONE,364,ITALIA,9999,1,PART,PRCNCT,PRSD,PRSD_SV_D,"2025-05-18 22:23:17",0,264,0,264,0,263,1,2400,2136,197,66
43,STRĂINĂTATE,CATANZARO,365,ITALIA,9999,1,PART,PRCNCT,PRSD,PRSD_SV_D,"2025-05-18 22:01:56",0,272,0,272,0,269,3,3200,2928,204,65
43,STRĂINĂTATE,"VIBO VALENTIA",366,ITALIA,9999,1,PART,PRCNCT,PRSD,PRSD_SV_D,"2025-05-18 22:01:52",0,294,0,294,0,291,3,3200,2906,232,59
43,STRĂINĂTATE,"LAMEZIA TERME",367,ITALIA,9999,1,PART,PRCNCT,PRSD,PRSD_SV_D,"2025-05-18 22:17:55",0,336,0,336,0,334,2,3200,2864,241,93
43,STRĂINĂTATE,CORIGLIANO-ROSSANO,368,ITALIA,9999,1,PART,PRCNCT,PRSD,PRSD_SV_D,"2025-05-18 22:45:28",0,755,0,755,0,754,1,3200,2445,678,76
43,STRĂINĂTATE,POTENZA,369,ITALIA,9999,1,PART,PRCNCT,PRSD,PRSD_SV_D,"2025-05-18 22:11:47",0,615,0,615,0,612,3,3200,2585,500,112
43,STRĂINĂTATE,MATERA,370,ITALIA,9999,1,PART,PRCNCT,PRSD,PRSD_SV_D,"2025-05-18 22:28:45",0,357,0,357,0,354,3,3200,2843,207,147
43,STRĂINĂTATE,CAMPOBASSO,371,ITALIA,9999,1,PART,PRCNCT,PRSD,PRSD_SV_D,"2025-05-18 21:51:27",0,323,0,323,0,321,2,3200,2877,238,83
43,STRĂINĂTATE,ISERNIA,372,ITALIA,9999,1,PART,PRCNCT,PRSD,PRSD_SV_D,"2025-05-18 22:17:41",0,235,0,235,0,233,2,3200,2965,182,51
43,STRĂINĂTATE,"BOLOGNA 1",373,ITALIA,9999,1,PART,PRCNCT,PRSD,PRSD_SV_D,"2025-05-18 22:58:31",0,2214,0,2214,0,2201,13,5600,3386,1214,987
43,STRĂINĂTATE,"BOLOGNA 2",374,ITALIA,9999,1,PART,PRCNCT,PRSD,PRSD_SV_D,"2025-05-18 22:51:17",0,1170,0,1170,0,1160,10,4800,3630,652,508
43,STRĂINĂTATE,"BOLOGNA 3 - BORGO PANIGALE",375,ITALIA,9999,1,PART,PRCNCT,PRSD,PRSD_SV_D,"2025-05-18 22:42:44",0,2397,0,2397,0,2384,13,5600,3203,1432,952
43,STRĂINĂTATE,ANCONA,376,ITALIA,9999,1,PART,PRCNCT,PRSD,PRSD_SV_D,"2025-05-18 22:25:22",0,2151,0,2151,0,2143,8,3200,1049,1560,583
43,STRĂINĂTATE,AREZZO,377,ITALIA,9999,1,PART,PRCNCT,PRSD,PRSD_SV_D,"2025-05-18 22:43:15",0,3004,0,3004,0,2990,14,4000,996,1984,1006
43,STRĂINĂTATE,"ASCOLI PICENO",378,ITALIA,9999,1,PART,PRCNCT,PRSD,PRSD_SV_D,"2025-05-18 22:40:25",0,918,0,918,0,907,11,3200,2282,706,201
43,STRĂINĂTATE,BUDRIO,379,ITALIA,9999,2,PART,PRCNCT,PRSD,PRSD_SV_D,"2025-05-19 03:28:07",0,712,0,712,0,708,4,3200,2488,501,207
43,STRĂINĂTATE,CESENA,380,ITALIA,9999,1,PART,PRCNCT,PRSD,PRSD_SV_D,"2025-05-18 22:43:24",0,1307,0,1307,0,1294,13,3200,1893,874,420
43,STRĂINĂTATE,FERRARA,381,ITALIA,9999,1,PART,PRCNCT,PRSD,PRSD_SV_D,"2025-05-18 22:11:39",0,2034,0,2034,0,2029,5,3200,1166,1431,598
43,STRĂINĂTATE,FIRENZE,382,ITALIA,9999,1,PART,PRCNCT,PRSD,PRSD_SV_D,"2025-05-19 00:27:56",0,2954,0,2954,0,2927,27,5600,2646,1579,1348
43,STRĂINĂTATE,FORLI,383,ITALIA,9999,1,PART,PRCNCT,PRSD,PRSD_SV_D,"2025-05-18 23:06:37",0,1859,0,1859,0,1841,18,3200,1341,1196,645
43,STRĂINĂTATE,GROSSETO,384,ITALIA,9999,1,PART,PRCNCT,PRSD,PRSD_SV_D,"2025-05-19 00:08:03",0,1445,0,1445,0,1437,8,3200,1755,1004,433
43,STRĂINĂTATE,IMOLA,385,ITALIA,9999,1,PART,PRCNCT,PRSD,PRSD_SV_D,"2025-05-18 23:41:58",0,2217,0,2217,0,2200,17,3200,983,1351,849
43,STRĂINĂTATE,LIVORNO,386,ITALIA,9999,1,PART,PRCNCT,PRSD,PRSD_SV_D,"2025-05-18 22:58:48",0,2119,0,2119,0,2098,21,3200,1081,1528,570
43,STRĂINĂTATE,LUCCA,387,ITALIA,9999,1,PART,PRCNCT,PRSD,PRSD_SV_D,"2025-05-18 22:53:14",0,1757,0,1757,0,1751,6,3200,1443,1206,545
43,STRĂINĂTATE,MACERATA,388,ITALIA,9999,1,PART,PRCNCT,PRSD,PRSD_SV_D,"2025-05-18 22:29:31",0,1332,0,1332,0,1327,5,3200,1868,929,398
43,STRĂINĂTATE,MASSA,389,ITALIA,9999,1,PART,PRCNCT,PRSD,PRSD_SV_D,"2025-05-18 22:32:17",0,1886,0,1886,0,1875,11,3200,1314,1328,547
43,STRĂINĂTATE,MODENA,390,ITALIA,9999,1,PART,PRCNCT,PRSD,PRSD_SV_D,"2025-05-18 23:02:09",0,3021,0,3021,0,3008,13,4000,979,1817,1191
43,STRĂINĂTATE,"MONTECATINI TERME",391,ITALIA,9999,1,PART,PRCNCT,PRSD,PRSD_SV_D,"2025-05-18 23:36:20",0,1411,0,1411,0,1402,9,3200,1789,849,553
43,STRĂINĂTATE,PARMA,392,ITALIA,9999,2,PART,PRCNCT,PRSD,PRSD_SV_D,"2025-05-19 05:30:00",0,2813,0,2813,0,2798,15,4000,1187,1482,1316
43,STRĂINĂTATE,PESARO,393,ITALIA,9999,1,PART,PRCNCT,PRSD,PRSD_SV_D,"2025-05-18 22:01:56",0,1198,0,1198,0,1189,9,3200,2002,713,476
43,STRĂINĂTATE,PIACENZA,394,ITALIA,9999,1,PART,PRCNCT,PRSD,PRSD_SV_D,"2025-05-19 01:10:12",0,2912,0,2912,0,2892,20,5600,2688,2154,738
43,STRĂINĂTATE,PISTOIA,395,ITALIA,9999,1,PART,PRCNCT,PRSD,PRSD_SV_D,"2025-05-18 22:24:26",0,656,0,656,0,650,6,3200,2544,423,227
43,STRĂINĂTATE,PRATO,396,ITALIA,9999,1,PART,PRCNCT,PRSD,PRSD_SV_D,"2025-05-18 23:26:02",0,1487,0,1487,0,1477,10,5600,4113,1013,464
43,STRĂINĂTATE,RAVENNA,397,ITALIA,9999,1,PART,PRCNCT,PRSD,PRSD_SV_D,"2025-05-18 23:42:05",0,2219,0,2219,0,2212,7,3200,981,1470,742
43,STRĂINĂTATE,"REGGIO EMILIA",398,ITALIA,9999,2,PART,PRCNCT,PRSD,PRSD_SV_D,"2025-05-19 03:34:43",0,1382,0,1382,0,1372,10,4000,2618,780,592
43,STRĂINĂTATE,RIMINI,399,ITALIA,9999,1,PART,PRCNCT,PRSD,PRSD_SV_D,"2025-05-18 21:59:37",0,2045,0,2045,0,2023,22,3200,1155,1184,839
43,STRĂINĂTATE,"SAN LAZZARO",400,ITALIA,9999,1,PART,PRCNCT,PRSD,PRSD_SV_D,"2025-05-18 21:49:39",0,348,0,348,0,345,3,3200,2852,193,152
43,STRĂINĂTATE,"SESTO FIORENTINO",401,ITALIA,9999,1,PART,PRCNCT,PRSD,PRSD_SV_D,"2025-05-18 22:24:44",0,1876,0,1876,0,1869,7,2400,524,1370,499
43,STRĂINĂTATE,SIENA,402,ITALIA,9999,1,PART,PRCNCT,PRSD,PRSD_SV_D,"2025-05-18 23:21:03",0,1135,0,1135,0,1129,6,4000,2865,620,509
43,STRĂINĂTATE,"CATANIA 1",403,ITALIA,9999,1,PART,PRCNCT,PRSD,PRSD_SV_D,"2025-05-18 22:22:48",0,1075,0,1075,0,1072,3,3200,2125,594,478
43,STRĂINĂTATE,"CATANIA 2",404,ITALIA,9999,1,PART,PRCNCT,PRSD,PRSD_SV_D,"2025-05-18 22:31:35",0,1458,0,1458,0,1437,21,3200,1742,831,606
43,STRĂINĂTATE,ALCAMO,405,ITALIA,9999,1,PART,PRCNCT,PRSD,PRSD_SV_D,"2025-05-18 22:16:30",0,774,0,774,0,764,10,3200,2426,577,187
43,STRĂINĂTATE,VITTORIA,406,ITALIA,9999,1,PART,PRCNCT,PRSD,PRSD_SV_D,"2025-05-18 22:16:37",0,1144,0,1144,0,1142,2,3200,2056,946,196
43,STRĂINĂTATE,PALERMO,407,ITALIA,9999,1,PART,PRCNCT,PRSD,PRSD_SV_D,"2025-05-18 22:50:13",0,1094,0,1094,0,1083,11,3200,2106,633,450
43,STRĂINĂTATE,CANICATTI,408,ITALIA,9999,1,PART,PRCNCT,PRSD,PRSD_SV_D,"2025-05-18 22:16:53",0,1031,0,1031,0,1024,7,3200,2169,876,148
43,STRĂINĂTATE,MESSINA,409,ITALIA,9999,2,PART,PRCNCT,PRSD,PRSD_SV_D,"2025-05-19 01:58:25",0,566,0,566,0,563,3,3200,2634,409,154
43,STRĂINĂTATE,"MILANO 1",410,ITALIA,9999,1,PART,PRCNCT,PRSD,PRSD_SV_D,"2025-05-18 22:34:18",0,1549,0,1549,0,1543,6,3200,1651,703,840
43,STRĂINĂTATE,"MILANO 2",411,ITALIA,9999,1,PART,PRCNCT,PRSD,PRSD_SV_D,"2025-05-18 22:42:30",0,1640,0,1640,0,1631,9,3200,1560,711,920
43,STRĂINĂTATE,"MILANO 3",412,ITALIA,9999,3,PART,PRCNCT,PRSD,PRSD_SV_D,"2025-05-19 03:36:55",0,1552,0,1552,0,1547,5,3200,1648,753,794
43,STRĂINĂTATE,"MILANO 4",413,ITALIA,9999,1,PART,PRCNCT,PRSD,PRSD_SV_D,"2025-05-18 22:58:29",0,1598,0,1598,0,1590,8,3200,1602,662,928
43,STRĂINĂTATE,"BERGAMO 1",414,ITALIA,9999,1,PART,PRCNCT,PRSD,PRSD_SV_D,"2025-05-18 21:59:41",0,2146,0,2146,0,2134,12,3200,1054,1392,742
43,STRĂINĂTATE,"BERGAMO 2",415,ITALIA,9999,1,PART,PRCNCT,PRSD,PRSD_SV_D,"2025-05-18 22:07:47",0,2170,0,2170,0,2160,10,3200,1030,1377,783
43,STRĂINĂTATE,"BRESCIA 1",416,ITALIA,9999,1,PART,PRCNCT,PRSD,PRSD_SV_D,"2025-05-18 23:31:28",0,2183,0,2183,0,2168,15,2800,617,1315,853
43,STRĂINĂTATE,"BRESCIA 2",417,ITALIA,9999,1,PART,PRCNCT,PRSD,PRSD_SV_D,"2025-05-18 23:45:12",0,2167,0,2167,0,2157,10,3200,1033,1313,844
43,STRĂINĂTATE,BOLZANO,418,ITALIA,9999,1,PART,PRCNCT,PRSD,PRSD_SV_D,"2025-05-18 23:17:22",0,1687,0,1687,0,1682,5,3200,1513,1072,610
43,STRĂINĂTATE,CLES,419,ITALIA,9999,1,PART,PRCNCT,PRSD,PRSD_SV_D,"2025-05-18 22:08:22",0,861,0,861,0,858,3,3200,2339,640,218
43,STRĂINĂTATE,COMO,420,ITALIA,9999,2,PART,PRCNCT,PRSD,PRSD_SV_D,"2025-05-18 23:35:12",0,2257,0,2257,0,2243,14,3200,943,1249,994
43,STRĂINĂTATE,CREMA,421,ITALIA,9999,1,PART,PRCNCT,PRSD,PRSD_SV_D,"2025-05-18 22:40:48",0,1358,0,1358,0,1352,6,2400,1042,999,353
43,STRĂINĂTATE,CREMONA,422,ITALIA,9999,1,PART,PRCNCT,PRSD,PRSD_SV_D,"2025-05-18 23:06:46",0,2341,0,2341,0,2326,15,3200,859,1694,632
43,STRĂINĂTATE,LODI,423,ITALIA,9999,1,PART,PRCNCT,PRSD,PRSD_SV_D,"2025-05-18 23:08:14",0,3355,0,3355,0,3343,12,3600,245,2565,778
43,STRĂINĂTATE,"MONZA 1",424,ITALIA,9999,1,PART,PRCNCT,PRSD,PRSD_SV_D,"2025-05-18 22:12:48",0,2628,0,2628,0,2614,14,3200,572,1762,852
43,STRĂINĂTATE,"MONZA 2",425,ITALIA,9999,1,PART,PRCNCT,PRSD,PRSD_SV_D,"2025-05-18 22:27:00",0,2583,0,2583,0,2575,8,3200,617,1718,857
43,STRĂINĂTATE,"MONZA 3",426,ITALIA,9999,1,PART,PRCNCT,PRSD,PRSD_SV_D,"2025-05-18 22:39:10",0,2123,0,2123,0,2118,5,3200,1077,1557,561
43,STRĂINĂTATE,MANTOVA,427,ITALIA,9999,1,PART,PRCNCT,PRSD,PRSD_SV_D,"2025-05-18 23:40:05",0,1478,0,1478,0,1469,9,3200,1722,1001,468
43,STRĂINĂTATE,MONTICHIARI,428,ITALIA,9999,1,PART,PRCNCT,PRSD,PRSD_SV_D,"2025-05-18 23:26:17",0,2938,0,2938,0,2926,12,3600,662,2031,895
43,STRĂINĂTATE,PAVIA,429,ITALIA,9999,1,PART,PRCNCT,PRSD,PRSD_SV_D,"2025-05-19 00:02:31",0,2996,0,2996,0,2983,13,3600,604,2240,743
43,STRĂINĂTATE,"ROMANO DI LOMBARDIA",430,ITALIA,9999,1,PART,PRCNCT,PRSD,PRSD_SV_D,"2025-05-18 22:19:53",0,1991,0,1991,0,1984,7,3199,1208,1441,543
43,STRĂINĂTATE,ROVERETO,431,ITALIA,9999,1,PART,PRCNCT,PRSD,PRSD_SV_D,"2025-05-18 21:51:58",0,912,0,912,0,906,6,3200,2288,532,374
43,STRĂINĂTATE,"SESTO SAN GIOVANNI",432,ITALIA,9999,1,PART,PRCNCT,PRSD,PRSD_SV_D,"2025-05-18 23:40:33",0,2891,0,2891,0,2876,15,3200,309,1952,924
43,STRĂINĂTATE,TRENTO,433,ITALIA,9999,1,PART,PRCNCT,PRSD,PRSD_SV_D,"2025-05-18 23:36:50",0,1753,0,1753,0,1739,14,3200,1447,966,773
43,STRĂINĂTATE,VARESE,434,ITALIA,9999,1,PART,PRCNCT,PRSD,PRSD_SV_D,"2025-05-18 22:42:54",0,1876,0,1876,0,1859,17,3200,1324,1118,741
43,STRĂINĂTATE,"TORINO 1",435,ITALIA,9999,1,PART,PRCNCT,PRSD,PRSD_SV_D,"2025-05-19 00:24:49",0,2149,0,2149,0,2131,18,4000,1851,1467,664
43,STRĂINĂTATE,"TORINO 2",436,ITALIA,9999,1,PART,PRCNCT,PRSD,PRSD_SV_D,"2025-05-18 23:40:27",0,2314,0,2314,0,2290,24,4000,1686,1602,688
43,STRĂINĂTATE,"TORINO 3",437,ITALIA,9999,2,PART,PRCNCT,PRSD,PRSD_SV_D,"2025-05-19 04:30:47",0,2214,0,2214,0,2202,12,4000,1786,1492,710
43,STRĂINĂTATE,"TORINO 4",438,ITALIA,9999,1,PART,PRCNCT,PRSD,PRSD_SV_D,"2025-05-19 00:09:41",0,2487,0,2487,0,2477,10,4000,1513,1571,906
43,STRĂINĂTATE,"TORINO 5",439,ITALIA,9999,1,PART,PRCNCT,PRSD,PRSD_SV_D,"2025-05-19 00:07:04",0,2499,0,2499,0,2483,16,4000,1501,1526,957
43,STRĂINĂTATE,"TORINO 6",440,ITALIA,9999,1,PART,PRCNCT,PRSD,PRSD_SV_D,"2025-05-18 23:03:53",0,690,0,690,0,690,0,4000,3310,379,311
43,STRĂINĂTATE,ALBA,441,ITALIA,9999,1,PART,PRCNCT,PRSD,PRSD_SV_D,"2025-05-18 22:51:24",0,1966,0,1966,0,1946,20,4000,2034,1369,577
43,STRĂINĂTATE,ALESSANDRIA,442,ITALIA,9999,1,PART,PRCNCT,PRSD,PRSD_SV_D,"2025-05-18 22:02:58",0,1694,0,1694,0,1687,7,4000,2306,1188,499
43,STRĂINĂTATE,AOSTA,443,ITALIA,9999,2,PART,PRCNCT,PRSD,PRSD_SV_D,"2025-05-18 23:39:11",0,796,0,796,0,793,3,4000,3204,531,262
43,STRĂINĂTATE,ASTI,444,ITALIA,9999,1,PART,PRCNCT,PRSD,PRSD_SV_D,"2025-05-18 22:51:06",0,1409,0,1409,0,1405,4,4000,2591,969,436
43,STRĂINĂTATE,BIELLA,445,ITALIA,9999,1,PART,PRCNCT,PRSD,PRSD_SV_D,"2025-05-18 23:05:58",0,703,0,703,0,698,5,4000,3297,472,226
43,STRĂINĂTATE,CARMAGNOLA,446,ITALIA,9999,1,PART,PRCNCT,PRSD,PRSD_SV_D,"2025-05-18 22:46:05",0,1390,0,1390,0,1374,16,4000,2610,974,400
43,STRĂINĂTATE,CHIERI,447,ITALIA,9999,1,PART,PRCNCT,PRSD,PRSD_SV_D,"2025-05-18 22:51:18",0,1157,0,1157,0,1151,6,4008,2851,789,362
43,STRĂINĂTATE,CHIVASSO,448,ITALIA,9999,1,PART,PRCNCT,PRSD,PRSD_SV_D,"2025-05-18 22:54:05",0,1439,0,1439,0,1428,11,4000,2561,970,458
43,STRĂINĂTATE,CIRIE,449,ITALIA,9999,1,PART,PRCNCT,PRSD,PRSD_SV_D,"2025-05-18 23:56:15",0,1267,0,1267,0,1261,6,4000,2733,858,403
43,STRĂINĂTATE,COLLEGNO,450,ITALIA,9999,1,PART,PRCNCT,PRSD,PRSD_SV_D,"2025-05-19 00:41:56",0,2392,0,2392,0,2379,13,3992,1600,1636,743
43,STRĂINĂTATE,CUNEO,451,ITALIA,9999,1,PART,PRCNCT,PRSD,PRSD_SV_D,"2025-05-18 22:58:25",0,1416,0,1416,0,1411,5,4000,2584,1025,386
43,STRĂINĂTATE,GENOVA,452,ITALIA,9999,3,PART,PRCNCT,PRSD,PRSD_SV_D,"2025-05-19 02:49:31",0,2817,0,2817,0,2804,13,4000,1183,1899,905
43,STRĂINĂTATE,IMPERIA,453,ITALIA,9999,1,PART,PRCNCT,PRSD,PRSD_SV_D,"2025-05-18 22:17:03",0,446,0,446,0,446,0,4000,3554,290,156
43,STRĂINĂTATE,IVREA,454,ITALIA,9999,1,PART,PRCNCT,PRSD,PRSD_SV_D,"2025-05-18 23:04:21",0,1374,0,1374,0,1361,13,4000,2626,955,406
43,STRĂINĂTATE,"LA SPEZIA",455,ITALIA,9999,1,PART,PRCNCT,PRSD,PRSD_SV_D,"2025-05-18 22:54:54",0,1531,0,1531,0,1519,12,4000,2469,1011,508
43,STRĂINĂTATE,MONCALIERI,456,ITALIA,9999,1,PART,PRCNCT,PRSD,PRSD_SV_D,"2025-05-18 23:13:14",0,1730,0,1730,0,1722,8,4000,2270,1207,515
43,STRĂINĂTATE,MONDOVI,457,ITALIA,9999,1,PART,PRCNCT,PRSD,PRSD_SV_D,"2025-05-18 22:50:23",0,721,0,721,0,719,2,4000,3279,532,187
43,STRĂINĂTATE,NICHELINO,458,ITALIA,9999,1,PART,PRCNCT,PRSD,PRSD_SV_D,"2025-05-18 22:59:13",0,1830,0,1830,0,1820,10,4000,2170,1253,567
43,STRĂINĂTATE,NOVARA,459,ITALIA,9999,1,PART,PRCNCT,PRSD,PRSD_SV_D,"2025-05-18 22:57:07",0,2144,0,2144,0,2130,14,4000,1856,1514,616
43,STRĂINĂTATE,PINEROLO,460,ITALIA,9999,1,PART,PRCNCT,PRSD,PRSD_SV_D,"2025-05-18 22:59:24",0,1579,0,1579,0,1571,8,4000,2421,1052,519
43,STRĂINĂTATE,SANREMO,461,ITALIA,9999,1,PART,PRCNCT,PRSD,PRSD_SV_D,"2025-05-18 22:17:45",0,1063,0,1063,0,1055,8,4000,2937,708,347
43,STRĂINĂTATE,SAVONA,462,ITALIA,9999,1,PART,PRCNCT,PRSD,PRSD_SV_D,"2025-05-18 22:38:56",0,820,0,820,0,813,7,4000,3180,565,248
43,STRĂINĂTATE,"SETTIMO TORINESE",463,ITALIA,9999,1,PART,PRCNCT,PRSD,PRSD_SV_D,"2025-05-18 23:23:06",0,1064,0,1064,0,1062,2,4000,2936,669,393
43,STRĂINĂTATE,SUSA,464,ITALIA,9999,2,PART,PRCNCT,PRSD,PRSD_SV_D,"2025-05-19 02:08:00",0,597,0,597,0,596,1,4000,3403,437,159
43,STRĂINĂTATE,TORTONA,465,ITALIA,9999,1,PART,PRCNCT,PRSD,PRSD_SV_D,"2025-05-18 23:13:44",0,2502,0,2502,0,2490,12,4000,1498,1889,601
43,STRĂINĂTATE,VERBANIA,466,ITALIA,9999,1,PART,PRCNCT,PRSD,PRSD_SV_D,"2025-05-18 22:45:46",0,507,0,507,0,505,2,4000,3493,320,185
43,STRĂINĂTATE,VERCELLI,467,ITALIA,9999,1,PART,PRCNCT,PRSD,PRSD_SV_D,"2025-05-18 23:06:47",0,800,0,800,0,796,4,4000,3200,577,219
43,STRĂINĂTATE,TRIESTE,468,ITALIA,9999,1,PART,PRCNCT,PRSD,PRSD_SV_D,"2025-05-18 23:01:07",0,1383,0,1383,0,1378,5,6400,5017,850,528
43,STRĂINĂTATE,"CERVIGNANO DEL FRIULI",469,ITALIA,9999,1,PART,PRCNCT,PRSD,PRSD_SV_D,"2025-05-18 22:46:24",0,1747,0,1747,0,1733,14,6400,4653,1316,417
43,STRĂINĂTATE,UDINE,470,ITALIA,9999,1,PART,PRCNCT,PRSD,PRSD_SV_D,"2025-05-18 22:26:03",0,2554,0,2554,0,2545,9,6400,3846,1690,855
43,STRĂINĂTATE,PORDENONE,471,ITALIA,9999,1,PART,PRCNCT,PRSD,PRSD_SV_D,"2025-05-18 23:19:00",0,2829,0,2829,0,2815,14,6400,3571,1880,935
43,STRĂINĂTATE,"PRATA DI PORDENONE",472,ITALIA,9999,1,PART,PRCNCT,PRSD,PRSD_SV_D,"2025-05-18 23:39:50",0,1341,0,1341,0,1337,4,6400,5059,938,399
43,STRĂINĂTATE,VENEZIA,473,ITALIA,9999,1,PART,PRCNCT,PRSD,PRSD_SV_D,"2025-05-19 00:30:44",0,1865,0,1865,0,1845,20,6400,4535,634,1211
43,STRĂINĂTATE,"SAN DONÀ DI PIAVE",474,ITALIA,9999,1,PART,PRCNCT,PRSD,PRSD_SV_D,"2025-05-18 22:16:25",0,1471,0,1471,0,1467,4,6400,4929,900,567
43,STRĂINĂTATE,TREVISO,475,ITALIA,9999,1,PART,PRCNCT,PRSD,PRSD_SV_D,"2025-05-19 00:59:47",0,3498,0,3498,0,3483,15,6400,2902,2084,1399
43,STRĂINĂTATE,"CASTELFRANCO VENETO",476,ITALIA,9999,1,PART,PRCNCT,PRSD,PRSD_SV_D,"2025-05-18 23:55:19",0,4888,0,4888,0,4865,23,6400,1512,3544,1321
43,STRĂINĂTATE,ODERZO,477,ITALIA,9999,1,PART,PRCNCT,PRSD,PRSD_SV_D,"2025-05-19 00:23:16",0,2371,0,2371,0,2355,16,6400,4029,1652,703
43,STRĂINĂTATE,PADOVA,478,ITALIA,9999,1,PART,PRCNCT,PRSD,PRSD_SV_D,"2025-05-18 23:20:52",0,1357,0,1357,0,1349,8,6400,5043,708,641
43,STRĂINĂTATE,ALBIGNASEGO,479,ITALIA,9999,1,PART,PRCNCT,PRSD,PRSD_SV_D,"2025-05-18 22:33:18",0,1845,0,1845,0,1835,10,6400,4555,1112,723
43,STRĂINĂTATE,CADONEGHE,480,ITALIA,9999,3,PART,PRCNCT,PRSD,PRSD_SV_D,"2025-05-19 05:08:14",0,3618,0,3618,0,3599,19,6400,2782,2503,1096
43,STRĂINĂTATE,LIMENA,481,ITALIA,9999,1,PART,PRCNCT,PRSD,PRSD_SV_D,"2025-05-19 00:17:56",0,2064,0,2064,0,2054,10,6400,4336,1403,651
43,STRĂINĂTATE,"ABANO TERME",482,ITALIA,9999,1,PART,PRCNCT,PRSD,PRSD_SV_D,"2025-05-18 23:02:20",0,1004,0,1004,0,999,5,6400,5396,622,377
43,STRĂINĂTATE,ROVIGO,483,ITALIA,9999,1,PART,PRCNCT,PRSD,PRSD_SV_D,"2025-05-19 00:24:58",0,1011,0,1011,0,1004,7,6400,5389,688,316
43,STRĂINĂTATE,"VERONA 1",484,ITALIA,9999,1,PART,PRCNCT,PRSD,PRSD_SV_D,"2025-05-18 23:51:01",0,4314,0,4314,0,4290,24,6400,2086,2785,1505
43,STRĂINĂTATE,"VERONA 2",485,ITALIA,9999,1,PART,PRCNCT,PRSD,PRSD_SV_D,"2025-05-18 23:21:09",0,2146,0,2146,0,2133,13,6400,4254,1406,727
43,STRĂINĂTATE,"VILLAFRANCA DI VERONA",486,ITALIA,9999,1,PART,PRCNCT,PRSD,PRSD_SV_D,"2025-05-18 23:31:00",0,2299,0,2299,0,2286,13,6400,4101,1567,719
43,STRĂINĂTATE,"VALEGGIO SUL MINCIO",487,ITALIA,9999,1,PART,PRCNCT,PRSD,PRSD_SV_D,"2025-05-18 22:07:00",0,1309,0,1309,0,1303,6,6400,5091,857,446
43,STRĂINĂTATE,CEREA,488,ITALIA,9999,1,PART,PRCNCT,PRSD,PRSD_SV_D,"2025-05-18 22:27:10",0,2139,0,2139,0,2128,11,6400,4261,1600,528
43,STRĂINĂTATE,VICENZA,489,ITALIA,9999,2,PART,PRCNCT,PRSD,PRSD_SV_D,"2025-05-19 05:31:06",0,2247,0,2247,0,2235,12,6400,4153,1349,886
43,STRĂINĂTATE,SCHIO,490,ITALIA,9999,1,PART,PRCNCT,PRSD,PRSD_SV_D,"2025-05-18 22:56:17",0,1176,0,1176,0,1168,8,6400,5224,654,514
43,STRĂINĂTATE,TOKYO,491,JAPONIA,9999,1,PART,PRCNCT,PRSD,PRSD_SV_D,"2025-05-18 17:49:21",0,1016,0,1016,0,1016,0,1600,584,101,915
43,STRĂINĂTATE,ASTANA,492,"REPUBLICA KAZAHSTAN",9999,1,PART,PRCNCT,PRSD,PRSD_SV_D,"2025-05-18 19:49:12",0,81,0,81,0,81,0,400,319,7,74
43,STRĂINĂTATE,NAIROBI,493,KENYA,9999,2,PART,PRCNCT,PRSD,PRSD_SV_D,"2025-05-19 01:17:26",0,60,0,60,0,60,0,400,340,10,50
43,STRĂINĂTATE,KUWEIT,494,KUWEIT,9999,1,PART,PRCNCT,PRSD,PRSD_SV_D,"2025-05-18 21:40:39",0,235,0,235,0,234,1,800,565,47,187
43,STRĂINĂTATE,BEIRUT,495,"REPUBLICA LIBANEZĂ",9999,1,PART,PRCNCT,PRSD,PRSD_SV_D,"2025-05-18 22:02:02",0,132,0,132,0,130,2,800,668,46,84
43,STRĂINĂTATE,VILNIUS,496,LITUANIA,9999,1,PART,PRCNCT,PRSD,PRSD_SV_D,"2025-05-18 22:12:15",0,303,0,303,0,297,6,1200,897,42,255
43,STRĂINĂTATE,RIGA,497,LETONIA,9999,1,PART,PRCNCT,PRSD,PRSD_SV_D,"2025-05-18 22:18:08",0,266,0,266,0,262,4,800,534,55,207
43,STRĂINĂTATE,"LUXEMBURG 1",498,LUXEMBURG,9999,1,PART,PRCNCT,PRSD,PRSD_SV_D,"2025-05-19 01:44:59",0,1674,0,1674,0,1666,8,5600,3926,436,1230
43,STRĂINĂTATE,"LUXEMBURG 2",499,LUXEMBURG,9999,1,PART,PRCNCT,PRSD,PRSD_SV_D,"2025-05-18 23:15:29",0,1538,0,1538,0,1532,6,5608,4070,468,1064
43,STRĂINĂTATE,"LUXEMBURG 3",500,LUXEMBURG,9999,1,PART,PRCNCT,PRSD,PRSD_SV_D,"2025-05-18 22:59:54",0,1731,0,1731,0,1727,4,5600,3869,525,1202
43,STRĂINĂTATE,SKOPJE,501,"REPUBLICA MACEDONIA DE NORD",9999,2,PART,PRCNCT,PRSD,PRSD_SV_D,"2025-05-19 02:51:56",0,227,0,227,0,222,5,800,573,68,154
43,STRĂINĂTATE,"KUALA LUMPUR",502,MALAYSIA,9999,1,PART,PRCNCT,PRSD,PRSD_SV_D,"2025-05-18 16:56:42",0,150,0,150,0,150,0,800,650,23,127
43,STRĂINĂTATE,"LONDRA-WESTMINSTER 1",503,"REGATUL UNIT AL MARII BRITANII ȘI AL IRLANDEI DE NORD",9999,3,PART,PRCNCT,PRSD,PRSD_SV_D,"2025-05-19 03:25:44",0,1904,0,1904,0,1889,15,6400,4496,338,1551
43,STRĂINĂTATE,"LONDRA-WESTMINSTER 2",504,"REGATUL UNIT AL MARII BRITANII ȘI AL IRLANDEI DE NORD",9999,1,PART,PRCNCT,PRSD,PRSD_SV_D,"2025-05-18 23:23:59",0,1932,0,1932,0,1921,11,6400,4468,404,1517
43,STRĂINĂTATE,"LONDRA-TOTTENHAM COURT ROAD",505,"REGATUL UNIT AL MARII BRITANII ȘI AL IRLANDEI DE NORD",9999,1,PART,PRCNCT,PRSD,PRSD_SV_D,"2025-05-18 22:57:00",0,2775,0,2775,0,2767,8,10400,7625,337,2430
43,STRĂINĂTATE,"LONDRA-WHITE CITY",506,"REGATUL UNIT AL MARII BRITANII ȘI AL IRLANDEI DE NORD",9999,3,PART,PRCNCT,PRSD,PRSD_SV_D,"2025-05-19 04:46:40",0,921,0,921,0,919,2,8800,7879,261,658
43,STRĂINĂTATE,LONDRA-NEWHAM,507,"REGATUL UNIT AL MARII BRITANII ȘI AL IRLANDEI DE NORD",9999,1,PART,PRCNCT,PRSD,PRSD_SV_D,"2025-05-19 01:19:30",0,3156,0,3156,0,3146,10,11200,8044,1786,1360
43,STRĂINĂTATE,LONDRA-STRATFORD,508,"REGATUL UNIT AL MARII BRITANII ȘI AL IRLANDEI DE NORD",9999,2,PART,PRCNCT,PRSD,PRSD_SV_D,"2025-05-19 03:20:47",0,4665,0,4665,0,4640,25,10400,5735,2636,2004
43,STRĂINĂTATE,"LONDRA-HARROW 1",509,"REGATUL UNIT AL MARII BRITANII ȘI AL IRLANDEI DE NORD",9999,2,PART,PRCNCT,PRSD,PRSD_SV_D,"2025-05-19 04:02:41",0,6423,0,6423,0,6393,30,10400,3977,4761,1632
43,STRĂINĂTATE,"LONDRA-HARROW 2",510,"REGATUL UNIT AL MARII BRITANII ȘI AL IRLANDEI DE NORD",9999,1,PART,PRCNCT,PRSD,PRSD_SV_D,"2025-05-19 00:21:46",0,1608,0,1608,0,1600,8,8400,6792,1206,394
43,STRĂINĂTATE,"LONDRA-HARROW 3",511,"REGATUL UNIT AL MARII BRITANII ȘI AL IRLANDEI DE NORD",9999,1,PART,PRCNCT,PRSD,PRSD_SV_D,"2025-05-19 04:10:42",0,9910,0,9910,0,9877,33,12000,2090,8230,1647
43,STRĂINĂTATE,LONDRA-WEMBLEY,512,"REGATUL UNIT AL MARII BRITANII ȘI AL IRLANDEI DE NORD",9999,1,PART,PRCNCT,PRSD,PRSD_SV_D,"2025-05-19 00:56:16",0,3046,0,3046,0,3036,10,8800,5754,2084,952
43,STRĂINĂTATE,"LONDRA-BRENT 1",513,"REGATUL UNIT AL MARII BRITANII ȘI AL IRLANDEI DE NORD",9999,1,PART,PRCNCT,PRSD,PRSD_SV_D,"2025-05-19 00:00:57",0,1098,0,1098,0,1092,6,8800,7702,687,405
43,STRĂINĂTATE,"LONDRA- BRENT 2",514,"REGATUL UNIT AL MARII BRITANII ȘI AL IRLANDEI DE NORD",9999,1,PART,PRCNCT,PRSD,PRSD_SV_D,"2025-05-19 00:35:24",0,1007,0,1007,0,998,9,8000,6993,665,333
43,STRĂINĂTATE,"LONDRA-REDBRIDGE 1",515,"REGATUL UNIT AL MARII BRITANII ȘI AL IRLANDEI DE NORD",9999,1,PART,PRCNCT,PRSD,PRSD_SV_D,"2025-05-19 00:45:00",0,2185,0,2185,0,2178,7,8007,5822,1505,673
43,STRĂINĂTATE,"LONDRA-REDBRIDGE 2",516,"REGATUL UNIT AL MARII BRITANII ȘI AL IRLANDEI DE NORD",9999,1,PART,PRCNCT,PRSD,PRSD_SV_D,"2025-05-19 01:05:48",0,2671,0,2671,0,2654,17,7600,4929,1975,679
43,STRĂINĂTATE,"LONDRA-WALTHAM FOREST 1",517,"REGATUL UNIT AL MARII BRITANII ȘI AL IRLANDEI DE NORD",9999,2,PART,PRCNCT,PRSD,PRSD_SV_D,"2025-05-19 05:32:26",0,1803,0,1803,0,1787,16,8800,6997,1154,633
43,STRĂINĂTATE,"LONDRA-WALTHAM FOREST 2",518,"REGATUL UNIT AL MARII BRITANII ȘI AL IRLANDEI DE NORD",9999,1,PART,PRCNCT,PRSD,PRSD_SV_D,"2025-05-19 01:41:34",0,3541,0,3541,0,3515,26,8800,5259,2397,1118
43,STRĂINĂTATE,"LONDRA-BARKING AND DAGENHAM 1",519,"REGATUL UNIT AL MARII BRITANII ȘI AL IRLANDEI DE NORD",9999,2,PART,PRCNCT,PRSD,PRSD_SV_D,"2025-05-19 01:50:41",0,1253,0,1253,0,1247,6,8800,7547,768,479
43,STRĂINĂTATE,"LONDRA-BARKING AND DAGENHAM 2",520,"REGATUL UNIT AL MARII BRITANII ȘI AL IRLANDEI DE NORD",9999,1,PART,PRCNCT,PRSD,PRSD_SV_D,"2025-05-19 03:22:38",0,4349,0,4349,0,4326,23,8800,4451,3389,937
43,STRĂINĂTATE,LONDRA-BARNET,521,"REGATUL UNIT AL MARII BRITANII ȘI AL IRLANDEI DE NORD",9999,1,PART,PRCNCT,PRSD,PRSD_SV_D,"2025-05-19 00:47:59",0,4998,0,4998,0,4969,29,5600,602,3157,1812
43,STRĂINĂTATE,"LONDRA-HOUNSLOW 1",522,"REGATUL UNIT AL MARII BRITANII ȘI AL IRLANDEI DE NORD",9999,2,PART,PRCNCT,PRSD,PRSD_SV_D,"2025-05-19 02:56:12",0,2777,0,2777,0,2762,15,4800,2023,1836,926
43,STRĂINĂTATE,"LONDRA-HOUNSLOW 2",523,"REGATUL UNIT AL MARII BRITANII ȘI AL IRLANDEI DE NORD",9999,1,PART,PRCNCT,PRSD,PRSD_SV_D,"2025-05-19 00:59:35",0,1090,0,1090,0,1088,2,8000,6910,532,556
43,STRĂINĂTATE,LONDRA-HARINGEY,524,"REGATUL UNIT AL MARII BRITANII ȘI AL IRLANDEI DE NORD",9999,1,PART,PRCNCT,PRSD,PRSD_SV_D,"2025-05-19 00:39:14",0,3546,0,3546,0,3529,17,8000,4454,2227,1302
43,STRĂINĂTATE,LONDRA-ENFIELD,525,"REGATUL UNIT AL MARII BRITANII ȘI AL IRLANDEI DE NORD",9999,2,PART,PRCNCT,PRSD,PRSD_SV_D,"2025-05-19 02:54:59",0,3446,0,3446,0,3427,19,8000,4554,2450,977
43,STRĂINĂTATE,LONDRA-GREENWICH,526,"REGATUL UNIT AL MARII BRITANII ȘI AL IRLANDEI DE NORD",9999,1,PART,PRCNCT,PRSD,PRSD_SV_D,"2025-05-19 01:00:42",0,2088,0,2088,0,2071,17,7200,5112,704,1367
43,STRĂINĂTATE,LONDRA-ROMFORD,527,"REGATUL UNIT AL MARII BRITANII ȘI AL IRLANDEI DE NORD",9999,2,PART,PRCNCT,PRSD,PRSD_SV_D,"2025-05-19 04:41:47",0,5487,0,5487,0,5459,28,7200,1713,3173,2286
43,STRĂINĂTATE,LONDRA-CROYDON,528,"REGATUL UNIT AL MARII BRITANII ȘI AL IRLANDEI DE NORD",9999,2,PART,PRCNCT,PRSD,PRSD_SV_D,"2025-05-19 04:32:07",0,3119,0,3119,0,3097,22,6400,3281,1779,1318
43,STRĂINĂTATE,LONDRA-RICHMOND,529,"REGATUL UNIT AL MARII BRITANII ȘI AL IRLANDEI DE NORD",9999,2,PART,PRCNCT,PRSD,PRSD_SV_D,"2025-05-19 02:03:00",0,935,0,935,0,931,4,4000,3065,222,709
43,STRĂINĂTATE,"LONDRA-HILLINGDON 1",530,"REGATUL UNIT AL MARII BRITANII ȘI AL IRLANDEI DE NORD",9999,1,PART,PRCNCT,PRSD,PRSD_SV_D,"2025-05-18 23:18:11",0,1491,0,1491,0,1484,7,4800,3309,834,650
43,STRĂINĂTATE,"LONDRA-HILLINGDON 2",531,"REGATUL UNIT AL MARII BRITANII ȘI AL IRLANDEI DE NORD",9999,2,PART,PRCNCT,PRSD,PRSD_SV_D,"2025-05-19 01:32:04",0,1739,0,1739,0,1727,12,4800,3061,976,751
43,STRĂINĂTATE,LONDRA-LEWISHAM,532,"REGATUL UNIT AL MARII BRITANII ȘI AL IRLANDEI DE NORD",9999,1,PART,PRCNCT,PRSD,PRSD_SV_D,"2025-05-18 23:38:18",0,1109,0,1109,0,1102,7,4800,3691,508,594
43,STRĂINĂTATE,LONDRA-MERTON,533,"REGATUL UNIT AL MARII BRITANII ȘI AL IRLANDEI DE NORD",9999,1,PART,PRCNCT,PRSD,PRSD_SV_D,"2025-05-18 22:52:35",0,1907,0,1907,0,1895,12,4800,2893,779,1116
43,STRĂINĂTATE,LONDRA-BROMLEY,534,"REGATUL UNIT AL MARII BRITANII ȘI AL IRLANDEI DE NORD",9999,1,PART,PRCNCT,PRSD,PRSD_SV_D,"2025-05-19 02:50:01",0,1961,0,1961,0,1951,10,4800,2839,960,991
43,STRĂINĂTATE,LONDRA-SOUTHWARK,535,"REGATUL UNIT AL MARII BRITANII ȘI AL IRLANDEI DE NORD",9999,1,PART,PRCNCT,PRSD,PRSD_SV_D,"2025-05-18 22:22:26",0,658,0,658,0,658,0,4800,4142,196,462
43,STRĂINĂTATE,LONDRA-WANDSWORTH,536,"REGATUL UNIT AL MARII BRITANII ȘI AL IRLANDEI DE NORD",9999,1,PART,PRCNCT,PRSD,PRSD_SV_D,"2025-05-18 23:08:04",0,729,0,729,0,724,5,4800,4071,168,556
43,STRĂINĂTATE,LONDRA-BEXLEY,537,"REGATUL UNIT AL MARII BRITANII ȘI AL IRLANDEI DE NORD",9999,1,PART,PRCNCT,PRSD,PRSD_SV_D,"2025-05-19 00:51:47",0,3104,0,3104,0,3086,18,5598,2494,1784,1302
43,STRĂINĂTATE,"BASILDON 1",538,"REGATUL UNIT AL MARII BRITANII ȘI AL IRLANDEI DE NORD",9999,1,PART,PRCNCT,PRSD,PRSD_SV_D,"2025-05-19 00:03:49",0,4010,0,4010,0,3984,26,4800,790,2402,1582
43,STRĂINĂTATE,"BASILDON 2",539,"REGATUL UNIT AL MARII BRITANII ȘI AL IRLANDEI DE NORD",9999,1,PART,PRCNCT,PRSD,PRSD_SV_D,"2025-05-19 01:15:21",0,2592,0,2592,0,2569,23,4800,2208,1526,1043
43,STRĂINĂTATE,BEDFORD,540,"REGATUL UNIT AL MARII BRITANII ȘI AL IRLANDEI DE NORD",9999,1,PART,PRCNCT,PRSD,PRSD_SV_D,"2025-05-19 00:08:37",0,2048,0,2048,0,2031,17,4800,2752,1219,812
43,STRĂINĂTATE,BOURNEMOUTH,541,"REGATUL UNIT AL MARII BRITANII ȘI AL IRLANDEI DE NORD",9999,1,PART,PRCNCT,PRSD,PRSD_SV_D,"2025-05-19 00:34:03",0,2021,0,2021,0,2011,10,4800,2779,959,1052
43,STRĂINĂTATE,"BRIGHTON AND HOVE",542,"REGATUL UNIT AL MARII BRITANII ȘI AL IRLANDEI DE NORD",9999,2,PART,PRCNCT,PRSD,PRSD_SV_D,"2025-05-19 03:39:58",0,1780,0,1780,0,1774,6,4000,2220,770,1004
43,STRĂINĂTATE,"BRISTOL 1",543,"REGATUL UNIT AL MARII BRITANII ȘI AL IRLANDEI DE NORD",9999,1,PART,PRCNCT,PRSD,PRSD_SV_D,"2025-05-19 00:04:07",0,2405,0,2405,0,2389,16,4000,1595,1267,1122
43,STRĂINĂTATE,"BRISTOL 2",544,"REGATUL UNIT AL MARII BRITANII ȘI AL IRLANDEI DE NORD",9999,1,PART,PRCNCT,PRSD,PRSD_SV_D,"2025-05-18 23:12:35",0,1290,0,1290,0,1285,5,4000,2710,539,746
43,STRĂINĂTATE,CAMBRIDGE,545,"REGATUL UNIT AL MARII BRITANII ȘI AL IRLANDEI DE NORD",9999,1,PART,PRCNCT,PRSD,PRSD_SV_D,"2025-05-19 00:27:09",0,2666,0,2666,0,2651,15,4008,1342,1032,1619
43,STRĂINĂTATE,CANTERBURY,546,"REGATUL UNIT AL MARII BRITANII ȘI AL IRLANDEI DE NORD",9999,1,PART,PRCNCT,PRSD,PRSD_SV_D,"2025-05-18 23:41:21",0,1776,0,1776,0,1768,8,4000,2224,954,814
43,STRĂINĂTATE,CARDIFF,547,"REGATUL UNIT AL MARII BRITANII ȘI AL IRLANDEI DE NORD",9999,1,PART,PRCNCT,PRSD,PRSD_SV_D,"2025-05-18 23:45:07",0,1559,0,1559,0,1549,10,4000,2441,841,708
43,STRĂINĂTATE,COLCHESTER,548,"REGATUL UNIT AL MARII BRITANII ȘI AL IRLANDEI DE NORD",9999,1,PART,PRCNCT,PRSD,PRSD_SV_D,"2025-05-18 23:24:28",0,2289,0,2289,0,2277,12,4000,1711,1140,1137
43,STRĂINĂTATE,CORNWALL,549,"REGATUL UNIT AL MARII BRITANII ȘI AL IRLANDEI DE NORD",9999,1,PART,PRCNCT,PRSD,PRSD_SV_D,"2025-05-18 22:11:33",0,457,0,457,0,456,1,4000,3543,274,182
43,STRĂINĂTATE,CRAWLEY,550,"REGATUL UNIT AL MARII BRITANII ȘI AL IRLANDEI DE NORD",9999,2,PART,PRCNCT,PRSD,PRSD_SV_D,"2025-05-19 02:53:09",0,2623,0,2623,0,2601,22,4807,2184,1266,1335
43,STRĂINĂTATE,EPPING,551,"REGATUL UNIT AL MARII BRITANII ȘI AL IRLANDEI DE NORD",9999,1,PART,PRCNCT,PRSD,PRSD_SV_D,"2025-05-19 01:17:32",0,2297,0,2297,0,2288,9,4000,1703,1350,938
43,STRĂINĂTATE,EXETER,552,"REGATUL UNIT AL MARII BRITANII ȘI AL IRLANDEI DE NORD",9999,1,PART,PRCNCT,PRSD,PRSD_SV_D,"2025-05-18 23:55:51",0,1174,0,1174,0,1167,7,4000,2826,550,617
43,STRĂINĂTATE,GLOUCESTER,553,"REGATUL UNIT AL MARII BRITANII ȘI AL IRLANDEI DE NORD",9999,1,PART,PRCNCT,PRSD,PRSD_SV_D,"2025-05-19 00:07:54",0,1226,0,1226,0,1222,4,4008,2782,651,571
43,STRĂINĂTATE,HATFIELD,554,"REGATUL UNIT AL MARII BRITANII ȘI AL IRLANDEI DE NORD",9999,1,PART,PRCNCT,PRSD,PRSD_SV_D,"2025-05-19 00:03:29",0,3290,0,3290,0,3277,13,4800,1510,1784,1493
43,STRĂINĂTATE,HEREFORD,555,"REGATUL UNIT AL MARII BRITANII ȘI AL IRLANDEI DE NORD",9999,1,PART,PRCNCT,PRSD,PRSD_SV_D,"2025-05-18 23:15:33",0,1028,0,1028,0,1024,4,4000,2972,670,354
43,STRĂINĂTATE,IPSWICH,556,"REGATUL UNIT AL MARII BRITANII ȘI AL IRLANDEI DE NORD",9999,1,PART,PRCNCT,PRSD,PRSD_SV_D,"2025-05-18 23:19:17",0,2751,0,2751,0,2734,17,5600,2849,2005,729
43,STRĂINĂTATE,JERSEY,557,"REGATUL UNIT AL MARII BRITANII ȘI AL IRLANDEI DE NORD",9999,1,PART,PRCNCT,PRSD,PRSD_SV_D,"2025-05-18 22:28:59",0,622,0,622,0,617,5,4000,3378,247,370
43,STRĂINĂTATE,"LUTON 1",558,"REGATUL UNIT AL MARII BRITANII ȘI AL IRLANDEI DE NORD",9999,1,PART,PRCNCT,PRSD,PRSD_SV_D,"2025-05-19 00:11:26",0,2162,0,2162,0,2149,13,4400,2238,1288,861
43,STRĂINĂTATE,"LUTON 2",559,"REGATUL UNIT AL MARII BRITANII ȘI AL IRLANDEI DE NORD",9999,2,PART,PRCNCT,PRSD,PRSD_SV_D,"2025-05-19 04:39:58",0,4657,0,4657,0,4624,33,5600,943,3067,1557
43,STRĂINĂTATE,MAIDSTONE,560,"REGATUL UNIT AL MARII BRITANII ȘI AL IRLANDEI DE NORD",9999,1,PART,PRCNCT,PRSD,PRSD_SV_D,"2025-05-18 23:18:27",0,3942,0,3942,0,3921,21,4800,858,2377,1544
43,STRĂINĂTATE,"MILTON KEYNES 1",561,"REGATUL UNIT AL MARII BRITANII ȘI AL IRLANDEI DE NORD",9999,1,PART,PRCNCT,PRSD,PRSD_SV_D,"2025-05-18 23:22:47",0,2361,0,2361,0,2349,12,5600,3239,1168,1181
43,STRĂINĂTATE,"MILTON KEYNES 2",562,"REGATUL UNIT AL MARII BRITANII ȘI AL IRLANDEI DE NORD",9999,1,PART,PRCNCT,PRSD,PRSD_SV_D,"2025-05-19 00:17:10",0,2387,0,2387,0,2371,16,5600,3213,1177,1194
43,STRĂINĂTATE,NORWICH,563,"REGATUL UNIT AL MARII BRITANII ȘI AL IRLANDEI DE NORD",9999,1,PART,PRCNCT,PRSD,PRSD_SV_D,"2025-05-18 23:46:24",0,1796,0,1796,0,1786,10,4000,2204,941,845
43,STRĂINĂTATE,OXFORD,564,"REGATUL UNIT AL MARII BRITANII ȘI AL IRLANDEI DE NORD",9999,2,PART,PRCNCT,PRSD,PRSD_SV_D,"2025-05-19 05:01:06",0,2984,0,2984,0,2967,17,4000,1016,1192,1775
43,STRĂINĂTATE,PETERBOROUGH,565,"REGATUL UNIT AL MARII BRITANII ȘI AL IRLANDEI DE NORD",9999,2,PART,PRCNCT,PRSD,PRSD_SV_D,"2025-05-19 05:38:36",0,4423,0,4423,0,4404,19,6400,1977,2965,1439
43,STRĂINĂTATE,PLYMOUTH,566,"REGATUL UNIT AL MARII BRITANII ȘI AL IRLANDEI DE NORD",9999,1,PART,PRCNCT,PRSD,PRSD_SV_D,"2025-05-18 22:54:46",0,1102,0,1102,0,1095,7,4000,2898,542,553
43,STRĂINĂTATE,PORTSMOUTH,567,"REGATUL UNIT AL MARII BRITANII ȘI AL IRLANDEI DE NORD",9999,1,PART,PRCNCT,PRSD,PRSD_SV_D,"2025-05-19 00:32:29",0,2850,0,2850,0,2843,7,4008,1158,1384,1459
43,STRĂINĂTATE,READING,568,"REGATUL UNIT AL MARII BRITANII ȘI AL IRLANDEI DE NORD",9999,1,PART,PRCNCT,PRSD,PRSD_SV_D,"2025-05-19 01:57:04",0,3718,0,3718,0,3701,17,4800,1082,1940,1761
43,STRĂINĂTATE,RUGBY,569,"REGATUL UNIT AL MARII BRITANII ȘI AL IRLANDEI DE NORD",9999,2,PART,PRCNCT,PRSD,PRSD_SV_D,"2025-05-19 03:44:58",0,1959,0,1959,0,1952,7,4000,2041,913,1039
43,STRĂINĂTATE,SALISBURY,570,"REGATUL UNIT AL MARII BRITANII ȘI AL IRLANDEI DE NORD",9999,1,PART,PRCNCT,PRSD,PRSD_SV_D,"2025-05-18 22:50:22",0,738,0,738,0,730,8,4000,3262,381,349
43,STRĂINĂTATE,SOUTHHAMPTON,571,"REGATUL UNIT AL MARII BRITANII ȘI AL IRLANDEI DE NORD",9999,1,PART,PRCNCT,PRSD,PRSD_SV_D,"2025-05-19 00:10:38",0,2734,0,2734,0,2719,15,5600,2856,1445,1274
43,STRĂINĂTATE,STOKE-ON-TRENT,572,"REGATUL UNIT AL MARII BRITANII ȘI AL IRLANDEI DE NORD",9999,1,PART,PRCNCT,PRSD,PRSD_SV_D,"2025-05-19 01:35:37",0,3266,0,3266,0,3248,18,6400,3134,2033,1215
43,STRĂINĂTATE,SWANSEA,573,"REGATUL UNIT AL MARII BRITANII ȘI AL IRLANDEI DE NORD",9999,1,PART,PRCNCT,PRSD,PRSD_SV_D,"2025-05-19 00:31:51",0,891,0,891,0,881,10,4000,3109,455,426
43,STRĂINĂTATE,SWINDON,574,"REGATUL UNIT AL MARII BRITANII ȘI AL IRLANDEI DE NORD",9999,1,PART,PRCNCT,PRSD,PRSD_SV_D,"2025-05-18 22:57:18",0,1655,0,1655,0,1644,11,4000,2345,829,815
43,STRĂINĂTATE,TAUNTON,575,"REGATUL UNIT AL MARII BRITANII ȘI AL IRLANDEI DE NORD",9999,1,PART,PRCNCT,PRSD,PRSD_SV_D,"2025-05-19 00:04:19",0,2284,0,2284,0,2272,12,4000,1716,1499,773
43,STRĂINĂTATE,WATFORD,576,"REGATUL UNIT AL MARII BRITANII ȘI AL IRLANDEI DE NORD",9999,1,PART,PRCNCT,PRSD,PRSD_SV_D,"2025-05-18 23:30:26",0,4455,0,4455,0,4426,29,6000,1545,2548,1878
43,STRĂINĂTATE,WINDSOR,577,"REGATUL UNIT AL MARII BRITANII ȘI AL IRLANDEI DE NORD",9999,1,PART,PRCNCT,PRSD,PRSD_SV_D,"2025-05-19 01:55:57",0,3325,0,3325,0,3298,27,4800,1475,1751,1547
43,STRĂINĂTATE,WOKING,578,"REGATUL UNIT AL MARII BRITANII ȘI AL IRLANDEI DE NORD",9999,1,PART,PRCNCT,PRSD,PRSD_SV_D,"2025-05-19 00:30:20",0,2673,0,2673,0,2661,12,4000,1327,1332,1329
43,STRĂINĂTATE,WORCESTER,579,"REGATUL UNIT AL MARII BRITANII ȘI AL IRLANDEI DE NORD",9999,1,PART,PRCNCT,PRSD,PRSD_SV_D,"2025-05-19 00:43:49",0,2045,0,2045,0,2034,11,3999,1954,1133,901
43,STRĂINĂTATE,"MANCHESTER 1",580,"REGATUL UNIT AL MARII BRITANII ȘI AL IRLANDEI DE NORD",9999,2,PART,PRCNCT,PRSD,PRSD_SV_D,"2025-05-19 01:28:25",0,1997,0,1997,0,1987,10,5600,3603,955,1032
43,STRĂINĂTATE,"MANCHESTER 2",581,"REGATUL UNIT AL MARII BRITANII ȘI AL IRLANDEI DE NORD",9999,1,PART,PRCNCT,PRSD,PRSD_SV_D,"2025-05-19 00:04:20",0,1973,0,1973,0,1966,7,5600,3627,888,1078
43,STRĂINĂTATE,BOLTON,582,"REGATUL UNIT AL MARII BRITANII ȘI AL IRLANDEI DE NORD",9999,1,PART,PRCNCT,PRSD,PRSD_SV_D,"2025-05-19 01:02:27",0,1380,0,1380,0,1380,0,4800,3420,714,666
43,STRĂINĂTATE,"NEWCASTLE UPON TYNE",583,"REGATUL UNIT AL MARII BRITANII ȘI AL IRLANDEI DE NORD",9999,2,PART,PRCNCT,PRSD,PRSD_SV_D,"2025-05-19 05:55:15",0,3056,0,3056,0,3041,15,4000,944,1949,1092
43,STRĂINĂTATE,"LEEDS 1",584,"REGATUL UNIT AL MARII BRITANII ȘI AL IRLANDEI DE NORD",9999,1,PART,PRCNCT,PRSD,PRSD_SV_D,"2025-05-19 00:59:35",0,2844,0,2844,0,2828,16,5600,2756,1984,844
43,STRĂINĂTATE,"LEEDS 2",585,"REGATUL UNIT AL MARII BRITANII ȘI AL IRLANDEI DE NORD",9999,1,PART,PRCNCT,PRSD,PRSD_SV_D,"2025-05-19 02:12:17",0,2030,0,2030,0,2021,9,4800,2770,909,1112
43,STRĂINĂTATE,LIVERPOOL,586,"REGATUL UNIT AL MARII BRITANII ȘI AL IRLANDEI DE NORD",9999,1,PART,PRCNCT,PRSD,PRSD_SV_D,"2025-05-19 04:04:31",0,4337,0,4337,0,4310,27,5600,1263,2439,1871
43,STRĂINĂTATE,PRESTON,587,"REGATUL UNIT AL MARII BRITANII ȘI AL IRLANDEI DE NORD",9999,1,PART,PRCNCT,PRSD,PRSD_SV_D,"2025-05-18 23:13:38",0,2718,0,2718,0,2701,17,4000,1282,1945,756
43,STRĂINĂTATE,HULL,588,"REGATUL UNIT AL MARII BRITANII ȘI AL IRLANDEI DE NORD",9999,1,PART,PRCNCT,PRSD,PRSD_SV_D,"2025-05-19 02:17:57",0,2729,0,2729,0,2716,13,4000,1271,2081,635
43,STRĂINĂTATE,DONCASTER,589,"REGATUL UNIT AL MARII BRITANII ȘI AL IRLANDEI DE NORD",9999,1,PART,PRCNCT,PRSD,PRSD_SV_D,"2025-05-19 04:22:58",0,5816,0,5816,0,5784,32,7200,1384,3877,1907
43,STRĂINĂTATE,SHEFFIELD,590,"REGATUL UNIT AL MARII BRITANII ȘI AL IRLANDEI DE NORD",9999,1,PART,PRCNCT,PRSD,PRSD_SV_D,"2025-05-19 02:14:26",0,1756,0,1756,0,1734,22,4400,2644,769,965
43,STRĂINĂTATE,NOTTINGHAM,591,"REGATUL UNIT AL MARII BRITANII ȘI AL IRLANDEI DE NORD",9999,1,PART,PRCNCT,PRSD,PRSD_SV_D,"2025-05-19 00:45:49",0,4130,0,4130,0,4106,24,5200,1070,2498,1608
43,STRĂINĂTATE,LOUGHBOROUGH,592,"REGATUL UNIT AL MARII BRITANII ȘI AL IRLANDEI DE NORD",9999,2,PART,PRCNCT,PRSD,PRSD_SV_D,"2025-05-19 01:18:30",0,1498,0,1498,0,1483,15,2400,902,847,636
43,STRĂINĂTATE,LEICESTER,593,"REGATUL UNIT AL MARII BRITANII ȘI AL IRLANDEI DE NORD",9999,1,PART,PRCNCT,PRSD,PRSD_SV_D,"2025-05-18 23:35:41",0,2568,0,2568,0,2538,30,4000,1432,1504,1034
43,STRĂINĂTATE,WOLVERHAMPTON,594,"REGATUL UNIT AL MARII BRITANII ȘI AL IRLANDEI DE NORD",9999,1,PART,PRCNCT,PRSD,PRSD_SV_D,"2025-05-19 00:47:17",0,3266,0,3266,0,3249,17,5200,1934,2077,1172
43,STRĂINĂTATE,WALSALL,595,"REGATUL UNIT AL MARII BRITANII ȘI AL IRLANDEI DE NORD",9999,1,PART,PRCNCT,PRSD,PRSD_SV_D,"2025-05-19 01:51:54",0,1930,0,1930,0,1916,14,3600,1670,1199,717
43,STRĂINĂTATE,"BIRMINGHAM 1",596,"REGATUL UNIT AL MARII BRITANII ȘI AL IRLANDEI DE NORD",9999,2,PART,PRCNCT,PRSD,PRSD_SV_D,"2025-05-19 04:34:01",0,2969,0,2969,0,2956,13,5600,2631,1976,980
43,STRĂINĂTATE,"BIRMINGHAM 2",597,"REGATUL UNIT AL MARII BRITANII ȘI AL IRLANDEI DE NORD",9999,1,PART,PRCNCT,PRSD,PRSD_SV_D,"2025-05-19 00:43:01",0,4041,0,4041,0,4019,22,5600,1559,2646,1373
43,STRĂINĂTATE,"COVENTRY 1",598,"REGATUL UNIT AL MARII BRITANII ȘI AL IRLANDEI DE NORD",9999,1,PART,PRCNCT,PRSD,PRSD_SV_D,"2025-05-19 00:54:17",0,2275,0,2275,0,2259,16,5600,3325,1321,938
43,STRĂINĂTATE,"COVENTRY 2",599,"REGATUL UNIT AL MARII BRITANII ȘI AL IRLANDEI DE NORD",9999,2,PART,PRCNCT,PRSD,PRSD_SV_D,"2025-05-19 05:34:59",0,4490,0,4490,0,4461,29,5600,1110,2812,1649
43,STRĂINĂTATE,"NORTHAMPTON 1",600,"REGATUL UNIT AL MARII BRITANII ȘI AL IRLANDEI DE NORD",9999,2,PART,PRCNCT,PRSD,PRSD_SV_D,"2025-05-19 04:50:23",0,7411,0,7411,0,7381,30,8400,989,4654,2727
43,STRĂINĂTATE,"NORTHAMPTON 2",601,"REGATUL UNIT AL MARII BRITANII ȘI AL IRLANDEI DE NORD",9999,1,PART,PRCNCT,PRSD,PRSD_SV_D,"2025-05-19 00:50:50",0,2460,0,2460,0,2449,11,5200,2740,1089,1360
43,STRĂINĂTATE,"EDINBURGH 1",602,"REGATUL UNIT AL MARII BRITANII ȘI AL IRLANDEI DE NORD",9999,1,PART,PRCNCT,PRSD,PRSD_SV_D,"2025-05-18 23:03:44",0,1827,0,1827,0,1818,9,2400,573,689,1129
43,STRĂINĂTATE,"EDINBURGH 2",603,"REGATUL UNIT AL MARII BRITANII ȘI AL IRLANDEI DE NORD",9999,1,PART,PRCNCT,PRSD,PRSD_SV_D,"2025-05-18 22:12:43",0,211,0,211,0,209,2,2400,2189,47,162
43,STRĂINĂTATE,ABERDEEN,604,"REGATUL UNIT AL MARII BRITANII ȘI AL IRLANDEI DE NORD",9999,1,PART,PRCNCT,PRSD,PRSD_SV_D,"2025-05-18 23:12:56",0,965,0,965,0,962,3,2400,1435,389,573
43,STRĂINĂTATE,"GLASGOW 1",605,"REGATUL UNIT AL MARII BRITANII ȘI AL IRLANDEI DE NORD",9999,1,PART,PRCNCT,PRSD,PRSD_SV_D,"2025-05-18 23:53:38",0,1074,0,1074,0,1071,3,2400,1326,476,595
43,STRĂINĂTATE,"GLASGOW 2",606,"REGATUL UNIT AL MARII BRITANII ȘI AL IRLANDEI DE NORD",9999,1,PART,PRCNCT,PRSD,PRSD_SV_D,"2025-05-18 23:04:43",0,1152,0,1152,0,1146,6,1600,448,740,406
43,STRĂINĂTATE,PERTH,607,"REGATUL UNIT AL MARII BRITANII ȘI AL IRLANDEI DE NORD",9999,1,PART,PRCNCT,PRSD,PRSD_SV_D,"2025-05-18 22:40:54",0,1111,0,1111,0,1110,1,1600,489,772,338
43,STRĂINĂTATE,BELFAST,608,"REGATUL UNIT AL MARII BRITANII ȘI AL IRLANDEI DE NORD",9999,1,PART,PRCNCT,PRSD,PRSD_SV_D,"2025-05-18 22:43:24",0,1213,0,1213,0,1202,11,2400,1187,774,428
43,STRĂINĂTATE,BALLYMENA,609,"REGATUL UNIT AL MARII BRITANII ȘI AL IRLANDEI DE NORD",9999,2,PART,PRCNCT,PRSD,PRSD_SV_D,"2025-05-19 02:51:57",0,930,0,930,0,926,4,2400,1470,583,343
43,STRĂINĂTATE,PORTADOWN,610,"REGATUL UNIT AL MARII BRITANII ȘI AL IRLANDEI DE NORD",9999,1,PART,PRCNCT,PRSD,PRSD_SV_D,"2025-05-18 22:25:37",0,624,0,624,0,621,3,1600,976,424,197
43,STRĂINĂTATE,RABAT,611,"REGATUL MAROC",9999,2,PART,PRCNCT,PRSD,PRSD_SV_D,"2025-05-19 00:37:05",0,254,0,254,0,252,2,800,546,61,191
43,STRĂINĂTATE,"CIUDAD DE MEXICO",612,MEXIC,9999,1,PART,PRCNCT,PRSD,PRSD_SV_D,"2025-05-18 22:10:05",0,122,0,122,0,122,0,800,678,24,98
43,STRĂINĂTATE,"CHIȘINĂU 1",613,"REPUBLICA MOLDOVA",9999,1,PART,PRCNCT,PRSD,PRSD_SV_D,"2025-05-18 23:05:46",0,5035,0,5035,0,4994,41,8000,2965,521,4473
43,STRĂINĂTATE,"CHIȘINĂU 2",614,"REPUBLICA MOLDOVA",9999,1,PART,PRCNCT,PRSD,PRSD_SV_D,"2025-05-18 23:57:40",0,5145,0,5145,0,5118,27,8000,2855,612,4506
43,STRĂINĂTATE,"CHIȘINĂU 3",615,"REPUBLICA MOLDOVA",9999,1,PART,PRCNCT,PRSD,PRSD_SV_D,"2025-05-18 23:13:00",0,1529,0,1529,0,1524,5,5600,4071,111,1413
43,STRĂINĂTATE,"CHIȘINĂU 4",616,"REPUBLICA MOLDOVA",9999,1,PART,PRCNCT,PRSD,PRSD_SV_D,"2025-05-18 23:42:43",0,2605,0,2605,0,2604,1,7999,5394,232,2372
43,STRĂINĂTATE,"CHIȘINĂU 5",617,"REPUBLICA MOLDOVA",9999,1,PART,PRCNCT,PRSD,PRSD_SV_D,"2025-05-18 23:16:21",0,1469,0,1469,0,1461,8,8000,6531,141,1320
43,STRĂINĂTATE,"CHIȘINĂU 6",618,"REPUBLICA MOLDOVA",9999,1,PART,PRCNCT,PRSD,PRSD_SV_D,"2025-05-19 00:00:46",0,5740,0,5740,0,5701,39,8000,2260,519,5182
43,STRĂINĂTATE,"CHIȘINĂU 7",619,"REPUBLICA MOLDOVA",9999,1,PART,PRCNCT,PRSD,PRSD_SV_D,"2025-05-18 23:06:25",0,1418,0,1418,0,1412,6,8000,6582,112,1300
43,STRĂINĂTATE,"CHIȘINĂU 8",620,"REPUBLICA MOLDOVA",9999,1,PART,PRCNCT,PRSD,PRSD_SV_D,"2025-05-18 23:15:24",0,1687,0,1687,0,1676,11,8000,6313,129,1547
43,STRĂINĂTATE,"CHIȘINĂU 9",621,"REPUBLICA MOLDOVA",9999,1,PART,PRCNCT,PRSD,PRSD_SV_D,"2025-05-18 23:17:06",0,2682,0,2682,0,2670,12,8000,5318,210,2460
43,STRĂINĂTATE,"CHIȘINĂU 10",622,"REPUBLICA MOLDOVA",9999,1,PART,PRCNCT,PRSD,PRSD_SV_D,"2025-05-18 23:27:51",0,2676,0,2676,0,2660,16,8000,5324,222,2438
43,STRĂINĂTATE,"CHIȘINĂU 11",623,"REPUBLICA MOLDOVA",9999,1,PART,PRCNCT,PRSD,PRSD_SV_D,"2025-05-18 22:59:30",0,2681,0,2681,0,2670,11,8000,5319,234,2436
43,STRĂINĂTATE,"CHIȘINĂU 12",624,"REPUBLICA MOLDOVA",9999,1,PART,PRCNCT,PRSD,PRSD_SV_D,"2025-05-18 22:35:56",0,2404,0,2404,0,2389,15,8000,5596,177,2212
43,STRĂINĂTATE,"CHIȘINĂU 13",625,"REPUBLICA MOLDOVA",9999,1,PART,PRCNCT,PRSD,PRSD_SV_D,"2025-05-19 01:02:48",0,4387,0,4387,0,4369,18,8000,3613,399,3970
43,STRĂINĂTATE,"CHIȘINĂU 14",626,"REPUBLICA MOLDOVA",9999,1,PART,PRCNCT,PRSD,PRSD_SV_D,"2025-05-19 01:44:11",0,4774,0,4774,0,4756,18,8000,3226,403,4353
43,STRĂINĂTATE,"CHIȘINĂU 15",627,"REPUBLICA MOLDOVA",9999,1,PART,PRCNCT,PRSD,PRSD_SV_D,"2025-05-18 23:01:39",0,5713,0,5713,0,5691,22,8000,2287,509,5182
43,STRĂINĂTATE,"CHIȘINĂU 16",628,"REPUBLICA MOLDOVA",9999,1,PART,PRCNCT,PRSD,PRSD_SV_D,"2025-05-19 00:24:16",0,5911,0,5911,0,5883,28,7992,2081,477,5406
43,STRĂINĂTATE,"CHIȘINĂU 17",629,"REPUBLICA MOLDOVA",9999,1,PART,PRCNCT,PRSD,PRSD_SV_D,"2025-05-19 00:56:33",0,5211,0,5211,0,5180,31,8000,2789,466,4714
43,STRĂINĂTATE,"CHIȘINĂU 18",630,"REPUBLICA MOLDOVA",9999,1,PART,PRCNCT,PRSD,PRSD_SV_D,"2025-05-19 00:01:47",0,5180,0,5180,0,5154,26,8000,2820,499,4655
43,STRĂINĂTATE,"CHIȘINĂU 19",631,"REPUBLICA MOLDOVA",9999,1,PART,PRCNCT,PRSD,PRSD_SV_D,"2025-05-19 00:35:00",0,5264,0,5264,0,5231,33,8000,2736,453,4778
43,STRĂINĂTATE,"CHIȘINĂU 20",632,"REPUBLICA MOLDOVA",9999,1,PART,PRCNCT,PRSD,PRSD_SV_D,"2025-05-18 22:47:35",0,3921,0,3921,0,3907,14,8000,4079,379,3528
43,STRĂINĂTATE,HÎNCEȘTI,633,"REPUBLICA MOLDOVA",9999,2,PART,PRCNCT,PRSD,PRSD_SV_D,"2025-05-19 02:50:07",0,4046,0,4046,0,4009,37,6399,2353,637,3372
43,STRĂINĂTATE,IALOVENI,634,"REPUBLICA MOLDOVA",9999,1,PART,PRCNCT,PRSD,PRSD_SV_D,"2025-05-19 00:51:28",0,5270,0,5270,0,5232,38,8800,3530,680,4552
43,STRĂINĂTATE,NISPORENI,635,"REPUBLICA MOLDOVA",9999,1,PART,PRCNCT,PRSD,PRSD_SV_D,"2025-05-19 00:20:10",0,2662,0,2662,0,2633,29,6400,3738,390,2243
43,STRĂINĂTATE,"ORHEI 1",636,"REPUBLICA MOLDOVA",9999,2,PART,PRCNCT,PRSD,PRSD_SV_D,"2025-05-19 03:36:46",0,4376,0,4376,0,4350,26,8100,3724,731,3619
43,STRĂINĂTATE,"ORHEI 2",637,"REPUBLICA MOLDOVA",9999,1,PART,PRCNCT,PRSD,PRSD_SV_D,"2025-05-19 00:41:33",0,926,0,926,0,924,2,3100,2174,151,773
43,STRĂINĂTATE,CĂUȘENI,638,"REPUBLICA MOLDOVA",9999,1,PART,PRCNCT,PRSD,PRSD_SV_D,"2025-05-18 23:39:35",0,2549,0,2549,0,2528,21,5600,3051,309,2219
43,STRĂINĂTATE,"ANENII NOI",639,"REPUBLICA MOLDOVA",9999,1,PART,PRCNCT,PRSD,PRSD_SV_D,"2025-05-19 00:12:57",0,2368,0,2368,0,2347,21,5600,3232,341,2006
43,STRĂINĂTATE,BARDAR,640,"REPUBLICA MOLDOVA",9999,1,PART,PRCNCT,PRSD,PRSD_SV_D,"2025-05-18 22:42:04",0,1039,0,1039,0,1027,12,3200,2161,127,900
43,STRĂINĂTATE,CĂLĂRAȘI,641,"REPUBLICA MOLDOVA",9999,1,PART,PRCNCT,PRSD,PRSD_SV_D,"2025-05-19 00:18:36",0,3094,0,3094,0,3062,32,6400,3306,386,2676
43,STRĂINĂTATE,DURLEȘTI,642,"REPUBLICA MOLDOVA",9999,1,PART,PRCNCT,PRSD,PRSD_SV_D,"2025-05-18 22:57:33",0,4035,0,4035,0,4031,4,6400,2365,350,3681
43,STRĂINĂTATE,STRĂȘENI,643,"REPUBLICA MOLDOVA",9999,1,PART,PRCNCT,PRSD,PRSD_SV_D,"2025-05-18 23:47:13",0,3963,0,3963,0,3930,33,6400,2437,430,3500
43,STRĂINĂTATE,STĂUCENI,644,"REPUBLICA MOLDOVA",9999,1,PART,PRCNCT,PRSD,PRSD_SV_D,"2025-05-18 23:14:41",0,4696,0,4696,0,4688,8,6400,1704,441,4247
43,STRĂINĂTATE,BĂCIOI,645,"REPUBLICA MOLDOVA",9999,1,PART,PRCNCT,PRSD,PRSD_SV_D,"2025-05-18 23:15:31",0,1427,0,1427,0,1418,9,5600,4173,141,1277
43,STRĂINĂTATE,MERENI,646,"REPUBLICA MOLDOVA",9999,1,PART,PRCNCT,PRSD,PRSD_SV_D,"2025-05-18 23:34:35",0,1434,0,1434,0,1425,9,5600,4166,141,1284
43,STRĂINĂTATE,RĂZENI,647,"REPUBLICA MOLDOVA",9999,1,PART,PRCNCT,PRSD,PRSD_SV_D,"2025-05-18 22:34:40",0,996,0,996,0,982,14,5600,4604,157,825
43,STRĂINĂTATE,COSTEȘTI,648,"REPUBLICA MOLDOVA",9999,1,PART,PRCNCT,PRSD,PRSD_SV_D,"2025-05-18 22:43:57",0,1595,0,1595,0,1583,12,5600,4005,193,1390
43,STRĂINĂTATE,"ȘTEFAN VODĂ",649,"REPUBLICA MOLDOVA",9999,1,PART,PRCNCT,PRSD,PRSD_SV_D,"2025-05-19 00:12:00",0,1368,0,1368,0,1359,9,6400,5032,189,1170
43,STRĂINĂTATE,CRIULENI,650,"REPUBLICA MOLDOVA",9999,1,PART,PRCNCT,PRSD,PRSD_SV_D,"2025-05-18 23:09:22",0,1770,0,1770,0,1753,17,6408,4638,208,1545
43,STRĂINĂTATE,"BĂLȚI 1",651,"REPUBLICA MOLDOVA",9999,2,PART,PRCNCT,PRSD,PRSD_SV_D,"2025-05-19 03:31:44",0,2312,0,2312,0,2301,11,3200,888,329,1972
43,STRĂINĂTATE,"BĂLȚI 2",652,"REPUBLICA MOLDOVA",9999,1,PART,PRCNCT,PRSD,PRSD_SV_D,"2025-05-18 23:29:40",0,2285,0,2285,0,2263,22,3200,915,330,1933
43,STRĂINĂTATE,BRICENI ,653,"REPUBLICA MOLDOVA",9999,1,PART,PRCNCT,PRSD,PRSD_SV_D,"2025-05-18 22:45:39",0,936,0,936,0,920,16,1200,264,263,657
43,STRĂINĂTATE,OCNIȚA,654,"REPUBLICA MOLDOVA",9999,1,PART,PRCNCT,PRSD,PRSD_SV_D,"2025-05-18 22:07:18",0,293,0,293,0,293,0,800,507,64,229
43,STRĂINĂTATE,EDINEȚ,655,"REPUBLICA MOLDOVA",9999,2,PART,PRCNCT,PRSD,PRSD_SV_D,"2025-05-19 03:38:03",0,1330,0,1330,0,1313,17,2400,1070,297,1016
43,STRĂINĂTATE,DONDUȘENI,656,"REPUBLICA MOLDOVA",9999,1,PART,PRCNCT,PRSD,PRSD_SV_D,"2025-05-18 22:15:10",0,431,0,431,0,428,3,800,369,98,330
43,STRĂINĂTATE,SOROCA,657,"REPUBLICA MOLDOVA",9999,1,PART,PRCNCT,PRSD,PRSD_SV_D,"2025-05-18 23:23:37",0,2057,0,2057,0,2044,13,3200,1143,369,1675
43,STRĂINĂTATE,RÎȘCANI,658,"REPUBLICA MOLDOVA",9999,1,PART,PRCNCT,PRSD,PRSD_SV_D,"2025-05-18 23:14:48",0,783,0,783,0,773,10,1600,817,154,619
43,STRĂINĂTATE,DROCHIA,659,"REPUBLICA MOLDOVA",9999,1,PART,PRCNCT,PRSD,PRSD_SV_D,"2025-05-18 22:28:41",0,1429,0,1429,0,1422,7,2400,971,273,1149
43,STRĂINĂTATE,FLOREȘTI,660,"REPUBLICA MOLDOVA",9999,1,PART,PRCNCT,PRSD,PRSD_SV_D,"2025-05-18 23:28:13",0,1514,0,1514,0,1499,15,2400,886,244,1255
43,STRĂINĂTATE,GLODENI,661,"REPUBLICA MOLDOVA",9999,1,PART,PRCNCT,PRSD,PRSD_SV_D,"2025-05-18 23:15:06",0,811,0,811,0,804,7,1608,797,135,669
43,STRĂINĂTATE,ȘOLDĂNEȘTI,662,"REPUBLICA MOLDOVA",9999,1,PART,PRCNCT,PRSD,PRSD_SV_D,"2025-05-18 21:51:12",0,607,0,607,0,601,6,1600,993,104,497
43,STRĂINĂTATE,SÎNGEREI,663,"REPUBLICA MOLDOVA",9999,1,PART,PRCNCT,PRSD,PRSD_SV_D,"2025-05-18 23:12:45",0,1410,0,1410,0,1402,8,2400,990,187,1215
43,STRĂINĂTATE,REZINA,664,"REPUBLICA MOLDOVA",9999,1,PART,PRCNCT,PRSD,PRSD_SV_D,"2025-05-18 23:25:05",0,967,0,967,0,956,11,1600,633,145,811
43,STRĂINĂTATE,"UNGHENI 1",665,"REPUBLICA MOLDOVA",9999,2,PART,PRCNCT,PRSD,PRSD_SV_D,"2025-05-19 03:23:18",0,2063,0,2063,0,2058,5,3200,1137,325,1733
43,STRĂINĂTATE,"UNGHENI 2",666,"REPUBLICA MOLDOVA",9999,1,PART,PRCNCT,PRSD,PRSD_SV_D,"2025-05-18 23:49:23",0,2062,0,2062,0,2041,21,3200,1138,381,1660
43,STRĂINĂTATE,FĂLEȘTI,667,"REPUBLICA MOLDOVA",9999,1,PART,PRCNCT,PRSD,PRSD_SV_D,"2025-05-18 22:13:30",0,1131,0,1131,0,1123,8,1608,477,224,899
43,STRĂINĂTATE,TELENEȘTI,668,"REPUBLICA MOLDOVA",9999,1,PART,PRCNCT,PRSD,PRSD_SV_D,"2025-05-18 23:04:19",0,1893,0,1893,0,1885,8,2400,507,239,1646
43,STRĂINĂTATE,"CAHUL 1",669,"REPUBLICA MOLDOVA",9999,1,PART,PRCNCT,PRSD,PRSD_SV_D,"2025-05-18 23:08:53",0,2155,0,2155,0,2139,16,2800,645,413,1726
43,STRĂINĂTATE,"CAHUL 2",670,"REPUBLICA MOLDOVA",9999,1,PART,PRCNCT,PRSD,PRSD_SV_D,"2025-05-19 00:27:48",0,2200,0,2200,0,2198,2,2800,600,367,1831
43,STRĂINĂTATE,CANTEMIR,671,"REPUBLICA MOLDOVA",9999,1,PART,PRCNCT,PRSD,PRSD_SV_D,"2025-05-18 22:37:50",0,1568,0,1568,0,1555,13,2400,832,244,1311
43,STRĂINĂTATE,CARABETOVCA,672,"REPUBLICA MOLDOVA",9999,1,PART,PRCNCT,PRSD,PRSD_SV_D,"2025-05-18 23:23:36",0,536,0,536,0,531,5,1600,1064,73,458
43,STRĂINĂTATE,CIMIȘLIA,673,"REPUBLICA MOLDOVA",9999,1,PART,PRCNCT,PRSD,PRSD_SV_D,"2025-05-18 22:49:31",0,1663,0,1663,0,1651,12,2400,737,253,1398
43,STRĂINĂTATE,COMRAT,674,"REPUBLICA MOLDOVA",9999,1,PART,PRCNCT,PRSD,PRSD_SV_D,"2025-05-18 21:41:45",0,423,0,423,0,423,0,800,377,74,349
43,STRĂINĂTATE,GIURGIULEȘTI,675,"REPUBLICA MOLDOVA",9999,1,PART,PRCNCT,PRSD,PRSD_SV_D,"2025-05-18 22:25:09",0,1047,0,1047,0,1042,5,1600,553,281,761
43,STRĂINĂTATE,LEOVA,676,"REPUBLICA MOLDOVA",9999,1,PART,PRCNCT,PRSD,PRSD_SV_D,"2025-05-18 23:20:05",0,1200,0,1200,0,1192,8,2401,1201,195,997
43,STRĂINĂTATE,PODGORICA,677,MUNTENEGRU,9999,1,PART,PRCNCT,PRSD,PRSD_SV_D,"2025-05-18 21:58:58",0,180,0,180,0,178,2,800,620,53,125
43,STRĂINĂTATE,ABUJA,678,"REPUBLICA FEDERALĂ NIGERIA",9999,2,PART,PRCNCT,PRSD,PRSD_SV_D,"2025-05-19 03:21:33",0,20,0,20,0,19,1,400,380,2,17
43,STRĂINĂTATE,"OSLO 1",679,NORVEGIA,9999,2,PART,PRCNCT,PRSD,PRSD_SV_D,"2025-05-19 05:14:26",0,2172,0,2172,0,2158,14,2800,628,969,1189
43,STRĂINĂTATE,"OSLO 2",680,NORVEGIA,9999,1,PART,PRCNCT,PRSD,PRSD_SV_D,"2025-05-18 22:42:58",0,839,0,839,0,833,6,1200,361,486,347
43,STRĂINĂTATE,JESSHEIM,681,NORVEGIA,9999,1,PART,PRCNCT,PRSD,PRSD_SV_D,"2025-05-18 23:12:55",0,748,0,748,0,740,8,1200,452,366,374
43,STRĂINĂTATE,DRAMMEN,682,NORVEGIA,9999,2,PART,PRCNCT,PRSD,PRSD_SV_D,"2025-05-19 05:48:37",0,620,0,620,0,617,3,800,180,304,313
43,STRĂINĂTATE,KRISTIANSAND,683,NORVEGIA,9999,1,PART,PRCNCT,PRSD,PRSD_SV_D,"2025-05-18 22:00:19",0,374,0,374,0,369,5,800,426,221,148
43,STRĂINĂTATE,STAVANGER,684,NORVEGIA,9999,1,PART,PRCNCT,PRSD,PRSD_SV_D,"2025-05-18 23:26:31",0,1198,0,1198,0,1186,12,1600,402,582,604
43,STRĂINĂTATE,BERGEN,685,NORVEGIA,9999,1,PART,PRCNCT,PRSD,PRSD_SV_D,"2025-05-18 22:32:32",0,1318,0,1318,0,1316,2,1600,282,694,622
43,STRĂINĂTATE,SKODJE,686,NORVEGIA,9999,1,PART,PRCNCT,PRSD,PRSD_SV_D,"2025-05-18 22:49:07",0,599,0,599,0,597,2,800,201,307,290
43,STRĂINĂTATE,TRONDHEIM,687,NORVEGIA,9999,2,PART,PRCNCT,PRSD,PRSD_SV_D,"2025-05-18 23:40:06",0,319,0,319,0,319,0,800,481,145,174
43,STRĂINĂTATE,TROMSO,688,NORVEGIA,9999,1,PART,PRCNCT,PRSD,PRSD_SV_D,"2025-05-18 21:46:19",0,212,0,212,0,210,2,800,588,102,108
43,STRĂINĂTATE,"HAGA 1",689,"REGATUL ȚĂRILOR DE JOS",9999,1,PART,PRCNCT,PRSD,PRSD_SV_D,"2025-05-18 23:53:05",0,1308,0,1308,0,1302,6,3200,1892,379,923
43,STRĂINĂTATE,"HAGA 2",690,"REGATUL ȚĂRILOR DE JOS",9999,1,PART,PRCNCT,PRSD,PRSD_SV_D,"2025-05-18 23:42:55",0,1343,0,1343,0,1337,6,3200,1857,402,935
43,STRĂINĂTATE,"HAGA 3",691,"REGATUL ȚĂRILOR DE JOS",9999,1,PART,PRCNCT,PRSD,PRSD_SV_D,"2025-05-18 23:16:07",0,1356,0,1356,0,1350,6,3200,1844,325,1025
43,STRĂINĂTATE,"AMSTERDAM 1",692,"REGATUL ȚĂRILOR DE JOS",9999,1,PART,PRCNCT,PRSD,PRSD_SV_D,"2025-05-18 22:12:50",0,2633,0,2633,0,2623,10,4000,1367,876,1747
43,STRĂINĂTATE,"AMSTERDAM 2",693,"REGATUL ȚĂRILOR DE JOS",9999,1,PART,PRCNCT,PRSD,PRSD_SV_D,"2025-05-18 22:47:44",0,2630,0,2630,0,2618,12,4000,1370,751,1867
43,STRĂINĂTATE,"AMSTERDAM 3",694,"REGATUL ȚĂRILOR DE JOS",9999,1,PART,PRCNCT,PRSD,PRSD_SV_D,"2025-05-18 23:04:15",0,2638,0,2638,0,2627,11,4000,1362,632,1995
43,STRĂINĂTATE,"ROTTERDAM 1",695,"REGATUL ȚĂRILOR DE JOS",9999,1,PART,PRCNCT,PRSD,PRSD_SV_D,"2025-05-18 23:31:52",0,1894,0,1894,0,1879,15,3200,1306,932,947
43,STRĂINĂTATE,"ROTTERDAM 2",696,"REGATUL ȚĂRILOR DE JOS",9999,1,PART,PRCNCT,PRSD,PRSD_SV_D,"2025-05-19 00:48:53",0,1925,0,1925,0,1913,12,4000,2075,813,1100
43,STRĂINĂTATE,"ROTTERDAM 3",697,"REGATUL ȚĂRILOR DE JOS",9999,1,PART,PRCNCT,PRSD,PRSD_SV_D,"2025-05-18 23:50:31",0,1890,0,1890,0,1884,6,3200,1310,1035,849
43,STRĂINĂTATE,"EINDHOVEN 1",698,"REGATUL ȚĂRILOR DE JOS",9999,1,PART,PRCNCT,PRSD,PRSD_SV_D,"2025-05-18 23:53:49",0,1757,0,1757,0,1751,6,2800,1043,932,819
43,STRĂINĂTATE,"EINDHOVEN 2",699,"REGATUL ȚĂRILOR DE JOS",9999,1,PART,PRCNCT,PRSD,PRSD_SV_D,"2025-05-18 23:21:27",0,1729,0,1729,0,1722,7,2799,1070,768,954
43,STRĂINĂTATE,"EINDHOVEN 3",700,"REGATUL ȚĂRILOR DE JOS",9999,1,PART,PRCNCT,PRSD,PRSD_SV_D,"2025-05-18 23:44:25",0,1716,0,1716,0,1708,8,3200,1484,899,809
43,STRĂINĂTATE,"BREDA 1",701,"REGATUL ȚĂRILOR DE JOS",9999,1,PART,PRCNCT,PRSD,PRSD_SV_D,"2025-05-18 23:42:10",0,1969,0,1969,0,1961,8,3200,1231,1303,658
43,STRĂINĂTATE,"BREDA 2",702,"REGATUL ȚĂRILOR DE JOS",9999,1,PART,PRCNCT,PRSD,PRSD_SV_D,"2025-05-18 23:02:34",0,2054,0,2054,0,2045,9,3200,1146,1482,563
43,STRĂINĂTATE,"BREDA 3",703,"REGATUL ȚĂRILOR DE JOS",9999,1,PART,PRCNCT,PRSD,PRSD_SV_D,"2025-05-18 23:23:32",0,1989,0,1989,0,1981,8,3200,1211,1563,418
43,STRĂINĂTATE,"GRONINGEN 1",704,"REGATUL ȚĂRILOR DE JOS",9999,1,PART,PRCNCT,PRSD,PRSD_SV_D,"2025-05-18 23:56:40",0,1561,0,1561,0,1556,5,3200,1639,627,929
43,STRĂINĂTATE,"GRONINGEN 2",705,"REGATUL ȚĂRILOR DE JOS",9999,1,PART,PRCNCT,PRSD,PRSD_SV_D,"2025-05-18 23:42:36",0,1552,0,1552,0,1550,2,3200,1648,662,888
43,STRĂINĂTATE,"UTRECHT 1",706,"REGATUL ȚĂRILOR DE JOS",9999,1,PART,PRCNCT,PRSD,PRSD_SV_D,"2025-05-18 23:51:17",0,1548,0,1548,0,1544,4,2800,1252,722,822
43,STRĂINĂTATE,"UTRECHT 2",707,"REGATUL ȚĂRILOR DE JOS",9999,2,PART,PRCNCT,PRSD,PRSD_SV_D,"2025-05-19 02:48:53",0,1571,0,1571,0,1564,7,3200,1629,688,876
43,STRĂINĂTATE,"DEN BOSCH 1",708,"REGATUL ȚĂRILOR DE JOS",9999,1,PART,PRCNCT,PRSD,PRSD_SV_D,"2025-05-18 23:29:51",0,1702,0,1702,0,1693,9,3600,1898,1171,522
43,STRĂINĂTATE,"DEN BOSCH 2",709,"REGATUL ȚĂRILOR DE JOS",9999,1,PART,PRCNCT,PRSD,PRSD_SV_D,"2025-05-18 23:03:16",0,1690,0,1690,0,1677,13,3600,1910,1114,563
43,STRĂINĂTATE,MAASTRICHT,710,"REGATUL ȚĂRILOR DE JOS",9999,1,PART,PRCNCT,PRSD,PRSD_SV_D,"2025-05-19 00:00:47",0,2923,0,2923,0,2909,14,4400,1477,1413,1496
43,STRĂINĂTATE,ENSCHEDE,711,"REGATUL ȚĂRILOR DE JOS",9999,1,PART,PRCNCT,PRSD,PRSD_SV_D,"2025-05-19 01:34:00",0,3391,0,3391,0,3382,9,4800,1409,2071,1311
43,STRĂINĂTATE,MUSCAT,712,"SULTANATUL OMAN",9999,1,PART,PRCNCT,PRSD,PRSD_SV_D,"2025-05-18 20:27:17",0,84,0,84,0,83,1,392,308,5,78
43,STRĂINĂTATE,ISLAMABAD,713,"REPUBLICA ISLAMICĂ PAKISTAN",9999,1,PART,PRCNCT,PRSD,PRSD_SV_D,"2025-05-18 20:03:23",0,31,0,31,0,31,0,400,369,3,28
43,STRĂINĂTATE,RAMALLAH,714,PALESTINA,9999,1,PART,PRCNCT,PRSD,PRSD_SV_D,"2025-05-18 21:28:48",0,26,0,26,0,26,0,400,374,4,22
43,STRĂINĂTATE,LIMA,715,"REPUBLICA PERU",9999,1,PART,PRCNCT,PRSD,PRSD_SV_D,"2025-05-18 21:46:53",0,118,0,118,0,117,1,408,290,13,104
43,STRĂINĂTATE,VARȘOVIA,716,POLONIA,9999,1,PART,PRCNCT,PRSD,PRSD_SV_D,"2025-05-18 23:42:24",0,1106,0,1106,0,1097,9,2400,1294,171,926
43,STRĂINĂTATE,CRACOVIA,717,POLONIA,9999,1,PART,PRCNCT,PRSD,PRSD_SV_D,"2025-05-18 22:58:13",0,779,0,779,0,770,9,2400,1621,120,650
43,STRĂINĂTATE,WROCŁAW,718,POLONIA,9999,1,PART,PRCNCT,PRSD,PRSD_SV_D,"2025-05-18 22:53:33",0,276,0,276,0,275,1,1600,1324,91,184
43,STRĂINĂTATE,GDAŃSK,719,POLONIA,9999,1,PART,PRCNCT,PRSD,PRSD_SV_D,"2025-05-18 21:47:00",0,204,0,204,0,204,0,1600,1396,50,154
43,STRĂINĂTATE,"LISABONA 1",720,PORTUGALIA,9999,1,PART,PRCNCT,PRSD,PRSD_SV_D,"2025-05-18 23:10:32",0,1068,0,1068,0,1063,5,2400,1332,429,634
43,STRĂINĂTATE,"LISABONA 2",721,PORTUGALIA,9999,2,PART,PRCNCT,PRSD,PRSD_SV_D,"2025-05-19 00:40:05",0,999,0,999,0,989,10,2400,1401,477,512
43,STRĂINĂTATE,"LISABONA 3",722,PORTUGALIA,9999,1,PART,PRCNCT,PRSD,PRSD_SV_D,"2025-05-18 21:50:03",0,793,0,793,0,787,6,2400,1607,151,636
43,STRĂINĂTATE,PORTO,723,PORTUGALIA,9999,1,PART,PRCNCT,PRSD,PRSD_SV_D,"2025-05-18 22:56:06",0,775,0,775,0,772,3,1600,825,191,581
43,STRĂINĂTATE,SANTARÉM,724,PORTUGALIA,9999,1,PART,PRCNCT,PRSD,PRSD_SV_D,"2025-05-18 22:59:30",0,315,0,315,0,314,1,1608,1293,189,125
43,STRĂINĂTATE,SETÚBAL,725,PORTUGALIA,9999,1,PART,PRCNCT,PRSD,PRSD_SV_D,"2025-05-18 23:56:49",0,686,0,686,0,684,2,1600,914,457,227
43,STRĂINĂTATE,LOULÉ,726,PORTUGALIA,9999,1,PART,PRCNCT,PRSD,PRSD_SV_D,"2025-05-18 22:25:03",0,890,0,890,0,885,5,2400,1510,604,281
43,STRĂINĂTATE,TAVIRA,727,PORTUGALIA,9999,1,PART,PRCNCT,PRSD,PRSD_SV_D,"2025-05-18 22:03:27",0,183,0,183,0,181,2,1600,1417,99,82
43,STRĂINĂTATE,LAGOS,728,PORTUGALIA,9999,1,PART,PRCNCT,PRSD,PRSD_SV_D,"2025-05-18 22:39:09",0,439,0,439,0,435,4,1600,1161,193,242
43,STRĂINĂTATE,DOHA,729,QATAR,9999,1,PART,PRCNCT,PRSD,PRSD_SV_D,"2025-05-18 22:21:04",0,730,0,730,0,724,6,1600,870,121,603
43,STRĂINĂTATE,MOSCOVA,730,"FEDERAȚIA RUSĂ",9999,1,PART,PRCNCT,PRSD,PRSD_SV_D,"2025-05-18 21:30:33",0,109,0,109,0,109,0,800,691,44,65
43,STRĂINĂTATE,"SANKT PETERSBURG",731,"FEDERAȚIA RUSĂ",9999,1,PART,PRCNCT,PRSD,PRSD_SV_D,"2025-05-18 21:26:14",0,24,0,24,0,24,0,400,376,11,13
43,STRĂINĂTATE,DAKAR,732,SENEGAL,9999,1,PART,PRCNCT,PRSD,PRSD_SV_D,"2025-05-18 21:24:07",0,22,0,22,0,22,0,400,378,4,18
43,STRĂINĂTATE,BELGRAD,733,"REPUBLICA SERBIA",9999,1,PART,PRCNCT,PRSD,PRSD_SV_D,"2025-05-18 22:14:27",0,513,0,513,0,508,5,1600,1087,94,414
43,STRĂINĂTATE,VÂRȘEȚ,734,"REPUBLICA SERBIA",9999,1,PART,PRCNCT,PRSD,PRSD_SV_D,"2025-05-18 22:41:17",0,460,0,460,0,456,4,2400,1940,130,326
43,STRĂINĂTATE,ZAJEČAR,735,"REPUBLICA SERBIA",9999,1,PART,PRCNCT,PRSD,PRSD_SV_D,"2025-05-18 21:13:57",0,80,0,80,0,79,1,800,720,31,48
43,STRĂINĂTATE,PRIȘTINA,736,"REPUBLICA SERBIA",9999,1,PART,PRCNCT,PRSD,PRSD_SV_D,"2025-05-18 22:01:51",0,245,0,245,0,240,5,800,555,57,183
43,STRĂINĂTATE,SINGAPORE,737,"REPUBLICA SINGAPORE",9999,1,PART,PRCNCT,PRSD,PRSD_SV_D,"2025-05-18 17:16:10",0,316,0,316,0,316,0,1600,1284,28,288
43,STRĂINĂTATE,DAMASC,738,"REPUBLICA ARABĂ SIRIANĂ",9999,1,PART,PRCNCT,PRSD,PRSD_SV_D,"2025-05-18 21:40:06",0,33,0,33,0,32,1,400,367,4,28
43,STRĂINĂTATE,BRATISLAVA,739,"REPUBLICA SLOVACĂ",9999,1,PART,PRCNCT,PRSD,PRSD_SV_D,"2025-05-18 23:05:43",0,959,0,959,0,954,5,3200,2241,363,591
43,STRĂINĂTATE,LJUBLJANA,740,SLOVENIA,9999,2,PART,PRCNCT,PRSD,PRSD_SV_D,"2025-05-19 04:32:01",0,323,0,323,0,320,3,1600,1277,76,244
43,STRĂINĂTATE,"MADRID 1",741,SPANIA,9999,1,PART,PRCNCT,PRSD,PRSD_SV_D,"2025-05-18 23:33:16",0,1044,0,1044,0,1035,9,4800,3756,459,576
43,STRĂINĂTATE,"MADRID 2",742,SPANIA,9999,1,PART,PRCNCT,PRSD,PRSD_SV_D,"2025-05-18 23:23:13",0,1040,0,1040,0,1030,10,4800,3760,495,535
43,STRĂINĂTATE,"MADRID 3",743,SPANIA,9999,1,PART,PRCNCT,PRSD,PRSD_SV_D,"2025-05-19 01:51:09",0,2588,0,2588,0,2565,23,4800,2212,1753,812
43,STRĂINĂTATE,"MADRID 4",744,SPANIA,9999,2,PART,PRCNCT,PRSD,PRSD_SV_D,"2025-05-19 01:58:12",0,2542,0,2542,0,2532,10,4800,2258,1728,804
43,STRĂINĂTATE,"MADRID 5",745,SPANIA,9999,1,PART,PRCNCT,PRSD,PRSD_SV_D,"2025-05-18 23:58:51",0,1489,0,1489,0,1477,12,3992,2503,397,1080
43,STRĂINĂTATE,"MADRID 6",746,SPANIA,9999,1,PART,PRCNCT,PRSD,PRSD_SV_D,"2025-05-18 22:27:42",0,282,0,282,0,278,4,4000,3718,167,111
43,STRĂINĂTATE,"MADRID 7",747,SPANIA,9999,1,PART,PRCNCT,PRSD,PRSD_SV_D,"2025-05-19 00:27:14",0,2134,0,2134,0,2108,26,4800,2666,1419,689
43,STRĂINĂTATE,ADEJE,748,SPANIA,9999,2,PART,PRCNCT,PRSD,PRSD_SV_D,"2025-05-19 02:49:12",0,1381,0,1381,0,1366,15,2400,1019,532,834
43,STRĂINĂTATE,"ALCALA DE HENARES 1",749,SPANIA,9999,1,PART,PRCNCT,PRSD,PRSD_SV_D,"2025-05-18 23:04:22",0,2587,0,2587,0,2587,0,4800,2213,1815,772
43,STRĂINĂTATE,"ALCALA DE HENARES 2",750,SPANIA,9999,1,PART,PRCNCT,PRSD,PRSD_SV_D,"2025-05-19 00:26:07",0,2549,0,2549,0,2534,15,4800,2251,1749,785
43,STRĂINĂTATE,ALCORCON,751,SPANIA,9999,1,PART,PRCNCT,PRSD,PRSD_SV_D,"2025-05-18 23:57:28",0,998,0,998,0,988,10,4000,3002,607,381
43,STRĂINĂTATE,ARANJUEZ,752,SPANIA,9999,1,PART,PRCNCT,PRSD,PRSD_SV_D,"2025-05-18 23:28:10",0,1057,0,1057,0,1055,2,4000,2943,731,324
43,STRĂINĂTATE,"ARGANDA DEL REY 1",753,SPANIA,9999,1,PART,PRCNCT,PRSD,PRSD_SV_D,"2025-05-18 23:31:25",0,1914,0,1914,0,1899,15,4800,2886,1268,631
43,STRĂINĂTATE,"ARGANDA DEL REY 2",754,SPANIA,9999,1,PART,PRCNCT,PRSD,PRSD_SV_D,"2025-05-18 23:33:32",0,1912,0,1912,0,1905,7,4800,2888,1303,602
43,STRĂINĂTATE,AVILA,755,SPANIA,9999,2,PART,PRCNCT,PRSD,PRSD_SV_D,"2025-05-19 00:29:39",0,671,0,671,0,671,0,2400,1729,516,155
43,STRĂINĂTATE,"AZUQUECA DE HENARES",756,SPANIA,9999,3,PART,PRCNCT,PRSD,PRSD_SV_D,"2025-05-19 02:45:06",0,1203,0,1203,0,1198,5,4000,2797,769,429
43,STRĂINĂTATE,"COLLADO VILLALBA",757,SPANIA,9999,1,PART,PRCNCT,PRSD,PRSD_SV_D,"2025-05-18 23:57:29",0,1727,0,1727,0,1721,6,4000,2273,1162,559
43,STRĂINĂTATE,"COSLADA 1",758,SPANIA,9999,1,PART,PRCNCT,PRSD,PRSD_SV_D,"2025-05-18 23:00:32",0,837,0,837,0,832,5,4000,3163,532,300
43,STRĂINĂTATE,"COSLADA 2",759,SPANIA,9999,1,PART,PRCNCT,PRSD,PRSD_SV_D,"2025-05-18 23:13:53",0,2575,0,2575,0,2558,17,4800,2225,1883,675
43,STRĂINĂTATE,"COSLADA 3",760,SPANIA,9999,1,PART,PRCNCT,PRSD,PRSD_SV_D,"2025-05-18 23:55:20",0,2608,0,2608,0,2596,12,4808,2200,1888,708
43,STRĂINĂTATE,FUENLABRADA,761,SPANIA,9999,1,PART,PRCNCT,PRSD,PRSD_SV_D,"2025-05-18 23:10:25",0,1385,0,1385,0,1375,10,4000,2615,987,388
43,STRĂINĂTATE,GETAFE,762,SPANIA,9999,1,PART,PRCNCT,PRSD,PRSD_SV_D,"2025-05-18 23:04:46",0,1896,0,1896,0,1883,13,4000,2104,1343,540
43,STRĂINĂTATE,GUADALAJARA,763,SPANIA,9999,1,PART,PRCNCT,PRSD,PRSD_SV_D,"2025-05-19 00:06:04",0,1993,0,1993,0,1982,11,3200,1207,1387,595
43,STRĂINĂTATE,"LAS PALMAS",764,SPANIA,9999,1,PART,PRCNCT,PRSD,PRSD_SV_D,"2025-05-18 22:35:52",0,358,0,358,0,352,6,2400,2042,171,181
43,STRĂINĂTATE,LEGANES,765,SPANIA,9999,1,PART,PRCNCT,PRSD,PRSD_SV_D,"2025-05-18 22:50:41",0,1362,0,1362,0,1352,10,4000,2638,968,384
43,STRĂINĂTATE,LEON,766,SPANIA,9999,1,PART,PRCNCT,PRSD,PRSD_SV_D,"2025-05-18 22:49:25",0,505,0,505,0,499,6,2400,1895,367,132
43,STRĂINĂTATE,MASPALOMAS,767,SPANIA,9999,1,PART,PRCNCT,PRSD,PRSD_SV_D,"2025-05-18 22:55:14",0,504,0,504,0,501,3,2400,1896,232,269
43,STRĂINĂTATE,MOSTOLES,768,SPANIA,9999,1,PART,PRCNCT,PRSD,PRSD_SV_D,"2025-05-18 23:56:03",0,1881,0,1881,0,1872,9,4799,2918,1279,593
43,STRĂINĂTATE,PINTO,769,SPANIA,9999,1,PART,PRCNCT,PRSD,PRSD_SV_D,"2025-05-18 23:46:40",0,1015,0,1015,0,1004,11,4000,2985,681,323
43,STRĂINĂTATE,RIVAS-VACIAMADRID,770,SPANIA,9999,1,PART,PRCNCT,PRSD,PRSD_SV_D,"2025-05-18 23:06:52",0,1006,0,1006,0,999,7,4000,2994,650,349
43,STRĂINĂTATE,SALAMANCA,771,SPANIA,9999,1,PART,PRCNCT,PRSD,PRSD_SV_D,"2025-05-18 21:55:20",0,337,0,337,0,336,1,2400,2063,220,116
43,STRĂINĂTATE,"SAN MARTIN DE LA VEGA",772,SPANIA,9999,2,PART,PRCNCT,PRSD,PRSD_SV_D,"2025-05-19 05:04:48",0,709,0,709,0,705,3,4000,3292,455,250
43,STRĂINĂTATE,"SAN SEBASTIAN DE LOS REYES",773,SPANIA,9999,1,PART,PRCNCT,PRSD,PRSD_SV_D,"2025-05-18 22:42:57",0,1803,0,1803,0,1796,7,4000,2197,1150,646
43,STRĂINĂTATE,"SANTA CRUZ DE TENERIFE",774,SPANIA,9999,1,PART,PRCNCT,PRSD,PRSD_SV_D,"2025-05-18 22:28:55",0,579,0,579,0,575,4,2400,1821,139,436
43,STRĂINĂTATE,SORIA,775,SPANIA,9999,1,PART,PRCNCT,PRSD,PRSD_SV_D,"2025-05-18 22:00:48",0,279,0,279,0,276,3,2400,2121,221,55
43,STRĂINĂTATE,"TORREJON DE ARDOZ 1",776,SPANIA,9999,1,PART,PRCNCT,PRSD,PRSD_SV_D,"2025-05-18 22:16:30",0,1740,0,1740,0,1731,9,4800,3060,1209,522
43,STRĂINĂTATE,"TORREJON DE ARDOZ 2",777,SPANIA,9999,1,PART,PRCNCT,PRSD,PRSD_SV_D,"2025-05-18 22:30:20",0,1753,0,1753,0,1738,15,4800,3047,1315,423
43,STRĂINĂTATE,VALDEMORO,778,SPANIA,9999,1,PART,PRCNCT,PRSD,PRSD_SV_D,"2025-05-18 23:20:30",0,1194,0,1194,0,1191,3,4000,2806,724,467
43,STRĂINĂTATE,VALLADOLID,779,SPANIA,9999,1,PART,PRCNCT,PRSD,PRSD_SV_D,"2025-05-19 00:02:17",0,1550,0,1550,0,1544,6,4000,2450,1214,330
43,STRĂINĂTATE,"VELILLA DE SAN ANTONIO",780,SPANIA,9999,1,PART,PRCNCT,PRSD,PRSD_SV_D,"2025-05-18 23:32:58",0,825,0,825,0,817,8,4000,3175,583,234
43,STRĂINĂTATE,"VILLANUEVA DE LA CANADA",781,SPANIA,9999,1,PART,PRCNCT,PRSD,PRSD_SV_D,"2025-05-19 00:11:35",0,1144,0,1144,0,1136,8,4000,2856,768,368
43,STRĂINĂTATE,"BARCELONA 1",782,SPANIA,9999,1,PART,PRCNCT,PRSD,PRSD_SV_D,"2025-05-19 04:07:47",0,2755,0,2755,0,2742,13,5592,2837,1352,1390
43,STRĂINĂTATE,"BARCELONA 2",783,SPANIA,9999,1,PART,PRCNCT,PRSD,PRSD_SV_D,"2025-05-19 00:31:22",0,2475,0,2475,0,2460,15,5599,3124,799,1661
43,STRĂINĂTATE,"BARCELONA 3",784,SPANIA,9999,1,PART,PRCNCT,PRSD,PRSD_SV_D,"2025-05-19 00:09:55",0,1352,0,1352,0,1347,5,5600,4248,269,1078
43,STRĂINĂTATE,FIGUERES,785,SPANIA,9999,3,PART,PRCNCT,PRSD,PRSD_SV_D,"2025-05-19 05:10:39",0,2227,0,2227,0,2218,9,4000,1773,1694,524
43,STRĂINĂTATE,"LLEIDA 1",786,SPANIA,9999,1,PART,PRCNCT,PRSD,PRSD_SV_D,"2025-05-19 00:38:19",0,3192,0,3192,0,3169,23,5600,2408,2474,695
43,STRĂINĂTATE,"LLEIDA 2",787,SPANIA,9999,1,PART,PRCNCT,PRSD,PRSD_SV_D,"2025-05-19 00:17:21",0,3248,0,3248,0,3233,15,5600,2352,2561,672
43,STRĂINĂTATE,"GIRONA 1",788,SPANIA,9999,1,PART,PRCNCT,PRSD,PRSD_SV_D,"2025-05-18 23:44:18",0,847,0,847,0,841,6,4000,3153,565,276
43,STRĂINĂTATE,"GIRONA 2",789,SPANIA,9999,1,PART,PRCNCT,PRSD,PRSD_SV_D,"2025-05-18 23:25:01",0,1995,0,1995,0,1986,9,4000,2005,1475,511
43,STRĂINĂTATE,GUISSONA,790,SPANIA,9999,1,PART,PRCNCT,PRSD,PRSD_SV_D,"2025-05-18 22:19:19",0,871,0,871,0,870,1,4000,3129,658,212
43,STRĂINĂTATE,"LLORET DE MAR",791,SPANIA,9999,2,PART,PRCNCT,PRSD,PRSD_SV_D,"2025-05-19 01:59:24",0,1262,0,1262,0,1255,7,3984,2722,797,458
43,STRĂINĂTATE,MANRESA,792,SPANIA,9999,1,PART,PRCNCT,PRSD,PRSD_SV_D,"2025-05-18 23:19:36",0,1469,0,1469,0,1461,8,4000,2531,1052,409
43,STRĂINĂTATE,REUS,793,SPANIA,9999,1,PART,PRCNCT,PRSD,PRSD_SV_D,"2025-05-18 23:27:19",0,1931,0,1931,0,1921,10,4000,2069,1301,620
43,STRĂINĂTATE,SABADELL,794,SPANIA,9999,1,PART,PRCNCT,PRSD,PRSD_SV_D,"2025-05-19 01:03:57",0,2189,0,2189,0,2175,14,4016,1827,1475,700
43,STRĂINĂTATE,"TARRAGONA 1",795,SPANIA,9999,1,PART,PRCNCT,PRSD,PRSD_SV_D,"2025-05-18 23:51:35",0,892,0,892,0,885,7,4000,3108,505,380
43,STRĂINĂTATE,"TARRAGONA 2",796,SPANIA,9999,1,PART,PRCNCT,PRSD,PRSD_SV_D,"2025-05-19 00:09:06",0,812,0,812,0,808,4,4000,3188,523,285
43,STRĂINĂTATE,TARREGA,797,SPANIA,9999,1,PART,PRCNCT,PRSD,PRSD_SV_D,"2025-05-18 23:03:37",0,833,0,833,0,832,1,4000,3167,609,223
43,STRĂINĂTATE,TORTOSA,798,SPANIA,9999,1,PART,PRCNCT,PRSD,PRSD_SV_D,"2025-05-18 22:14:22",0,1214,0,1214,0,1209,5,4000,2786,916,293
43,STRĂINĂTATE,"VILANOVA I LA GELTRU",799,SPANIA,9999,1,PART,PRCNCT,PRSD,PRSD_SV_D,"2025-05-18 23:12:32",0,1263,0,1263,0,1254,9,4000,2737,827,427
43,STRĂINĂTATE,"PALMA DE MALLORCA",800,SPANIA,9999,1,PART,PRCNCT,PRSD,PRSD_SV_D,"2025-05-19 00:32:56",0,2008,0,2008,0,1997,11,4000,1992,1125,872
43,STRĂINĂTATE,POLLENÇA,801,SPANIA,9999,1,PART,PRCNCT,PRSD,PRSD_SV_D,"2025-05-18 22:37:11",0,515,0,515,0,514,1,4000,3485,320,194
43,STRĂINĂTATE,"IBIZA 1",802,SPANIA,9999,1,PART,PRCNCT,PRSD,PRSD_SV_D,"2025-05-18 22:45:26",0,1392,0,1392,0,1387,5,4000,2608,848,539
43,STRĂINĂTATE,"IBIZA 2",803,SPANIA,9999,1,PART,PRCNCT,PRSD,PRSD_SV_D,"2025-05-18 22:07:28",0,518,0,518,0,515,3,4000,3482,366,149
43,STRĂINĂTATE,"BILBAO 1",804,SPANIA,9999,1,PART,PRCNCT,PRSD,PRSD_SV_D,"2025-05-18 22:47:26",0,1081,0,1081,0,1078,3,3200,2119,756,322
43,STRĂINĂTATE,"BILBAO 2",805,SPANIA,9999,1,PART,PRCNCT,PRSD,PRSD_SV_D,"2025-05-18 22:50:16",0,1007,0,1007,0,1000,7,3200,2193,721,279
43,STRĂINĂTATE,"BILBAO 3",806,SPANIA,9999,1,PART,PRCNCT,PRSD,PRSD_SV_D,"2025-05-18 22:39:57",0,1010,0,1010,0,1003,7,2400,1390,721,282
43,STRĂINĂTATE,"BURGOS 1",807,SPANIA,9999,1,PART,PRCNCT,PRSD,PRSD_SV_D,"2025-05-18 23:26:31",0,873,0,873,0,869,4,3200,2327,624,245
43,STRĂINĂTATE,"BURGOS 2",808,SPANIA,9999,1,PART,PRCNCT,PRSD,PRSD_SV_D,"2025-05-18 23:03:02",0,831,0,831,0,829,2,2400,1569,603,226
43,STRĂINĂTATE,CALAHORRA,809,SPANIA,9999,2,PART,PRCNCT,PRSD,PRSD_SV_D,"2025-05-19 01:06:40",0,1388,0,1388,0,1384,4,2390,1002,1080,304
43,STRĂINĂTATE,GIJON,810,SPANIA,9999,1,PART,PRCNCT,PRSD,PRSD_SV_D,"2025-05-18 22:58:09",0,785,0,785,0,783,2,2400,1615,571,212
43,STRĂINĂTATE,"LOGRONO 1",811,SPANIA,9999,1,PART,PRCNCT,PRSD,PRSD_SV_D,"2025-05-18 22:07:14",0,863,0,863,0,862,1,2400,1537,658,204
43,STRĂINĂTATE,"LOGRONO 2",812,SPANIA,9999,1,PART,PRCNCT,PRSD,PRSD_SV_D,"2025-05-18 22:40:06",0,851,0,851,0,842,9,3200,2349,579,263
43,STRĂINĂTATE,"LOGRONO 3",813,SPANIA,9999,1,PART,PRCNCT,PRSD,PRSD_SV_D,"2025-05-18 22:28:03",0,1068,0,1068,0,1062,6,3200,2132,746,316
43,STRĂINĂTATE,OVIEDO,814,SPANIA,9999,1,PART,PRCNCT,PRSD,PRSD_SV_D,"2025-05-18 22:45:03",0,962,0,962,0,955,7,2400,1438,634,321
43,STRĂINĂTATE,"PAMPLONA 1",815,SPANIA,9999,1,PART,PRCNCT,PRSD,PRSD_SV_D,"2025-05-18 23:17:34",0,731,0,731,0,729,2,3200,2469,534,195
43,STRĂINĂTATE,"PAMPLONA 2",816,SPANIA,9999,1,PART,PRCNCT,PRSD,PRSD_SV_D,"2025-05-18 22:47:55",0,732,0,732,0,729,3,2400,1668,509,220
43,STRĂINĂTATE,"SAN SEBASTIAN",817,SPANIA,9999,1,PART,PRCNCT,PRSD,PRSD_SV_D,"2025-05-19 00:04:13",0,2647,0,2647,0,2636,11,4000,1353,2013,623
43,STRĂINĂTATE,"SANTANDER 1",818,SPANIA,9999,1,PART,PRCNCT,PRSD,PRSD_SV_D,"2025-05-18 22:26:53",0,616,0,616,0,611,5,3200,2584,333,278
43,STRĂINĂTATE,"SANTANDER 2",819,SPANIA,9999,2,PART,PRCNCT,PRSD,PRSD_SV_D,"2025-05-19 02:56:46",0,616,0,616,0,612,4,3200,2584,330,282
43,STRĂINĂTATE,VIGO,820,SPANIA,9999,1,PART,PRCNCT,PRSD,PRSD_SV_D,"2025-05-18 23:39:14",0,570,0,570,0,567,3,3200,2630,350,217
43,STRĂINĂTATE,"SEVILLA 1",821,SPANIA,9999,2,PART,PRCNCT,PRSD,PRSD_SV_D,"2025-05-19 05:51:28",0,1090,0,1090,0,1083,7,1600,510,792,291
43,STRĂINĂTATE,"SEVILLA 2",822,SPANIA,9999,1,PART,PRCNCT,PRSD,PRSD_SV_D,"2025-05-18 22:31:06",0,353,0,353,0,352,1,1600,1247,119,233
43,STRĂINĂTATE,CADIZ,823,SPANIA,9999,1,PART,PRCNCT,PRSD,PRSD_SV_D,"2025-05-18 22:04:34",0,481,0,481,0,480,1,1600,1119,299,181
43,STRĂINĂTATE,ALMONTE,824,SPANIA,9999,2,PART,PRCNCT,PRSD,PRSD_SV_D,"2025-05-19 04:32:10",0,1955,0,1955,0,1935,20,2400,445,1715,220
43,STRĂINĂTATE,"ROCIANA DEL CONDADO",825,SPANIA,9999,1,PART,PRCNCT,PRSD,PRSD_SV_D,"2025-05-18 22:27:58",0,624,0,624,0,623,1,1600,976,540,83
43,STRĂINĂTATE,"PALOS DE LA FRONTERA",826,SPANIA,9999,1,PART,PRCNCT,PRSD,PRSD_SV_D,"2025-05-18 22:09:12",0,1181,0,1181,0,1175,6,1600,419,1000,175
43,STRĂINĂTATE,MOGUER,827,SPANIA,9999,1,PART,PRCNCT,PRSD,PRSD_SV_D,"2025-05-18 22:41:58",0,812,0,812,0,808,4,1600,788,706,102
43,STRĂINĂTATE,HUELVA,828,SPANIA,9999,1,PART,PRCNCT,PRSD,PRSD_SV_D,"2025-05-18 23:24:15",0,427,0,427,0,427,0,1000,573,329,98
43,STRĂINĂTATE,LEPE,829,SPANIA,9999,1,PART,PRCNCT,PRSD,PRSD_SV_D,"2025-05-18 22:08:32",0,1511,0,1511,0,1507,4,2200,689,1275,232
43,STRĂINĂTATE,"MALAGA 1",830,SPANIA,9999,1,PART,PRCNCT,PRSD,PRSD_SV_D,"2025-05-18 23:05:39",0,1311,0,1311,0,1295,16,1600,289,517,778
43,STRĂINĂTATE,"MALAGA 2",831,SPANIA,9999,1,PART,PRCNCT,PRSD,PRSD_SV_D,"2025-05-18 23:08:29",0,1092,0,1092,0,1084,8,1600,508,468,616
43,STRĂINĂTATE,MARBELLA,832,SPANIA,9999,2,PART,PRCNCT,PRSD,PRSD_SV_D,"2025-05-19 02:10:47",0,1292,0,1292,0,1283,9,1600,308,489,794
43,STRĂINĂTATE,MANILVA,833,SPANIA,9999,1,PART,PRCNCT,PRSD,PRSD_SV_D,"2025-05-18 22:55:07",0,732,0,732,0,723,9,1600,868,354,369
43,STRĂINĂTATE,CORDOBA,834,SPANIA,9999,1,PART,PRCNCT,PRSD,PRSD_SV_D,"2025-05-18 22:44:05",0,686,0,686,0,684,2,1600,914,482,202
43,STRĂINĂTATE,ALMENDRALEJO,835,SPANIA,9999,2,PART,PRCNCT,PRSD,PRSD_SV_D,"2025-05-19 04:38:43",0,826,0,826,0,823,3,1600,774,727,96
43,STRĂINĂTATE,MERIDA,836,SPANIA,9999,1,PART,PRCNCT,PRSD,PRSD_SV_D,"2025-05-18 22:02:29",0,336,0,336,0,335,1,1600,1264,270,65
43,STRĂINĂTATE,"ZARAGOZA 1",837,SPANIA,9999,1,PART,PRCNCT,PRSD,PRSD_SV_D,"2025-05-18 23:08:44",0,2271,0,2271,0,2247,24,4000,1729,1577,670
43,STRĂINĂTATE,"ZARAGOZA 2",838,SPANIA,9999,1,PART,PRCNCT,PRSD,PRSD_SV_D,"2025-05-18 23:31:59",0,2338,0,2338,0,2318,20,4000,1662,1662,656
43,STRĂINĂTATE,"ZARAGOZA 3",839,SPANIA,9999,1,PART,PRCNCT,PRSD,PRSD_SV_D,"2025-05-18 23:53:28",0,2120,0,2120,0,2104,16,4000,1880,1468,636
43,STRĂINĂTATE,"ZARAGOZA 4",840,SPANIA,9999,1,PART,PRCNCT,PRSD,PRSD_SV_D,"2025-05-18 23:28:54",0,2217,0,2217,0,2202,15,4000,1783,1550,652
43,STRĂINĂTATE,ALCAÑIZ,841,SPANIA,9999,1,PART,PRCNCT,PRSD,PRSD_SV_D,"2025-05-18 23:26:52",0,1079,0,1079,0,1072,7,4000,2921,813,259
43,STRĂINĂTATE,CALATAYUD,842,SPANIA,9999,1,PART,PRCNCT,PRSD,PRSD_SV_D,"2025-05-18 23:36:30",0,2444,0,2444,0,2433,11,3992,1548,2024,409
43,STRĂINĂTATE,"CIUDAD REAL",843,SPANIA,9999,1,PART,PRCNCT,PRSD,PRSD_SV_D,"2025-05-18 22:30:58",0,834,0,834,0,834,0,3200,2366,592,242
43,STRĂINĂTATE,ALBACETE,844,SPANIA,9999,1,PART,PRCNCT,PRSD,PRSD_SV_D,"2025-05-18 22:26:56",0,931,0,931,0,924,7,3200,2269,741,183
43,STRĂINĂTATE,"ALCÁZAR DE SAN JUAN",845,SPANIA,9999,1,PART,PRCNCT,PRSD,PRSD_SV_D,"2025-05-18 22:19:29",0,890,0,890,0,887,3,3200,2310,679,208
43,STRĂINĂTATE,CUENCA,846,SPANIA,9999,1,PART,PRCNCT,PRSD,PRSD_SV_D,"2025-05-18 22:10:47",0,568,0,568,0,567,1,3200,2632,436,131
43,STRĂINĂTATE,MADRIDEJOS,847,SPANIA,9999,1,PART,PRCNCT,PRSD,PRSD_SV_D,"2025-05-18 21:53:15",0,378,0,378,0,375,3,3200,2822,308,67
43,STRĂINĂTATE,OCAÑA,848,SPANIA,9999,2,PART,PRCNCT,PRSD,PRSD_SV_D,"2025-05-19 00:27:52",0,456,0,456,0,454,2,3200,2744,340,114
43,STRĂINĂTATE,"QUINTANAR DE LA ORDEN",849,SPANIA,9999,1,PART,PRCNCT,PRSD,PRSD_SV_D,"2025-05-18 22:34:56",0,1084,0,1084,0,1082,2,4000,2916,888,194
43,STRĂINĂTATE,"QUINTANAR DEL REY",850,SPANIA,9999,1,PART,PRCNCT,PRSD,PRSD_SV_D,"2025-05-18 22:04:15",0,609,0,609,0,609,0,3200,2591,528,81
43,STRĂINĂTATE,"TALAVERA DE LA REINA",851,SPANIA,9999,1,PART,PRCNCT,PRSD,PRSD_SV_D,"2025-05-18 23:21:42",0,1134,0,1134,0,1130,4,4000,2866,814,316
43,STRĂINĂTATE,TARANCÓN,852,SPANIA,9999,2,PART,PRCNCT,PRSD,PRSD_SV_D,"2025-05-19 01:22:36",0,946,0,946,0,937,9,4000,3054,733,204
43,STRĂINĂTATE,TOLEDO,853,SPANIA,9999,1,PART,PRCNCT,PRSD,PRSD_SV_D,"2025-05-18 23:26:31",0,1576,0,1576,0,1570,6,4000,2424,1156,414
43,STRĂINĂTATE,TOMELLOSO,854,SPANIA,9999,1,PART,PRCNCT,PRSD,PRSD_SV_D,"2025-05-18 22:22:38",0,1290,0,1290,0,1280,10,3200,1910,1098,182
43,STRĂINĂTATE,VILLARROBLEDO,855,SPANIA,9999,1,PART,PRCNCT,PRSD,PRSD_SV_D,"2025-05-18 22:18:25",0,705,0,705,0,701,4,3200,2495,605,96
43,STRĂINĂTATE,"ALMERIA 1",856,SPANIA,9999,1,PART,PRCNCT,PRSD,PRSD_SV_D,"2025-05-18 23:29:46",0,1654,0,1654,0,1647,7,2400,746,1275,372
43,STRĂINĂTATE,"ALMERIA 2",857,SPANIA,9999,1,PART,PRCNCT,PRSD,PRSD_SV_D,"2025-05-18 21:56:39",0,106,0,106,0,103,3,1600,1494,60,43
43,STRĂINĂTATE,"ROQUETAS DE MAR 1",858,SPANIA,9999,1,PART,PRCNCT,PRSD,PRSD_SV_D,"2025-05-18 22:57:14",0,1064,0,1064,0,1057,7,2400,1336,882,175
43,STRĂINĂTATE,"ROQUETAS DE MAR 2",859,SPANIA,9999,1,PART,PRCNCT,PRSD,PRSD_SV_D,"2025-05-18 23:03:23",0,1075,0,1075,0,1073,2,2400,1325,890,183
43,STRĂINĂTATE,"ROQUETAS DE MAR 3",860,SPANIA,9999,1,PART,PRCNCT,PRSD,PRSD_SV_D,"2025-05-18 23:46:23",0,1081,0,1081,0,1077,4,2400,1319,833,244
43,STRĂINĂTATE,"EL EJIDO 1",861,SPANIA,9999,1,PART,PRCNCT,PRSD,PRSD_SV_D,"2025-05-18 23:51:51",0,813,0,813,0,808,5,1600,787,613,195
43,STRĂINĂTATE,"EL EJIDO 2",862,SPANIA,9999,1,PART,PRCNCT,PRSD,PRSD_SV_D,"2025-05-18 22:58:25",0,820,0,820,0,818,2,1600,780,638,180
43,STRĂINĂTATE,MOTRIL,863,SPANIA,9999,1,PART,PRCNCT,PRSD,PRSD_SV_D,"2025-05-18 23:16:12",0,1419,0,1419,0,1413,6,2400,981,1095,318
43,STRĂINĂTATE,GRANADA,864,SPANIA,9999,1,PART,PRCNCT,PRSD,PRSD_SV_D,"2025-05-18 23:07:16",0,794,0,794,0,788,6,1600,806,517,271
43,STRĂINĂTATE,LORCA,865,SPANIA,9999,1,PART,PRCNCT,PRSD,PRSD_SV_D,"2025-05-18 23:36:00",0,980,0,980,0,977,3,1600,620,786,191
43,STRĂINĂTATE,MURCIA,866,SPANIA,9999,1,PART,PRCNCT,PRSD,PRSD_SV_D,"2025-05-19 00:09:39",0,1505,0,1505,0,1494,11,2400,895,958,536
43,STRĂINĂTATE,UBEDA,867,SPANIA,9999,1,PART,PRCNCT,PRSD,PRSD_SV_D,"2025-05-18 21:37:59",0,241,0,241,0,239,2,1600,1359,190,49
43,STRĂINĂTATE,"CASTELLON 1",868,SPANIA,9999,1,PART,PRCNCT,PRSD,PRSD_SV_D,"2025-05-18 23:49:56",0,2048,0,2048,0,2035,13,3200,1152,1327,708
43,STRĂINĂTATE,"CASTELLON 2",869,SPANIA,9999,1,PART,PRCNCT,PRSD,PRSD_SV_D,"2025-05-18 22:55:09",0,2060,0,2060,0,2043,17,3200,1140,1371,672
43,STRĂINĂTATE,"CASTELLON 3",870,SPANIA,9999,1,PART,PRCNCT,PRSD,PRSD_SV_D,"2025-05-18 23:47:25",0,2045,0,2045,0,2031,14,3200,1155,1392,639
43,STRĂINĂTATE,ALMAZORA,871,SPANIA,9999,1,PART,PRCNCT,PRSD,PRSD_SV_D,"2025-05-18 22:50:09",0,1150,0,1150,0,1145,5,3200,2050,829,316
43,STRĂINĂTATE,ONDA,872,SPANIA,9999,1,PART,PRCNCT,PRSD,PRSD_SV_D,"2025-05-18 23:21:12",0,582,0,582,0,580,2,3200,2618,417,163
43,STRĂINĂTATE,"OROPESA DEL MAR",873,SPANIA,9999,1,PART,PRCNCT,PRSD,PRSD_SV_D,"2025-05-18 23:04:35",0,909,0,909,0,899,10,3200,2291,598,301
43,STRĂINĂTATE,PENISCOLA,874,SPANIA,9999,2,PART,PRCNCT,PRSD,PRSD_SV_D,"2025-05-19 00:19:38",0,565,0,565,0,564,1,3200,2635,346,218
43,STRĂINĂTATE,VILA-REAL,875,SPANIA,9999,1,PART,PRCNCT,PRSD,PRSD_SV_D,"2025-05-18 23:10:20",0,2106,0,2106,0,2097,9,3200,1094,1455,642
43,STRĂINĂTATE,VINAROS,876,SPANIA,9999,2,PART,PRCNCT,PRSD,PRSD_SV_D,"2025-05-19 01:46:59",0,1801,0,1801,0,1792,9,3200,1399,1253,539
43,STRĂINĂTATE,GANDIA,877,SPANIA,9999,1,PART,PRCNCT,PRSD,PRSD_SV_D,"2025-05-18 23:32:23",0,1801,0,1801,0,1791,10,3200,1399,1212,579
43,STRĂINĂTATE,PATERNA,878,SPANIA,9999,1,PART,PRCNCT,PRSD,PRSD_SV_D,"2025-05-18 23:18:50",0,2498,0,2498,0,2482,16,3200,702,1738,744
43,STRĂINĂTATE,ALMUSSAFES,879,SPANIA,9999,1,PART,PRCNCT,PRSD,PRSD_SV_D,"2025-05-18 22:02:36",0,972,0,972,0,970,2,3200,2228,747,223
43,STRĂINĂTATE,"VALENCIA 1",880,SPANIA,9999,1,PART,PRCNCT,PRSD,PRSD_SV_D,"2025-05-18 23:08:05",0,1302,0,1302,0,1292,10,3200,1898,542,750
43,STRĂINĂTATE,"VALENCIA 2",881,SPANIA,9999,2,PART,PRCNCT,PRSD,PRSD_SV_D,"2025-05-19 00:56:42",0,995,0,995,0,986,9,3200,2205,477,509
43,STRĂINĂTATE,"VALENCIA 3",882,SPANIA,9999,1,PART,PRCNCT,PRSD,PRSD_SV_D,"2025-05-19 01:32:36",0,2373,0,2373,0,2357,15,3200,827,1455,902
43,STRĂINĂTATE,XATIVA,883,SPANIA,9999,1,PART,PRCNCT,PRSD,PRSD_SV_D,"2025-05-18 23:13:31",0,1168,0,1168,0,1164,4,3200,2032,945,219
43,STRĂINĂTATE,ALICANTE,884,SPANIA,9999,1,PART,PRCNCT,PRSD,PRSD_SV_D,"2025-05-19 00:42:51",0,1782,0,1782,0,1766,16,3200,1418,895,871
43,STRĂINĂTATE,ELCHE,885,SPANIA,9999,1,PART,PRCNCT,PRSD,PRSD_SV_D,"2025-05-18 23:50:54",0,1419,0,1419,0,1410,9,3200,1781,1011,399
43,STRĂINĂTATE,BENIDORM,886,SPANIA,9999,2,PART,PRCNCT,PRSD,PRSD_SV_D,"2025-05-19 04:42:08",0,2342,0,2342,0,2330,12,3200,858,1401,929
43,STRĂINĂTATE,TORREVIEJA,887,SPANIA,9999,1,PART,PRCNCT,PRSD,PRSD_SV_D,"2025-05-18 23:54:49",0,1762,0,1762,0,1752,10,3200,1438,1103,649
43,STRĂINĂTATE,COLOMBO,888,"SRI LANKA",9999,1,PART,PRCNCT,PRSD,PRSD_SV_D,"2025-05-18 19:16:10",0,32,0,32,0,32,0,400,368,7,25
43,STRĂINĂTATE,"WASHINGTON DC",889,"STATELE UNITE ALE AMERICII",9999,1,PART,PRCNCT,PRSD,PRSD_SV_D,"2025-05-18 23:41:57",0,663,0,663,0,661,2,3192,2529,85,576
43,STRĂINĂTATE,"OLD HICKORY, TN",890,"STATELE UNITE ALE AMERICII",9999,1,PART,PRCNCT,PRSD,PRSD_SV_D,"2025-05-18 22:29:53",0,192,0,192,0,191,1,3200,3008,62,129
43,STRĂINĂTATE,"CHARLOTTE, NC",891,"STATELE UNITE ALE AMERICII",9999,1,PART,PRCNCT,PRSD,PRSD_SV_D,"2025-05-18 22:18:23",0,444,0,444,0,440,4,3200,2756,148,292
43,STRĂINĂTATE,"CLEVELAND, OH",892,"STATELE UNITE ALE AMERICII",9999,1,PART,PRCNCT,PRSD,PRSD_SV_D,"2025-05-18 22:19:39",0,542,0,542,0,542,0,3200,2658,149,393
43,STRĂINĂTATE,"NORFOLK, VA",893,"STATELE UNITE ALE AMERICII",9999,1,PART,PRCNCT,PRSD,PRSD_SV_D,"2025-05-18 21:49:37",0,122,0,122,0,122,0,2400,2278,24,98
43,STRĂINĂTATE,"EASLEY, SC",894,"STATELE UNITE ALE AMERICII",9999,1,PART,PRCNCT,PRSD,PRSD_SV_D,"2025-05-18 22:03:23",0,131,0,131,0,131,0,2400,2269,47,84
43,STRĂINĂTATE,"POTOMAC, MD",895,"STATELE UNITE ALE AMERICII",9999,1,PART,PRCNCT,PRSD,PRSD_SV_D,"2025-05-18 22:38:46",0,688,0,688,0,687,1,3200,2512,136,551
43,STRĂINĂTATE,"CHICAGO 1",896,"STATELE UNITE ALE AMERICII",9999,1,PART,PRCNCT,PRSD,PRSD_SV_D,"2025-05-18 22:38:32",0,336,0,336,0,335,1,3200,2864,48,287
43,STRĂINĂTATE,"CHICAGO 2",897,"STATELE UNITE ALE AMERICII",9999,1,PART,PRCNCT,PRSD,PRSD_SV_D,"2025-05-18 22:32:57",0,137,0,137,0,137,0,2400,2263,44,93
43,STRĂINĂTATE,"CHICAGO 3",898,"STATELE UNITE ALE AMERICII",9999,1,PART,PRCNCT,PRSD,PRSD_SV_D,"2025-05-18 23:05:49",0,511,0,511,0,511,0,2400,1889,205,306
43,STRĂINĂTATE,"CHICAGO 4",899,"STATELE UNITE ALE AMERICII",9999,1,PART,PRCNCT,PRSD,PRSD_SV_D,"2025-05-18 22:30:43",0,281,0,281,0,280,1,2400,2119,59,221
43,STRĂINĂTATE,"CHICAGO 5",900,"STATELE UNITE ALE AMERICII",9999,2,PART,PRCNCT,PRSD,PRSD_SV_D,"2025-05-19 03:27:41",0,324,0,324,0,323,1,3200,2876,133,190
43,STRĂINĂTATE,NILES,901,"STATELE UNITE ALE AMERICII",9999,1,PART,PRCNCT,PRSD,PRSD_SV_D,"2025-05-18 23:35:33",0,1486,0,1486,0,1480,6,2800,1314,645,835
43,STRĂINĂTATE,AURORA,902,"STATELE UNITE ALE AMERICII",9999,1,PART,PRCNCT,PRSD,PRSD_SV_D,"2025-05-18 22:17:40",0,483,0,483,0,481,2,2400,1917,100,381
43,STRĂINĂTATE,"MICHIGAN 1",903,"STATELE UNITE ALE AMERICII",9999,1,PART,PRCNCT,PRSD,PRSD_SV_D,"2025-05-18 22:12:10",0,774,0,774,0,771,3,2400,1626,335,436
43,STRĂINĂTATE,"MICHIGAN 2",904,"STATELE UNITE ALE AMERICII",9999,1,PART,PRCNCT,PRSD,PRSD_SV_D,"2025-05-18 22:40:09",0,669,0,669,0,669,0,2800,2131,331,338
43,STRĂINĂTATE,INDIANA,905,"STATELE UNITE ALE AMERICII",9999,1,PART,PRCNCT,PRSD,PRSD_SV_D,"2025-05-18 21:44:06",0,208,0,208,0,208,0,1600,1392,39,169
43,STRĂINĂTATE,MINNESOTA,906,"STATELE UNITE ALE AMERICII",9999,1,PART,PRCNCT,PRSD,PRSD_SV_D,"2025-05-18 21:45:16",0,175,0,175,0,175,0,1600,1425,34,141
43,STRĂINĂTATE,MISSOURI,907,"STATELE UNITE ALE AMERICII",9999,3,PART,PRCNCT,PRSD,PRSD_SV_D,"2025-05-19 05:53:11",0,106,0,106,0,106,0,1600,1494,40,66
43,STRĂINĂTATE,"LOS ANGELES",908,"STATELE UNITE ALE AMERICII",9999,1,PART,PRCNCT,PRSD,PRSD_SV_D,"2025-05-18 23:26:01",0,628,0,628,0,627,1,1200,572,95,532
43,STRĂINĂTATE,ANAHEIM,909,"STATELE UNITE ALE AMERICII",9999,2,PART,PRCNCT,PRSD,PRSD_SV_D,"2025-05-19 03:29:20",0,661,0,661,0,654,7,1200,539,285,369
43,STRĂINĂTATE,DENVER,910,"STATELE UNITE ALE AMERICII",9999,1,PART,PRCNCT,PRSD,PRSD_SV_D,"2025-05-18 21:58:24",0,308,0,308,0,307,1,800,492,69,238
43,STRĂINĂTATE,"LAS VEGAS",911,"STATELE UNITE ALE AMERICII",9999,1,PART,PRCNCT,PRSD,PRSD_SV_D,"2025-05-18 22:50:44",0,405,0,405,0,404,1,1200,795,143,261
43,STRĂINĂTATE,PHOENIX,912,"STATELE UNITE ALE AMERICII",9999,1,PART,PRCNCT,PRSD,PRSD_SV_D,"2025-05-18 23:38:28",0,1029,0,1029,0,1025,4,2400,1371,600,425
43,STRĂINĂTATE,PORTLAND,913,"STATELE UNITE ALE AMERICII",9999,1,PART,PRCNCT,PRSD,PRSD_SV_D,"2025-05-18 22:23:34",0,615,0,615,0,611,4,1200,585,328,283
43,STRĂINĂTATE,SACRAMENTO,914,"STATELE UNITE ALE AMERICII",9999,1,PART,PRCNCT,PRSD,PRSD_SV_D,"2025-05-18 21:58:30",0,450,0,450,0,448,2,1200,750,210,238
43,STRĂINĂTATE,"SALT LAKE CITY",915,"STATELE UNITE ALE AMERICII",9999,1,PART,PRCNCT,PRSD,PRSD_SV_D,"2025-05-18 21:35:08",0,149,0,149,0,148,1,800,651,14,134
43,STRĂINĂTATE,"SAN DIEGO",916,"STATELE UNITE ALE AMERICII",9999,1,PART,PRCNCT,PRSD,PRSD_SV_D,"2025-05-18 21:45:37",0,279,0,279,0,277,2,800,521,28,249
43,STRĂINĂTATE,"SAN FRANCISCO 1",917,"STATELE UNITE ALE AMERICII",9999,1,PART,PRCNCT,PRSD,PRSD_SV_D,"2025-05-18 23:21:30",0,828,0,828,0,824,4,1600,772,92,732
43,STRĂINĂTATE,"SAN FRANCISCO 2",918,"STATELE UNITE ALE AMERICII",9999,1,PART,PRCNCT,PRSD,PRSD_SV_D,"2025-05-18 22:31:48",0,373,0,373,0,373,0,1200,827,47,326
43,STRĂINĂTATE,SEATTLE,919,"STATELE UNITE ALE AMERICII",9999,1,PART,PRCNCT,PRSD,PRSD_SV_D,"2025-05-18 22:35:12",0,1367,0,1367,0,1364,3,2400,1033,302,1062
43,STRĂINĂTATE,MIAMI,920,"STATELE UNITE ALE AMERICII",9999,1,PART,PRCNCT,PRSD,PRSD_SV_D,"2025-05-18 22:58:58",0,402,0,402,0,400,2,1600,1198,67,333
43,STRĂINĂTATE,DACULA,921,"STATELE UNITE ALE AMERICII",9999,1,PART,PRCNCT,PRSD,PRSD_SV_D,"2025-05-18 23:26:16",0,1156,0,1156,0,1148,8,1600,444,497,651
43,STRĂINĂTATE,DALLAS,922,"STATELE UNITE ALE AMERICII",9999,1,PART,PRCNCT,PRSD,PRSD_SV_D,"2025-05-18 22:40:13",0,443,0,443,0,440,3,1600,1157,126,314
43,STRĂINĂTATE,"FORT MYERS",923,"STATELE UNITE ALE AMERICII",9999,1,PART,PRCNCT,PRSD,PRSD_SV_D,"2025-05-18 21:37:06",0,116,0,116,0,115,1,1600,1484,49,66
43,STRĂINĂTATE,HOUSTON,924,"STATELE UNITE ALE AMERICII",9999,1,PART,PRCNCT,PRSD,PRSD_SV_D,"2025-05-18 22:05:41",0,635,0,635,0,632,3,1600,965,225,407
43,STRĂINĂTATE,JACKSONVILLE,925,"STATELE UNITE ALE AMERICII",9999,1,PART,PRCNCT,PRSD,PRSD_SV_D,"2025-05-18 22:30:03",0,313,0,313,0,310,3,1600,1287,124,186
43,STRĂINĂTATE,MIRAMAR,926,"STATELE UNITE ALE AMERICII",9999,1,PART,PRCNCT,PRSD,PRSD_SV_D,"2025-05-18 23:43:17",0,1037,0,1037,0,1032,5,1600,563,402,630
43,STRĂINĂTATE,NAPLES,927,"STATELE UNITE ALE AMERICII",9999,1,PART,PRCNCT,PRSD,PRSD_SV_D,"2025-05-18 22:21:16",0,214,0,214,0,212,2,1600,1386,107,105
43,STRĂINĂTATE,"SAN ANTONIO",928,"STATELE UNITE ALE AMERICII",9999,1,PART,PRCNCT,PRSD,PRSD_SV_D,"2025-05-18 22:55:51",0,265,0,265,0,265,0,1600,1335,91,174
43,STRĂINĂTATE,TAMPA,929,"STATELE UNITE ALE AMERICII",9999,1,PART,PRCNCT,PRSD,PRSD_SV_D,"2025-05-18 23:57:49",0,381,0,381,0,380,1,1600,1219,126,254
43,STRĂINĂTATE,"NEW YORK 1",930,"STATELE UNITE ALE AMERICII",9999,1,PART,PRCNCT,PRSD,PRSD_SV_D,"2025-05-19 00:34:15",0,1197,0,1197,0,1193,4,3192,1995,190,1003
43,STRĂINĂTATE,"NEW YORK 2",931,"STATELE UNITE ALE AMERICII",9999,1,PART,PRCNCT,PRSD,PRSD_SV_D,"2025-05-19 00:05:17",0,928,0,928,0,925,3,3200,2272,104,821
43,STRĂINĂTATE,"LONG VALLEY",932,"STATELE UNITE ALE AMERICII",9999,1,PART,PRCNCT,PRSD,PRSD_SV_D,"2025-05-18 23:45:04",0,410,0,410,0,408,2,2400,1990,81,327
43,STRĂINĂTATE,PHILADELPHIA,933,"STATELE UNITE ALE AMERICII",9999,1,PART,PRCNCT,PRSD,PRSD_SV_D,"2025-05-18 23:44:24",0,446,0,446,0,445,1,2408,1962,89,356
43,STRĂINĂTATE,QUEENS,934,"STATELE UNITE ALE AMERICII",9999,3,PART,PRCNCT,PRSD,PRSD_SV_D,"2025-05-19 02:33:52",0,585,0,585,0,582,3,3192,2607,236,346
43,STRĂINĂTATE,SHELTON,935,"STATELE UNITE ALE AMERICII",9999,2,PART,PRCNCT,PRSD,PRSD_SV_D,"2025-05-19 02:51:14",0,455,0,455,0,455,0,2400,1945,97,358
43,STRĂINĂTATE,VICTOR,936,"STATELE UNITE ALE AMERICII",9999,1,PART,PRCNCT,PRSD,PRSD_SV_D,"2025-05-18 21:53:53",0,107,0,107,0,107,0,1600,1493,21,86
43,STRĂINĂTATE,WAKEFIELD,937,"STATELE UNITE ALE AMERICII",9999,1,PART,PRCNCT,PRSD,PRSD_SV_D,"2025-05-19 00:24:31",0,937,0,937,0,936,1,3200,2263,86,850
43,STRĂINĂTATE,"WEST LAWN",938,"STATELE UNITE ALE AMERICII",9999,1,PART,PRCNCT,PRSD,PRSD_SV_D,"2025-05-18 22:00:09",0,261,0,261,0,261,0,2400,2139,104,157
43,STRĂINĂTATE,"STOCKHOLM 1",939,SUEDIA,9999,1,PART,PRCNCT,PRSD,PRSD_SV_D,"2025-05-19 03:37:47",0,2400,0,2400,0,2381,19,3200,800,917,1464
43,STRĂINĂTATE,"STOCKHOLM 2",940,SUEDIA,9999,1,PART,PRCNCT,PRSD,PRSD_SV_D,"2025-05-18 22:50:56",0,780,0,780,0,778,2,1600,820,189,589
43,STRĂINĂTATE,GÖTEBORG,941,SUEDIA,9999,1,PART,PRCNCT,PRSD,PRSD_SV_D,"2025-05-19 00:24:03",0,2226,0,2226,0,2214,12,3200,974,1043,1171
43,STRĂINĂTATE,MALMÖ,942,SUEDIA,9999,3,PART,PRCNCT,PRSD,PRSD_SV_D,"2025-05-19 04:02:34",0,2185,0,2185,0,2176,9,2800,615,955,1221
43,STRĂINĂTATE,SÖLVESBORG,943,SUEDIA,9999,1,PART,PRCNCT,PRSD,PRSD_SV_D,"2025-05-18 22:17:33",0,738,0,738,0,736,2,1200,462,372,364
43,STRĂINĂTATE,UPPSALA,944,SUEDIA,9999,1,PART,PRCNCT,PRSD,PRSD_SV_D,"2025-05-18 23:21:19",0,951,0,951,0,947,4,1200,249,518,429
43,STRĂINĂTATE,BANGKOK,945,"REGATUL THAILANDEI",9999,1,PART,PRCNCT,PRSD,PRSD_SV_D,"2025-05-18 18:15:36",0,266,0,266,0,266,0,800,534,33,233
43,STRĂINĂTATE,TUNIS,946,"REPUBLICA TUNISIANĂ",9999,1,PART,PRCNCT,PRSD,PRSD_SV_D,"2025-05-18 21:48:26",0,203,0,203,0,198,5,800,597,46,152
43,STRĂINĂTATE,ANKARA,947,TURCIA,9999,2,PART,PRCNCT,PRSD,PRSD_SV_D,"2025-05-19 03:33:19",0,219,0,219,0,216,3,2400,2181,36,180
43,STRĂINĂTATE,ANTALYA,948,TURCIA,9999,2,PART,PRCNCT,PRSD,PRSD_SV_D,"2025-05-18 23:16:19",0,780,0,780,0,775,5,2400,1620,206,569
43,STRĂINĂTATE,"ISTANBUL 1",949,TURCIA,9999,2,PART,PRCNCT,PRSD,PRSD_SV_D,"2025-05-19 02:18:18",0,462,0,462,0,461,1,2400,1938,151,310
43,STRĂINĂTATE,"ISTANBUL 2",950,TURCIA,9999,1,PART,PRCNCT,PRSD,PRSD_SV_D,"2025-05-18 22:23:19",0,1564,0,1564,0,1547,17,2400,836,382,1165
43,STRĂINĂTATE,IZMIR,951,TURCIA,9999,2,PART,PRCNCT,PRSD,PRSD_SV_D,"2025-05-19 05:55:56",0,278,0,278,0,275,3,2408,2130,94,181
43,STRĂINĂTATE,ASHGABAT,952,TURKMENISTAN,9999,1,PART,PRCNCT,PRSD,PRSD_SV_D,"2025-05-18 19:22:44",0,7,0,7,0,7,0,400,393,0,7
43,STRĂINĂTATE,KIEV,953,UCRAINA,9999,1,PART,PRCNCT,PRSD,PRSD_SV_D,"2025-05-18 22:01:00",0,107,0,107,0,106,1,400,293,20,86
43,STRĂINĂTATE,SOLOTVINO,954,UCRAINA,9999,1,PART,PRCNCT,PRSD,PRSD_SV_D,"2025-05-18 21:43:11",0,75,0,75,0,74,1,400,325,17,57
43,STRĂINĂTATE,CERNĂUȚI,955,UCRAINA,9999,1,PART,PRCNCT,PRSD,PRSD_SV_D,"2025-05-18 21:36:34",0,249,0,249,0,249,0,1200,951,69,180
43,STRĂINĂTATE,"BUDAPESTA 1",956,UNGARIA,9999,1,PART,PRCNCT,PRSD,PRSD_SV_D,"2025-05-19 00:31:05",0,2923,0,2923,0,2917,6,3108,185,201,2716
43,STRĂINĂTATE,"BUDAPESTA 2",957,UNGARIA,9999,1,PART,PRCNCT,PRSD,PRSD_SV_D,"2025-05-19 00:55:50",0,2963,0,2963,0,2953,10,3150,187,212,2741
43,STRĂINĂTATE,"BUDAPESTA 3",958,UNGARIA,9999,1,PART,PRCNCT,PRSD,PRSD_SV_D,"2025-05-19 00:46:02",0,1880,0,1880,0,1873,7,2050,170,140,1733
43,STRĂINĂTATE,"BUDAPESTA 4",959,UNGARIA,9999,1,PART,PRCNCT,PRSD,PRSD_SV_D,"2025-05-19 01:36:52",0,1951,0,1951,0,1944,7,2100,149,143,1801
43,STRĂINĂTATE,SZEGED,960,UNGARIA,9999,1,PART,PRCNCT,PRSD,PRSD_SV_D,"2025-05-18 22:17:06",0,769,0,769,0,763,6,1200,431,97,666
43,STRĂINĂTATE,GYULA,961,UNGARIA,9999,1,PART,PRCNCT,PRSD,PRSD_SV_D,"2025-05-18 22:36:48",0,564,0,564,0,558,6,1200,636,79,479
43,STRĂINĂTATE,MONTEVIDEO,962,"REPUBLICA ORIENTALĂ A URUGUAYULUI",9999,1,PART,PRCNCT,PRSD,PRSD_SV_D,"2025-05-18 21:55:52",0,20,0,20,0,20,0,400,380,6,14
43,STRĂINĂTATE,TAȘKENT,963,UZBEKISTAN,9999,1,PART,PRCNCT,PRSD,PRSD_SV_D,"2025-05-18 19:51:03",0,35,0,35,0,35,0,400,365,1,34
43,STRĂINĂTATE,HANOI,964,"REPUBLICA SOCIALISTĂ VIETNAM",9999,1,PART,PRCNCT,PRSD,PRSD_SV_D,"2025-05-18 17:18:55",0,87,0,87,0,87,0,800,713,2,85
43,STRĂINĂTATE,HARARE,965,ZIMBABWE,9999,2,PART,PRCNCT,PRSD,PRSD_SV_D,"2025-05-18 23:13:05",0,8,0,8,0,8,0,400,392,1,7
42,"MUNICIPIUL BUCUREŞTI","LICEUL TEORETIC ”NICOLAE IORGA”",1,"BUCUREŞTI SECTORUL 1",179141,1,PART,PRCNCT,PRSD,PRSD_SV_SECTOR,"2025-05-18 23:12:32",1306,633,350,283,0,625,8,1040,407,176,449
42,"MUNICIPIUL BUCUREŞTI","LICEUL TEORETIC ”NICOLAE IORGA”",2,"BUCUREŞTI SECTORUL 1",179141,1,PART,PRCNCT,PRSD,PRSD_SV_SECTOR,"2025-05-18 22:23:48",1111,825,635,186,4,817,8,1229,404,167,650
42,"MUNICIPIUL BUCUREŞTI","LICEUL TEORETIC ”NICOLAE IORGA”",3,"BUCUREŞTI SECTORUL 1",179141,1,PART,PRCNCT,PRSD,PRSD_SV_SECTOR,"2025-05-18 22:31:29",1153,862,670,192,0,849,13,1270,408,215,634
42,"MUNICIPIUL BUCUREŞTI","LICEUL TEORETIC ”NICOLAE IORGA”",4,"BUCUREŞTI SECTORUL 1",179141,1,PART,PRCNCT,PRSD,PRSD_SV_SECTOR,"2025-05-18 22:39:54",973,759,525,232,2,751,8,1070,311,167,584
42,"MUNICIPIUL BUCUREŞTI","LICEUL TEORETIC ”NICOLAE IORGA”",5,"BUCUREŞTI SECTORUL 1",179141,3,PART,PRCNCT,PRSD,PRSD_SV_SECTOR,"2025-05-19 00:37:24",1176,807,704,100,3,792,15,1290,483,154,638
42,"MUNICIPIUL BUCUREŞTI","LICEUL GRECO-CATOLIC ”TIMOTEI CIPARIU”",6,"BUCUREŞTI SECTORUL 1",179141,1,PART,PRCNCT,PRSD,PRSD_SV_SECTOR,"2025-05-18 21:56:59",1358,944,774,169,1,926,18,1490,546,219,707
42,"MUNICIPIUL BUCUREŞTI","LICEUL GRECO-CATOLIC ”TIMOTEI CIPARIU”",7,"BUCUREŞTI SECTORUL 1",179141,1,PART,PRCNCT,PRSD,PRSD_SV_SECTOR,"2025-05-18 22:17:07",1287,856,720,136,0,848,8,1420,564,248,600
42,"MUNICIPIUL BUCUREŞTI","LICEUL GRECO-CATOLIC ”TIMOTEI CIPARIU”",8,"BUCUREŞTI SECTORUL 1",179141,1,PART,PRCNCT,PRSD,PRSD_SV_SECTOR,"2025-05-18 22:31:30",1380,953,822,130,1,934,19,1520,567,281,653
42,"MUNICIPIUL BUCUREŞTI","ȘCOALA GIMNAZIALĂ NR.13",9,"BUCUREŞTI SECTORUL 1",179141,1,PART,PRCNCT,PRSD,PRSD_SV_SECTOR,"2025-05-18 22:01:40",1286,872,776,96,0,863,9,1420,548,284,579
42,"MUNICIPIUL BUCUREŞTI","ŞCOALA GIMNAZIALĂ NR.13",10,"BUCUREŞTI SECTORUL 1",179141,1,PART,PRCNCT,PRSD,PRSD_SV_SECTOR,"2025-05-18 22:05:51",1272,816,730,86,0,808,8,1400,584,376,432
42,"MUNICIPIUL BUCUREŞTI","ŞCOALA GIMNAZIALĂ NR.13",11,"BUCUREŞTI SECTORUL 1",179141,1,PART,PRCNCT,PRSD,PRSD_SV_SECTOR,"2025-05-18 22:01:17",1192,828,680,123,25,816,12,1310,482,287,529
42,"MUNICIPIUL BUCUREŞTI","ŞCOALA GIMNAZIALĂ NR.13",12,"BUCUREŞTI SECTORUL 1",179141,1,PART,PRCNCT,PRSD,PRSD_SV_SECTOR,"2025-05-18 22:06:50",1212,763,650,113,0,747,16,1330,567,343,404
42,"MUNICIPIUL BUCUREŞTI","ŞCOALA GIMNAZIALĂ NR.179",13,"BUCUREŞTI SECTORUL 1",179141,1,PART,PRCNCT,PRSD,PRSD_SV_SECTOR,"2025-05-18 23:00:54",1304,924,737,186,1,911,13,1430,506,286,625
42,"MUNICIPIUL BUCUREŞTI","ŞCOALA GIMNAZIALĂ NR.179",14,"BUCUREŞTI SECTORUL 1",179141,1,PART,PRCNCT,PRSD,PRSD_SV_SECTOR,"2025-05-18 22:58:05",1309,992,798,159,35,982,10,1440,448,299,683
42,"MUNICIPIUL BUCUREŞTI","ŞCOALA GIMNAZIALĂ NR.179",15,"BUCUREŞTI SECTORUL 1",179141,1,PART,PRCNCT,PRSD,PRSD_SV_SECTOR,"2025-05-18 22:43:02",1347,875,777,98,0,862,13,1480,605,234,628
42,"MUNICIPIUL BUCUREŞTI","ŞCOALA GIMNAZIALĂ NR.179",16,"BUCUREŞTI SECTORUL 1",179141,1,PART,PRCNCT,PRSD,PRSD_SV_SECTOR,"2025-05-18 22:23:08",1163,809,711,98,0,800,9,1280,471,207,593
42,"MUNICIPIUL BUCUREŞTI","ŞCOALA GIMNAZIALĂ NR.179",17,"BUCUREŞTI SECTORUL 1",179141,3,PART,PRCNCT,PRSD,PRSD_SV_SECTOR,"2025-05-19 01:43:50",1347,872,812,60,0,859,13,1480,608,257,602
42,"MUNICIPIUL BUCUREŞTI","LICEUL TEORETIC ”C-TIN BRÂNCOVEANU”",18,"BUCUREŞTI SECTORUL 1",179141,1,PART,PRCNCT,PRSD,PRSD_SV_SECTOR,"2025-05-18 22:46:38",1076,804,584,220,0,793,11,1180,376,249,544
42,"MUNICIPIUL BUCUREŞTI","LICEUL TEORETIC ”C-TIN BRÂNCOVEANU”",19,"BUCUREŞTI SECTORUL 1",179141,1,PART,PRCNCT,PRSD,PRSD_SV_SECTOR,"2025-05-18 22:17:36",1252,926,684,241,1,907,19,1380,454,268,639
42,"MUNICIPIUL BUCUREŞTI","LICEUL TEORETIC ”C-TIN BRÂNCOVEANU”",20,"BUCUREŞTI SECTORUL 1",179141,1,PART,PRCNCT,PRSD,PRSD_SV_SECTOR,"2025-05-18 22:35:59",1161,743,562,180,1,732,11,1280,537,208,524
42,"MUNICIPIUL BUCUREŞTI","LICEUL TEORETIC ”C-TIN BRÂNCOVEANU”",21,"BUCUREŞTI SECTORUL 1",179141,1,PART,PRCNCT,PRSD,PRSD_SV_SECTOR,"2025-05-18 21:48:31",1229,830,716,113,1,817,13,1350,520,223,594
42,"MUNICIPIUL BUCUREŞTI","ȘCOALA GIMNAZIALĂ NR.178",22,"BUCUREŞTI SECTORUL 1",179141,1,PART,PRCNCT,PRSD,PRSD_SV_SECTOR,"2025-05-18 22:28:17",1251,937,703,233,1,912,25,1380,443,281,631
42,"MUNICIPIUL BUCUREŞTI","ŞCOALA GIMNAZIALĂ NR.178",23,"BUCUREŞTI SECTORUL 1",179141,1,PART,PRCNCT,PRSD,PRSD_SV_SECTOR,"2025-05-18 22:04:27",1148,795,631,161,3,776,19,1260,465,216,560
42,"MUNICIPIUL BUCUREŞTI","ŞCOALA GIMNAZIALĂ NR.178",24,"BUCUREŞTI SECTORUL 1",179141,1,PART,PRCNCT,PRSD,PRSD_SV_SECTOR,"2025-05-18 22:13:41",1104,856,651,202,3,846,10,1210,354,245,601
42,"MUNICIPIUL BUCUREŞTI","ŞCOALA GIMNAZIALĂ SPECIALĂ NR.8",25,"BUCUREŞTI SECTORUL 1",179141,2,PART,PRCNCT,PRSD,PRSD_SV_SECTOR,"2025-05-18 23:09:21",1390,879,739,138,2,872,7,1530,651,322,550
42,"MUNICIPIUL BUCUREŞTI","ŞCOALA GIMNAZIALĂ SPECIALĂ NR.8",26,"BUCUREŞTI SECTORUL 1",179141,1,PART,PRCNCT,PRSD,PRSD_SV_SECTOR,"2025-05-18 22:08:02",1396,823,744,77,2,813,10,1540,717,186,627
42,"MUNICIPIUL BUCUREŞTI","ȘCOALA GIMNAZIALĂ SPECIALĂ NR.8",27,"BUCUREŞTI SECTORUL 1",179141,2,PART,PRCNCT,PRSD,PRSD_SV_SECTOR,"2025-05-18 23:19:44",1326,890,819,70,1,878,12,1368,478,199,679
42,"MUNICIPIUL BUCUREŞTI","ŞCOALA GIMNAZIALĂ SPECIALĂ NR.8",28,"BUCUREŞTI SECTORUL 1",179141,1,PART,PRCNCT,PRSD,PRSD_SV_SECTOR,"2025-05-18 22:24:00",1342,912,824,86,2,901,11,1480,568,207,694
42,"MUNICIPIUL BUCUREŞTI","ŞCOALA GIMNAZIALĂ ”NICOLAE GRIGORESCU”",29,"BUCUREŞTI SECTORUL 1",179141,1,PART,PRCNCT,PRSD,PRSD_SV_SECTOR,"2025-05-18 21:52:43",1314,848,723,124,1,838,10,1450,602,243,595
42,"MUNICIPIUL BUCUREŞTI","ŞCOALA GIMNAZIALĂ ”NICOLAE GRIGORESCU”",30,"BUCUREŞTI SECTORUL 1",179141,1,PART,PRCNCT,PRSD,PRSD_SV_SECTOR,"2025-05-18 21:50:51",1338,953,844,105,4,940,13,1470,517,282,658
42,"MUNICIPIUL BUCUREŞTI","ŞCOALA GIMNAZIALĂ ”NICOLAE GRIGORESCU”",31,"BUCUREŞTI SECTORUL 1",179141,1,PART,PRCNCT,PRSD,PRSD_SV_SECTOR,"2025-05-18 21:53:14",1315,941,775,166,0,931,10,1450,509,276,655
42,"MUNICIPIUL BUCUREŞTI","ȘCOALA GIMNAZIALĂ NR. 6 - APICULTORILOR SALĂ SPORT",32,"BUCUREŞTI SECTORUL 1",179141,1,PART,PRCNCT,PRSD,PRSD_SV_SECTOR,"2025-05-18 22:24:32",1535,1038,907,131,0,1028,10,1690,652,297,731
42,"MUNICIPIUL BUCUREŞTI","ȘCOALA GIMNAZIALĂ NR. 6 - APICULTORILOR SALĂ SPORT",33,"BUCUREŞTI SECTORUL 1",179141,1,PART,PRCNCT,PRSD,PRSD_SV_SECTOR,"2025-05-18 22:25:22",1549,1084,901,182,1,1070,14,1710,626,256,814
42,"MUNICIPIUL BUCUREŞTI","ȘCOALA GIMNAZIALĂ NR. 6 - APICULTORILOR SALĂ SPORT",34,"BUCUREŞTI SECTORUL 1",179141,2,PART,PRCNCT,PRSD,PRSD_SV_SECTOR,"2025-05-19 00:47:44",1448,1200,910,255,35,1186,14,1590,390,273,913
42,"MUNICIPIUL BUCUREŞTI","ȘCOALA GIMNAZIALĂ NR. 6 - APICULTORILOR SALĂ SPORT",35,"BUCUREŞTI SECTORUL 1",179141,2,PART,PRCNCT,PRSD,PRSD_SV_SECTOR,"2025-05-19 01:05:30",1459,1002,891,110,1,989,13,1600,598,232,757
42,"MUNICIPIUL BUCUREŞTI","ŞCOALA GIMNAZIALĂ NR.6",36,"BUCUREŞTI SECTORUL 1",179141,1,PART,PRCNCT,PRSD,PRSD_SV_SECTOR,"2025-05-18 22:37:32",987,856,635,191,30,849,7,1080,224,182,667
42,"MUNICIPIUL BUCUREŞTI","ŞCOALA GIMNAZIALĂ NR.6",37,"BUCUREŞTI SECTORUL 1",179141,1,PART,PRCNCT,PRSD,PRSD_SV_SECTOR,"2025-05-18 22:16:20",1114,809,653,153,3,801,8,1230,421,239,562
42,"MUNICIPIUL BUCUREŞTI","UNIVERSITATEA DE ȘTIINȚE AGRONOMICE ȘI MEDICINĂ VETERINARĂ BUCUREȘTI",38,"BUCUREŞTI SECTORUL 1",179141,1,PART,PRCNCT,PRSD,PRSD_SV_SECTOR,"2025-05-18 22:46:14",1256,1304,708,501,95,1294,10,1380,76,302,992
42,"MUNICIPIUL BUCUREŞTI","UNIVERSITATEA DE ŞTIINŢE AGRONOMICE ŞI MEDICINĂ VETERINARĂ BUCUREŞTI",39,"BUCUREŞTI SECTORUL 1",179141,1,PART,PRCNCT,PRSD,PRSD_SV_SECTOR,"2025-05-18 22:21:04",1209,1234,713,459,62,1215,19,1330,96,273,942
42,"MUNICIPIUL BUCUREŞTI","DIRECŢIA PUBLICĂ DE EVIDENŢĂ A PERSOANEI ŞI STARE CIVILĂ SECT.1",40,"BUCUREŞTI SECTORUL 1",179141,1,PART,PRCNCT,PRSD,PRSD_SV_SECTOR,"2025-05-18 22:41:14",1120,912,631,199,82,903,9,1230,318,216,687
42,"MUNICIPIUL BUCUREŞTI","ŞCOALA GIMNAZIALĂ NR.7",41,"BUCUREŞTI SECTORUL 1",179141,1,PART,PRCNCT,PRSD,PRSD_SV_SECTOR,"2025-05-18 22:03:18",1220,829,680,148,1,823,6,1340,511,195,628
42,"MUNICIPIUL BUCUREŞTI","ŞCOALA GIMNAZIALĂ NR.7",42,"BUCUREŞTI SECTORUL 1",179141,1,PART,PRCNCT,PRSD,PRSD_SV_SECTOR,"2025-05-18 22:58:30",1414,940,786,154,0,929,11,1550,610,228,701
42,"MUNICIPIUL BUCUREŞTI","ŞCOALA GIMNAZIALĂ NR.7",43,"BUCUREŞTI SECTORUL 1",179141,1,PART,PRCNCT,PRSD,PRSD_SV_SECTOR,"2025-05-18 22:16:52",1377,948,799,149,0,933,15,1520,572,250,683
42,"MUNICIPIUL BUCUREŞTI","COLEGIUL TEHNOLOGIC ”VIACESLAV HARNAJ”",44,"BUCUREŞTI SECTORUL 1",179141,1,PART,PRCNCT,PRSD,PRSD_SV_SECTOR,"2025-05-18 23:00:10",1512,1112,879,233,0,1108,4,1660,548,294,814
42,"MUNICIPIUL BUCUREŞTI","COLEGIUL TEHNOLOGIC ”VIACESLAV HARNAJ”",45,"BUCUREŞTI SECTORUL 1",179141,1,PART,PRCNCT,PRSD,PRSD_SV_SECTOR,"2025-05-18 22:12:57",1540,1089,876,213,0,1076,13,1690,601,260,816
42,"MUNICIPIUL BUCUREŞTI","COLEGIUL TEHNOLOGIC ”VIACESLAV HARNAJ”",46,"BUCUREŞTI SECTORUL 1",179141,1,PART,PRCNCT,PRSD,PRSD_SV_SECTOR,"2025-05-18 23:01:15",1528,1070,863,198,9,1048,22,1680,610,273,775
42,"MUNICIPIUL BUCUREŞTI","ŞCOALA GIMNAZIALĂ ”HERĂSTRĂU”",47,"BUCUREŞTI SECTORUL 1",179141,1,PART,PRCNCT,PRSD,PRSD_SV_SECTOR,"2025-05-18 22:15:06",1410,898,806,72,20,885,13,1550,652,199,686
42,"MUNICIPIUL BUCUREŞTI","ŞCOALA GIMNAZIALĂ ”HERĂSTRĂU”",48,"BUCUREŞTI SECTORUL 1",179141,1,PART,PRCNCT,PRSD,PRSD_SV_SECTOR,"2025-05-18 22:29:45",1451,958,872,83,3,947,11,1600,642,182,765
42,"MUNICIPIUL BUCUREŞTI","ŞCOALA GIMNAZIALĂ ”HERĂSTRĂU”",49,"BUCUREŞTI SECTORUL 1",179141,1,PART,PRCNCT,PRSD,PRSD_SV_SECTOR,"2025-05-18 23:22:25",1362,872,790,81,1,853,19,1500,628,200,653
42,"MUNICIPIUL BUCUREŞTI","ŞCOALA GIMNAZIALĂ ”HERĂSTRĂU”",50,"BUCUREŞTI SECTORUL 1",179141,1,PART,PRCNCT,PRSD,PRSD_SV_SECTOR,"2025-05-18 22:13:40",1356,923,768,155,0,902,21,1490,567,192,710
42,"MUNICIPIUL BUCUREŞTI","ŞCOALA GIMNAZIALĂ ”HERĂSTRĂU”",51,"BUCUREŞTI SECTORUL 1",179141,1,PART,PRCNCT,PRSD,PRSD_SV_SECTOR,"2025-05-18 22:33:22",1491,1110,876,231,3,1098,12,1640,530,236,862
42,"MUNICIPIUL BUCUREŞTI","ŞCOALA GIMNAZIALĂ ”HERĂSTRĂU”",52,"BUCUREŞTI SECTORUL 1",179141,1,PART,PRCNCT,PRSD,PRSD_SV_SECTOR,"2025-05-18 22:44:56",1407,1132,813,318,1,1111,21,1550,418,221,890
42,"MUNICIPIUL BUCUREŞTI","ŞCOALA GIMNAZIALĂ ”HERĂSTRĂU”",53,"BUCUREŞTI SECTORUL 1",179141,1,PART,PRCNCT,PRSD,PRSD_SV_SECTOR,"2025-05-18 23:08:59",1230,855,689,163,3,841,14,1350,495,189,652
42,"MUNICIPIUL BUCUREŞTI","ŞCOALA GIMNAZIALĂ ”HERĂSTRĂU”",54,"BUCUREŞTI SECTORUL 1",179141,1,PART,PRCNCT,PRSD,PRSD_SV_SECTOR,"2025-05-18 23:23:37",1335,1001,792,208,1,984,17,1470,469,223,761
42,"MUNICIPIUL BUCUREŞTI","ŞCOALA GIMNAZIALĂ ”HERĂSTRĂU”",55,"BUCUREŞTI SECTORUL 1",179141,1,PART,PRCNCT,PRSD,PRSD_SV_SECTOR,"2025-05-18 22:19:07",1268,1110,725,384,1,1099,11,1390,280,272,827
42,"MUNICIPIUL BUCUREŞTI","ŞCOALA GIMNAZIALĂ ”HERĂSTRĂU”",56,"BUCUREŞTI SECTORUL 1",179141,1,PART,PRCNCT,PRSD,PRSD_SV_SECTOR,"2025-05-18 22:42:48",1235,1106,731,374,1,1090,16,1760,654,220,870
42,"MUNICIPIUL BUCUREŞTI","ŞCOALA GIMNAZIALĂ ”HERĂSTRĂU”",57,"BUCUREŞTI SECTORUL 1",179141,1,PART,PRCNCT,PRSD,PRSD_SV_SECTOR,"2025-05-18 22:48:28",1358,1003,813,189,1,987,16,1500,497,197,790
42,"MUNICIPIUL BUCUREŞTI","ŞCOALA GIMNAZIALĂ ”HERĂSTRĂU”",58,"BUCUREŞTI SECTORUL 1",179141,1,PART,PRCNCT,PRSD,PRSD_SV_SECTOR,"2025-05-18 22:06:27",1279,773,687,86,0,759,14,1410,637,171,588
42,"MUNICIPIUL BUCUREŞTI","ŞCOALA GIMNAZIALĂ ”PIA BRĂTIANU”",59,"BUCUREŞTI SECTORUL 1",179141,1,PART,PRCNCT,PRSD,PRSD_SV_SECTOR,"2025-05-18 22:47:25",1248,926,739,186,1,915,11,1370,444,169,746
42,"MUNICIPIUL BUCUREŞTI","ŞCOALA GIMNAZIALĂ ”PIA BRĂTIANU”",60,"BUCUREŞTI SECTORUL 1",179141,1,PART,PRCNCT,PRSD,PRSD_SV_SECTOR,"2025-05-18 22:59:27",1230,832,690,138,4,825,7,1350,518,153,672
42,"MUNICIPIUL BUCUREŞTI","COMPLEXUL SOCIAL DE SERVICII ”ODĂI”",61,"BUCUREŞTI SECTORUL 1",179141,1,PART,PRCNCT,PRSD,PRSD_SV_SECTOR,"2025-05-18 21:51:15",702,538,421,82,35,525,13,770,232,292,233
42,"MUNICIPIUL BUCUREŞTI","COLEGIUL NAŢIONAL DE INFORMATICĂ ”TUDOR VIANU”",62,"BUCUREŞTI SECTORUL 1",179141,1,PART,PRCNCT,PRSD,PRSD_SV_SECTOR,"2025-05-18 22:34:14",1092,878,604,185,89,861,17,1200,322,208,653
42,"MUNICIPIUL BUCUREŞTI","COLEGIUL NAŢIONAL DE INFORMATICĂ ”TUDOR VIANU”",63,"BUCUREŞTI SECTORUL 1",179141,1,PART,PRCNCT,PRSD,PRSD_SV_SECTOR,"2025-05-18 22:38:17",1264,1076,783,202,91,1064,12,1390,314,227,837
42,"MUNICIPIUL BUCUREŞTI","COLEGIUL NAŢIONAL DE INFORMATICĂ ”TUDOR VIANU”",64,"BUCUREŞTI SECTORUL 1",179141,1,PART,PRCNCT,PRSD,PRSD_SV_SECTOR,"2025-05-18 22:21:32",1062,798,604,158,36,790,8,1170,372,197,593
42,"MUNICIPIUL BUCUREŞTI","COLEGIUL NAŢIONAL ”I.L. CARAGIALE”",65,"BUCUREŞTI SECTORUL 1",179141,1,PART,PRCNCT,PRSD,PRSD_SV_SECTOR,"2025-05-18 22:18:39",926,851,493,290,68,838,13,1020,169,197,641
42,"MUNICIPIUL BUCUREŞTI","COLEGIUL NAŢIONAL ”I.L. CARAGIALE”",66,"BUCUREŞTI SECTORUL 1",179141,1,PART,PRCNCT,PRSD,PRSD_SV_SECTOR,"2025-05-18 22:38:02",1019,864,618,207,39,855,9,1120,256,173,682
42,"MUNICIPIUL BUCUREŞTI","ŞCOALA GIMNAZIALĂ ”TITU MAIORESCU”",67,"BUCUREŞTI SECTORUL 1",179141,1,PART,PRCNCT,PRSD,PRSD_SV_SECTOR,"2025-05-18 23:31:49",1366,1025,759,266,0,1003,22,1500,475,235,768
42,"MUNICIPIUL BUCUREŞTI","ŞCOALA GIMNAZIALĂ ”TITU MAIORESCU”",68,"BUCUREŞTI SECTORUL 1",179141,1,PART,PRCNCT,PRSD,PRSD_SV_SECTOR,"2025-05-18 22:42:55",1276,997,732,265,0,978,19,1400,403,184,794
42,"MUNICIPIUL BUCUREŞTI","LICEUL TEORETIC ”JEAN MONNET”",69,"BUCUREŞTI SECTORUL 1",179141,1,PART,PRCNCT,PRSD,PRSD_SV_SECTOR,"2025-05-18 23:39:37",1315,1166,731,433,2,1148,18,1850,684,258,890
42,"MUNICIPIUL BUCUREŞTI","LICEUL TEORETIC ”JEAN MONNET”",70,"BUCUREŞTI SECTORUL 1",179141,1,PART,PRCNCT,PRSD,PRSD_SV_SECTOR,"2025-05-18 23:28:38",1313,1269,775,494,0,1241,28,1850,581,278,963
42,"MUNICIPIUL BUCUREŞTI","COLEGIUL ECONOMIC ”V. MADGEARU”",71,"BUCUREŞTI SECTORUL 1",179141,1,PART,PRCNCT,PRSD,PRSD_SV_SECTOR,"2025-05-19 00:24:46",987,815,518,296,1,808,7,1080,265,186,622
42,"MUNICIPIUL BUCUREŞTI","COLEGIUL ECONOMIC ”V. MADGEARU”",72,"BUCUREŞTI SECTORUL 1",179141,1,PART,PRCNCT,PRSD,PRSD_SV_SECTOR,"2025-05-18 22:08:54",977,760,508,249,3,755,5,1070,310,176,579
42,"MUNICIPIUL BUCUREŞTI","ACADEMIA DE STUDII ECONOMICE DIN BUCUREŞTI",73,"BUCUREŞTI SECTORUL 1",179141,1,PART,PRCNCT,PRSD,PRSD_SV_SECTOR,"2025-05-18 23:25:22",1413,1361,646,714,1,1338,23,1560,199,278,1060
42,"MUNICIPIUL BUCUREŞTI","UNIVERSITATEA DE ARHITECTURĂ ŞI URBANISM ION MINCU",74,"BUCUREŞTI SECTORUL 1",179141,1,PART,PRCNCT,PRSD,PRSD_SV_SECTOR,"2025-05-18 23:03:51",842,1223,361,862,0,1213,10,1330,107,194,1019
42,"MUNICIPIUL BUCUREŞTI","UNIVERSITATEA DE ARHITECTURĂ ŞI URBANISM ION MINCU",75,"BUCUREŞTI SECTORUL 1",179141,1,PART,PRCNCT,PRSD,PRSD_SV_SECTOR,"2025-05-19 00:02:34",909,1202,398,803,1,1184,18,1400,198,237,947
42,"MUNICIPIUL BUCUREŞTI","ŞCOALA GIMNAZIALĂ NR.5",76,"BUCUREŞTI SECTORUL 1",179141,1,PART,PRCNCT,PRSD,PRSD_SV_SECTOR,"2025-05-18 23:15:42",1598,1443,773,670,0,1422,21,1760,317,284,1138
42,"MUNICIPIUL BUCUREŞTI","COLEGIUL NAŢIONAL DE MUZICĂ ”GEORGE ENESCU”",77,"BUCUREŞTI SECTORUL 1",179141,2,PART,PRCNCT,PRSD,PRSD_SV_SECTOR,"2025-05-19 01:59:22",1003,973,530,396,47,965,8,1099,126,197,768
42,"MUNICIPIUL BUCUREŞTI","COLEGIUL NAŢIONAL DE MUZICĂ ”GEORGE ENESCU”",78,"BUCUREŞTI SECTORUL 1",179141,1,PART,PRCNCT,PRSD,PRSD_SV_SECTOR,"2025-05-18 22:11:47",1153,887,539,296,52,878,9,1270,383,217,661
42,"MUNICIPIUL BUCUREŞTI","COLEGIUL TEHNIC DE ARHITECTURĂ ŞI LUCRĂRI PUBLICE ”IOAN N. SOCOLESCU”",79,"BUCUREŞTI SECTORUL 1",179141,1,PART,PRCNCT,PRSD,PRSD_SV_SECTOR,"2025-05-18 22:36:24",901,706,475,231,0,699,7,990,284,187,512
42,"MUNICIPIUL BUCUREŞTI","COLEGIUL NAŢIONAL ”SFÂNTUL SAVA”",80,"BUCUREŞTI SECTORUL 1",179141,2,PART,PRCNCT,PRSD,PRSD_SV_SECTOR,"2025-05-19 02:25:46",1223,772,590,181,1,756,16,1355,583,172,584
42,"MUNICIPIUL BUCUREŞTI","COLEGIUL NAŢIONAL ”SFÂNTUL SAVA”",81,"BUCUREŞTI SECTORUL 1",179141,1,PART,PRCNCT,PRSD,PRSD_SV_SECTOR,"2025-05-18 22:21:59",1196,788,571,217,0,782,6,1320,532,177,605
42,"MUNICIPIUL BUCUREŞTI","COLEGIUL NAŢIONAL ”SFÂNTUL SAVA”",82,"BUCUREŞTI SECTORUL 1",179141,1,PART,PRCNCT,PRSD,PRSD_SV_SECTOR,"2025-05-18 21:54:24",1091,670,523,145,2,663,7,1200,530,159,504
42,"MUNICIPIUL BUCUREŞTI","UNIVERSITATEA NAŢIONALĂ DE MUZICĂ DIN BUCUREŞTI",83,"BUCUREŞTI SECTORUL 1",179141,1,PART,PRCNCT,PRSD,PRSD_SV_SECTOR,"2025-05-18 23:03:49",838,738,389,349,0,722,16,920,182,177,545
42,"MUNICIPIUL BUCUREŞTI","UNIVERSITATEA NAŢIONALĂ DE MUZICĂ DIN BUCUREŞTI",84,"BUCUREŞTI SECTORUL 1",179141,1,PART,PRCNCT,PRSD,PRSD_SV_SECTOR,"2025-05-18 22:31:03",829,697,411,283,3,692,5,910,213,131,561
42,"MUNICIPIUL BUCUREŞTI","LICEUL DE ARTE PLASTICE ”NICOLAE TONITZA”",85,"BUCUREŞTI SECTORUL 1",179141,1,PART,PRCNCT,PRSD,PRSD_SV_SECTOR,"2025-05-18 21:48:42",1395,917,730,187,0,907,10,1530,613,236,671
42,"MUNICIPIUL BUCUREŞTI","LICEUL DE ARTE PLASTICE ”NICOLAE TONITZA”",86,"BUCUREŞTI SECTORUL 1",179141,1,PART,PRCNCT,PRSD,PRSD_SV_SECTOR,"2025-05-18 22:27:18",1005,784,554,228,2,770,14,1100,316,149,621
42,"MUNICIPIUL BUCUREŞTI","LICEUL DE ARTE PLASTICE ”NICOLAE TONITZA”",87,"BUCUREŞTI SECTORUL 1",179141,1,PART,PRCNCT,PRSD,PRSD_SV_SECTOR,"2025-05-18 22:31:31",1195,776,617,156,3,761,15,1320,544,199,562
42,"MUNICIPIUL BUCUREŞTI","LICEUL DE ARTE PLASTICE ”NICOLAE TONITZA”",88,"BUCUREŞTI SECTORUL 1",179141,1,PART,PRCNCT,PRSD,PRSD_SV_SECTOR,"2025-05-18 21:53:46",1298,805,702,61,42,798,7,1430,625,181,617
42,"MUNICIPIUL BUCUREŞTI","CENTRUL NAŢIONAL DE CALIFICARE ŞI INSTRUIRE FEROVIARĂ CENAFER",89,"BUCUREŞTI SECTORUL 1",179141,1,PART,PRCNCT,PRSD,PRSD_SV_SECTOR,"2025-05-18 23:19:22",1530,1650,840,808,2,1634,16,2080,430,428,1206
42,"MUNICIPIUL BUCUREŞTI","CENTRUL NAŢIONAL DE CALIFICARE ŞI INSTRUIRE FEROVIARĂ CENAFER",90,"BUCUREŞTI SECTORUL 1",179141,1,PART,PRCNCT,PRSD,PRSD_SV_SECTOR,"2025-05-18 22:27:31",1138,721,633,88,0,712,9,1250,529,216,496
42,"MUNICIPIUL BUCUREŞTI","CENTRUL NAŢIONAL DE CALIFICARE ŞI INSTRUIRE FEROVIARĂ CENAFER",91,"BUCUREŞTI SECTORUL 1",179141,1,PART,PRCNCT,PRSD,PRSD_SV_SECTOR,"2025-05-18 22:01:45",1356,867,769,97,1,857,10,1490,623,237,620
42,"MUNICIPIUL BUCUREŞTI","ŞCOALA GIMNAZIALĂ ”NICOLAE TITULESCU”",92,"BUCUREŞTI SECTORUL 1",179141,1,PART,PRCNCT,PRSD,PRSD_SV_SECTOR,"2025-05-18 22:45:09",1169,776,652,123,1,767,9,1290,514,244,523
42,"MUNICIPIUL BUCUREŞTI","ŞCOALA GIMNAZIALĂ ”NICOLAE TITULESCU”",93,"BUCUREŞTI SECTORUL 1",179141,1,PART,PRCNCT,PRSD,PRSD_SV_SECTOR,"2025-05-18 22:13:07",907,772,464,307,1,765,7,1000,228,149,616
42,"MUNICIPIUL BUCUREŞTI","ŞCOALA GIMNAZIALĂ ”NICOLAE TITULESCU”",94,"BUCUREŞTI SECTORUL 1",179141,1,PART,PRCNCT,PRSD,PRSD_SV_SECTOR,"2025-05-18 22:08:26",1277,940,739,199,2,923,17,1400,460,211,712
42,"MUNICIPIUL BUCUREŞTI","ŞCOALA GIMNAZIALĂ ”NICOLAE TITULESCU”",95,"BUCUREŞTI SECTORUL 1",179141,1,PART,PRCNCT,PRSD,PRSD_SV_SECTOR,"2025-05-18 22:11:53",1153,754,600,153,1,748,6,1270,516,176,572
42,"MUNICIPIUL BUCUREŞTI","ȘCOALA GIMNAZIALĂ ”NICOLAE TITULESCU”",96,"BUCUREŞTI SECTORUL 1",179141,1,PART,PRCNCT,PRSD,PRSD_SV_SECTOR,"2025-05-18 22:07:52",1349,871,759,109,3,857,14,1480,609,143,714
42,"MUNICIPIUL BUCUREŞTI","LICEUL TEORETIC ”ALEXANDRU VLAHUŢĂ”",97,"BUCUREŞTI SECTORUL 1",179141,1,PART,PRCNCT,PRSD,PRSD_SV_SECTOR,"2025-05-18 22:14:08",1141,833,649,136,48,820,13,1260,427,177,643
42,"MUNICIPIUL BUCUREŞTI","LICEUL TEORETIC ”ALEXANDRU VLAHUŢĂ”",98,"BUCUREŞTI SECTORUL 1",179141,1,PART,PRCNCT,PRSD,PRSD_SV_SECTOR,"2025-05-18 22:33:29",1444,992,844,98,50,977,15,1582,590,273,704
42,"MUNICIPIUL BUCUREŞTI","LICEUL TEORETIC ”ALEXANDRU VLAHUŢĂ”",99,"BUCUREŞTI SECTORUL 1",179141,1,PART,PRCNCT,PRSD,PRSD_SV_SECTOR,"2025-05-18 23:09:59",1140,735,606,74,55,724,11,1250,515,198,526
42,"MUNICIPIUL BUCUREŞTI","COLEGIUL GERMAN ”GOETHE”",100,"BUCUREŞTI SECTORUL 1",179141,2,PART,PRCNCT,PRSD,PRSD_SV_SECTOR,"2025-05-19 00:55:37",1197,668,617,50,1,656,12,910,242,152,504
42,"MUNICIPIUL BUCUREŞTI","COLEGIUL GERMAN ”GOETHE”",101,"BUCUREŞTI SECTORUL 1",179141,1,PART,PRCNCT,PRSD,PRSD_SV_SECTOR,"2025-05-18 22:16:46",1272,717,627,88,2,703,14,1400,683,177,526
42,"MUNICIPIUL BUCUREŞTI","COLEGIUL GERMAN ”GOETHE”",102,"BUCUREŞTI SECTORUL 1",179141,1,PART,PRCNCT,PRSD,PRSD_SV_SECTOR,"2025-05-18 22:13:48",1149,800,602,198,0,791,9,1260,460,195,596
42,"MUNICIPIUL BUCUREŞTI","LICEUL TEORETIC BILINGV ”MIGUEL DE CERVANTES”",103,"BUCUREŞTI SECTORUL 1",179141,1,PART,PRCNCT,PRSD,PRSD_SV_SECTOR,"2025-05-18 21:54:09",866,689,457,228,4,680,9,950,261,202,478
42,"MUNICIPIUL BUCUREŞTI","LICEUL TEORETIC BILINGV ”MIGUEL DE CERVANTES”",104,"BUCUREŞTI SECTORUL 1",179141,1,PART,PRCNCT,PRSD,PRSD_SV_SECTOR,"2025-05-18 22:05:08",924,618,487,129,2,610,8,1020,402,157,453
42,"MUNICIPIUL BUCUREŞTI","ȘCOALA GIMNAZIALĂ ”URUGUAY”",105,"BUCUREŞTI SECTORUL 1",179141,1,PART,PRCNCT,PRSD,PRSD_SV_SECTOR,"2025-05-18 22:10:17",1216,721,591,75,55,710,11,1340,619,222,488
42,"MUNICIPIUL BUCUREŞTI","ȘCOALA GIMNAZIALĂ ”URUGUAY”",106,"BUCUREŞTI SECTORUL 1",179141,1,PART,PRCNCT,PRSD,PRSD_SV_SECTOR,"2025-05-18 22:55:37",1184,657,535,73,49,648,9,900,243,290,358
42,"MUNICIPIUL BUCUREŞTI","ŞCOALA GIMNAZIALĂ ”URUGUAY”",107,"BUCUREŞTI SECTORUL 1",179141,1,PART,PRCNCT,PRSD,PRSD_SV_SECTOR,"2025-05-18 22:11:40",1208,875,656,158,61,860,15,1330,455,237,623
42,"MUNICIPIUL BUCUREŞTI","ŞCOALA GIMNAZIALĂ ”URUGUAY”",108,"BUCUREŞTI SECTORUL 1",179141,1,PART,PRCNCT,PRSD,PRSD_SV_SECTOR,"2025-05-18 22:20:25",1205,805,689,69,47,793,12,1330,525,225,568
42,"MUNICIPIUL BUCUREŞTI","ȘCOALA GIMNAZIALĂ ”URUGUAY”",109,"BUCUREŞTI SECTORUL 1",179141,1,PART,PRCNCT,PRSD,PRSD_SV_SECTOR,"2025-05-18 22:30:00",1212,658,556,57,45,652,6,1330,672,254,398
42,"MUNICIPIUL BUCUREŞTI","ŞCOALA GIMNAZIALĂ ”ALEXANDRU COSTESCU” NR.182",110,"BUCUREŞTI SECTORUL 1",179141,1,PART,PRCNCT,PRSD,PRSD_SV_SECTOR,"2025-05-18 21:57:55",1266,804,745,57,2,795,9,1390,586,237,558
42,"MUNICIPIUL BUCUREŞTI","ŞCOALA GIMNAZIALĂ ”ALEXANDRU COSTESCU” NR.182",111,"BUCUREŞTI SECTORUL 1",179141,1,PART,PRCNCT,PRSD,PRSD_SV_SECTOR,"2025-05-18 21:30:33",1374,823,776,47,0,812,11,1510,687,242,570
42,"MUNICIPIUL BUCUREŞTI","ŞCOALA GIMNAZIALĂ ”ALEXANDRU COSTESCU” NR.182",112,"BUCUREŞTI SECTORUL 1",179141,1,PART,PRCNCT,PRSD,PRSD_SV_SECTOR,"2025-05-18 22:01:51",1246,827,720,107,0,821,6,1370,543,226,595
42,"MUNICIPIUL BUCUREŞTI","ŞCOALA GIMNAZIALĂ ”ALEXANDRU COSTESCU” NR.182",113,"BUCUREŞTI SECTORUL 1",179141,1,PART,PRCNCT,PRSD,PRSD_SV_SECTOR,"2025-05-18 21:52:42",1410,885,799,85,1,872,13,1550,665,283,589
42,"MUNICIPIUL BUCUREŞTI","ȘCOALA GIMNAZIALĂ ”ALEXANDRU COSTESCU” NR.182",114,"BUCUREŞTI SECTORUL 1",179141,1,PART,PRCNCT,PRSD,PRSD_SV_SECTOR,"2025-05-18 21:52:14",1375,864,750,114,0,856,8,1510,646,331,525
42,"MUNICIPIUL BUCUREŞTI","ŞCOALA GIMNAZIALĂ ”SFINŢII VOIEVOZI”",115,"BUCUREŞTI SECTORUL 1",179141,1,PART,PRCNCT,PRSD,PRSD_SV_SECTOR,"2025-05-18 22:38:49",1095,851,524,288,39,839,12,1210,359,276,563
42,"MUNICIPIUL BUCUREŞTI","ŞCOALA GIMNAZIALĂ ”SFINŢII VOIEVOZI”",116,"BUCUREŞTI SECTORUL 1",179141,1,PART,PRCNCT,PRSD,PRSD_SV_SECTOR,"2025-05-18 22:10:20",1401,1017,704,310,3,998,19,1540,523,247,751
42,"MUNICIPIUL BUCUREŞTI","ŞCOALA GIMNAZIALĂ ”SFINŢII VOIEVOZI”",117,"BUCUREŞTI SECTORUL 1",179141,1,PART,PRCNCT,PRSD,PRSD_SV_SECTOR,"2025-05-18 21:48:00",1093,735,544,190,1,718,17,1200,465,220,498
42,"MUNICIPIUL BUCUREŞTI","ŞCOALA GIMNAZIALĂ ”SFINŢII VOIEVOZI”",118,"BUCUREŞTI SECTORUL 1",179141,2,PART,PRCNCT,PRSD,PRSD_SV_SECTOR,"2025-05-19 01:27:03",1324,883,698,107,78,866,17,1460,577,244,622
42,"MUNICIPIUL BUCUREŞTI","ȘCOALA GIMNAZIALĂ ”AVENOR”",119,"BUCUREŞTI SECTORUL 1",179141,1,PART,PRCNCT,PRSD,PRSD_SV_SECTOR,"2025-05-18 23:11:53",1562,1267,972,293,2,1265,2,1720,453,216,1049
42,"MUNICIPIUL BUCUREŞTI","ȘCOALA GIMNAZIALĂ ”AVENOR”",120,"BUCUREŞTI SECTORUL 1",179141,1,PART,PRCNCT,PRSD,PRSD_SV_SECTOR,"2025-05-19 00:03:07",1558,1223,936,286,1,1205,18,1720,497,156,1049
42,"MUNICIPIUL BUCUREŞTI","COLEGIUL NAŢIONAL ”ION NECULCE”",121,"BUCUREŞTI SECTORUL 1",179141,1,PART,PRCNCT,PRSD,PRSD_SV_SECTOR,"2025-05-18 22:03:31",1454,997,776,173,48,979,18,1600,603,215,764
42,"MUNICIPIUL BUCUREŞTI","COLEGIUL NAŢIONAL ”ION NECULCE”",122,"BUCUREŞTI SECTORUL 1",179141,1,PART,PRCNCT,PRSD,PRSD_SV_SECTOR,"2025-05-18 22:43:35",1406,935,751,134,50,921,14,1550,615,210,711
42,"MUNICIPIUL BUCUREŞTI","COLEGIUL NAŢIONAL ”ION NECULCE”",123,"BUCUREŞTI SECTORUL 1",179141,1,PART,PRCNCT,PRSD,PRSD_SV_SECTOR,"2025-05-18 22:13:32",1458,1040,825,165,50,1011,29,1600,560,243,768
42,"MUNICIPIUL BUCUREŞTI","COLEGIUL NAŢIONAL ”ION NECULCE”",124,"BUCUREŞTI SECTORUL 1",179141,1,PART,PRCNCT,PRSD,PRSD_SV_SECTOR,"2025-05-18 21:50:57",1434,992,829,98,65,976,16,1580,588,250,726
42,"MUNICIPIUL BUCUREŞTI","COLEGIUL NAŢIONAL ”ION NECULCE”",125,"BUCUREŞTI SECTORUL 1",179141,1,PART,PRCNCT,PRSD,PRSD_SV_SECTOR,"2025-05-18 22:31:46",1423,861,762,70,29,849,12,1560,699,254,595
42,"MUNICIPIUL BUCUREŞTI","ŞCOALA GIMNAZIALĂ ”GEO BOGZA”",126,"BUCUREŞTI SECTORUL 1",179141,1,PART,PRCNCT,PRSD,PRSD_SV_SECTOR,"2025-05-18 22:31:50",1005,678,553,123,2,669,9,1110,432,200,469
42,"MUNICIPIUL BUCUREŞTI","ŞCOALA GIMNAZIALĂ ”GEO BOGZA”",127,"BUCUREŞTI SECTORUL 1",179141,1,PART,PRCNCT,PRSD,PRSD_SV_SECTOR,"2025-05-18 22:38:45",1089,707,614,92,1,693,14,1200,493,178,515
42,"MUNICIPIUL BUCUREŞTI","ŞCOALA GIMNAZIALĂ ”GEO BOGZA”",128,"BUCUREŞTI SECTORUL 1",179141,1,PART,PRCNCT,PRSD,PRSD_SV_SECTOR,"2025-05-18 22:08:54",827,575,510,65,0,556,19,910,335,158,398
42,"MUNICIPIUL BUCUREŞTI","ŞCOALA GIMNAZIALĂ ”PETRE ISPIRESCU”",129,"BUCUREŞTI SECTORUL 1",179141,1,PART,PRCNCT,PRSD,PRSD_SV_SECTOR,"2025-05-18 22:21:51",1297,859,734,120,5,841,18,1430,571,177,664
42,"MUNICIPIUL BUCUREŞTI","ŞCOALA GIMNAZIALĂ ”PETRE ISPIRESCU”",130,"BUCUREŞTI SECTORUL 1",179141,2,PART,PRCNCT,PRSD,PRSD_SV_SECTOR,"2025-05-18 22:44:32",1343,838,775,58,5,834,4,1480,642,201,633
42,"MUNICIPIUL BUCUREŞTI","ŞCOALA GIMNAZIALĂ ”PETRE ISPIRESCU”",131,"BUCUREŞTI SECTORUL 1",179141,1,PART,PRCNCT,PRSD,PRSD_SV_SECTOR,"2025-05-18 22:03:43",1299,815,748,66,1,801,14,1430,615,204,597
42,"MUNICIPIUL BUCUREŞTI","ŞCOALA GIMNAZIALĂ ”PETRE ISPIRESCU”",132,"BUCUREŞTI SECTORUL 1",179141,1,PART,PRCNCT,PRSD,PRSD_SV_SECTOR,"2025-05-18 21:34:08",1029,701,650,51,0,693,8,1130,429,193,500
42,"MUNICIPIUL BUCUREŞTI","ŞCOALA GIMNAZIALĂ ”PETRE ISPIRESCU”",133,"BUCUREŞTI SECTORUL 1",179141,1,PART,PRCNCT,PRSD,PRSD_SV_SECTOR,"2025-05-18 22:11:43",1059,725,637,85,3,709,16,1160,435,216,493
42,"MUNICIPIUL BUCUREŞTI","ŞCOALA GIMNAZIALĂ ”SF.NICOLAE”",134,"BUCUREŞTI SECTORUL 1",179141,1,PART,PRCNCT,PRSD,PRSD_SV_SECTOR,"2025-05-18 22:07:07",1373,873,747,124,2,860,13,1500,627,214,646
42,"MUNICIPIUL BUCUREŞTI","ŞCOALA GIMNAZIALĂ ”SF.NICOLAE”",135,"BUCUREŞTI SECTORUL 1",179141,1,PART,PRCNCT,PRSD,PRSD_SV_SECTOR,"2025-05-18 22:09:08",1210,772,637,134,1,762,10,1330,558,176,586
42,"MUNICIPIUL BUCUREŞTI","COLEGIUL NAŢIONAL ”AUREL VLAICU”",136,"BUCUREŞTI SECTORUL 1",179141,1,PART,PRCNCT,PRSD,PRSD_SV_SECTOR,"2025-05-18 22:27:36",1276,911,824,85,2,905,6,1400,489,205,700
42,"MUNICIPIUL BUCUREŞTI","COLEGIUL NAŢIONAL ”AUREL VLAICU”",137,"BUCUREŞTI SECTORUL 1",179141,1,PART,PRCNCT,PRSD,PRSD_SV_SECTOR,"2025-05-18 22:51:03",1267,893,775,114,4,884,9,1390,497,214,670
42,"MUNICIPIUL BUCUREŞTI","COLEGIUL NAŢIONAL ”AUREL VLAICU”",138,"BUCUREŞTI SECTORUL 1",179141,1,PART,PRCNCT,PRSD,PRSD_SV_SECTOR,"2025-05-18 21:58:21",1218,802,674,126,2,790,12,1340,538,196,594
42,"MUNICIPIUL BUCUREŞTI","COLEGIUL TEHNIC ” VALTER MĂRĂCINEANU”",139,"BUCUREŞTI SECTORUL 1",179141,1,PART,PRCNCT,PRSD,PRSD_SV_SECTOR,"2025-05-18 22:37:41",1081,672,548,123,1,662,10,1190,518,218,444
42,"MUNICIPIUL BUCUREŞTI","COLEGIUL TEHNIC ” VALTER MĂRĂCINEANU”",140,"BUCUREŞTI SECTORUL 1",179141,1,PART,PRCNCT,PRSD,PRSD_SV_SECTOR,"2025-05-18 22:18:42",1368,864,750,112,2,849,15,1510,646,293,556
42,"MUNICIPIUL BUCUREŞTI","COLEGIUL TEHNIC ” VALTER MĂRĂCINEANU”",141,"BUCUREŞTI SECTORUL 1",179141,1,PART,PRCNCT,PRSD,PRSD_SV_SECTOR,"2025-05-18 22:22:29",1154,686,614,57,15,676,10,1270,584,201,475
42,"MUNICIPIUL BUCUREŞTI","COLEGIUL TEHNIC FEROVIAR ”MIHAI I”",142,"BUCUREŞTI SECTORUL 1",179141,1,PART,PRCNCT,PRSD,PRSD_SV_SECTOR,"2025-05-18 22:00:05",1183,739,651,88,0,727,12,1300,561,364,363
42,"MUNICIPIUL BUCUREŞTI","COLEGIUL TEHNIC FEROVIAR ”MIHAI I”",143,"BUCUREŞTI SECTORUL 1",179141,1,PART,PRCNCT,PRSD,PRSD_SV_SECTOR,"2025-05-18 22:00:07",1125,605,548,57,0,593,12,840,235,232,361
42,"MUNICIPIUL BUCUREŞTI","ŞCOALA GIMNAZIALĂ NR.162",144,"BUCUREŞTI SECTORUL 1",179141,1,PART,PRCNCT,PRSD,PRSD_SV_SECTOR,"2025-05-18 21:47:02",1388,888,755,132,1,878,10,1530,642,359,519
42,"MUNICIPIUL BUCUREŞTI","ŞCOALA GIMNAZIALĂ NR.162",145,"BUCUREŞTI SECTORUL 1",179141,2,PART,PRCNCT,PRSD,PRSD_SV_SECTOR,"2025-05-18 23:17:53",1398,759,705,54,0,740,19,1140,381,345,395
42,"MUNICIPIUL BUCUREŞTI","ŞCOALA GIMNAZIALĂ NR.183",146,"BUCUREŞTI SECTORUL 1",179141,1,PART,PRCNCT,PRSD,PRSD_SV_SECTOR,"2025-05-18 22:23:07",1380,756,655,101,0,740,16,1520,764,326,414
42,"MUNICIPIUL BUCUREŞTI","ŞCOALA GIMNAZIALĂ NR.183",147,"BUCUREŞTI SECTORUL 1",179141,1,PART,PRCNCT,PRSD,PRSD_SV_SECTOR,"2025-05-18 22:02:33",1387,752,704,48,0,739,13,1520,768,343,396
42,"MUNICIPIUL BUCUREŞTI","ŞCOALA GIMNAZIALĂ NR.183",148,"BUCUREŞTI SECTORUL 1",179141,1,PART,PRCNCT,PRSD,PRSD_SV_SECTOR,"2025-05-18 22:10:09",1535,940,885,53,2,931,9,1690,750,301,630
42,"MUNICIPIUL BUCUREŞTI","ŞCOALA GIMNAZIALĂ NR.183",149,"BUCUREŞTI SECTORUL 1",179141,1,PART,PRCNCT,PRSD,PRSD_SV_SECTOR,"2025-05-18 22:55:14",1542,994,914,80,0,978,16,1700,706,319,659
42,"MUNICIPIUL BUCUREŞTI","ȘCOALA GIMNAZIALĂ NR.183",150,"BUCUREŞTI SECTORUL 1",179141,1,PART,PRCNCT,PRSD,PRSD_SV_SECTOR,"2025-05-18 22:33:01",1499,876,825,45,6,865,11,1650,774,321,544
42,"MUNICIPIUL BUCUREŞTI","GRĂDINIȚA NR. 46",151,"BUCUREŞTI SECTORUL 1",179141,1,PART,PRCNCT,PRSD,PRSD_SV_SECTOR,"2025-05-18 22:10:20",1320,718,653,64,1,704,14,1458,740,379,325
42,"MUNICIPIUL BUCUREŞTI","GRĂDINIȚA NR. 46",152,"BUCUREŞTI SECTORUL 1",179141,1,PART,PRCNCT,PRSD,PRSD_SV_SECTOR,"2025-05-18 22:03:31",1204,709,656,52,1,690,19,1320,611,341,349
42,"MUNICIPIUL BUCUREŞTI","ŞCOALA GIMNAZIALĂ NR.153",153,"BUCUREŞTI SECTORUL 1",179141,1,PART,PRCNCT,PRSD,PRSD_SV_SECTOR,"2025-05-18 22:35:40",1465,678,638,40,0,663,15,1210,532,423,240
42,"MUNICIPIUL BUCUREŞTI","ŞCOALA GIMNAZIALĂ NR.184",154,"BUCUREŞTI SECTORUL 1",179141,1,PART,PRCNCT,PRSD,PRSD_SV_SECTOR,"2025-05-18 22:12:02",1589,998,884,114,0,984,14,1750,752,359,625
42,"MUNICIPIUL BUCUREŞTI","ŞCOALA GIMNAZIALĂ NR.184",155,"BUCUREŞTI SECTORUL 1",179141,1,PART,PRCNCT,PRSD,PRSD_SV_SECTOR,"2025-05-18 22:14:58",1632,942,864,78,0,933,9,1790,848,426,507
42,"MUNICIPIUL BUCUREŞTI","ŞCOALA GIMNAZIALĂ NR.184",156,"BUCUREŞTI SECTORUL 1",179141,2,PART,PRCNCT,PRSD,PRSD_SV_SECTOR,"2025-05-19 01:01:50",1595,883,805,75,3,871,12,1349,466,394,477
42,"MUNICIPIUL BUCUREŞTI","ŞCOALA GIMNAZIALĂ NR.184",157,"BUCUREŞTI SECTORUL 1",179141,1,PART,PRCNCT,PRSD,PRSD_SV_SECTOR,"2025-05-18 22:50:06",1524,862,823,39,0,853,9,1680,818,418,435
42,"MUNICIPIUL BUCUREŞTI","ȘCOALA GIMNAZIALĂ NR.184",158,"BUCUREŞTI SECTORUL 1",179141,1,PART,PRCNCT,PRSD,PRSD_SV_SECTOR,"2025-05-18 22:31:33",1601,991,949,42,0,975,16,1760,769,340,635
42,"MUNICIPIUL BUCUREŞTI","ŞCOALA GIMNAZIALĂ NR.181",159,"BUCUREŞTI SECTORUL 1",179141,1,PART,PRCNCT,PRSD,PRSD_SV_SECTOR,"2025-05-18 22:13:08",1162,781,699,82,0,768,13,1280,499,336,432
42,"MUNICIPIUL BUCUREŞTI","ŞCOALA GIMNAZIALĂ NR.181",160,"BUCUREŞTI SECTORUL 1",179141,1,PART,PRCNCT,PRSD,PRSD_SV_SECTOR,"2025-05-18 22:14:19",1207,726,647,78,1,716,10,1330,604,297,419
42,"MUNICIPIUL BUCUREŞTI","ŞCOALA GIMNAZIALĂ NR.181",161,"BUCUREŞTI SECTORUL 1",179141,1,PART,PRCNCT,PRSD,PRSD_SV_SECTOR,"2025-05-18 21:58:17",1290,825,769,56,0,806,19,1420,595,290,516
42,"MUNICIPIUL BUCUREŞTI","ŞCOALA GIMNAZIALĂ NR.181",162,"BUCUREŞTI SECTORUL 1",179141,1,PART,PRCNCT,PRSD,PRSD_SV_SECTOR,"2025-05-18 22:19:57",1148,703,667,36,0,695,8,1260,557,273,422
42,"MUNICIPIUL BUCUREŞTI","SCOALA GIMNAZIALĂ NR. 192",163,"BUCUREŞTI SECTORUL 1",179141,1,PART,PRCNCT,PRSD,PRSD_SV_SECTOR,"2025-05-18 22:48:35",1549,1100,877,223,0,1086,14,1700,600,332,754
42,"MUNICIPIUL BUCUREŞTI","ȘCOALA GIMNAZIALĂ NR.192",164,"BUCUREŞTI SECTORUL 1",179141,1,PART,PRCNCT,PRSD,PRSD_SV_SECTOR,"2025-05-18 22:48:23",1620,1148,924,212,12,1136,12,1780,632,282,854
42,"MUNICIPIUL BUCUREŞTI","ŞCOALA GIMNAZIALĂ NR.192",165,"BUCUREŞTI SECTORUL 1",179141,1,PART,PRCNCT,PRSD,PRSD_SV_SECTOR,"2025-05-18 22:54:14",1542,990,828,162,0,973,17,1700,710,304,669
42,"MUNICIPIUL BUCUREŞTI","ACADEMIA DE POLIȚIE ”ALEXANDRU IOAN CUZA”",166,"BUCUREŞTI SECTORUL 1",179141,1,PART,PRCNCT,PRSD,PRSD_SV_SECTOR,"2025-05-18 23:27:05",1099,1345,574,771,0,1328,17,1610,265,236,1092
42,"MUNICIPIUL BUCUREŞTI","ŞCOALA GIMNAZIALĂ NR. 28",167,"BUCUREŞTI SECTORUL 2",179150,1,PART,PRCNCT,PRSD,PRSD_SV_SECTOR,"2025-05-18 22:09:50",2518,1126,846,220,60,1106,20,2600,1474,285,821
42,"MUNICIPIUL BUCUREŞTI","ŞCOALA GIMNAZIALĂ NR. 28",168,"BUCUREŞTI SECTORUL 2",179150,1,PART,PRCNCT,PRSD,PRSD_SV_SECTOR,"2025-05-18 22:44:44",1098,928,596,289,43,920,8,1200,272,196,724
42,"MUNICIPIUL BUCUREŞTI","ŞCOALA GIMNAZIALĂ NR. 28",169,"BUCUREŞTI SECTORUL 2",179150,1,PART,PRCNCT,PRSD,PRSD_SV_SECTOR,"2025-05-18 22:54:49",1361,1128,745,304,79,1117,11,1408,280,253,864
42,"MUNICIPIUL BUCUREŞTI","ŞCOALA GIMNAZIALĂ ”MARIA ROSETTI”",170,"BUCUREŞTI SECTORUL 2",179150,1,PART,PRCNCT,PRSD,PRSD_SV_SECTOR,"2025-05-18 23:19:21",1688,1199,1005,193,1,1180,19,1800,601,219,961
42,"MUNICIPIUL BUCUREŞTI","ŞCOALA GIMNAZIALĂ ”MARIA ROSETTI”",171,"BUCUREŞTI SECTORUL 2",179150,1,PART,PRCNCT,PRSD,PRSD_SV_SECTOR,"2025-05-18 22:11:05",866,747,510,237,0,738,9,1000,253,142,596
42,"MUNICIPIUL BUCUREŞTI","ŞCOALA GIMNAZIALĂ ”MARIA ROSETTI”",172,"BUCUREŞTI SECTORUL 2",179150,1,PART,PRCNCT,PRSD,PRSD_SV_SECTOR,"2025-05-18 21:58:03",874,646,457,187,2,638,8,1000,354,126,512
42,"MUNICIPIUL BUCUREŞTI","LICEUL TEORETIC ”C.A. ROSETTI ”",173,"BUCUREŞTI SECTORUL 2",179150,1,PART,PRCNCT,PRSD,PRSD_SV_SECTOR,"2025-05-18 22:57:37",937,748,510,237,1,742,6,1000,252,164,578
42,"MUNICIPIUL BUCUREŞTI","LICEUL TEORETIC ”C.A. ROSETTI ”",174,"BUCUREŞTI SECTORUL 2",179150,1,PART,PRCNCT,PRSD,PRSD_SV_SECTOR,"2025-05-18 22:47:22",1840,1160,1034,121,5,1145,15,2000,840,261,884
42,"MUNICIPIUL BUCUREŞTI","LICEUL TEORETIC ”C.A. ROSETTI ”",175,"BUCUREŞTI SECTORUL 2",179150,1,PART,PRCNCT,PRSD,PRSD_SV_SECTOR,"2025-05-18 22:05:24",1479,950,802,146,2,936,14,1600,650,236,700
42,"MUNICIPIUL BUCUREŞTI","LICEUL TEORETIC ”TRAIAN”",176,"BUCUREŞTI SECTORUL 2",179150,1,PART,PRCNCT,PRSD,PRSD_SV_SECTOR,"2025-05-18 22:32:45",1790,1192,1004,188,0,1176,16,2000,808,286,890
42,"MUNICIPIUL BUCUREŞTI","LICEUL TEORETIC ”TRAIAN”",177,"BUCUREŞTI SECTORUL 2",179150,2,PART,PRCNCT,PRSD,PRSD_SV_SECTOR,"2025-05-19 01:27:38",1706,1080,970,110,0,1063,16,1800,720,270,793
42,"MUNICIPIUL BUCUREŞTI","LICEUL TEORETIC ”TRAIAN”",178,"BUCUREŞTI SECTORUL 2",179150,1,PART,PRCNCT,PRSD,PRSD_SV_SECTOR,"2025-05-18 21:47:50",1764,1153,977,176,0,1135,18,1800,647,370,765
42,"MUNICIPIUL BUCUREŞTI","LICEUL TEORETIC ”TRAIAN”",179,"BUCUREŞTI SECTORUL 2",179150,1,PART,PRCNCT,PRSD,PRSD_SV_SECTOR,"2025-05-18 22:09:51",1759,1084,1021,63,0,1070,14,2000,916,250,820
42,"MUNICIPIUL BUCUREŞTI","ŞCOALA GIMNAZIALĂ NR. 31",180,"BUCUREŞTI SECTORUL 2",179150,1,PART,PRCNCT,PRSD,PRSD_SV_SECTOR,"2025-05-18 23:00:32",1354,1169,734,435,0,1157,12,1600,431,350,807
42,"MUNICIPIUL BUCUREŞTI","ŞCOALA GIMNAZIALĂ NR. 31",181,"BUCUREŞTI SECTORUL 2",179150,1,PART,PRCNCT,PRSD,PRSD_SV_SECTOR,"2025-05-18 22:21:55",1942,1166,1054,111,1,1152,14,2000,834,313,839
42,"MUNICIPIUL BUCUREŞTI","ŞCOALA GIMNAZIALĂ NR. 31",182,"BUCUREŞTI SECTORUL 2",179150,1,PART,PRCNCT,PRSD,PRSD_SV_SECTOR,"2025-05-18 22:54:00",1617,1067,864,201,2,1051,16,1776,709,301,750
42,"MUNICIPIUL BUCUREŞTI","ŞCOALA GIMNAZIALĂ NR. 31",183,"BUCUREŞTI SECTORUL 2",179150,1,PART,PRCNCT,PRSD,PRSD_SV_SECTOR,"2025-05-18 22:34:41",1544,949,848,100,1,936,13,1600,651,243,693
42,"MUNICIPIUL BUCUREŞTI","ŞCOALA GIMNAZIALĂ NR. 31",184,"BUCUREŞTI SECTORUL 2",179150,1,PART,PRCNCT,PRSD,PRSD_SV_SECTOR,"2025-05-18 22:12:59",1765,1207,904,301,2,1197,10,1800,593,267,930
42,"MUNICIPIUL BUCUREŞTI","UNIVERSITATEA TEHNICĂ DE CONSTRUCŢII BUCUREŞTI",185,"BUCUREŞTI SECTORUL 2",179150,1,PART,PRCNCT,PRSD,PRSD_SV_SECTOR,"2025-05-18 22:10:49",1610,1035,875,134,26,1029,6,1800,765,251,778
42,"MUNICIPIUL BUCUREŞTI","UNIVERSITATEA TEHNICĂ DE CONSTRUCŢII BUCUREŞTI",186,"BUCUREŞTI SECTORUL 2",179150,1,PART,PRCNCT,PRSD,PRSD_SV_SECTOR,"2025-05-18 22:33:56",1552,890,793,97,0,874,16,1800,910,307,567
42,"MUNICIPIUL BUCUREŞTI","UNIVERSITATEA TEHNICĂ DE CONSTRUCŢII BUCUREŞTI",187,"BUCUREŞTI SECTORUL 2",179150,1,PART,PRCNCT,PRSD,PRSD_SV_SECTOR,"2025-05-18 22:38:07",1616,928,768,158,2,914,14,1800,872,235,679
42,"MUNICIPIUL BUCUREŞTI","UNIVERSITATEA TEHNICĂ DE CONSTRUCŢII BUCUREŞTI",188,"BUCUREŞTI SECTORUL 2",179150,1,PART,PRCNCT,PRSD,PRSD_SV_SECTOR,"2025-05-18 22:11:52",1528,959,817,140,2,935,23,1600,641,263,672
42,"MUNICIPIUL BUCUREŞTI","UNIVERSITATEA TEHNICĂ DE CONSTRUCŢII BUCUREŞTI",189,"BUCUREŞTI SECTORUL 2",179150,1,PART,PRCNCT,PRSD,PRSD_SV_SECTOR,"2025-05-18 22:17:26",1621,1091,903,188,0,1077,14,1800,709,293,784
42,"MUNICIPIUL BUCUREŞTI","UNIVERSITATEA TEHNICĂ DE CONSTRUCŢII BUCUREŞTI",190,"BUCUREŞTI SECTORUL 2",179150,1,PART,PRCNCT,PRSD,PRSD_SV_SECTOR,"2025-05-18 21:58:51",1748,984,930,54,0,965,19,2000,1016,336,629
42,"MUNICIPIUL BUCUREŞTI","UNIVERSITATEA TEHNICĂ DE CONSTRUCŢII BUCUREŞTI",191,"BUCUREŞTI SECTORUL 2",179150,1,PART,PRCNCT,PRSD,PRSD_SV_SECTOR,"2025-05-18 22:40:15",1403,933,718,213,2,922,11,1600,667,256,666
42,"MUNICIPIUL BUCUREŞTI","UNIVERSITATEA TEHNICĂ DE CONSTRUCŢII BUCUREŞTI",192,"BUCUREŞTI SECTORUL 2",179150,1,PART,PRCNCT,PRSD,PRSD_SV_SECTOR,"2025-05-18 21:36:18",1217,636,537,99,0,626,10,1600,964,274,352
42,"MUNICIPIUL BUCUREŞTI","UNIVERSITATEA TEHNICĂ DE CONSTRUCŢII BUCUREŞTI",193,"BUCUREŞTI SECTORUL 2",179150,1,PART,PRCNCT,PRSD,PRSD_SV_SECTOR,"2025-05-18 22:06:05",1544,983,879,102,2,971,12,1800,817,222,749
42,"MUNICIPIUL BUCUREŞTI","UNIVERSITATEA TEHNICĂ DE CONSTRUCŢII BUCUREŞTI",194,"BUCUREŞTI SECTORUL 2",179150,1,PART,PRCNCT,PRSD,PRSD_SV_SECTOR,"2025-05-18 21:55:56",1571,906,759,146,1,901,5,1800,894,324,577
42,"MUNICIPIUL BUCUREŞTI","LICEUL TEHNOLOGIC CONSTANTIN BRÂNCUŞI",195,"BUCUREŞTI SECTORUL 2",179150,1,PART,PRCNCT,PRSD,PRSD_SV_SECTOR,"2025-05-18 23:33:12",2332,2390,1236,1140,14,2375,15,2400,10,428,1947
42,"MUNICIPIUL BUCUREŞTI","ŞCOALA GIMNAZIALĂ NR. 27",196,"BUCUREŞTI SECTORUL 2",179150,1,PART,PRCNCT,PRSD,PRSD_SV_SECTOR,"2025-05-18 21:44:55",1361,821,694,125,2,801,20,1600,779,214,587
42,"MUNICIPIUL BUCUREŞTI","ŞCOALA GIMNAZIALĂ NR. 27",197,"BUCUREŞTI SECTORUL 2",179150,1,PART,PRCNCT,PRSD,PRSD_SV_SECTOR,"2025-05-18 22:11:05",1464,952,791,159,2,936,16,1600,648,253,683
42,"MUNICIPIUL BUCUREŞTI","ŞCOALA GIMNAZIALĂ NR. 27",198,"BUCUREŞTI SECTORUL 2",179150,1,PART,PRCNCT,PRSD,PRSD_SV_SECTOR,"2025-05-18 21:47:08",1153,760,604,155,1,747,13,1200,440,169,578
42,"MUNICIPIUL BUCUREŞTI","ŞCOALA GIMNAZIALĂ NR. 27",199,"BUCUREŞTI SECTORUL 2",179150,3,PART,PRCNCT,PRSD,PRSD_SV_SECTOR,"2025-05-19 02:25:43",1257,1061,692,369,0,1043,18,1399,338,292,751
42,"MUNICIPIUL BUCUREŞTI","ŞCOALA GIMNAZIALĂ NR. 27",200,"BUCUREŞTI SECTORUL 2",179150,1,PART,PRCNCT,PRSD,PRSD_SV_SECTOR,"2025-05-18 22:13:01",984,665,559,105,1,659,6,1200,535,167,492
42,"MUNICIPIUL BUCUREŞTI","ŞCOALA GIMNAZIALĂ ”GRIGORE GHICA VOIEVOD”",201,"BUCUREŞTI SECTORUL 2",179150,1,PART,PRCNCT,PRSD,PRSD_SV_SECTOR,"2025-05-18 22:29:24",1625,1182,896,284,2,1180,2,1800,618,317,863
42,"MUNICIPIUL BUCUREŞTI","ŞCOALA GIMNAZIALĂ ”GRIGORE GHICA VOIEVOD”",202,"BUCUREŞTI SECTORUL 2",179150,1,PART,PRCNCT,PRSD,PRSD_SV_SECTOR,"2025-05-18 22:45:41",1433,957,817,139,1,950,7,1600,643,232,718
42,"MUNICIPIUL BUCUREŞTI","ŞCOALA GIMNAZIALĂ ”GRIGORE GHICA VOIEVOD”",203,"BUCUREŞTI SECTORUL 2",179150,1,PART,PRCNCT,PRSD,PRSD_SV_SECTOR,"2025-05-18 22:25:59",1791,1023,926,96,1,1012,11,2000,977,326,686
42,"MUNICIPIUL BUCUREŞTI","ŞCOALA GIMNAZIALĂ ”GRIGORE GHICA VOIEVOD”",204,"BUCUREŞTI SECTORUL 2",179150,1,PART,PRCNCT,PRSD,PRSD_SV_SECTOR,"2025-05-18 22:22:50",1659,935,865,69,1,910,25,1800,865,335,575
42,"MUNICIPIUL BUCUREŞTI","ŞCOALA GIMNAZIALĂ ”GRIGORE GHICA VOIEVOD”",205,"BUCUREŞTI SECTORUL 2",179150,2,PART,PRCNCT,PRSD,PRSD_SV_SECTOR,"2025-05-18 23:57:58",1544,886,827,58,1,866,20,1600,714,230,636
42,"MUNICIPIUL BUCUREŞTI","ŞCOALA GIMNAZIALĂ ”GRIGORE GHICA VOIEVOD”",206,"BUCUREŞTI SECTORUL 2",179150,1,PART,PRCNCT,PRSD,PRSD_SV_SECTOR,"2025-05-18 22:07:16",1332,730,679,51,0,714,16,1400,670,232,482
42,"MUNICIPIUL BUCUREŞTI","ŞCOALA GIMNAZIALĂ ”GRIGORE GHICA VOIEVOD”",207,"BUCUREŞTI SECTORUL 2",179150,1,PART,PRCNCT,PRSD,PRSD_SV_SECTOR,"2025-05-18 22:43:12",1532,774,714,60,0,760,14,1600,826,329,431
42,"MUNICIPIUL BUCUREŞTI","GRĂDINIŢA NR. 233",208,"BUCUREŞTI SECTORUL 2",179150,1,PART,PRCNCT,PRSD,PRSD_SV_SECTOR,"2025-05-18 22:11:22",1317,805,690,115,0,791,14,1400,595,225,566
42,"MUNICIPIUL BUCUREŞTI","GRĂDINIŢA NR. 233",209,"BUCUREŞTI SECTORUL 2",179150,1,PART,PRCNCT,PRSD,PRSD_SV_SECTOR,"2025-05-18 21:51:47",1194,773,669,101,3,762,11,1400,627,183,579
42,"MUNICIPIUL BUCUREŞTI","ŞCOALA GIMNAZIALĂ NR. 39",210,"BUCUREŞTI SECTORUL 2",179150,1,PART,PRCNCT,PRSD,PRSD_SV_SECTOR,"2025-05-18 23:05:52",1627,1131,922,206,3,1107,24,1800,669,345,762
42,"MUNICIPIUL BUCUREŞTI","ŞCOALA GIMNAZIALĂ NR. 39",211,"BUCUREŞTI SECTORUL 2",179150,1,PART,PRCNCT,PRSD,PRSD_SV_SECTOR,"2025-05-18 22:09:49",1321,829,684,145,0,812,17,1401,572,248,564
42,"MUNICIPIUL BUCUREŞTI","ŞCOALA GIMNAZIALĂ NR. 39",212,"BUCUREŞTI SECTORUL 2",179150,1,PART,PRCNCT,PRSD,PRSD_SV_SECTOR,"2025-05-18 22:24:17",1577,926,796,115,15,919,7,1800,874,370,549
42,"MUNICIPIUL BUCUREŞTI","ŞCOALA GIMNAZIALĂ NR. 39",213,"BUCUREŞTI SECTORUL 2",179150,1,PART,PRCNCT,PRSD,PRSD_SV_SECTOR,"2025-05-18 22:27:23",1424,882,751,130,1,870,12,1600,718,320,550
42,"MUNICIPIUL BUCUREŞTI","ŞCOALA GIMNAZIALĂ NR. 39",214,"BUCUREŞTI SECTORUL 2",179150,1,PART,PRCNCT,PRSD,PRSD_SV_SECTOR,"2025-05-18 21:28:11",1525,926,842,84,0,910,16,1600,674,280,630
42,"MUNICIPIUL BUCUREŞTI","ŞCOALA GIMNAZIALĂ NR. 39",215,"BUCUREŞTI SECTORUL 2",179150,1,PART,PRCNCT,PRSD,PRSD_SV_SECTOR,"2025-05-18 22:00:57",1687,924,842,79,3,909,15,1800,876,281,628
42,"MUNICIPIUL BUCUREŞTI","ŞCOALA GIMNAZIALĂ NR. 39",216,"BUCUREŞTI SECTORUL 2",179150,1,PART,PRCNCT,PRSD,PRSD_SV_SECTOR,"2025-05-18 22:37:39",1495,814,749,64,1,801,13,1600,786,260,541
42,"MUNICIPIUL BUCUREŞTI","ŞCOALA GIMNAZIALĂ NR. 40",217,"BUCUREŞTI SECTORUL 2",179150,1,PART,PRCNCT,PRSD,PRSD_SV_SECTOR,"2025-05-18 22:46:17",1710,1006,934,70,2,990,16,1400,394,481,509
42,"MUNICIPIUL BUCUREŞTI","ŞCOALA GIMNAZIALĂ NR. 40",218,"BUCUREŞTI SECTORUL 2",179150,1,PART,PRCNCT,PRSD,PRSD_SV_SECTOR,"2025-05-18 21:45:09",1640,1033,934,99,0,1017,16,1800,767,464,553
42,"MUNICIPIUL BUCUREŞTI","ŞCOALA GIMNAZIALĂ NR. 40",219,"BUCUREŞTI SECTORUL 2",179150,1,PART,PRCNCT,PRSD,PRSD_SV_SECTOR,"2025-05-18 21:41:17",1646,1044,982,62,0,1025,19,1800,756,439,586
42,"MUNICIPIUL BUCUREŞTI","ŞCOALA GIMNAZIALĂ NR. 40",220,"BUCUREŞTI SECTORUL 2",179150,1,PART,PRCNCT,PRSD,PRSD_SV_SECTOR,"2025-05-18 21:37:19",1560,925,873,52,0,909,16,1800,875,391,518
42,"MUNICIPIUL BUCUREŞTI","ŞCOALA GIMNAZIALĂ NR. 40",221,"BUCUREŞTI SECTORUL 2",179150,1,PART,PRCNCT,PRSD,PRSD_SV_SECTOR,"2025-05-18 21:49:39",1925,1129,1087,42,0,1119,10,2000,871,490,629
42,"MUNICIPIUL BUCUREŞTI","ŞCOALA GIMNAZIALĂ NR. 40",222,"BUCUREŞTI SECTORUL 2",179150,1,PART,PRCNCT,PRSD,PRSD_SV_SECTOR,"2025-05-18 21:44:37",1826,1025,982,43,0,1008,17,2000,975,479,529
42,"MUNICIPIUL BUCUREŞTI","ŞCOALA GIMNAZIALĂ NR. 41",223,"BUCUREŞTI SECTORUL 2",179150,1,PART,PRCNCT,PRSD,PRSD_SV_SECTOR,"2025-05-18 22:04:17",1700,995,904,87,4,977,18,1800,805,449,528
42,"MUNICIPIUL BUCUREŞTI","ŞCOALA GIMNAZIALĂ NR. 41",224,"BUCUREŞTI SECTORUL 2",179150,1,PART,PRCNCT,PRSD,PRSD_SV_SECTOR,"2025-05-18 21:58:01",1838,1065,998,67,0,1056,9,2000,935,552,504
42,"MUNICIPIUL BUCUREŞTI","ŞCOALA GIMNAZIALĂ NR. 41",225,"BUCUREŞTI SECTORUL 2",179150,2,PART,PRCNCT,PRSD,PRSD_SV_SECTOR,"2025-05-19 02:35:04",1850,1159,1085,72,2,1148,11,2000,841,526,622
42,"MUNICIPIUL BUCUREŞTI","ŞCOALA GIMNAZIALĂ NR. 32",226,"BUCUREŞTI SECTORUL 2",179150,1,PART,PRCNCT,PRSD,PRSD_SV_SECTOR,"2025-05-18 21:53:44",1668,1170,948,157,65,1155,15,1797,627,513,642
42,"MUNICIPIUL BUCUREŞTI","ŞCOALA GIMNAZIALĂ NR. 32",227,"BUCUREŞTI SECTORUL 2",179150,1,PART,PRCNCT,PRSD,PRSD_SV_SECTOR,"2025-05-18 21:28:51",1676,1062,950,43,69,1039,23,1800,738,410,629
42,"MUNICIPIUL BUCUREŞTI","ŞCOALA GIMNAZIALĂ NR. 32",228,"BUCUREŞTI SECTORUL 2",179150,1,PART,PRCNCT,PRSD,PRSD_SV_SECTOR,"2025-05-18 21:58:21",1701,1042,919,51,72,1031,11,1800,758,440,591
42,"MUNICIPIUL BUCUREŞTI","ŞCOALA GIMNAZIALĂ NR. 32",229,"BUCUREŞTI SECTORUL 2",179150,1,PART,PRCNCT,PRSD,PRSD_SV_SECTOR,"2025-05-18 21:56:37",2009,1124,982,81,61,1106,18,2200,1076,394,712
42,"MUNICIPIUL BUCUREŞTI","ŞCOALA GIMNAZIALĂ NR. 32",230,"BUCUREŞTI SECTORUL 2",179150,1,PART,PRCNCT,PRSD,PRSD_SV_SECTOR,"2025-05-18 21:36:19",1197,784,660,61,63,776,8,1400,616,302,474
42,"MUNICIPIUL BUCUREŞTI","COLEGIUL NAŢIONAL ”VICTOR BABEŞ”",231,"BUCUREŞTI SECTORUL 2",179150,1,PART,PRCNCT,PRSD,PRSD_SV_SECTOR,"2025-05-18 21:33:02",1729,1204,851,259,94,1192,12,2000,796,393,799
42,"MUNICIPIUL BUCUREŞTI","COLEGIUL NAŢIONAL ”VICTOR BABEŞ”",232,"BUCUREŞTI SECTORUL 2",179150,1,PART,PRCNCT,PRSD,PRSD_SV_SECTOR,"2025-05-18 22:10:11",1629,1007,833,123,51,991,16,1800,793,304,687
42,"MUNICIPIUL BUCUREŞTI","COLEGIUL NAŢIONAL ”VICTOR BABEŞ”",233,"BUCUREŞTI SECTORUL 2",179150,1,PART,PRCNCT,PRSD,PRSD_SV_SECTOR,"2025-05-18 22:09:08",1958,1193,1086,59,48,1174,19,2000,807,412,762
42,"MUNICIPIUL BUCUREŞTI","COLEGIUL NAŢIONAL ”VICTOR BABEŞ”",234,"BUCUREŞTI SECTORUL 2",179150,1,PART,PRCNCT,PRSD,PRSD_SV_SECTOR,"2025-05-18 21:52:45",2106,1152,1054,49,49,1143,9,2200,1048,415,728
42,"MUNICIPIUL BUCUREŞTI","ŞCOALA GIMNAZIALĂ NR. 25 ( FOSTA GRĂDINITĂ NR. 11)",235,"BUCUREŞTI SECTORUL 2",179150,1,PART,PRCNCT,PRSD,PRSD_SV_SECTOR,"2025-05-18 22:13:12",1612,861,783,78,0,844,17,1797,936,322,522
42,"MUNICIPIUL BUCUREŞTI","ŞCOALA GIMNAZIALĂ NR. 25 ( FOSTA GRĂDINITĂ NR. 11)",236,"BUCUREŞTI SECTORUL 2",179150,1,PART,PRCNCT,PRSD,PRSD_SV_SECTOR,"2025-05-18 21:48:12",1543,863,768,95,0,846,17,1600,737,359,487
42,"MUNICIPIUL BUCUREŞTI","ŞCOALA GIMNAZIALĂ NR. 145",237,"BUCUREŞTI SECTORUL 2",179150,1,PART,PRCNCT,PRSD,PRSD_SV_SECTOR,"2025-05-18 22:21:31",2123,1266,1034,232,0,1250,16,2400,1134,473,777
42,"MUNICIPIUL BUCUREŞTI","ŞCOALA GIMNAZIALĂ NR. 145",238,"BUCUREŞTI SECTORUL 2",179150,1,PART,PRCNCT,PRSD,PRSD_SV_SECTOR,"2025-05-18 22:09:52",1495,950,770,180,0,938,12,1600,650,323,615
42,"MUNICIPIUL BUCUREŞTI","ŞCOALA GIMNAZIALĂ NR. 145",239,"BUCUREŞTI SECTORUL 2",179150,3,PART,PRCNCT,PRSD,PRSD_SV_SECTOR,"2025-05-19 02:33:01",1604,826,782,43,1,808,18,1800,974,348,460
42,"MUNICIPIUL BUCUREŞTI","ŞCOALA GIMNAZIALĂ NR. 145",240,"BUCUREŞTI SECTORUL 2",179150,1,PART,PRCNCT,PRSD,PRSD_SV_SECTOR,"2025-05-18 21:42:25",1668,772,710,62,0,763,9,1800,1028,378,385
42,"MUNICIPIUL BUCUREŞTI","ŞCOALA GIMNAZIALĂ NR. 145",241,"BUCUREŞTI SECTORUL 2",179150,1,PART,PRCNCT,PRSD,PRSD_SV_SECTOR,"2025-05-18 21:49:51",1513,816,785,31,0,808,8,1600,784,337,471
42,"MUNICIPIUL BUCUREŞTI","ŞCOALA GIMNAZIALĂ NR. 145",242,"BUCUREŞTI SECTORUL 2",179150,1,PART,PRCNCT,PRSD,PRSD_SV_SECTOR,"2025-05-18 21:32:16",1632,918,858,60,0,909,9,1800,882,347,562
42,"MUNICIPIUL BUCUREŞTI","ŞCOALA GIMNAZIALĂ NR. 145",243,"BUCUREŞTI SECTORUL 2",179150,1,PART,PRCNCT,PRSD,PRSD_SV_SECTOR,"2025-05-18 22:04:41",1652,859,827,32,0,846,13,1800,941,383,463
42,"MUNICIPIUL BUCUREŞTI","ŞCOALA GIMNAZIALĂ NR. 145",244,"BUCUREŞTI SECTORUL 2",179150,1,PART,PRCNCT,PRSD,PRSD_SV_SECTOR,"2025-05-18 21:39:59",1476,549,527,22,0,544,5,1600,1051,349,195
42,"MUNICIPIUL BUCUREŞTI","ŞCOALA GIMNAZIALĂ NR. 62",245,"BUCUREŞTI SECTORUL 2",179150,1,PART,PRCNCT,PRSD,PRSD_SV_SECTOR,"2025-05-18 22:12:49",1455,848,766,82,0,832,16,1600,752,314,518
42,"MUNICIPIUL BUCUREŞTI","ŞCOALA GIMNAZIALĂ NR. 62",246,"BUCUREŞTI SECTORUL 2",179150,1,PART,PRCNCT,PRSD,PRSD_SV_SECTOR,"2025-05-18 21:51:03",1305,697,634,63,0,683,14,1400,703,335,348
42,"MUNICIPIUL BUCUREŞTI","ŞCOALA GIMNAZIALĂ NR. 62",247,"BUCUREŞTI SECTORUL 2",179150,1,PART,PRCNCT,PRSD,PRSD_SV_SECTOR,"2025-05-18 21:29:43",1242,808,742,66,0,798,10,1400,592,282,516
42,"MUNICIPIUL BUCUREŞTI","ŞCOALA GIMNAZIALĂ NR. 62",248,"BUCUREŞTI SECTORUL 2",179150,1,PART,PRCNCT,PRSD,PRSD_SV_SECTOR,"2025-05-18 21:57:34",1457,868,779,89,0,850,18,1600,732,326,524
42,"MUNICIPIUL BUCUREŞTI","ŞCOALA GIMNAZIALĂ NR. 62",249,"BUCUREŞTI SECTORUL 2",179150,1,PART,PRCNCT,PRSD,PRSD_SV_SECTOR,"2025-05-18 21:42:25",1395,758,741,17,0,745,13,1600,842,285,460
42,"MUNICIPIUL BUCUREŞTI","ŞCOALA GIMNAZIALĂ NR. 62",250,"BUCUREŞTI SECTORUL 2",179150,1,PART,PRCNCT,PRSD,PRSD_SV_SECTOR,"2025-05-18 21:38:33",1223,693,665,28,0,682,11,1400,707,223,459
42,"MUNICIPIUL BUCUREŞTI","ŞCOALA GIMNAZIALĂ NR. 62",251,"BUCUREŞTI SECTORUL 2",179150,1,PART,PRCNCT,PRSD,PRSD_SV_SECTOR,"2025-05-18 21:37:56",1073,652,551,101,0,635,17,1200,548,241,394
42,"MUNICIPIUL BUCUREŞTI","LICEUL TEHNOLOGIC ”SF. PANTELIMON”",252,"BUCUREŞTI SECTORUL 2",179150,1,PART,PRCNCT,PRSD,PRSD_SV_SECTOR,"2025-05-18 22:29:00",1756,1116,1000,112,4,1096,20,2000,884,297,799
42,"MUNICIPIUL BUCUREŞTI","LICEUL TEHNOLOGIC ”SF. PANTELIMON”",253,"BUCUREŞTI SECTORUL 2",179150,1,PART,PRCNCT,PRSD,PRSD_SV_SECTOR,"2025-05-18 22:39:58",1209,751,691,60,0,735,15,1400,649,159,576
42,"MUNICIPIUL BUCUREŞTI","LICEUL TEHNOLOGIC ”SF. PANTELIMON”",254,"BUCUREŞTI SECTORUL 2",179150,1,PART,PRCNCT,PRSD,PRSD_SV_SECTOR,"2025-05-18 21:48:31",1215,742,686,55,1,735,7,1400,658,182,553
42,"MUNICIPIUL BUCUREŞTI","LICEUL TEHNOLOGIC ”SF. PANTELIMON”",255,"BUCUREŞTI SECTORUL 2",179150,1,PART,PRCNCT,PRSD,PRSD_SV_SECTOR,"2025-05-18 21:48:36",1463,857,807,47,3,842,15,1600,743,205,637
42,"MUNICIPIUL BUCUREŞTI","ŞCOALA GIMNAZIALĂ NR. 51",256,"BUCUREŞTI SECTORUL 2",179150,1,PART,PRCNCT,PRSD,PRSD_SV_SECTOR,"2025-05-18 22:27:37",1343,911,736,175,0,904,7,1600,689,243,661
42,"MUNICIPIUL BUCUREŞTI","ŞCOALA GIMNAZIALĂ NR. 51",257,"BUCUREŞTI SECTORUL 2",179150,1,PART,PRCNCT,PRSD,PRSD_SV_SECTOR,"2025-05-18 21:56:44",1336,785,608,177,0,776,9,1400,615,289,487
42,"MUNICIPIUL BUCUREŞTI","ŞCOALA GIMNAZIALĂ NR. 51",258,"BUCUREŞTI SECTORUL 2",179150,1,PART,PRCNCT,PRSD,PRSD_SV_SECTOR,"2025-05-18 22:18:18",1281,748,672,75,1,735,13,1400,652,234,501
42,"MUNICIPIUL BUCUREŞTI","GRADINIŢA NR. 280",259,"BUCUREŞTI SECTORUL 2",179150,1,PART,PRCNCT,PRSD,PRSD_SV_SECTOR,"2025-05-18 21:52:24",1251,795,653,142,0,785,10,1400,605,210,575
42,"MUNICIPIUL BUCUREŞTI","GRADINIŢA NR. 280",260,"BUCUREŞTI SECTORUL 2",179150,3,PART,PRCNCT,PRSD,PRSD_SV_SECTOR,"2025-05-19 02:21:24",2109,1225,1161,63,1,1214,11,2200,975,336,878
42,"MUNICIPIUL BUCUREŞTI","ŞCOALA GIMNAZIALĂ NR. 77",261,"BUCUREŞTI SECTORUL 2",179150,1,PART,PRCNCT,PRSD,PRSD_SV_SECTOR,"2025-05-18 21:33:38",1303,757,684,73,0,747,10,1400,643,324,423
42,"MUNICIPIUL BUCUREŞTI","ŞCOALA GIMNAZIALĂ NR. 77",262,"BUCUREŞTI SECTORUL 2",179150,1,PART,PRCNCT,PRSD,PRSD_SV_SECTOR,"2025-05-18 22:13:52",1355,893,764,129,0,877,16,1600,707,260,617
42,"MUNICIPIUL BUCUREŞTI","ŞCOALA GIMNAZIALĂ NR. 77",263,"BUCUREŞTI SECTORUL 2",179150,1,PART,PRCNCT,PRSD,PRSD_SV_SECTOR,"2025-05-18 22:20:29",1486,920,831,87,2,913,5,1600,680,245,668
42,"MUNICIPIUL BUCUREŞTI","ŞCOALA GIMNAZIALĂ NR. 77",264,"BUCUREŞTI SECTORUL 2",179150,1,PART,PRCNCT,PRSD,PRSD_SV_SECTOR,"2025-05-18 22:11:21",1947,1289,1160,127,2,1273,16,2001,712,280,993
42,"MUNICIPIUL BUCUREŞTI","ŞCOALA GIMNAZIALĂ NR. 77",265,"BUCUREŞTI SECTORUL 2",179150,1,PART,PRCNCT,PRSD,PRSD_SV_SECTOR,"2025-05-18 22:16:00",2139,1224,1138,17,69,1201,23,2200,976,427,774
42,"MUNICIPIUL BUCUREŞTI","ŞCOALA GIMNAZIALĂ NR. 77",266,"BUCUREŞTI SECTORUL 2",179150,1,PART,PRCNCT,PRSD,PRSD_SV_SECTOR,"2025-05-18 21:46:11",1437,784,743,40,1,773,11,1600,816,274,499
42,"MUNICIPIUL BUCUREŞTI","LICEUL TEORETIC ”LUCIAN BLAGA”",267,"BUCUREŞTI SECTORUL 2",179150,1,PART,PRCNCT,PRSD,PRSD_SV_SECTOR,"2025-05-18 22:12:35",1528,848,780,67,1,835,13,1600,752,358,477
42,"MUNICIPIUL BUCUREŞTI","LICEUL TEORETIC ”LUCIAN BLAGA”",268,"BUCUREŞTI SECTORUL 2",179150,1,PART,PRCNCT,PRSD,PRSD_SV_SECTOR,"2025-05-18 21:56:59",1572,691,588,102,1,676,15,1600,909,383,293
42,"MUNICIPIUL BUCUREŞTI","LICEUL TEORETIC ”LUCIAN BLAGA”",269,"BUCUREŞTI SECTORUL 2",179150,1,PART,PRCNCT,PRSD,PRSD_SV_SECTOR,"2025-05-18 22:39:23",1688,1038,923,115,0,1024,14,1800,762,414,610
42,"MUNICIPIUL BUCUREŞTI","LICEUL TEORETIC ”LUCIAN BLAGA”",270,"BUCUREŞTI SECTORUL 2",179150,1,PART,PRCNCT,PRSD,PRSD_SV_SECTOR,"2025-05-18 22:28:45",1694,856,799,57,0,841,15,1800,944,352,489
42,"MUNICIPIUL BUCUREŞTI","LICEUL TEORETIC ”LUCIAN BLAGA”",271,"BUCUREŞTI SECTORUL 2",179150,1,PART,PRCNCT,PRSD,PRSD_SV_SECTOR,"2025-05-18 21:40:27",1710,886,848,38,0,871,15,1800,914,399,472
42,"MUNICIPIUL BUCUREŞTI","ŞCOALA GIMNAZIALĂ NR. 66",272,"BUCUREŞTI SECTORUL 2",179150,1,PART,PRCNCT,PRSD,PRSD_SV_SECTOR,"2025-05-18 21:37:15",1637,900,855,44,1,883,17,1800,900,377,506
42,"MUNICIPIUL BUCUREŞTI","ŞCOALA GIMNAZIALĂ NR. 66",273,"BUCUREŞTI SECTORUL 2",179150,1,PART,PRCNCT,PRSD,PRSD_SV_SECTOR,"2025-05-18 21:38:37",1183,782,681,71,30,766,16,1400,618,260,506
42,"MUNICIPIUL BUCUREŞTI","ŞCOALA GIMNAZIALĂ NR. 66",274,"BUCUREŞTI SECTORUL 2",179150,1,PART,PRCNCT,PRSD,PRSD_SV_SECTOR,"2025-05-18 21:57:24",1434,794,659,134,1,778,16,1600,806,310,468
42,"MUNICIPIUL BUCUREŞTI","ŞCOALA GIMNAZIALĂ NR. 66",275,"BUCUREŞTI SECTORUL 2",179150,1,PART,PRCNCT,PRSD,PRSD_SV_SECTOR,"2025-05-18 21:46:46",1276,767,700,65,2,757,10,1400,633,218,539
42,"MUNICIPIUL BUCUREŞTI","ŞCOALA GIMNAZIALĂ NR. 66",276,"BUCUREŞTI SECTORUL 2",179150,1,PART,PRCNCT,PRSD,PRSD_SV_SECTOR,"2025-05-18 21:50:14",1695,918,886,31,1,911,7,1800,882,395,516
42,"MUNICIPIUL BUCUREŞTI","GRADINIŢA NR. 189",277,"BUCUREŞTI SECTORUL 2",179150,1,PART,PRCNCT,PRSD,PRSD_SV_SECTOR,"2025-05-18 21:49:31",932,597,520,77,0,590,7,1200,603,197,393
42,"MUNICIPIUL BUCUREŞTI","GRADINIŢA NR. 189",278,"BUCUREŞTI SECTORUL 2",179150,1,PART,PRCNCT,PRSD,PRSD_SV_SECTOR,"2025-05-18 21:56:02",931,578,533,44,1,571,7,1200,622,158,413
42,"MUNICIPIUL BUCUREŞTI","COLEGUL TEHNIC ”DIMITRIE LEONIDA”",279,"BUCUREŞTI SECTORUL 2",179150,1,PART,PRCNCT,PRSD,PRSD_SV_SECTOR,"2025-05-18 22:06:46",1005,796,572,224,0,783,13,1200,404,211,572
42,"MUNICIPIUL BUCUREŞTI","COLEGUL TEHNIC ”DIMITRIE LEONIDA”",280,"BUCUREŞTI SECTORUL 2",179150,1,PART,PRCNCT,PRSD,PRSD_SV_SECTOR,"2025-05-18 22:32:31",1279,926,739,121,66,913,13,1400,474,298,615
42,"MUNICIPIUL BUCUREŞTI","ŞCOALA GIMNAZIALĂ ”PETRE GHELMEZ”",281,"BUCUREŞTI SECTORUL 2",179150,1,PART,PRCNCT,PRSD,PRSD_SV_SECTOR,"2025-05-18 22:13:18",1487,860,806,54,0,846,14,1600,740,228,618
42,"MUNICIPIUL BUCUREŞTI","ŞCOALA GIMNAZIALĂ ”PETRE GHELMEZ”",282,"BUCUREŞTI SECTORUL 2",179150,1,PART,PRCNCT,PRSD,PRSD_SV_SECTOR,"2025-05-18 22:26:14",1586,1015,874,141,0,998,17,1800,785,338,660
42,"MUNICIPIUL BUCUREŞTI","ŞCOALA GIMNAZIALĂ ”PETRE GHELMEZ”",283,"BUCUREŞTI SECTORUL 2",179150,1,PART,PRCNCT,PRSD,PRSD_SV_SECTOR,"2025-05-18 21:46:57",1713,1166,1047,118,1,1153,13,1800,634,232,921
42,"MUNICIPIUL BUCUREŞTI","ŞCOALA GIMNAZIALĂ ”PETRE GHELMEZ”",284,"BUCUREŞTI SECTORUL 2",179150,1,PART,PRCNCT,PRSD,PRSD_SV_SECTOR,"2025-05-18 22:11:32",1239,748,648,100,0,736,12,1400,652,230,506
42,"MUNICIPIUL BUCUREŞTI","ŞCOALA GIMNAZIALĂ ”PETRE GHELMEZ”",285,"BUCUREŞTI SECTORUL 2",179150,1,PART,PRCNCT,PRSD,PRSD_SV_SECTOR,"2025-05-18 22:02:58",1550,903,834,69,0,888,15,1600,697,334,554
42,"MUNICIPIUL BUCUREŞTI","ŞCOALA GIMNAZIALĂ ”PETRE GHELMEZ”",286,"BUCUREŞTI SECTORUL 2",179150,1,PART,PRCNCT,PRSD,PRSD_SV_SECTOR,"2025-05-18 22:14:46",1412,852,804,48,0,839,13,1600,748,261,578
42,"MUNICIPIUL BUCUREŞTI","ŞCOALA GIMNAZIALĂ NR. 4",287,"BUCUREŞTI SECTORUL 2",179150,1,PART,PRCNCT,PRSD,PRSD_SV_SECTOR,"2025-05-18 22:11:57",1528,985,838,147,0,962,23,1600,615,311,651
42,"MUNICIPIUL BUCUREŞTI","ŞCOALA GIMNAZIALĂ NR. 4",288,"BUCUREŞTI SECTORUL 2",179150,1,PART,PRCNCT,PRSD,PRSD_SV_SECTOR,"2025-05-18 21:51:01",1529,915,824,90,1,897,18,1600,685,329,568
42,"MUNICIPIUL BUCUREŞTI","ŞCOALA GIMNAZIALĂ NR. 4",289,"BUCUREŞTI SECTORUL 2",179150,1,PART,PRCNCT,PRSD,PRSD_SV_SECTOR,"2025-05-18 22:01:55",1645,978,884,94,0,960,18,1800,822,344,616
42,"MUNICIPIUL BUCUREŞTI","ŞCOALA GIMNAZIALĂ NR. 4",290,"BUCUREŞTI SECTORUL 2",179150,1,PART,PRCNCT,PRSD,PRSD_SV_SECTOR,"2025-05-18 22:15:56",1796,1072,1022,50,0,1056,16,2000,928,318,738
42,"MUNICIPIUL BUCUREŞTI","ŞCOALA GIMNAZIALĂ NR. 4",291,"BUCUREŞTI SECTORUL 2",179150,1,PART,PRCNCT,PRSD,PRSD_SV_SECTOR,"2025-05-18 21:55:58",1341,800,741,55,4,788,12,1600,800,196,592
42,"MUNICIPIUL BUCUREŞTI","ŞCOALA GIMNAZIALĂ NR. 25",292,"BUCUREŞTI SECTORUL 2",179150,1,PART,PRCNCT,PRSD,PRSD_SV_SECTOR,"2025-05-18 21:56:20",1657,1026,853,173,0,1013,13,1800,774,285,728
42,"MUNICIPIUL BUCUREŞTI","ŞCOALA GIMNAZIALĂ NR. 25",293,"BUCUREŞTI SECTORUL 2",179150,1,PART,PRCNCT,PRSD,PRSD_SV_SECTOR,"2025-05-18 22:12:39",1796,1065,973,86,6,1056,9,2000,935,450,606
42,"MUNICIPIUL BUCUREŞTI","ŞCOALA GIMNAZIALĂ NR. 25",294,"BUCUREŞTI SECTORUL 2",179150,1,PART,PRCNCT,PRSD,PRSD_SV_SECTOR,"2025-05-18 22:15:16",1756,1097,1017,79,1,1082,15,2000,903,431,651
42,"MUNICIPIUL BUCUREŞTI","ŞCOALA GIMNAZIALĂ NR. 25",295,"BUCUREŞTI SECTORUL 2",179150,1,PART,PRCNCT,PRSD,PRSD_SV_SECTOR,"2025-05-18 22:32:26",2136,1262,1179,83,0,1250,12,2400,1138,234,1016
42,"MUNICIPIUL BUCUREŞTI","ŞCOALA GIMNAZIALĂ ”FERDINAND I” (FOSTA ȘCOALĂ NR. 64)",296,"BUCUREŞTI SECTORUL 2",179150,1,PART,PRCNCT,PRSD,PRSD_SV_SECTOR,"2025-05-18 22:08:53",1407,885,748,137,0,869,16,1600,715,275,594
42,"MUNICIPIUL BUCUREŞTI","ŞCOALA GIMNAZIALĂ ”FERDINAND I” (FOSTA ȘCOALĂ NR. 64)",297,"BUCUREŞTI SECTORUL 2",179150,1,PART,PRCNCT,PRSD,PRSD_SV_SECTOR,"2025-05-18 22:09:52",1244,803,667,135,1,786,17,1400,597,239,547
42,"MUNICIPIUL BUCUREŞTI","ŞCOALA GIMNAZIALĂ ”FERDINAND I” (FOSTA ȘCOALĂ NR. 64)",298,"BUCUREŞTI SECTORUL 2",179150,1,PART,PRCNCT,PRSD,PRSD_SV_SECTOR,"2025-05-18 21:56:38",1122,687,610,76,1,678,9,1200,513,232,446
42,"MUNICIPIUL BUCUREŞTI","ŞCOALA GIMNAZIALĂ ”FERDINAND I” (FOSTA ȘCOALĂ NR. 64)",299,"BUCUREŞTI SECTORUL 2",179150,1,PART,PRCNCT,PRSD,PRSD_SV_SECTOR,"2025-05-18 22:30:32",1836,989,938,50,1,973,16,2000,1011,378,595
42,"MUNICIPIUL BUCUREŞTI","ŞCOALA GIMNAZIALĂ ”FERDINAND I” (FOSTA ȘCOALĂ NR. 64)",300,"BUCUREŞTI SECTORUL 2",179150,3,PART,PRCNCT,PRSD,PRSD_SV_SECTOR,"2025-05-19 02:18:25",1328,685,649,36,0,671,14,1599,914,273,398
42,"MUNICIPIUL BUCUREŞTI","LICEUL TEHNOLOGIC ELECTRONICA INDUSTRIALĂ",301,"BUCUREŞTI SECTORUL 2",179150,1,PART,PRCNCT,PRSD,PRSD_SV_SECTOR,"2025-05-18 22:14:07",1433,858,824,33,1,842,16,1600,742,196,646
42,"MUNICIPIUL BUCUREŞTI","LICEUL TEHNOLOGIC ELECTRONICA INDUSTRIALĂ",302,"BUCUREŞTI SECTORUL 2",179150,1,PART,PRCNCT,PRSD,PRSD_SV_SECTOR,"2025-05-18 22:18:53",1416,834,760,74,0,815,19,1600,766,243,572
42,"MUNICIPIUL BUCUREŞTI","LICEUL TEHNOLOGIC ELECTRONICA INDUSTRIALĂ",303,"BUCUREŞTI SECTORUL 2",179150,1,PART,PRCNCT,PRSD,PRSD_SV_SECTOR,"2025-05-18 22:41:55",1169,723,604,113,6,715,8,1199,476,193,522
42,"MUNICIPIUL BUCUREŞTI","COLEGIUL NAŢIONAL ”IULIA HAŞDEU”",304,"BUCUREŞTI SECTORUL 2",179150,1,PART,PRCNCT,PRSD,PRSD_SV_SECTOR,"2025-05-18 22:01:50",1302,1129,733,396,0,1112,17,1400,271,253,859
42,"MUNICIPIUL BUCUREŞTI","COLEGIUL NAŢIONAL ”IULIA HAŞDEU”",305,"BUCUREŞTI SECTORUL 2",179150,1,PART,PRCNCT,PRSD,PRSD_SV_SECTOR,"2025-05-18 22:59:46",1234,806,580,226,0,800,6,1394,588,197,603
42,"MUNICIPIUL BUCUREŞTI","COLEGIUL NAŢIONAL ”IULIA HAŞDEU”",306,"BUCUREŞTI SECTORUL 2",179150,1,PART,PRCNCT,PRSD,PRSD_SV_SECTOR,"2025-05-18 21:43:12",1461,1021,781,240,0,1005,16,1600,579,235,770
42,"MUNICIPIUL BUCUREŞTI","LICEUL TEHNOLOGIC ”I.C. BRĂTIANU” (FOST LICEUL TEHNOLOGIC MECANICĂ FINĂ)",307,"BUCUREŞTI SECTORUL 2",179150,1,PART,PRCNCT,PRSD,PRSD_SV_SECTOR,"2025-05-18 21:43:11",1354,968,779,189,0,959,9,1600,632,230,729
42,"MUNICIPIUL BUCUREŞTI","LICEUL TEHNOLOGIC ”I.C. BRĂTIANU” (FOST LICEUL TEHNOLOGIC MECANICĂ FINĂ)",308,"BUCUREŞTI SECTORUL 2",179150,1,PART,PRCNCT,PRSD,PRSD_SV_SECTOR,"2025-05-18 21:52:17",1084,693,577,114,2,684,9,1200,507,144,540
42,"MUNICIPIUL BUCUREŞTI","LICEUL TEHNOLOGIC ”I.C. BRĂTIANU” (FOST LICEUL TEHNOLOGIC MECANICĂ FINĂ)",309,"BUCUREŞTI SECTORUL 2",179150,1,PART,PRCNCT,PRSD,PRSD_SV_SECTOR,"2025-05-18 21:53:33",1006,715,556,159,0,706,9,1200,485,178,528
42,"MUNICIPIUL BUCUREŞTI","LICEUL TEHNOLOGIC ”I.C. BRĂTIANU” (FOST LICEUL TEHNOLOGIC MECANICĂ FINĂ)",310,"BUCUREŞTI SECTORUL 2",179150,1,PART,PRCNCT,PRSD,PRSD_SV_SECTOR,"2025-05-18 22:16:53",1571,996,880,115,1,982,14,1600,604,231,751
42,"MUNICIPIUL BUCUREŞTI","CLUB SPORTIV ŞCOLAR NR. 2",311,"BUCUREŞTI SECTORUL 2",179150,1,PART,PRCNCT,PRSD,PRSD_SV_SECTOR,"2025-05-18 23:29:08",1509,1110,844,262,4,1095,15,1600,490,309,786
42,"MUNICIPIUL BUCUREŞTI","CLUB SPORTIV ŞCOLAR NR. 2",312,"BUCUREŞTI SECTORUL 2",179150,1,PART,PRCNCT,PRSD,PRSD_SV_SECTOR,"2025-05-18 22:35:44",1258,966,681,284,1,960,6,1400,434,216,744
42,"MUNICIPIUL BUCUREŞTI","GRĂDINIȚA CLOPOȚEL (FOSTA GRADINIŢA NR. 201)",313,"BUCUREŞTI SECTORUL 2",179150,1,PART,PRCNCT,PRSD,PRSD_SV_SECTOR,"2025-05-18 22:18:17",1295,829,734,94,1,819,10,1400,571,167,652
42,"MUNICIPIUL BUCUREŞTI","GRĂDINIȚA CLOPOȚEL (FOSTA GRADINIŢA NR. 201)",314,"BUCUREŞTI SECTORUL 2",179150,1,PART,PRCNCT,PRSD,PRSD_SV_SECTOR,"2025-05-18 21:50:00",1444,983,851,132,0,969,14,1600,617,251,718
42,"MUNICIPIUL BUCUREŞTI","GRĂDINIȚA CLOPOȚEL (FOSTA GRADINIŢA NR. 201)",315,"BUCUREŞTI SECTORUL 2",179150,3,PART,PRCNCT,PRSD,PRSD_SV_SECTOR,"2025-05-19 01:09:14",1233,775,716,58,1,756,19,1400,625,187,569
42,"MUNICIPIUL BUCUREŞTI","GRĂDINIȚA CLOPOȚEL (FOSTA GRADINIŢA NR. 201)",316,"BUCUREŞTI SECTORUL 2",179150,1,PART,PRCNCT,PRSD,PRSD_SV_SECTOR,"2025-05-18 21:56:36",1136,705,626,79,0,697,8,1200,495,142,555
42,"MUNICIPIUL BUCUREŞTI","COLEGIUL NAŢIONAL ”EMIL RACOVIŢĂ”",317,"BUCUREŞTI SECTORUL 2",179150,1,PART,PRCNCT,PRSD,PRSD_SV_SECTOR,"2025-05-18 21:50:39",1334,1010,790,220,0,998,12,1400,390,223,775
42,"MUNICIPIUL BUCUREŞTI","COLEGIUL NAŢIONAL ”EMIL RACOVIŢĂ”",318,"BUCUREŞTI SECTORUL 2",179150,1,PART,PRCNCT,PRSD,PRSD_SV_SECTOR,"2025-05-18 21:39:57",1026,779,602,176,1,765,14,1200,421,178,587
42,"MUNICIPIUL BUCUREŞTI","COLEGIUL NAŢIONAL ”EMIL RACOVIŢĂ”",319,"BUCUREŞTI SECTORUL 2",179150,1,PART,PRCNCT,PRSD,PRSD_SV_SECTOR,"2025-05-18 22:09:39",1682,1023,890,95,38,1003,20,1800,777,295,708
42,"MUNICIPIUL BUCUREŞTI","GRĂDINIŢA LUMINIȚA (FOSTA GRADINITA NR. 16)",320,"BUCUREŞTI SECTORUL 2",179150,1,PART,PRCNCT,PRSD,PRSD_SV_SECTOR,"2025-05-18 22:12:37",1137,831,648,182,1,816,15,1206,375,166,650
42,"MUNICIPIUL BUCUREŞTI","GRĂDINIŢA LUMINIȚA (FOSTA GRADINITA NR. 16)",321,"BUCUREŞTI SECTORUL 2",179150,1,PART,PRCNCT,PRSD,PRSD_SV_SECTOR,"2025-05-18 22:03:23",1127,788,718,69,1,774,14,1200,412,183,591
42,"MUNICIPIUL BUCUREŞTI","GRĂDINIŢA NR. 256",322,"BUCUREŞTI SECTORUL 2",179150,1,PART,PRCNCT,PRSD,PRSD_SV_SECTOR,"2025-05-18 22:06:13",1435,940,859,79,2,924,16,1600,660,210,714
42,"MUNICIPIUL BUCUREŞTI","ŞCOALA GIMNAZIALĂ NR. 49",323,"BUCUREŞTI SECTORUL 2",179150,1,PART,PRCNCT,PRSD,PRSD_SV_SECTOR,"2025-05-18 22:39:13",1140,871,709,147,15,856,15,1200,329,181,675
42,"MUNICIPIUL BUCUREŞTI","ŞCOALA GIMNAZIALĂ NR. 49",324,"BUCUREŞTI SECTORUL 2",179150,1,PART,PRCNCT,PRSD,PRSD_SV_SECTOR,"2025-05-18 22:12:50",1117,844,657,185,2,832,12,1200,356,201,631
42,"MUNICIPIUL BUCUREŞTI","ŞCOALA GIMNAZIALĂ NR. 46",325,"BUCUREŞTI SECTORUL 2",179150,1,PART,PRCNCT,PRSD,PRSD_SV_SECTOR,"2025-05-18 21:45:36",1355,949,753,196,0,939,10,1600,651,307,632
42,"MUNICIPIUL BUCUREŞTI","ŞCOALA GIMNAZIALĂ NR. 46",326,"BUCUREŞTI SECTORUL 2",179150,1,PART,PRCNCT,PRSD,PRSD_SV_SECTOR,"2025-05-18 21:30:31",1397,948,757,191,0,928,20,1600,652,263,665
42,"MUNICIPIUL BUCUREŞTI","ŞCOALA GIMNAZIALĂ NR. 46",327,"BUCUREŞTI SECTORUL 2",179150,1,PART,PRCNCT,PRSD,PRSD_SV_SECTOR,"2025-05-18 21:42:12",1504,935,840,95,0,923,12,1600,665,249,674
42,"MUNICIPIUL BUCUREŞTI","ŞCOALA GIMNAZIALĂ NR. 46",328,"BUCUREŞTI SECTORUL 2",179150,1,PART,PRCNCT,PRSD,PRSD_SV_SECTOR,"2025-05-18 21:43:20",1758,1104,980,122,2,1086,18,2000,896,285,801
42,"MUNICIPIUL BUCUREŞTI","ŞCOALA GIMNAZIALĂ TUDOR ARGHEZI (FOSTA ȘCOALĂ NR. 19)",329,"BUCUREŞTI SECTORUL 2",179150,1,PART,PRCNCT,PRSD,PRSD_SV_SECTOR,"2025-05-18 21:56:03",994,739,482,257,0,730,9,1200,461,164,566
42,"MUNICIPIUL BUCUREŞTI","ŞCOALA GIMNAZIALĂ TUDOR ARGHEZI (FOSTA ȘCOALĂ NR. 19)",330,"BUCUREŞTI SECTORUL 2",179150,1,PART,PRCNCT,PRSD,PRSD_SV_SECTOR,"2025-05-18 22:08:04",868,759,440,319,0,749,10,1000,241,165,584
42,"MUNICIPIUL BUCUREŞTI","COLEGIUL NAŢIONAL ”SPIRU HARET”",331,"BUCUREŞTI SECTORUL 2",179150,1,PART,PRCNCT,PRSD,PRSD_SV_SECTOR,"2025-05-18 22:44:21",1078,885,517,316,52,868,17,1191,306,181,687
42,"MUNICIPIUL BUCUREŞTI","COLEGIUL NAŢIONAL ”SPIRU HARET”",332,"BUCUREŞTI SECTORUL 2",179150,1,PART,PRCNCT,PRSD,PRSD_SV_SECTOR,"2025-05-18 22:47:49",1086,741,578,160,3,733,8,1200,459,177,556
42,"MUNICIPIUL BUCUREŞTI","COLEGIUL NAŢIONAL ”CANTEMIR VODĂ”",333,"BUCUREŞTI SECTORUL 2",179150,1,PART,PRCNCT,PRSD,PRSD_SV_SECTOR,"2025-05-18 22:16:16",885,762,474,168,120,751,11,1000,238,179,572
42,"MUNICIPIUL BUCUREŞTI","COLEGIUL NAŢIONAL ”CANTEMIR VODĂ”",334,"BUCUREŞTI SECTORUL 2",179150,1,PART,PRCNCT,PRSD,PRSD_SV_SECTOR,"2025-05-18 22:02:00",1143,918,671,244,3,897,21,1200,282,228,669
42,"MUNICIPIUL BUCUREŞTI","COLEGIUL NAŢIONAL ”CANTEMIR VODĂ”",335,"BUCUREŞTI SECTORUL 2",179150,1,PART,PRCNCT,PRSD,PRSD_SV_SECTOR,"2025-05-18 22:10:15",1076,702,575,126,1,688,14,1208,506,201,487
42,"MUNICIPIUL BUCUREŞTI","COLEGIUL NAŢIONAL ”CANTEMIR VODĂ”",336,"BUCUREŞTI SECTORUL 2",179150,1,PART,PRCNCT,PRSD,PRSD_SV_SECTOR,"2025-05-18 22:33:12",1412,812,753,59,0,790,22,1600,788,224,566
42,"MUNICIPIUL BUCUREŞTI","ŞCOALA GIMNAZIALĂ NR. 24",337,"BUCUREŞTI SECTORUL 2",179150,1,PART,PRCNCT,PRSD,PRSD_SV_SECTOR,"2025-05-18 21:56:08",1688,1160,940,140,80,1146,14,1800,640,296,850
42,"MUNICIPIUL BUCUREŞTI","ŞCOALA GIMNAZIALĂ NR. 24",338,"BUCUREŞTI SECTORUL 2",179150,1,PART,PRCNCT,PRSD,PRSD_SV_SECTOR,"2025-05-18 22:11:26",1386,878,759,105,14,868,10,1600,722,244,624
42,"MUNICIPIUL BUCUREŞTI","ŞCOALA GIMNAZIALĂ NR. 24",339,"BUCUREŞTI SECTORUL 2",179150,1,PART,PRCNCT,PRSD,PRSD_SV_SECTOR,"2025-05-18 23:08:22",1299,889,680,166,43,876,13,1600,711,238,638
42,"MUNICIPIUL BUCUREŞTI","ŞCOALA GIMNAZIALĂ NR. 24",340,"BUCUREŞTI SECTORUL 2",179150,1,PART,PRCNCT,PRSD,PRSD_SV_SECTOR,"2025-05-18 22:09:30",1419,974,769,198,7,954,20,1600,626,233,721
42,"MUNICIPIUL BUCUREŞTI","ȘCOALA GIMNAZIALĂ ”MAICA DOMNULUI” (FOSTA ŞCOALA NR. 26)",341,"BUCUREŞTI SECTORUL 2",179150,1,PART,PRCNCT,PRSD,PRSD_SV_SECTOR,"2025-05-18 21:51:52",1096,681,571,110,0,668,13,1200,519,180,488
42,"MUNICIPIUL BUCUREŞTI","ȘCOALA GIMNAZIALĂ ”MAICA DOMNULUI” (FOSTA ŞCOALA NR. 26)",342,"BUCUREŞTI SECTORUL 2",179150,1,PART,PRCNCT,PRSD,PRSD_SV_SECTOR,"2025-05-18 21:50:46",1223,757,697,59,1,744,13,1400,643,181,563
42,"MUNICIPIUL BUCUREŞTI","ŞCOALA PROFESIONALĂ SPECIALĂ NR. 3",343,"BUCUREŞTI SECTORUL 2",179150,1,PART,PRCNCT,PRSD,PRSD_SV_SECTOR,"2025-05-18 21:46:17",1520,930,808,119,3,919,11,1600,670,305,614
42,"MUNICIPIUL BUCUREŞTI","ŞCOALA PROFESIONALĂ SPECIALĂ NR. 3",344,"BUCUREŞTI SECTORUL 2",179150,1,PART,PRCNCT,PRSD,PRSD_SV_SECTOR,"2025-05-18 21:47:36",1199,767,638,129,0,755,12,1400,633,181,574
42,"MUNICIPIUL BUCUREŞTI","ŞCOALA GIMNAZIALĂ NR. 307",345,"BUCUREŞTI SECTORUL 2",179150,1,PART,PRCNCT,PRSD,PRSD_SV_SECTOR,"2025-05-18 21:56:57",1224,916,717,199,0,901,15,1400,484,204,697
42,"MUNICIPIUL BUCUREŞTI","ŞCOALA GIMNAZIALĂ NR. 307",346,"BUCUREŞTI SECTORUL 2",179150,1,PART,PRCNCT,PRSD,PRSD_SV_SECTOR,"2025-05-18 22:32:10",979,825,485,340,0,811,14,1200,375,197,614
42,"MUNICIPIUL BUCUREŞTI","ŞCOALA GIMNAZIALĂ NR. 307",347,"BUCUREŞTI SECTORUL 2",179150,1,PART,PRCNCT,PRSD,PRSD_SV_SECTOR,"2025-05-18 22:21:44",1350,946,784,161,1,930,16,1600,654,221,709
42,"MUNICIPIUL BUCUREŞTI","ŞCOALA GIMNAZIALĂ NR. 71",348,"BUCUREŞTI SECTORUL 2",179150,1,PART,PRCNCT,PRSD,PRSD_SV_SECTOR,"2025-05-18 21:44:39",1168,736,569,165,2,728,8,1200,464,203,525
42,"MUNICIPIUL BUCUREŞTI","ŞCOALA GIMNAZIALĂ NR. 71",349,"BUCUREŞTI SECTORUL 2",179150,1,PART,PRCNCT,PRSD,PRSD_SV_SECTOR,"2025-05-18 22:08:49",1112,649,554,90,5,638,11,1200,551,204,434
42,"MUNICIPIUL BUCUREŞTI","COLEGIUL ECONOMIC ”A.D. XENOPOL”",350,"BUCUREŞTI SECTORUL 2",179150,1,PART,PRCNCT,PRSD,PRSD_SV_SECTOR,"2025-05-18 22:17:41",1090,661,570,91,0,654,7,1200,539,178,476
42,"MUNICIPIUL BUCUREŞTI","COLEGIUL ECONOMIC ”A.D. XENOPOL”",351,"BUCUREŞTI SECTORUL 2",179150,1,PART,PRCNCT,PRSD,PRSD_SV_SECTOR,"2025-05-18 21:58:02",864,533,416,116,1,522,11,1000,467,140,382
42,"MUNICIPIUL BUCUREŞTI","COLEGIUL ECONOMIC ”A.D. XENOPOL”",352,"BUCUREŞTI SECTORUL 2",179150,1,PART,PRCNCT,PRSD,PRSD_SV_SECTOR,"2025-05-18 22:44:45",1298,840,730,110,0,823,17,1400,560,220,603
42,"MUNICIPIUL BUCUREŞTI","COLEGIUL ECONOMIC ”A.D. XENOPOL”",353,"BUCUREŞTI SECTORUL 2",179150,3,PART,PRCNCT,PRSD,PRSD_SV_SECTOR,"2025-05-19 00:58:37",1390,818,752,66,0,808,10,1608,790,271,537
42,"MUNICIPIUL BUCUREŞTI","COLEGIUL NAȚIONAL BILINGV ”GEORGE COȘBUC”",354,"BUCUREŞTI SECTORUL 2",179150,1,PART,PRCNCT,PRSD,PRSD_SV_SECTOR,"2025-05-18 22:04:43",1285,812,685,127,0,799,13,1400,588,190,609
42,"MUNICIPIUL BUCUREŞTI","COLEGIUL NAȚIONAL BILINGV ”GEORGE COȘBUC”",355,"BUCUREŞTI SECTORUL 2",179150,1,PART,PRCNCT,PRSD,PRSD_SV_SECTOR,"2025-05-18 22:56:42",1553,981,801,178,2,967,14,1600,619,241,726
42,"MUNICIPIUL BUCUREŞTI","ŞCOALA GIMNAZIALĂ ”MAICA DOMNULUI” (FOSTA ȘCOALĂ NR. 50)",356,"BUCUREŞTI SECTORUL 2",179150,1,PART,PRCNCT,PRSD,PRSD_SV_SECTOR,"2025-05-18 21:48:18",1350,1006,796,208,2,995,11,1400,394,199,796
42,"MUNICIPIUL BUCUREŞTI","ŞCOALA GIMNAZIALĂ ”MAICA DOMNULUI” (FOSTA ȘCOALĂ NR. 50)",357,"BUCUREŞTI SECTORUL 2",179150,1,PART,PRCNCT,PRSD,PRSD_SV_SECTOR,"2025-05-18 22:07:42",1388,918,765,152,1,907,11,1600,682,196,711
42,"MUNICIPIUL BUCUREŞTI","ŞCOALA GIMNAZIALĂ ”MAICA DOMNULUI” (FOSTA ȘCOALĂ NR. 50)",358,"BUCUREŞTI SECTORUL 2",179150,1,PART,PRCNCT,PRSD,PRSD_SV_SECTOR,"2025-05-18 22:15:34",1627,981,866,115,0,966,15,1800,819,303,663
42,"MUNICIPIUL BUCUREŞTI","COLEGIUL NAŢIONAL ”MIHAI VITEAZUL”",359,"BUCUREŞTI SECTORUL 2",179150,1,PART,PRCNCT,PRSD,PRSD_SV_SECTOR,"2025-05-18 22:57:06",1556,1150,859,198,93,1139,11,1600,450,287,852
42,"MUNICIPIUL BUCUREŞTI","COLEGIUL NAŢIONAL ”MIHAI VITEAZUL”",360,"BUCUREŞTI SECTORUL 2",179150,1,PART,PRCNCT,PRSD,PRSD_SV_SECTOR,"2025-05-18 21:57:07",1387,953,762,128,63,935,18,1600,647,305,630
42,"MUNICIPIUL BUCUREŞTI","ŞCOALA GIMNAZIALĂ NR. 56",361,"BUCUREŞTI SECTORUL 2",179150,1,PART,PRCNCT,PRSD,PRSD_SV_SECTOR,"2025-05-18 22:13:16",1352,870,765,105,0,850,20,1400,530,218,632
42,"MUNICIPIUL BUCUREŞTI","ŞCOALA GIMNAZIALĂ NR. 56",362,"BUCUREŞTI SECTORUL 2",179150,1,PART,PRCNCT,PRSD,PRSD_SV_SECTOR,"2025-05-18 22:13:53",1116,775,643,131,1,767,8,1200,425,191,576
42,"MUNICIPIUL BUCUREŞTI","ŞCOALA GIMNAZIALĂ NR. 85",363,"BUCUREŞTI SECTORUL 2",179150,1,PART,PRCNCT,PRSD,PRSD_SV_SECTOR,"2025-05-18 21:43:29",939,767,567,200,0,754,13,1000,233,159,595
42,"MUNICIPIUL BUCUREŞTI","ŞCOALA GIMNAZIALĂ NR. 85",364,"BUCUREŞTI SECTORUL 2",179150,1,PART,PRCNCT,PRSD,PRSD_SV_SECTOR,"2025-05-18 22:05:30",1191,698,619,76,3,691,7,1400,702,166,525
42,"MUNICIPIUL BUCUREŞTI","ŞCOALA GIMNAZIALĂ NR. 85",365,"BUCUREŞTI SECTORUL 2",179150,1,PART,PRCNCT,PRSD,PRSD_SV_SECTOR,"2025-05-18 21:58:16",1184,710,668,42,0,699,11,1400,690,191,508
42,"MUNICIPIUL BUCUREŞTI","ŞCOALA GIMNAZIALĂ NR. 85",366,"BUCUREŞTI SECTORUL 2",179150,1,PART,PRCNCT,PRSD,PRSD_SV_SECTOR,"2025-05-18 21:45:04",1028,632,580,50,2,625,7,1200,568,149,476
42,"MUNICIPIUL BUCUREŞTI","ȘCOALA GIMNAZIALĂ ”IANCULUI”",367,"BUCUREŞTI SECTORUL 2",179150,1,PART,PRCNCT,PRSD,PRSD_SV_SECTOR,"2025-05-18 21:59:00",1265,863,705,158,0,853,10,1400,537,238,615
42,"MUNICIPIUL BUCUREŞTI","ȘCOALA GIMNAZIALĂ ”IANCULUI”",368,"BUCUREŞTI SECTORUL 2",179150,1,PART,PRCNCT,PRSD,PRSD_SV_SECTOR,"2025-05-18 22:06:59",1818,1098,958,139,1,1085,13,2073,975,292,793
42,"MUNICIPIUL BUCUREŞTI","COLEGIUL ECONOMIC ”NICOLAE KRETZULESCU”;",369,"BUCUREŞTI SECTORUL 3",179169,1,PART,PRCNCT,PRSD,PRSD_SV_SECTOR,"2025-05-18 22:08:06",1393,463,355,107,1,457,6,1600,1137,131,326
42,"MUNICIPIUL BUCUREŞTI","COLEGIUL ECONOMIC ”NICOLAE KRETZULESCU”;",370,"BUCUREŞTI SECTORUL 3",179169,1,PART,PRCNCT,PRSD,PRSD_SV_SECTOR,"2025-05-18 22:01:55",661,320,244,37,39,315,5,800,480,126,189
42,"MUNICIPIUL BUCUREŞTI","COLEGIUL ECONOMIC ”NICOLAE KRETZULESCU”;",371,"BUCUREŞTI SECTORUL 3",179169,1,PART,PRCNCT,PRSD,PRSD_SV_SECTOR,"2025-05-18 21:45:33",704,674,309,252,113,667,7,800,126,188,479
42,"MUNICIPIUL BUCUREŞTI","COLEGIUL ECONOMIC ”NICOLAE KRETZULESCU”;",372,"BUCUREŞTI SECTORUL 3",179169,1,PART,PRCNCT,PRSD,PRSD_SV_SECTOR,"2025-05-18 21:40:07",1148,481,376,104,1,474,7,1300,819,173,301
42,"MUNICIPIUL BUCUREŞTI","COLEGIUL ECONOMIC ”NICOLAE KRETZULESCU”;",373,"BUCUREŞTI SECTORUL 3",179169,1,PART,PRCNCT,PRSD,PRSD_SV_SECTOR,"2025-05-18 21:47:54",909,423,375,47,1,416,7,1000,577,173,243
42,"MUNICIPIUL BUCUREŞTI","COLEGIUL ECONOMIC ”NICOLAE KRETZULESCU”;",374,"BUCUREŞTI SECTORUL 3",179169,1,PART,PRCNCT,PRSD,PRSD_SV_SECTOR,"2025-05-18 22:25:37",1324,758,653,71,34,747,11,1400,642,223,524
42,"MUNICIPIUL BUCUREŞTI","ŞCOALA GIMNAZIALĂ ”BARBU DELAVRANCEA”",375,"BUCUREŞTI SECTORUL 3",179169,1,PART,PRCNCT,PRSD,PRSD_SV_SECTOR,"2025-05-18 22:27:39",1639,914,889,22,3,904,10,1800,886,233,671
42,"MUNICIPIUL BUCUREŞTI","ŞCOALA GIMNAZIALĂ ”BARBU DELAVRANCEA”",376,"BUCUREŞTI SECTORUL 3",179169,1,PART,PRCNCT,PRSD,PRSD_SV_SECTOR,"2025-05-18 21:27:14",3140,170,29,141,0,169,1,3400,3230,42,127
42,"MUNICIPIUL BUCUREŞTI","ȘCOALA GIMNAZIALĂ ”BARBU DELAVRANCEA”",377,"BUCUREŞTI SECTORUL 3",179169,1,PART,PRCNCT,PRSD,PRSD_SV_SECTOR,"2025-05-18 21:25:19",2929,146,23,123,0,142,4,3300,3154,46,96
42,"MUNICIPIUL BUCUREŞTI","ŞCOALA GIMNAZIALĂ ”BARBU DELAVRANCEA”",378,"BUCUREŞTI SECTORUL 3",179169,1,PART,PRCNCT,PRSD,PRSD_SV_SECTOR,"2025-05-18 21:24:34",3098,145,18,127,0,144,1,3400,3255,37,107
42,"MUNICIPIUL BUCUREŞTI","ŞCOALA GIMNAZIALĂ ”BARBU DELAVRANCEA”",379,"BUCUREŞTI SECTORUL 3",179169,1,PART,PRCNCT,PRSD,PRSD_SV_SECTOR,"2025-05-18 21:32:29",3150,155,55,72,28,152,3,3400,3245,48,104
42,"MUNICIPIUL BUCUREŞTI","COLEGIUL NAŢIONAL ”MATEI BASARAB”;",380,"BUCUREŞTI SECTORUL 3",179169,1,PART,PRCNCT,PRSD,PRSD_SV_SECTOR,"2025-05-18 21:37:43",2492,216,7,209,0,214,2,2800,2584,36,178
42,"MUNICIPIUL BUCUREŞTI","COLEGIUL NAŢIONAL ”MATEI BASARAB”;",381,"BUCUREŞTI SECTORUL 3",179169,1,PART,PRCNCT,PRSD,PRSD_SV_SECTOR,"2025-05-18 22:05:34",1769,782,738,39,5,769,13,2000,1218,272,497
42,"MUNICIPIUL BUCUREŞTI","COLEGIUL NAŢIONAL ”MATEI BASARAB”;",382,"BUCUREŞTI SECTORUL 3",179169,1,PART,PRCNCT,PRSD,PRSD_SV_SECTOR,"2025-05-18 22:21:55",1909,825,758,67,0,815,10,2100,1275,250,565
42,"MUNICIPIUL BUCUREŞTI","COLEGIUL NAŢIONAL ”MATEI BASARAB”;",383,"BUCUREŞTI SECTORUL 3",179169,1,PART,PRCNCT,PRSD,PRSD_SV_SECTOR,"2025-05-18 22:13:48",1795,924,892,31,1,901,23,2000,1076,262,639
42,"MUNICIPIUL BUCUREŞTI","COLEGIUL NAȚIONAL ”MATEI BASARAB”",384,"BUCUREŞTI SECTORUL 3",179169,2,PART,PRCNCT,PRSD,PRSD_SV_SECTOR,"2025-05-18 22:57:02",2578,111,6,105,0,111,0,2900,2789,19,92
42,"MUNICIPIUL BUCUREŞTI","COLEGIUL NAȚIONAL ”MATEI BASARAB”",385,"BUCUREŞTI SECTORUL 3",179169,1,PART,PRCNCT,PRSD,PRSD_SV_SECTOR,"2025-05-18 21:33:17",3064,112,19,93,0,112,0,3407,3295,27,85
42,"MUNICIPIUL BUCUREŞTI","COLEGIUL NAȚIONAL ”MATEI BASARAB”",386,"BUCUREŞTI SECTORUL 3",179169,1,PART,PRCNCT,PRSD,PRSD_SV_SECTOR,"2025-05-18 21:26:27",2594,28,6,22,0,28,0,2900,2872,6,22
42,"MUNICIPIUL BUCUREŞTI","CENTRUL ȘCOLAR DE EDUCAȚIE INCLUZIVĂ NR.5;",387,"BUCUREŞTI SECTORUL 3",179169,1,PART,PRCNCT,PRSD,PRSD_SV_SECTOR,"2025-05-18 21:46:05",1314,926,734,192,0,910,16,1401,475,246,664
42,"MUNICIPIUL BUCUREŞTI","CENTRUL ȘCOLAR DE EDUCAȚIE INCLUZIVĂ NR.5;",388,"BUCUREŞTI SECTORUL 3",179169,1,PART,PRCNCT,PRSD,PRSD_SV_SECTOR,"2025-05-18 21:46:54",1386,833,703,128,2,820,13,1600,767,271,549
42,"MUNICIPIUL BUCUREŞTI","CENTRUL ȘCOLAR DE EDUCAȚIE INCLUZIVĂ NR.5;",389,"BUCUREŞTI SECTORUL 3",179169,1,PART,PRCNCT,PRSD,PRSD_SV_SECTOR,"2025-05-18 21:39:14",1020,676,560,115,1,666,10,1200,524,206,460
42,"MUNICIPIUL BUCUREŞTI","CENTRUL ȘCOLAR DE EDUCAȚIE INCLUZIVĂ NR.5;",390,"BUCUREŞTI SECTORUL 3",179169,1,PART,PRCNCT,PRSD,PRSD_SV_SECTOR,"2025-05-18 21:49:31",1310,852,703,147,2,842,10,1399,547,225,617
42,"MUNICIPIUL BUCUREŞTI","CENTRUL ȘCOLAR DE EDUCAȚIE INCLUZIVĂ NR.5;",391,"BUCUREŞTI SECTORUL 3",179169,1,PART,PRCNCT,PRSD,PRSD_SV_SECTOR,"2025-05-19 02:27:31",1130,710,592,118,0,704,6,1300,590,186,518
42,"MUNICIPIUL BUCUREŞTI","CENTRUL ȘCOLAR DE EDUCAȚIE INCLUZIVĂ NR.5;",392,"BUCUREŞTI SECTORUL 3",179169,1,PART,PRCNCT,PRSD,PRSD_SV_SECTOR,"2025-05-18 21:50:43",1572,871,765,104,2,862,9,1700,829,236,626
42,"MUNICIPIUL BUCUREŞTI","CENTRUL ȘCOLAR DE EDUCAȚIE INCLUZIVĂ NR.5;",393,"BUCUREŞTI SECTORUL 3",179169,1,PART,PRCNCT,PRSD,PRSD_SV_SECTOR,"2025-05-18 21:51:50",1109,674,506,167,1,667,7,1200,526,216,451
42,"MUNICIPIUL BUCUREŞTI","ŞCOALA GIMNAZIALĂ ”CEZAR BOLLIAC”;",394,"BUCUREŞTI SECTORUL 3",179169,1,PART,PRCNCT,PRSD,PRSD_SV_SECTOR,"2025-05-18 21:35:23",1428,973,852,120,1,959,14,1600,627,283,676
42,"MUNICIPIUL BUCUREŞTI","ŞCOALA GIMNAZIALĂ ”CEZAR BOLLIAC”;",395,"BUCUREŞTI SECTORUL 3",179169,1,PART,PRCNCT,PRSD,PRSD_SV_SECTOR,"2025-05-18 22:18:21",1456,1089,806,283,0,1067,22,1600,511,247,820
42,"MUNICIPIUL BUCUREŞTI","ŞCOALA GIMNAZIALĂ ”CEZAR BOLLIAC”;",396,"BUCUREŞTI SECTORUL 3",179169,1,PART,PRCNCT,PRSD,PRSD_SV_SECTOR,"2025-05-18 22:11:19",1378,1131,806,281,44,1110,21,1600,469,242,868
42,"MUNICIPIUL BUCUREŞTI","ŞCOALA GIMNAZIALĂ ”CEZAR BOLLIAC”;",397,"BUCUREŞTI SECTORUL 3",179169,1,PART,PRCNCT,PRSD,PRSD_SV_SECTOR,"2025-05-18 21:56:58",1436,1022,827,193,2,1004,18,1600,578,261,743
42,"MUNICIPIUL BUCUREŞTI","ŞCOALA GIMNAZIALĂ ”CEZAR BOLLIAC”;",398,"BUCUREŞTI SECTORUL 3",179169,1,PART,PRCNCT,PRSD,PRSD_SV_SECTOR,"2025-05-18 21:57:41",1164,847,704,98,45,835,12,1300,453,196,639
42,"MUNICIPIUL BUCUREŞTI","ŞCOALA GIMNAZIALĂ ”CEZAR BOLLIAC”;",399,"BUCUREŞTI SECTORUL 3",179169,1,PART,PRCNCT,PRSD,PRSD_SV_SECTOR,"2025-05-18 21:48:34",1584,964,890,73,1,954,10,1800,836,236,718
42,"MUNICIPIUL BUCUREŞTI","ŞCOALA GIMNAZIALĂ ”CEZAR BOLLIAC”;",400,"BUCUREŞTI SECTORUL 3",179169,1,PART,PRCNCT,PRSD,PRSD_SV_SECTOR,"2025-05-18 22:07:58",1364,829,780,49,0,815,14,1600,771,216,599
42,"MUNICIPIUL BUCUREŞTI","ŞCOALA GIMNAZIALĂ ”CEZAR BOLLIAC”;",401,"BUCUREŞTI SECTORUL 3",179169,1,PART,PRCNCT,PRSD,PRSD_SV_SECTOR,"2025-05-18 22:01:42",1428,903,849,52,2,887,16,1600,697,216,671
42,"MUNICIPIUL BUCUREŞTI","ŞCOALA GIMNAZIALĂ NR.80;",402,"BUCUREŞTI SECTORUL 3",179169,1,PART,PRCNCT,PRSD,PRSD_SV_SECTOR,"2025-05-18 22:30:37",1207,975,668,307,0,963,12,2100,1125,250,713
42,"MUNICIPIUL BUCUREŞTI","ŞCOALA GIMNAZIALĂ NR.80;",403,"BUCUREŞTI SECTORUL 3",179169,1,PART,PRCNCT,PRSD,PRSD_SV_SECTOR,"2025-05-18 21:51:38",1077,705,464,241,0,700,5,2000,1295,142,558
42,"MUNICIPIUL BUCUREŞTI","ŞCOALA GIMNAZIALĂ NR.80;",404,"BUCUREŞTI SECTORUL 3",179169,1,PART,PRCNCT,PRSD,PRSD_SV_SECTOR,"2025-05-18 23:46:16",1869,1113,1041,72,0,1094,19,2100,987,298,796
42,"MUNICIPIUL BUCUREŞTI","ŞCOALA GIMNAZIALĂ NR.80;",405,"BUCUREŞTI SECTORUL 3",179169,1,PART,PRCNCT,PRSD,PRSD_SV_SECTOR,"2025-05-18 22:14:20",1416,996,813,181,2,983,13,1400,404,231,752
42,"MUNICIPIUL BUCUREŞTI","ŞCOALA GIMNAZIALĂ NR.80;",406,"BUCUREŞTI SECTORUL 3",179169,1,PART,PRCNCT,PRSD,PRSD_SV_SECTOR,"2025-05-18 21:50:01",984,817,533,283,1,807,10,1800,983,165,642
42,"MUNICIPIUL BUCUREŞTI","ŞCOALA GIMNAZIALĂ NR.80;",407,"BUCUREŞTI SECTORUL 3",179169,2,PART,PRCNCT,PRSD,PRSD_SV_SECTOR,"2025-05-19 01:46:33",967,778,506,270,2,767,11,1800,1022,176,591
42,"MUNICIPIUL BUCUREŞTI","ŞCOALA GIMNAZIALĂ NR.80;",408,"BUCUREŞTI SECTORUL 3",179169,1,PART,PRCNCT,PRSD,PRSD_SV_SECTOR,"2025-05-18 22:01:35",1131,889,674,214,1,879,10,1300,411,176,703
42,"MUNICIPIUL BUCUREŞTI","ŞCOALA GIMNAZIALĂ NR.80;",409,"BUCUREŞTI SECTORUL 3",179169,1,PART,PRCNCT,PRSD,PRSD_SV_SECTOR,"2025-05-18 21:41:49",985,734,569,165,0,728,6,1800,1066,168,560
42,"MUNICIPIUL BUCUREŞTI","ŞCOALA GIMNAZIALĂ NR.81;",410,"BUCUREŞTI SECTORUL 3",179169,1,PART,PRCNCT,PRSD,PRSD_SV_SECTOR,"2025-05-18 22:07:48",1755,1336,1043,291,2,1322,14,2000,664,332,990
42,"MUNICIPIUL BUCUREŞTI","ŞCOALA GIMNAZIALĂ NR.81;",411,"BUCUREŞTI SECTORUL 3",179169,1,PART,PRCNCT,PRSD,PRSD_SV_SECTOR,"2025-05-18 23:23:07",1527,999,728,271,0,985,14,1700,701,235,750
42,"MUNICIPIUL BUCUREŞTI","ŞCOALA GIMNAZIALĂ NR.81;",412,"BUCUREŞTI SECTORUL 3",179169,1,PART,PRCNCT,PRSD,PRSD_SV_SECTOR,"2025-05-18 22:13:56",1336,1086,777,308,1,1065,21,1400,314,257,808
42,"MUNICIPIUL BUCUREŞTI","ŞCOALA GIMNAZIALĂ NR.81;",413,"BUCUREŞTI SECTORUL 3",179169,1,PART,PRCNCT,PRSD,PRSD_SV_SECTOR,"2025-05-18 22:05:50",985,817,574,242,1,805,12,999,182,205,600
42,"MUNICIPIUL BUCUREŞTI","ŞCOALA GIMNAZIALĂ NR.81;",414,"BUCUREŞTI SECTORUL 3",179169,1,PART,PRCNCT,PRSD,PRSD_SV_SECTOR,"2025-05-18 22:04:39",1767,1319,1180,139,0,1283,36,2000,681,289,994
42,"MUNICIPIUL BUCUREŞTI","ŞCOALA GIMNAZIALĂ NR.81;",415,"BUCUREŞTI SECTORUL 3",179169,1,PART,PRCNCT,PRSD,PRSD_SV_SECTOR,"2025-05-18 22:15:38",1416,1059,745,314,0,1045,14,1600,541,214,831
42,"MUNICIPIUL BUCUREŞTI","ŞCOALA GIMNAZIALĂ NR.81;",416,"BUCUREŞTI SECTORUL 3",179169,1,PART,PRCNCT,PRSD,PRSD_SV_SECTOR,"2025-05-18 21:39:59",1401,884,777,106,1,872,12,1600,716,241,631
42,"MUNICIPIUL BUCUREŞTI","ŞCOALA GIMNAZIALĂ NR.81;",417,"BUCUREŞTI SECTORUL 3",179169,1,PART,PRCNCT,PRSD,PRSD_SV_SECTOR,"2025-05-18 22:33:08",1295,786,663,123,0,775,11,1400,614,200,575
42,"MUNICIPIUL BUCUREŞTI","ŞCOALA GIMNAZIALĂ NR.81;",418,"BUCUREŞTI SECTORUL 3",179169,2,PART,PRCNCT,PRSD,PRSD_SV_SECTOR,"2025-05-19 01:54:40",1131,908,673,234,1,889,19,1200,292,192,697
42,"MUNICIPIUL BUCUREŞTI","COLEGIUL TEHNIC ”MIHAI BRAVU”;",419,"BUCUREŞTI SECTORUL 3",179169,1,PART,PRCNCT,PRSD,PRSD_SV_SECTOR,"2025-05-18 21:49:15",1471,748,588,158,2,745,3,1600,852,219,526
42,"MUNICIPIUL BUCUREŞTI","COLEGIUL TEHNIC ”MIHAI BRAVU”;",420,"BUCUREŞTI SECTORUL 3",179169,1,PART,PRCNCT,PRSD,PRSD_SV_SECTOR,"2025-05-18 22:19:19",1535,933,775,155,3,918,15,1700,767,227,691
42,"MUNICIPIUL BUCUREŞTI","COLEGIUL TEHNIC ”MIHAI BRAVU”;",421,"BUCUREŞTI SECTORUL 3",179169,2,PART,PRCNCT,PRSD,PRSD_SV_SECTOR,"2025-05-19 01:37:28",1344,845,702,136,7,839,6,1400,555,192,647
42,"MUNICIPIUL BUCUREŞTI","COLEGIUL TEHNIC ”MIHAI BRAVU”;",422,"BUCUREŞTI SECTORUL 3",179169,1,PART,PRCNCT,PRSD,PRSD_SV_SECTOR,"2025-05-18 22:01:22",1491,874,775,99,0,862,12,1600,726,236,626
42,"MUNICIPIUL BUCUREŞTI","COLEGIUL TEHNIC ”MIHAI BRAVU”;",423,"BUCUREŞTI SECTORUL 3",179169,1,PART,PRCNCT,PRSD,PRSD_SV_SECTOR,"2025-05-18 22:04:12",960,526,466,60,0,520,6,1000,474,177,343
42,"MUNICIPIUL BUCUREŞTI","COLEGIUL TEHNIC ”MIHAI BRAVU”;",424,"BUCUREŞTI SECTORUL 3",179169,1,PART,PRCNCT,PRSD,PRSD_SV_SECTOR,"2025-05-18 22:23:41",1465,886,782,103,1,864,22,1600,714,255,609
42,"MUNICIPIUL BUCUREŞTI","COLEGIUL TEHNIC ”MIHAI BRAVU”;",425,"BUCUREŞTI SECTORUL 3",179169,1,PART,PRCNCT,PRSD,PRSD_SV_SECTOR,"2025-05-18 21:58:06",1226,701,654,47,0,690,11,1300,599,206,484
42,"MUNICIPIUL BUCUREŞTI","COLEGIUL TEHNIC ”MIHAI BRAVU”;",426,"BUCUREŞTI SECTORUL 3",179169,1,PART,PRCNCT,PRSD,PRSD_SV_SECTOR,"2025-05-18 22:13:40",1061,748,579,169,0,741,7,1200,452,174,567
42,"MUNICIPIUL BUCUREŞTI","COLEGIUL TEHNIC ”MIHAI BRAVU”;",427,"BUCUREŞTI SECTORUL 3",179169,1,PART,PRCNCT,PRSD,PRSD_SV_SECTOR,"2025-05-18 22:00:55",1121,838,602,236,0,825,13,1300,462,239,586
42,"MUNICIPIUL BUCUREŞTI","COLEGIUL TEHNIC ”MIHAI BRAVU”;",428,"BUCUREŞTI SECTORUL 3",179169,1,PART,PRCNCT,PRSD,PRSD_SV_SECTOR,"2025-05-18 22:22:58",1183,814,676,138,0,801,13,1300,486,222,579
42,"MUNICIPIUL BUCUREŞTI","COLEGIUL TEHNIC ”MIHAI BRAVU”;",429,"BUCUREŞTI SECTORUL 3",179169,1,PART,PRCNCT,PRSD,PRSD_SV_SECTOR,"2025-05-18 23:59:36",1315,926,716,209,1,913,13,1600,674,202,711
42,"MUNICIPIUL BUCUREŞTI","COLEGIUL TEHNIC ”MIHAI BRAVU”;",430,"BUCUREŞTI SECTORUL 3",179169,1,PART,PRCNCT,PRSD,PRSD_SV_SECTOR,"2025-05-18 22:13:52",1299,742,629,113,0,734,8,1600,858,186,548
42,"MUNICIPIUL BUCUREŞTI","COLEGIUL TEHNIC ”MIHAI BRAVU”;",431,"BUCUREŞTI SECTORUL 3",179169,1,PART,PRCNCT,PRSD,PRSD_SV_SECTOR,"2025-05-18 22:32:53",1033,636,542,92,2,629,7,1200,564,178,451
42,"MUNICIPIUL BUCUREŞTI","ŞCOALA GIMNAZIALĂ NR.95;",432,"BUCUREŞTI SECTORUL 3",179169,1,PART,PRCNCT,PRSD,PRSD_SV_SECTOR,"2025-05-18 21:38:29",1438,838,750,88,0,830,8,1600,762,211,619
42,"MUNICIPIUL BUCUREŞTI","ŞCOALA GIMNAZIALĂ NR.95;",433,"BUCUREŞTI SECTORUL 3",179169,1,PART,PRCNCT,PRSD,PRSD_SV_SECTOR,"2025-05-18 21:50:13",1828,1144,991,152,1,1125,19,2000,856,234,891
42,"MUNICIPIUL BUCUREŞTI","ŞCOALA GIMNAZIALĂ NR.95;",434,"BUCUREŞTI SECTORUL 3",179169,3,PART,PRCNCT,PRSD,PRSD_SV_SECTOR,"2025-05-18 23:50:28",1446,899,690,206,3,891,8,1600,701,286,605
42,"MUNICIPIUL BUCUREŞTI","ŞCOALA GIMNAZIALĂ NR.95;",435,"BUCUREŞTI SECTORUL 3",179169,1,PART,PRCNCT,PRSD,PRSD_SV_SECTOR,"2025-05-18 21:59:09",1417,1177,785,392,0,1163,14,1600,423,233,930
42,"MUNICIPIUL BUCUREŞTI","ŞCOALA GIMNAZIALĂ NR.95;",436,"BUCUREŞTI SECTORUL 3",179169,1,PART,PRCNCT,PRSD,PRSD_SV_SECTOR,"2025-05-18 22:03:46",1390,952,720,229,3,939,13,1600,648,219,720
42,"MUNICIPIUL BUCUREŞTI","ŞCOALA GIMNAZIALĂ NR.95;",437,"BUCUREŞTI SECTORUL 3",179169,1,PART,PRCNCT,PRSD,PRSD_SV_SECTOR,"2025-05-18 21:58:24",1376,861,588,273,0,849,12,1400,539,250,599
42,"MUNICIPIUL BUCUREŞTI","ŞCOALA GIMNAZIALĂ NR.95;",438,"BUCUREŞTI SECTORUL 3",179169,1,PART,PRCNCT,PRSD,PRSD_SV_SECTOR,"2025-05-18 22:22:42",1648,1111,951,159,1,1096,15,1800,689,277,819
42,"MUNICIPIUL BUCUREŞTI","ŞCOALA GIMNAZIALĂ NR.95;",439,"BUCUREŞTI SECTORUL 3",179169,1,PART,PRCNCT,PRSD,PRSD_SV_SECTOR,"2025-05-18 21:51:18",1285,812,733,77,2,793,19,1400,588,240,553
42,"MUNICIPIUL BUCUREŞTI","ŞCOALA GIMNAZIALĂ NR.95;",440,"BUCUREŞTI SECTORUL 3",179169,1,PART,PRCNCT,PRSD,PRSD_SV_SECTOR,"2025-05-18 21:53:32",1365,940,792,147,1,922,18,1600,660,239,683
42,"MUNICIPIUL BUCUREŞTI","ŞCOALA GIMNAZIALĂ NR.95;",441,"BUCUREŞTI SECTORUL 3",179169,1,PART,PRCNCT,PRSD,PRSD_SV_SECTOR,"2025-05-18 22:06:31",1458,861,792,68,1,856,5,1600,739,229,627
42,"MUNICIPIUL BUCUREŞTI","ŞCOALA GIMNAZIALĂ NR.84",442,"BUCUREŞTI SECTORUL 3",179169,1,PART,PRCNCT,PRSD,PRSD_SV_SECTOR,"2025-05-18 22:27:55",1410,921,771,147,3,911,10,1600,679,260,651
42,"MUNICIPIUL BUCUREŞTI","ŞCOALA GIMNAZIALĂ NR.84",443,"BUCUREŞTI SECTORUL 3",179169,1,PART,PRCNCT,PRSD,PRSD_SV_SECTOR,"2025-05-18 21:49:14",1269,779,515,263,1,766,13,1399,620,272,494
42,"MUNICIPIUL BUCUREŞTI","ŞCOALA GIMNAZIALĂ NR.84",444,"BUCUREŞTI SECTORUL 3",179169,1,PART,PRCNCT,PRSD,PRSD_SV_SECTOR,"2025-05-18 22:00:38",1174,739,605,134,0,733,6,1300,561,214,519
42,"MUNICIPIUL BUCUREŞTI","ŞCOALA GIMNAZIALĂ NR.84",445,"BUCUREŞTI SECTORUL 3",179169,1,PART,PRCNCT,PRSD,PRSD_SV_SECTOR,"2025-05-18 22:03:24",1285,907,676,231,0,904,3,1400,493,266,638
42,"MUNICIPIUL BUCUREŞTI","ŞCOALA GIMNAZIALĂ NR.84",446,"BUCUREŞTI SECTORUL 3",179169,1,PART,PRCNCT,PRSD,PRSD_SV_SECTOR,"2025-05-18 22:26:21",1281,830,679,151,0,819,11,1400,570,222,597
42,"MUNICIPIUL BUCUREŞTI","ŞCOALA GIMNAZIALĂ NR.84;",447,"BUCUREŞTI SECTORUL 3",179169,1,PART,PRCNCT,PRSD,PRSD_SV_SECTOR,"2025-05-18 22:17:25",1100,712,563,149,0,704,8,1200,488,241,463
42,"MUNICIPIUL BUCUREŞTI","ŞCOALA GIMNAZIALĂ NR.86;",448,"BUCUREŞTI SECTORUL 3",179169,1,PART,PRCNCT,PRSD,PRSD_SV_SECTOR,"2025-05-18 21:54:28",1275,877,699,176,2,861,16,1400,523,207,654
42,"MUNICIPIUL BUCUREŞTI","ŞCOALA GIMNAZIALĂ NR.86;",449,"BUCUREŞTI SECTORUL 3",179169,1,PART,PRCNCT,PRSD,PRSD_SV_SECTOR,"2025-05-18 22:47:04",1763,1155,997,156,2,1139,16,2000,845,250,889
42,"MUNICIPIUL BUCUREŞTI","ŞCOALA GIMNAZIALĂ NR.86;",450,"BUCUREŞTI SECTORUL 3",179169,1,PART,PRCNCT,PRSD,PRSD_SV_SECTOR,"2025-05-18 21:50:22",1531,1044,881,159,4,1019,25,1700,656,265,754
42,"MUNICIPIUL BUCUREŞTI","ŞCOALA GIMNAZIALĂ NR.86;",451,"BUCUREŞTI SECTORUL 3",179169,1,PART,PRCNCT,PRSD,PRSD_SV_SECTOR,"2025-05-18 21:51:21",1504,974,787,185,2,962,12,1700,726,250,712
42,"MUNICIPIUL BUCUREŞTI","ŞCOALA GIMNAZIALĂ NR.86;",452,"BUCUREŞTI SECTORUL 3",179169,1,PART,PRCNCT,PRSD,PRSD_SV_SECTOR,"2025-05-18 21:46:48",1486,809,741,68,0,795,14,1700,891,238,557
42,"MUNICIPIUL BUCUREŞTI","ŞCOALA GIMNAZIALĂ NR.86;",453,"BUCUREŞTI SECTORUL 3",179169,1,PART,PRCNCT,PRSD,PRSD_SV_SECTOR,"2025-05-18 22:07:41",1211,749,656,91,2,742,7,1300,551,207,535
42,"MUNICIPIUL BUCUREŞTI","ŞCOALA GIMNAZIALĂ NR.86;",454,"BUCUREŞTI SECTORUL 3",179169,1,PART,PRCNCT,PRSD,PRSD_SV_SECTOR,"2025-05-18 21:42:41",1580,956,891,64,1,945,11,1700,744,176,769
42,"MUNICIPIUL BUCUREŞTI","ŞCOALA GIMNAZIALĂ ”LEONARDO DA VINCI”;",455,"BUCUREŞTI SECTORUL 3",179169,1,PART,PRCNCT,PRSD,PRSD_SV_SECTOR,"2025-05-18 22:12:42",1591,997,897,86,14,983,14,1700,703,243,740
42,"MUNICIPIUL BUCUREŞTI","ŞCOALA GIMNAZIALĂ ”LEONARDO DA VINCI”;",456,"BUCUREŞTI SECTORUL 3",179169,1,PART,PRCNCT,PRSD,PRSD_SV_SECTOR,"2025-05-18 21:52:15",1301,861,705,154,2,849,12,1400,539,212,637
42,"MUNICIPIUL BUCUREŞTI","ŞCOALA GIMNAZIALĂ ”LEONARDO DA VINCI”;",457,"BUCUREŞTI SECTORUL 3",179169,1,PART,PRCNCT,PRSD,PRSD_SV_SECTOR,"2025-05-18 22:26:10",1392,1073,736,337,0,1065,8,1600,527,287,778
42,"MUNICIPIUL BUCUREŞTI","ŞCOALA GIMNAZIALĂ ”LEONARDO DA VINCI”;",458,"BUCUREŞTI SECTORUL 3",179169,1,PART,PRCNCT,PRSD,PRSD_SV_SECTOR,"2025-05-18 21:36:21",1177,837,667,170,0,827,10,1300,463,214,613
42,"MUNICIPIUL BUCUREŞTI","ŞCOALA GIMNAZIALĂ ”LEONARDO DA VINCI”;",459,"BUCUREŞTI SECTORUL 3",179169,1,PART,PRCNCT,PRSD,PRSD_SV_SECTOR,"2025-05-18 22:15:49",1108,760,666,94,0,749,11,1200,440,164,585
42,"MUNICIPIUL BUCUREŞTI","ŞCOALA GIMNAZIALĂ ”LEONARDO DA VINCI”;",460,"BUCUREŞTI SECTORUL 3",179169,1,PART,PRCNCT,PRSD,PRSD_SV_SECTOR,"2025-05-18 21:52:13",1036,687,595,92,0,670,17,1200,513,182,488
42,"MUNICIPIUL BUCUREŞTI","ŞCOALA GIMNAZIALĂ ”LEONARDO DA VINCI”;",461,"BUCUREŞTI SECTORUL 3",179169,1,PART,PRCNCT,PRSD,PRSD_SV_SECTOR,"2025-05-18 21:44:23",997,632,604,28,0,621,11,1000,368,171,450
42,"MUNICIPIUL BUCUREŞTI","ŞCOALA GIMNAZIALĂ ”LEONARDO DA VINCI”;",462,"BUCUREŞTI SECTORUL 3",179169,1,PART,PRCNCT,PRSD,PRSD_SV_SECTOR,"2025-05-18 22:01:05",902,577,526,49,2,565,12,1000,423,156,409
42,"MUNICIPIUL BUCUREŞTI","ŞCOALA GIMNAZIALĂ ”LEONARDO DA VINCI”;",463,"BUCUREŞTI SECTORUL 3",179169,1,PART,PRCNCT,PRSD,PRSD_SV_SECTOR,"2025-05-18 22:00:14",1136,667,622,45,0,659,8,1300,633,191,468
42,"MUNICIPIUL BUCUREŞTI","LICEUL TEORETIC ”BENJAMIN FRANKLIN”;",464,"BUCUREŞTI SECTORUL 3",179169,1,PART,PRCNCT,PRSD,PRSD_SV_SECTOR,"2025-05-18 21:38:21",1210,807,670,137,0,792,15,1300,493,181,611
42,"MUNICIPIUL BUCUREŞTI","LICEUL TEORETIC ”BENJAMIN FRANKLIN”;",465,"BUCUREŞTI SECTORUL 3",179169,1,PART,PRCNCT,PRSD,PRSD_SV_SECTOR,"2025-05-18 22:30:27",1250,783,712,71,0,770,13,1400,617,211,559
42,"MUNICIPIUL BUCUREŞTI","LICEUL TEORETIC ”BENJAMIN FRANKLIN”;",466,"BUCUREŞTI SECTORUL 3",179169,1,PART,PRCNCT,PRSD,PRSD_SV_SECTOR,"2025-05-18 21:37:28",919,516,485,31,0,503,13,999,483,121,382
42,"MUNICIPIUL BUCUREŞTI","LICEUL TEORETIC ”BENJAMIN FRANKLIN”;",467,"BUCUREŞTI SECTORUL 3",179169,1,PART,PRCNCT,PRSD,PRSD_SV_SECTOR,"2025-05-18 21:57:58",1025,643,614,26,3,633,10,1200,557,184,449
42,"MUNICIPIUL BUCUREŞTI","COLEGIUL TEHNIC ”ANGHEL SALIGNY”;",468,"BUCUREŞTI SECTORUL 3",179169,1,PART,PRCNCT,PRSD,PRSD_SV_SECTOR,"2025-05-18 21:52:21",1138,757,635,120,2,744,13,1300,543,205,539
42,"MUNICIPIUL BUCUREŞTI","COLEGIUL TEHNIC ”ANGHEL SALIGNY”;",469,"BUCUREŞTI SECTORUL 3",179169,1,PART,PRCNCT,PRSD,PRSD_SV_SECTOR,"2025-05-18 21:42:44",1215,720,663,57,0,708,12,1300,580,204,504
42,"MUNICIPIUL BUCUREŞTI","COLEGIUL TEHNIC ”ANGHEL SALIGNY”;",470,"BUCUREŞTI SECTORUL 3",179169,1,PART,PRCNCT,PRSD,PRSD_SV_SECTOR,"2025-05-18 21:50:45",1269,664,617,47,0,654,10,1400,736,191,463
42,"MUNICIPIUL BUCUREŞTI","COLEGIUL TEHNIC ”ANGHEL SALIGNY”;",471,"BUCUREŞTI SECTORUL 3",179169,1,PART,PRCNCT,PRSD,PRSD_SV_SECTOR,"2025-05-18 21:52:59",1218,740,692,47,1,734,6,1300,560,180,554
42,"MUNICIPIUL BUCUREŞTI","COLEGIUL TEHNIC ”ANGHEL SALIGNY”;",472,"BUCUREŞTI SECTORUL 3",179169,1,PART,PRCNCT,PRSD,PRSD_SV_SECTOR,"2025-05-18 21:50:48",1752,1014,970,43,1,1004,10,2000,986,273,731
42,"MUNICIPIUL BUCUREŞTI","COLEGIUL TEHNIC ”ANGHEL SALIGNY”;",473,"BUCUREŞTI SECTORUL 3",179169,1,PART,PRCNCT,PRSD,PRSD_SV_SECTOR,"2025-05-18 22:09:13",721,538,336,202,0,531,7,800,262,147,384
42,"MUNICIPIUL BUCUREŞTI","COLEGIUL TEHNIC ”ANGHEL SALIGNY”;",474,"BUCUREŞTI SECTORUL 3",179169,1,PART,PRCNCT,PRSD,PRSD_SV_SECTOR,"2025-05-18 21:46:24",751,547,428,118,1,542,5,900,353,144,398
42,"MUNICIPIUL BUCUREŞTI","ŞCOALA GIMNAZIALĂ NR.88",475,"BUCUREŞTI SECTORUL 3",179169,1,PART,PRCNCT,PRSD,PRSD_SV_SECTOR,"2025-05-18 21:54:04",1247,877,673,203,1,866,11,1400,523,219,647
42,"MUNICIPIUL BUCUREŞTI","ŞCOALA GIMNAZIALĂ NR.88",476,"BUCUREŞTI SECTORUL 3",179169,1,PART,PRCNCT,PRSD,PRSD_SV_SECTOR,"2025-05-18 22:17:20",1301,869,734,134,1,861,8,1400,531,205,656
42,"MUNICIPIUL BUCUREŞTI","ŞCOALA GIMNAZIALĂ NR.88",477,"BUCUREŞTI SECTORUL 3",179169,1,PART,PRCNCT,PRSD,PRSD_SV_SECTOR,"2025-05-18 22:13:14",1191,855,643,210,2,839,16,1300,445,211,628
42,"MUNICIPIUL BUCUREŞTI","ŞCOALA GIMNAZIALĂ NR.88",478,"BUCUREŞTI SECTORUL 3",179169,1,PART,PRCNCT,PRSD,PRSD_SV_SECTOR,"2025-05-18 21:47:03",1380,911,795,115,1,896,15,1600,689,210,686
42,"MUNICIPIUL BUCUREŞTI","ŞCOALA GIMNAZIALĂ NR.88",479,"BUCUREŞTI SECTORUL 3",179169,1,PART,PRCNCT,PRSD,PRSD_SV_SECTOR,"2025-05-18 21:37:29",1392,887,800,84,3,871,16,1600,713,195,676
42,"MUNICIPIUL BUCUREŞTI","ŞCOALA GIMNAZIALĂ NR.88",480,"BUCUREŞTI SECTORUL 3",179169,1,PART,PRCNCT,PRSD,PRSD_SV_SECTOR,"2025-05-18 21:29:13",1197,770,670,100,0,754,16,1300,530,153,601
42,"MUNICIPIUL BUCUREŞTI","ŞCOALA GIMNAZIALĂ ”MIHAI BOTEZ”;",481,"BUCUREŞTI SECTORUL 3",179169,1,PART,PRCNCT,PRSD,PRSD_SV_SECTOR,"2025-05-18 21:59:51",1449,1034,840,192,2,1024,10,1600,566,251,773
42,"MUNICIPIUL BUCUREŞTI","ŞCOALA GIMNAZIALĂ ”MIHAI BOTEZ”;",482,"BUCUREŞTI SECTORUL 3",179169,1,PART,PRCNCT,PRSD,PRSD_SV_SECTOR,"2025-05-18 22:03:44",1240,837,672,165,0,825,12,1300,463,228,597
42,"MUNICIPIUL BUCUREŞTI","ŞCOALA GIMNAZIALĂ ”MIHAI BOTEZ”;",483,"BUCUREŞTI SECTORUL 3",179169,1,PART,PRCNCT,PRSD,PRSD_SV_SECTOR,"2025-05-18 21:30:21",1232,783,655,128,0,773,10,1300,517,223,550
42,"MUNICIPIUL BUCUREŞTI","ŞCOALA GIMNAZIALĂ ”MIHAI BOTEZ”;",484,"BUCUREŞTI SECTORUL 3",179169,1,PART,PRCNCT,PRSD,PRSD_SV_SECTOR,"2025-05-18 21:51:19",2112,1265,1168,97,0,1258,7,2400,1135,300,958
42,"MUNICIPIUL BUCUREŞTI","ŞCOALA GIMNAZIALĂ ”MIHAI BOTEZ”;",485,"BUCUREŞTI SECTORUL 3",179169,1,PART,PRCNCT,PRSD,PRSD_SV_SECTOR,"2025-05-18 22:21:57",1289,764,694,69,1,753,11,1408,644,236,517
42,"MUNICIPIUL BUCUREŞTI","ŞCOALA GIMNAZIALĂ ”MIHAI BOTEZ”;",486,"BUCUREŞTI SECTORUL 3",179169,2,PART,PRCNCT,PRSD,PRSD_SV_SECTOR,"2025-05-19 03:37:36",1286,885,707,176,2,857,16,1412,527,255,602
42,"MUNICIPIUL BUCUREŞTI","ŞCOALA GIMNAZIALĂ ”MIHAI BOTEZ”;",487,"BUCUREŞTI SECTORUL 3",179169,1,PART,PRCNCT,PRSD,PRSD_SV_SECTOR,"2025-05-18 22:23:14",1228,828,664,164,0,816,12,1300,472,258,558
42,"MUNICIPIUL BUCUREŞTI","ŞCOALA GIMNAZIALĂ ”MIHAI BOTEZ”;",488,"BUCUREŞTI SECTORUL 3",179169,1,PART,PRCNCT,PRSD,PRSD_SV_SECTOR,"2025-05-18 21:33:59",1226,805,634,171,0,798,7,1300,495,210,588
42,"MUNICIPIUL BUCUREŞTI","ŞCOALA GIMNAZIALĂ ”MIHAI BOTEZ”;",489,"BUCUREŞTI SECTORUL 3",179169,1,PART,PRCNCT,PRSD,PRSD_SV_SECTOR,"2025-05-18 21:36:54",1386,844,692,152,0,834,10,1400,556,230,604
42,"MUNICIPIUL BUCUREŞTI","ŞCOALA GIMNAZIALĂ ”MIHAI BOTEZ”;",490,"BUCUREŞTI SECTORUL 3",179169,1,PART,PRCNCT,PRSD,PRSD_SV_SECTOR,"2025-05-18 22:36:56",1358,802,716,82,4,791,11,1376,574,247,544
42,"MUNICIPIUL BUCUREŞTI","ŞCOALA GIMNAZIALĂ ”MIHAI BOTEZ”;",491,"BUCUREŞTI SECTORUL 3",179169,1,PART,PRCNCT,PRSD,PRSD_SV_SECTOR,"2025-05-18 21:52:24",1478,884,783,101,0,875,9,1700,816,329,546
42,"MUNICIPIUL BUCUREŞTI","LICEUL TEORETIC ”DANTE ALIGHIERI”;",492,"BUCUREŞTI SECTORUL 3",179169,1,PART,PRCNCT,PRSD,PRSD_SV_SECTOR,"2025-05-18 21:44:59",1353,892,773,119,0,879,13,1400,508,185,694
42,"MUNICIPIUL BUCUREŞTI","LICEUL TEORETIC ”DANTE ALIGHIERI”;",493,"BUCUREŞTI SECTORUL 3",179169,1,PART,PRCNCT,PRSD,PRSD_SV_SECTOR,"2025-05-18 22:01:42",1267,897,697,200,0,878,19,1400,503,218,660
42,"MUNICIPIUL BUCUREŞTI","LICEUL TEORETIC ”DANTE ALIGHIERI”;",494,"BUCUREŞTI SECTORUL 3",179169,1,PART,PRCNCT,PRSD,PRSD_SV_SECTOR,"2025-05-18 21:47:36",1025,734,592,139,3,727,7,1200,466,170,557
42,"MUNICIPIUL BUCUREŞTI","LICEUL TEORETIC ”DANTE ALIGHIERI”;",495,"BUCUREŞTI SECTORUL 3",179169,2,PART,PRCNCT,PRSD,PRSD_SV_SECTOR,"2025-05-18 22:46:42",1021,685,600,85,0,674,11,1200,515,165,509
42,"MUNICIPIUL BUCUREŞTI","LICEUL TEORETIC ”DANTE ALIGHIERI”;",496,"BUCUREŞTI SECTORUL 3",179169,1,PART,PRCNCT,PRSD,PRSD_SV_SECTOR,"2025-05-18 21:34:40",1138,696,635,61,0,691,5,1301,605,164,527
42,"MUNICIPIUL BUCUREŞTI","ŞCOALA GIMNAZIALĂ NR.195;",497,"BUCUREŞTI SECTORUL 3",179169,1,PART,PRCNCT,PRSD,PRSD_SV_SECTOR,"2025-05-18 21:45:23",1160,943,736,203,4,931,12,1300,357,143,788
42,"MUNICIPIUL BUCUREŞTI","ŞCOALA GIMNAZIALĂ NR.195;",498,"BUCUREŞTI SECTORUL 3",179169,1,PART,PRCNCT,PRSD,PRSD_SV_SECTOR,"2025-05-18 22:33:59",1110,851,689,159,3,835,16,1200,349,181,654
42,"MUNICIPIUL BUCUREŞTI","ŞCOALA GIMNAZIALĂ NR.195;",499,"BUCUREŞTI SECTORUL 3",179169,1,PART,PRCNCT,PRSD,PRSD_SV_SECTOR,"2025-05-18 21:32:24",1063,705,633,68,4,694,11,1200,495,137,557
42,"MUNICIPIUL BUCUREŞTI","ŞCOALA GIMNAZIALĂ NR.195;",500,"BUCUREŞTI SECTORUL 3",179169,1,PART,PRCNCT,PRSD,PRSD_SV_SECTOR,"2025-05-18 22:17:31",928,624,541,81,2,616,8,1000,376,147,469
42,"MUNICIPIUL BUCUREŞTI","ŞCOALA GIMNAZIALĂ NR.195;",501,"BUCUREŞTI SECTORUL 3",179169,1,PART,PRCNCT,PRSD,PRSD_SV_SECTOR,"2025-05-18 21:30:16",965,605,550,55,0,594,11,1000,395,134,460
42,"MUNICIPIUL BUCUREŞTI","LICEUL TEHNOLOGIC ”ELIE RADU”;",502,"BUCUREŞTI SECTORUL 3",179169,1,PART,PRCNCT,PRSD,PRSD_SV_SECTOR,"2025-05-18 21:50:13",1370,880,659,221,0,871,9,1600,720,256,615
42,"MUNICIPIUL BUCUREŞTI","LICEUL TEHNOLOGIC ”ELIE RADU”;",503,"BUCUREŞTI SECTORUL 3",179169,1,PART,PRCNCT,PRSD,PRSD_SV_SECTOR,"2025-05-18 22:07:04",1339,792,687,105,0,785,7,1399,607,224,561
42,"MUNICIPIUL BUCUREŞTI","LICEUL TEHNOLOGIC ”ELIE RADU”;",504,"BUCUREŞTI SECTORUL 3",179169,1,PART,PRCNCT,PRSD,PRSD_SV_SECTOR,"2025-05-18 22:05:35",938,669,494,175,0,658,11,1000,331,172,486
42,"MUNICIPIUL BUCUREŞTI","LICEUL TEHNOLOGIC ”ELIE RADU”;",505,"BUCUREŞTI SECTORUL 3",179169,1,PART,PRCNCT,PRSD,PRSD_SV_SECTOR,"2025-05-18 22:05:21",1500,884,722,162,0,877,7,1700,816,340,537
42,"MUNICIPIUL BUCUREŞTI","LICEUL TEHNOLOGIC ”ELIE RADU”;",506,"BUCUREŞTI SECTORUL 3",179169,1,PART,PRCNCT,PRSD,PRSD_SV_SECTOR,"2025-05-18 21:35:34",1409,743,655,88,0,732,11,1600,857,322,410
42,"MUNICIPIUL BUCUREŞTI","LICEUL TEORETIC ”DECEBAL”;",507,"BUCUREŞTI SECTORUL 3",179169,1,PART,PRCNCT,PRSD,PRSD_SV_SECTOR,"2025-05-18 22:01:59",1024,636,523,113,0,623,13,1208,572,221,402
42,"MUNICIPIUL BUCUREŞTI","LICEUL TEORETIC ”DECEBAL”;",508,"BUCUREŞTI SECTORUL 3",179169,1,PART,PRCNCT,PRSD,PRSD_SV_SECTOR,"2025-05-18 21:46:57",1288,769,637,132,0,761,8,1400,631,255,506
42,"MUNICIPIUL BUCUREŞTI","LICEUL TEORETIC ”DECEBAL”;",509,"BUCUREŞTI SECTORUL 3",179169,1,PART,PRCNCT,PRSD,PRSD_SV_SECTOR,"2025-05-18 21:39:28",1334,690,587,102,1,681,9,1399,709,283,398
42,"MUNICIPIUL BUCUREŞTI","LICEUL TEORETIC ”DECEBAL”;",510,"BUCUREŞTI SECTORUL 3",179169,1,PART,PRCNCT,PRSD,PRSD_SV_SECTOR,"2025-05-18 21:30:01",1260,564,521,43,0,557,7,1400,836,235,322
42,"MUNICIPIUL BUCUREŞTI","ŞCOALA GIMNAZIALĂ NR.54;",511,"BUCUREŞTI SECTORUL 3",179169,1,PART,PRCNCT,PRSD,PRSD_SV_SECTOR,"2025-05-18 21:58:35",980,772,529,243,0,762,10,1000,228,215,547
42,"MUNICIPIUL BUCUREŞTI","ŞCOALA GIMNAZIALĂ NR.54;",512,"BUCUREŞTI SECTORUL 3",179169,1,PART,PRCNCT,PRSD,PRSD_SV_SECTOR,"2025-05-18 21:30:16",1300,804,706,97,1,792,12,1400,596,235,557
42,"MUNICIPIUL BUCUREŞTI","ŞCOALA GIMNAZIALĂ NR.54;",513,"BUCUREŞTI SECTORUL 3",179169,1,PART,PRCNCT,PRSD,PRSD_SV_SECTOR,"2025-05-18 22:18:09",1377,882,716,166,0,875,7,1584,702,242,633
42,"MUNICIPIUL BUCUREŞTI","ŞCOALA GIMNAZIALĂ NR.54;",514,"BUCUREŞTI SECTORUL 3",179169,1,PART,PRCNCT,PRSD,PRSD_SV_SECTOR,"2025-05-18 21:28:09",1253,807,693,114,0,797,10,1400,593,233,564
42,"MUNICIPIUL BUCUREŞTI","ŞCOALA GIMNAZIALĂ NR.54;",515,"BUCUREŞTI SECTORUL 3",179169,1,PART,PRCNCT,PRSD,PRSD_SV_SECTOR,"2025-05-18 21:48:09",1212,712,631,80,1,707,5,1300,588,219,488
42,"MUNICIPIUL BUCUREŞTI","ŞCOALA GIMNAZIALĂ NR.54;",516,"BUCUREŞTI SECTORUL 3",179169,1,PART,PRCNCT,PRSD,PRSD_SV_SECTOR,"2025-05-18 21:44:02",1024,609,531,78,0,600,9,1200,591,172,428
42,"MUNICIPIUL BUCUREŞTI","ŞCOALA GIMNAZIALĂ NR.54;",517,"BUCUREŞTI SECTORUL 3",179169,1,PART,PRCNCT,PRSD,PRSD_SV_SECTOR,"2025-05-18 21:38:36",1225,656,609,45,2,643,13,1300,644,186,457
42,"MUNICIPIUL BUCUREŞTI","ŞCOALA GIMNAZIALĂ NR.54;",518,"BUCUREŞTI SECTORUL 3",179169,1,PART,PRCNCT,PRSD,PRSD_SV_SECTOR,"2025-05-18 21:26:44",1083,603,554,49,0,596,7,1200,597,189,407
42,"MUNICIPIUL BUCUREŞTI","ŞCOALA GIMNAZIALĂ NR.54;",519,"BUCUREŞTI SECTORUL 3",179169,1,PART,PRCNCT,PRSD,PRSD_SV_SECTOR,"2025-05-18 21:23:10",1159,590,565,25,0,584,6,1300,710,160,424
42,"MUNICIPIUL BUCUREŞTI","ŞCOALA GIMNAZIALĂ NR.54;",520,"BUCUREŞTI SECTORUL 3",179169,1,PART,PRCNCT,PRSD,PRSD_SV_SECTOR,"2025-05-18 21:57:15",1370,753,707,46,0,744,9,1400,647,265,479
42,"MUNICIPIUL BUCUREŞTI","ŞCOALA GIMNAZIALĂ ”NICOLAE LABIŞ”;",521,"BUCUREŞTI SECTORUL 3",179169,1,PART,PRCNCT,PRSD,PRSD_SV_SECTOR,"2025-05-18 22:07:18",1421,980,814,166,0,966,14,1600,620,234,732
42,"MUNICIPIUL BUCUREŞTI","ŞCOALA GIMNAZIALĂ ”NICOLAE LABIŞ”;",522,"BUCUREŞTI SECTORUL 3",179169,1,PART,PRCNCT,PRSD,PRSD_SV_SECTOR,"2025-05-18 21:39:58",1293,805,715,90,0,789,16,1400,595,165,624
42,"MUNICIPIUL BUCUREŞTI","ŞCOALA GIMNAZIALĂ ”NICOLAE LABIŞ”;",523,"BUCUREŞTI SECTORUL 3",179169,1,PART,PRCNCT,PRSD,PRSD_SV_SECTOR,"2025-05-18 21:47:55",1796,1017,943,74,0,1003,14,2000,983,311,692
42,"MUNICIPIUL BUCUREŞTI","ŞCOALA GIMNAZIALĂ ”NICOLAE LABIŞ”;",524,"BUCUREŞTI SECTORUL 3",179169,1,PART,PRCNCT,PRSD,PRSD_SV_SECTOR,"2025-05-18 22:07:42",1349,899,735,164,0,884,15,1399,500,217,667
42,"MUNICIPIUL BUCUREŞTI","ŞCOALA GIMNAZIALĂ ”NICOLAE LABIŞ”;",525,"BUCUREŞTI SECTORUL 3",179169,1,PART,PRCNCT,PRSD,PRSD_SV_SECTOR,"2025-05-18 21:53:17",1519,878,810,68,0,863,15,1700,822,257,606
42,"MUNICIPIUL BUCUREŞTI","ŞCOALA GIMNAZIALĂ ”NICOLAE LABIŞ”;",526,"BUCUREŞTI SECTORUL 3",179169,1,PART,PRCNCT,PRSD,PRSD_SV_SECTOR,"2025-05-18 21:57:49",1647,958,905,52,1,947,11,1798,840,319,628
42,"MUNICIPIUL BUCUREŞTI","ŞCOALA GIMNAZIALĂ ”NICOLAE LABIŞ”;",527,"BUCUREŞTI SECTORUL 3",179169,1,PART,PRCNCT,PRSD,PRSD_SV_SECTOR,"2025-05-18 22:10:30",1144,740,698,41,1,729,11,1300,560,144,585
42,"MUNICIPIUL BUCUREŞTI","ŞCOALA GIMNAZIALĂ ”NICOLAE LABIŞ”;",528,"BUCUREŞTI SECTORUL 3",179169,1,PART,PRCNCT,PRSD,PRSD_SV_SECTOR,"2025-05-18 22:46:27",1173,730,690,39,1,714,16,1300,570,162,552
42,"MUNICIPIUL BUCUREŞTI","ŞCOALA GIMNAZIALĂ NR.20;",529,"BUCUREŞTI SECTORUL 3",179169,1,PART,PRCNCT,PRSD,PRSD_SV_SECTOR,"2025-05-18 21:36:24",1511,1026,839,186,1,1017,9,1700,674,288,729
42,"MUNICIPIUL BUCUREŞTI","ŞCOALA GIMNAZIALĂ NR.20;",530,"BUCUREŞTI SECTORUL 3",179169,1,PART,PRCNCT,PRSD,PRSD_SV_SECTOR,"2025-05-18 21:57:19",1368,1004,706,297,1,992,12,1600,596,273,719
42,"MUNICIPIUL BUCUREŞTI","ŞCOALA GIMNAZIALĂ NR.20;",531,"BUCUREŞTI SECTORUL 3",179169,1,PART,PRCNCT,PRSD,PRSD_SV_SECTOR,"2025-05-18 22:09:14",1719,1123,1012,111,0,1105,18,1800,677,327,778
42,"MUNICIPIUL BUCUREŞTI","ŞCOALA GIMNAZIALĂ NR.20;",532,"BUCUREŞTI SECTORUL 3",179169,2,PART,PRCNCT,PRSD,PRSD_SV_SECTOR,"2025-05-19 00:37:36",1282,751,653,98,0,736,15,1400,649,171,565
42,"MUNICIPIUL BUCUREŞTI","ŞCOALA GIMNAZIALĂ NR.20;",533,"BUCUREŞTI SECTORUL 3",179169,1,PART,PRCNCT,PRSD,PRSD_SV_SECTOR,"2025-05-18 21:33:34",1792,1069,992,75,2,1042,27,2000,931,312,730
42,"MUNICIPIUL BUCUREŞTI","ŞCOALA GIMNAZIALĂ NR.20;",534,"BUCUREŞTI SECTORUL 3",179169,1,PART,PRCNCT,PRSD,PRSD_SV_SECTOR,"2025-05-18 21:37:15",1680,929,884,43,2,918,11,1800,871,257,661
42,"MUNICIPIUL BUCUREŞTI","ŞCOALA GIMNAZIALĂ NR.20;",535,"BUCUREŞTI SECTORUL 3",179169,1,PART,PRCNCT,PRSD,PRSD_SV_SECTOR,"2025-05-18 21:21:18",1395,786,745,41,0,773,13,1600,814,235,538
42,"MUNICIPIUL BUCUREŞTI","ŞCOALA GIMNAZIALĂ NR.20;",536,"BUCUREŞTI SECTORUL 3",179169,1,PART,PRCNCT,PRSD,PRSD_SV_SECTOR,"2025-05-18 21:40:56",1678,1009,938,70,1,996,13,1800,791,295,701
42,"MUNICIPIUL BUCUREŞTI","ŞCOALA GIMNAZIALĂ NR.20;",537,"BUCUREŞTI SECTORUL 3",179169,1,PART,PRCNCT,PRSD,PRSD_SV_SECTOR,"2025-05-18 21:40:52",1378,817,716,101,0,809,8,1600,783,263,546
42,"MUNICIPIUL BUCUREŞTI","ŞCOALA GIMNAZIALĂ NR.20;",538,"BUCUREŞTI SECTORUL 3",179169,1,PART,PRCNCT,PRSD,PRSD_SV_SECTOR,"2025-05-18 22:01:49",1306,803,716,87,0,787,16,1400,597,235,552
42,"MUNICIPIUL BUCUREŞTI","ŞCOALA GIMNAZIALĂ NR.20;",539,"BUCUREŞTI SECTORUL 3",179169,1,PART,PRCNCT,PRSD,PRSD_SV_SECTOR,"2025-05-18 22:06:33",1813,1160,1079,70,11,1149,11,2000,840,294,855
42,"MUNICIPIUL BUCUREŞTI","ŞCOALA GIMNAZIALĂ NR.20;",540,"BUCUREŞTI SECTORUL 3",179169,1,PART,PRCNCT,PRSD,PRSD_SV_SECTOR,"2025-05-18 22:31:10",1479,921,870,51,0,917,4,1600,679,220,697
42,"MUNICIPIUL BUCUREŞTI","ŞCOALA GIMNAZIALĂ NR.20;",541,"BUCUREŞTI SECTORUL 3",179169,1,PART,PRCNCT,PRSD,PRSD_SV_SECTOR,"2025-05-18 22:05:24",1696,940,906,33,1,925,15,1800,860,262,663
42,"MUNICIPIUL BUCUREŞTI","ŞCOALA GIMNAZIALĂ NR.20;",542,"BUCUREŞTI SECTORUL 3",179169,1,PART,PRCNCT,PRSD,PRSD_SV_SECTOR,"2025-05-18 22:11:42",1721,1057,1009,47,1,1041,16,1800,743,317,724
42,"MUNICIPIUL BUCUREŞTI","ŞCOALA GIMNAZIALĂ NR.20;",543,"BUCUREŞTI SECTORUL 3",179169,1,PART,PRCNCT,PRSD,PRSD_SV_SECTOR,"2025-05-18 22:04:01",1354,789,738,50,1,783,6,1400,611,240,543
42,"MUNICIPIUL BUCUREŞTI","COLEGIUL TEHNIC ”COSTIN D. NENIŢESCU”;",544,"BUCUREŞTI SECTORUL 3",179169,1,PART,PRCNCT,PRSD,PRSD_SV_SECTOR,"2025-05-18 22:53:29",1995,1573,1211,361,1,1554,19,2200,627,367,1187
42,"MUNICIPIUL BUCUREŞTI","COLEGIUL TEHNIC ”COSTIN D. NENIŢESCU”;",545,"BUCUREŞTI SECTORUL 3",179169,1,PART,PRCNCT,PRSD,PRSD_SV_SECTOR,"2025-05-18 22:00:00",1784,1303,896,407,0,1277,26,1800,497,385,892
42,"MUNICIPIUL BUCUREŞTI","COLEGIUL TEHNIC ”COSTIN D. NENIŢESCU”;",546,"BUCUREŞTI SECTORUL 3",179169,1,PART,PRCNCT,PRSD,PRSD_SV_SECTOR,"2025-05-18 22:13:48",1671,1159,928,231,0,1147,12,1800,641,320,827
42,"MUNICIPIUL BUCUREŞTI","COLEGIUL TEHNIC ”COSTIN D. NENIŢESCU”;",547,"BUCUREŞTI SECTORUL 3",179169,1,PART,PRCNCT,PRSD,PRSD_SV_SECTOR,"2025-05-18 21:39:02",1604,1115,896,217,2,1101,14,1700,585,275,826
42,"MUNICIPIUL BUCUREŞTI","COLEGIUL TEHNIC ”COSTIN D. NENIŢESCU”;",548,"BUCUREŞTI SECTORUL 3",179169,1,PART,PRCNCT,PRSD,PRSD_SV_SECTOR,"2025-05-18 21:42:02",1631,1082,925,157,0,1067,15,1800,718,256,811
42,"MUNICIPIUL BUCUREŞTI","COLEGIUL TEHNIC ”COSTIN D. NENIȚESCU”;",549,"BUCUREŞTI SECTORUL 3",179169,1,PART,PRCNCT,PRSD,PRSD_SV_SECTOR,"2025-05-18 21:37:50",1588,308,25,283,0,305,3,1700,1392,59,246
42,"MUNICIPIUL BUCUREŞTI","COLEGIUL TEHNIC ”COSTIN D. NENIȚESCU”;",550,"BUCUREŞTI SECTORUL 3",179169,2,PART,PRCNCT,PRSD,PRSD_SV_SECTOR,"2025-05-19 01:06:32",1712,274,44,230,0,272,2,1800,1526,67,205
42,"MUNICIPIUL BUCUREŞTI","COLEGIUL TEHNIC ”COSTIN D. NENIȚESCU”;",551,"BUCUREŞTI SECTORUL 3",179169,1,PART,PRCNCT,PRSD,PRSD_SV_SECTOR,"2025-05-18 22:09:28",1976,681,510,171,0,677,4,2200,1519,93,584
42,"MUNICIPIUL BUCUREŞTI","ŞCOALA GIMNAZIALĂ NR.112;",552,"BUCUREŞTI SECTORUL 3",179169,1,PART,PRCNCT,PRSD,PRSD_SV_SECTOR,"2025-05-18 21:44:02",1105,775,604,171,0,758,17,1200,425,266,492
42,"MUNICIPIUL BUCUREŞTI","ŞCOALA GIMNAZIALĂ NR.112;",553,"BUCUREŞTI SECTORUL 3",179169,1,PART,PRCNCT,PRSD,PRSD_SV_SECTOR,"2025-05-18 21:48:47",1089,823,580,243,0,810,13,1200,377,266,544
42,"MUNICIPIUL BUCUREŞTI","ŞCOALA GIMNAZIALĂ NR.112;",554,"BUCUREŞTI SECTORUL 3",179169,1,PART,PRCNCT,PRSD,PRSD_SV_SECTOR,"2025-05-18 21:49:22",1175,810,620,190,0,804,6,1300,490,263,541
42,"MUNICIPIUL BUCUREŞTI","ŞCOALA GIMNAZIALĂ NR.112;",555,"BUCUREŞTI SECTORUL 3",179169,1,PART,PRCNCT,PRSD,PRSD_SV_SECTOR,"2025-05-18 21:48:37",1408,915,799,114,2,900,15,1600,685,216,684
42,"MUNICIPIUL BUCUREŞTI","ŞCOALA GIMNAZIALĂ NR.112;",556,"BUCUREŞTI SECTORUL 3",179169,1,PART,PRCNCT,PRSD,PRSD_SV_SECTOR,"2025-05-18 21:55:34",1133,717,650,67,0,703,14,1300,583,192,511
42,"MUNICIPIUL BUCUREŞTI","ŞCOALA GIMNAZIALĂ NR.112;",557,"BUCUREŞTI SECTORUL 3",179169,1,PART,PRCNCT,PRSD,PRSD_SV_SECTOR,"2025-05-18 21:33:55",1118,656,622,34,0,646,10,1200,544,194,452
42,"MUNICIPIUL BUCUREŞTI","ŞCOALA GIMNAZIALĂ NR.112;",558,"BUCUREŞTI SECTORUL 3",179169,1,PART,PRCNCT,PRSD,PRSD_SV_SECTOR,"2025-05-18 21:44:09",1058,580,537,43,0,573,7,1200,620,200,373
42,"MUNICIPIUL BUCUREŞTI","ŞCOALA GIMNAZIALĂ NR.112;",559,"BUCUREŞTI SECTORUL 3",179169,1,PART,PRCNCT,PRSD,PRSD_SV_SECTOR,"2025-05-18 21:28:25",1034,579,550,29,0,575,4,1200,621,187,388
42,"MUNICIPIUL BUCUREŞTI","ŞCOALA GIMNAZIALĂ NR.112;",560,"BUCUREŞTI SECTORUL 3",179169,1,PART,PRCNCT,PRSD,PRSD_SV_SECTOR,"2025-05-18 21:22:47",1354,827,770,57,0,811,16,1400,573,227,584
42,"MUNICIPIUL BUCUREŞTI","ŞCOALA GIMNAZIALĂ NR.112;",561,"BUCUREŞTI SECTORUL 3",179169,1,PART,PRCNCT,PRSD,PRSD_SV_SECTOR,"2025-05-18 21:22:43",1076,533,511,22,0,526,7,1200,667,211,315
42,"MUNICIPIUL BUCUREŞTI","ŞCOALA GIMNAZIALĂ NR.200;",562,"BUCUREŞTI SECTORUL 3",179169,1,PART,PRCNCT,PRSD,PRSD_SV_SECTOR,"2025-05-18 21:54:54",1564,1048,913,132,3,1029,19,1700,652,313,716
42,"MUNICIPIUL BUCUREŞTI","ŞCOALA GIMNAZIALĂ NR.200;",563,"BUCUREŞTI SECTORUL 3",179169,1,PART,PRCNCT,PRSD,PRSD_SV_SECTOR,"2025-05-18 21:40:57",1500,1051,883,168,0,1039,12,1600,549,288,751
42,"MUNICIPIUL BUCUREŞTI","ŞCOALA GIMNAZIALĂ NR.200;",564,"BUCUREŞTI SECTORUL 3",179169,1,PART,PRCNCT,PRSD,PRSD_SV_SECTOR,"2025-05-18 21:48:04",1701,1112,962,132,18,1093,19,1813,701,270,823
42,"MUNICIPIUL BUCUREŞTI","ŞCOALA GIMNAZIALĂ NR.200;",565,"BUCUREŞTI SECTORUL 3",179169,1,PART,PRCNCT,PRSD,PRSD_SV_SECTOR,"2025-05-18 21:51:10",1401,761,698,60,3,750,11,1600,839,225,525
42,"MUNICIPIUL BUCUREŞTI","ŞCOALA GIMNAZIALĂ NR.200;",566,"BUCUREŞTI SECTORUL 3",179169,1,PART,PRCNCT,PRSD,PRSD_SV_SECTOR,"2025-05-18 22:05:07",1338,734,666,67,1,727,7,1400,666,257,470
42,"MUNICIPIUL BUCUREŞTI","ŞCOALA GIMNAZIALĂ NR.200;",567,"BUCUREŞTI SECTORUL 3",179169,1,PART,PRCNCT,PRSD,PRSD_SV_SECTOR,"2025-05-18 21:30:40",1261,689,655,34,0,676,13,1400,711,240,436
42,"MUNICIPIUL BUCUREŞTI","ŞCOALA GIMNAZIALĂ NR.200;",568,"BUCUREŞTI SECTORUL 3",179169,1,PART,PRCNCT,PRSD,PRSD_SV_SECTOR,"2025-05-18 21:54:50",1685,1057,984,72,1,1040,17,1800,743,221,819
42,"MUNICIPIUL BUCUREŞTI","ŞCOALA GIMNAZIALĂ ”FEDERICO GARCIA LORCA”;",569,"BUCUREŞTI SECTORUL 3",179169,1,PART,PRCNCT,PRSD,PRSD_SV_SECTOR,"2025-05-18 21:50:54",1160,842,617,225,0,826,16,1300,458,208,618
42,"MUNICIPIUL BUCUREŞTI","ŞCOALA GIMNAZIALĂ ”FEDERICO GARCIA LORCA”;",570,"BUCUREŞTI SECTORUL 3",179169,1,PART,PRCNCT,PRSD,PRSD_SV_SECTOR,"2025-05-18 21:52:03",981,793,582,211,0,780,13,1000,207,173,607
42,"MUNICIPIUL BUCUREŞTI","ŞCOALA GIMNAZIALĂ ”FEDERICO GARCIA LORCA”;",571,"BUCUREŞTI SECTORUL 3",179169,1,PART,PRCNCT,PRSD,PRSD_SV_SECTOR,"2025-05-18 22:11:12",1152,814,701,111,2,803,11,1300,486,204,599
42,"MUNICIPIUL BUCUREŞTI","ŞCOALA GIMNAZIALĂ ”FEDERICO GARCIA LORCA”;",572,"BUCUREŞTI SECTORUL 3",179169,1,PART,PRCNCT,PRSD,PRSD_SV_SECTOR,"2025-05-18 22:02:16",1708,1147,1082,64,1,1125,22,1800,653,203,922
42,"MUNICIPIUL BUCUREŞTI","ŞCOALA GIMNAZIALĂ ”FEDERICO GARCIA LORCA”;",573,"BUCUREŞTI SECTORUL 3",179169,1,PART,PRCNCT,PRSD,PRSD_SV_SECTOR,"2025-05-18 21:37:58",1351,842,771,67,4,835,7,1400,558,180,655
42,"MUNICIPIUL BUCUREŞTI","ŞCOALA GIMNAZIALĂ ”FEDERICO GARCIA LORCA”;",574,"BUCUREŞTI SECTORUL 3",179169,1,PART,PRCNCT,PRSD,PRSD_SV_SECTOR,"2025-05-18 21:36:37",1158,711,658,52,1,697,14,1300,589,198,499
42,"MUNICIPIUL BUCUREŞTI","ŞCOALA GIMNAZIALĂ ”FEDERICO GARCIA LORCA”;",575,"BUCUREŞTI SECTORUL 3",179169,1,PART,PRCNCT,PRSD,PRSD_SV_SECTOR,"2025-05-18 22:26:41",1283,749,705,39,5,741,8,1400,651,207,534
42,"MUNICIPIUL BUCUREŞTI","ŞCOALA GIMNAZIALĂ NR. 22;",576,"BUCUREŞTI SECTORUL 3",179169,1,PART,PRCNCT,PRSD,PRSD_SV_SECTOR,"2025-05-18 21:38:27",1917,1140,1021,112,7,1128,12,2100,960,397,731
42,"MUNICIPIUL BUCUREŞTI","ŞCOALA GIMNAZIALĂ NR. 22;",577,"BUCUREŞTI SECTORUL 3",179169,1,PART,PRCNCT,PRSD,PRSD_SV_SECTOR,"2025-05-18 21:34:08",1632,1117,837,279,1,1104,13,1800,683,387,717
42,"MUNICIPIUL BUCUREŞTI","ŞCOALA GIMNAZIALĂ NR. 22;",578,"BUCUREŞTI SECTORUL 3",179169,1,PART,PRCNCT,PRSD,PRSD_SV_SECTOR,"2025-05-18 22:02:05",1724,978,883,94,1,964,14,1800,822,253,711
42,"MUNICIPIUL BUCUREŞTI","ŞCOALA GIMNAZIALĂ NR. 22;",579,"BUCUREŞTI SECTORUL 3",179169,1,PART,PRCNCT,PRSD,PRSD_SV_SECTOR,"2025-05-18 22:21:11",1739,424,328,96,0,420,4,1799,1375,215,205
42,"MUNICIPIUL BUCUREŞTI","ŞCOALA GIMNAZIALĂ NR. 22;",580,"BUCUREŞTI SECTORUL 3",179169,1,PART,PRCNCT,PRSD,PRSD_SV_SECTOR,"2025-05-18 21:55:27",1594,837,756,81,0,825,12,1699,862,286,539
42,"MUNICIPIUL BUCUREŞTI","ŞCOALA GIMNAZIALĂ NR. 22;",581,"BUCUREŞTI SECTORUL 3",179169,1,PART,PRCNCT,PRSD,PRSD_SV_SECTOR,"2025-05-18 22:04:47",1722,1031,974,56,1,1015,16,1800,769,333,682
42,"MUNICIPIUL BUCUREŞTI","ŞCOALA GIMNAZIALĂ NR. 22;",582,"BUCUREŞTI SECTORUL 3",179169,1,PART,PRCNCT,PRSD,PRSD_SV_SECTOR,"2025-05-18 21:35:00",1679,909,864,45,0,904,5,1800,891,297,607
42,"MUNICIPIUL BUCUREŞTI","ŞCOALA GIMNAZIALĂ NR. 22;",583,"BUCUREŞTI SECTORUL 3",179169,1,PART,PRCNCT,PRSD,PRSD_SV_SECTOR,"2025-05-18 21:41:25",1714,997,948,49,0,973,24,1800,803,402,571
42,"MUNICIPIUL BUCUREŞTI","ŞCOALA GIMNAZIALĂ NR. 22;",584,"BUCUREŞTI SECTORUL 3",179169,1,PART,PRCNCT,PRSD,PRSD_SV_SECTOR,"2025-05-18 21:47:04",1258,756,713,40,3,749,7,1400,644,276,473
42,"MUNICIPIUL BUCUREŞTI","ŞCOALA GIMNAZIALĂ NR. 22;",585,"BUCUREŞTI SECTORUL 3",179169,1,PART,PRCNCT,PRSD,PRSD_SV_SECTOR,"2025-05-18 21:43:01",979,545,524,19,2,539,6,1000,455,159,380
42,"MUNICIPIUL BUCUREŞTI","LICEUL TEORETIC ”AL. I. CUZA”;",586,"BUCUREŞTI SECTORUL 3",179169,1,PART,PRCNCT,PRSD,PRSD_SV_SECTOR,"2025-05-18 21:38:51",1246,809,693,116,0,799,10,1400,591,198,601
42,"MUNICIPIUL BUCUREŞTI","LICEUL TEORETIC ”AL. I. CUZA”;",587,"BUCUREŞTI SECTORUL 3",179169,1,PART,PRCNCT,PRSD,PRSD_SV_SECTOR,"2025-05-18 21:57:34",1194,754,709,45,0,742,12,1300,546,187,555
42,"MUNICIPIUL BUCUREŞTI","LICEUL TEORETIC ”AL. I. CUZA”;",588,"BUCUREŞTI SECTORUL 3",179169,1,PART,PRCNCT,PRSD,PRSD_SV_SECTOR,"2025-05-18 21:45:06",1196,1000,736,264,0,980,20,1300,300,258,722
42,"MUNICIPIUL BUCUREŞTI","LICEUL TEORETIC ”AL. I. CUZA”;",589,"BUCUREŞTI SECTORUL 3",179169,1,PART,PRCNCT,PRSD,PRSD_SV_SECTOR,"2025-05-18 21:46:41",1267,861,719,141,1,848,13,1400,539,218,630
42,"MUNICIPIUL BUCUREŞTI","LICEUL TEORETIC ”AL. I. CUZA”;",590,"BUCUREŞTI SECTORUL 3",179169,1,PART,PRCNCT,PRSD,PRSD_SV_SECTOR,"2025-05-18 21:53:08",1198,753,678,75,0,741,12,1300,547,191,550
42,"MUNICIPIUL BUCUREŞTI","LICEUL TEORETIC ”AL. I. CUZA”;",591,"BUCUREŞTI SECTORUL 3",179169,1,PART,PRCNCT,PRSD,PRSD_SV_SECTOR,"2025-05-18 21:33:41",1403,827,758,67,2,815,12,1600,773,185,630
42,"MUNICIPIUL BUCUREŞTI","LICEUL TEORETIC ”NICHITA STĂNESCU”;",592,"BUCUREŞTI SECTORUL 3",179169,1,PART,PRCNCT,PRSD,PRSD_SV_SECTOR,"2025-05-18 22:17:03",1019,760,513,247,0,748,12,1200,440,200,548
42,"MUNICIPIUL BUCUREŞTI","LICEUL TEORETIC ”NICHITA STĂNESCU”;",593,"BUCUREŞTI SECTORUL 3",179169,1,PART,PRCNCT,PRSD,PRSD_SV_SECTOR,"2025-05-18 21:47:09",1157,765,554,211,0,748,17,1300,535,235,513
42,"MUNICIPIUL BUCUREŞTI","LICEUL TEORETIC ”NICHITA STĂNESCU”;",594,"BUCUREŞTI SECTORUL 3",179169,1,PART,PRCNCT,PRSD,PRSD_SV_SECTOR,"2025-05-18 22:10:00",1595,664,492,172,0,652,12,1800,1136,205,447
42,"MUNICIPIUL BUCUREŞTI","LICEUL TEORETIC ”NICHITA STĂNESCU”;",595,"BUCUREŞTI SECTORUL 3",179169,1,PART,PRCNCT,PRSD,PRSD_SV_SECTOR,"2025-05-18 21:42:35",1026,661,559,102,0,655,6,1208,547,161,494
42,"MUNICIPIUL BUCUREŞTI","LICEUL TEORETIC ”NICHITA STĂNESCU”;",596,"BUCUREŞTI SECTORUL 3",179169,1,PART,PRCNCT,PRSD,PRSD_SV_SECTOR,"2025-05-18 21:35:45",1247,728,648,80,0,719,9,1400,672,226,493
42,"MUNICIPIUL BUCUREŞTI","LICEUL TEORETIC ”NICHITA STĂNESCU”;",597,"BUCUREŞTI SECTORUL 3",179169,1,PART,PRCNCT,PRSD,PRSD_SV_SECTOR,"2025-05-18 21:40:26",1386,760,700,60,0,754,6,1600,840,265,489
42,"MUNICIPIUL BUCUREŞTI","LICEUL TEORETIC ”NICHITA STĂNESCU”;",598,"BUCUREŞTI SECTORUL 3",179169,1,PART,PRCNCT,PRSD,PRSD_SV_SECTOR,"2025-05-18 21:47:10",1243,773,709,64,0,761,12,1400,627,223,538
42,"MUNICIPIUL BUCUREŞTI","LICEUL TEORETIC ”NICHITA STĂNESCU”;",599,"BUCUREŞTI SECTORUL 3",179169,1,PART,PRCNCT,PRSD,PRSD_SV_SECTOR,"2025-05-18 21:36:21",1129,615,566,49,0,611,4,1300,685,144,467
42,"MUNICIPIUL BUCUREŞTI","LICEUL TEORETIC ”NICHITA STĂNESCU”;",600,"BUCUREŞTI SECTORUL 3",179169,1,PART,PRCNCT,PRSD,PRSD_SV_SECTOR,"2025-05-18 21:55:20",1519,897,844,53,0,877,20,1700,803,254,623
42,"MUNICIPIUL BUCUREŞTI","LICEUL TEORETIC ”NICHITA STĂNESCU”;",601,"BUCUREŞTI SECTORUL 3",179169,1,PART,PRCNCT,PRSD,PRSD_SV_SECTOR,"2025-05-18 21:59:09",1260,729,683,45,1,715,14,1399,670,193,522
42,"MUNICIPIUL BUCUREŞTI","ŞCOALA GIMNAZIALĂ NR.149;",602,"BUCUREŞTI SECTORUL 3",179169,1,PART,PRCNCT,PRSD,PRSD_SV_SECTOR,"2025-05-18 21:58:24",1418,1132,799,332,1,1115,17,1600,468,261,854
42,"MUNICIPIUL BUCUREŞTI","ŞCOALA GIMNAZIALĂ NR.149;",603,"BUCUREŞTI SECTORUL 3",179169,1,PART,PRCNCT,PRSD,PRSD_SV_SECTOR,"2025-05-18 22:36:16",2347,1482,1271,210,1,1472,10,2500,1018,351,1121
42,"MUNICIPIUL BUCUREŞTI","ŞCOALA GIMNAZIALĂ NR.149;",604,"BUCUREŞTI SECTORUL 3",179169,1,PART,PRCNCT,PRSD,PRSD_SV_SECTOR,"2025-05-18 22:24:02",1782,1120,985,135,0,1105,15,2000,880,348,757
42,"MUNICIPIUL BUCUREŞTI","ŞCOALA GIMNAZIALĂ NR. 82;",605,"BUCUREŞTI SECTORUL 3",179169,1,PART,PRCNCT,PRSD,PRSD_SV_SECTOR,"2025-05-18 22:07:00",2300,1613,1448,165,0,1596,17,2500,887,332,1264
42,"MUNICIPIUL BUCUREŞTI","ŞCOALA GIMNAZIALĂ NR. 82;",606,"BUCUREŞTI SECTORUL 3",179169,1,PART,PRCNCT,PRSD,PRSD_SV_SECTOR,"2025-05-18 22:10:14",1740,1081,960,121,0,1066,15,2000,919,313,753
42,"MUNICIPIUL BUCUREŞTI","ŞCOALA GIMNAZIALĂ NR. 82;",607,"BUCUREŞTI SECTORUL 3",179169,1,PART,PRCNCT,PRSD,PRSD_SV_SECTOR,"2025-05-18 22:36:03",1309,881,709,154,18,859,22,1400,519,267,592
42,"MUNICIPIUL BUCUREŞTI","ŞCOALA GIMNAZIALĂ NR. 82;",608,"BUCUREŞTI SECTORUL 3",179169,1,PART,PRCNCT,PRSD,PRSD_SV_SECTOR,"2025-05-18 21:49:59",1475,940,778,161,1,924,16,1600,660,264,660
42,"MUNICIPIUL BUCUREŞTI","ŞCOALA GIMNAZIALĂ NR. 82;",609,"BUCUREŞTI SECTORUL 3",179169,1,PART,PRCNCT,PRSD,PRSD_SV_SECTOR,"2025-05-18 23:38:32",1877,1396,1030,363,3,1375,21,2108,712,361,1014
42,"MUNICIPIUL BUCUREŞTI","ŞCOALA GIMNAZIALĂ NR. 82;",610,"BUCUREŞTI SECTORUL 3",179169,1,PART,PRCNCT,PRSD,PRSD_SV_SECTOR,"2025-05-18 22:08:31",1916,1279,1198,79,2,1268,11,2100,821,234,1034
42,"MUNICIPIUL BUCUREŞTI","ŞCOALA GIMNAZIALĂ NR. 82;",611,"BUCUREŞTI SECTORUL 3",179169,1,PART,PRCNCT,PRSD,PRSD_SV_SECTOR,"2025-05-18 21:46:11",1506,895,814,80,1,875,20,1700,805,242,633
42,"MUNICIPIUL BUCUREŞTI","ŞCOALA GIMNAZIALĂ NR. 82;",612,"BUCUREŞTI SECTORUL 3",179169,1,PART,PRCNCT,PRSD,PRSD_SV_SECTOR,"2025-05-18 22:24:25",2005,1246,1144,102,0,1229,17,2200,954,357,872
42,"MUNICIPIUL BUCUREŞTI","ŞCOALA GIMNAZIALĂ NR.116;",613,"BUCUREŞTI SECTORUL 3",179169,1,PART,PRCNCT,PRSD,PRSD_SV_SECTOR,"2025-05-18 22:35:21",2724,1668,1543,125,0,1652,16,3000,1332,443,1209
42,"MUNICIPIUL BUCUREŞTI","ŞCOALA GIMNAZIALĂ NR.116;",614,"BUCUREŞTI SECTORUL 3",179169,1,PART,PRCNCT,PRSD,PRSD_SV_SECTOR,"2025-05-18 21:50:56",2176,1488,1214,274,0,1478,10,2400,912,319,1159
42,"MUNICIPIUL BUCUREŞTI","ŞCOALA GIMNAZIALĂ NR.116;",615,"BUCUREŞTI SECTORUL 3",179169,1,PART,PRCNCT,PRSD,PRSD_SV_SECTOR,"2025-05-18 22:47:59",1982,1503,1079,424,0,1485,18,2200,697,449,1036
42,"MUNICIPIUL BUCUREŞTI","ŞCOALA GIMNAZIALĂ NR.116;",616,"BUCUREŞTI SECTORUL 3",179169,1,PART,PRCNCT,PRSD,PRSD_SV_SECTOR,"2025-05-18 22:15:28",1833,1360,997,363,0,1346,14,2000,640,369,977
42,"MUNICIPIUL BUCUREŞTI","ŞCOALA GIMNAZIALĂ NR.116;",617,"BUCUREŞTI SECTORUL 3",179169,1,PART,PRCNCT,PRSD,PRSD_SV_SECTOR,"2025-05-18 21:47:14",2069,1498,1195,302,1,1483,15,2200,702,337,1146
42,"MUNICIPIUL BUCUREŞTI","ŞCOALA GIMNAZIALĂ NR.116;",618,"BUCUREŞTI SECTORUL 3",179169,1,PART,PRCNCT,PRSD,PRSD_SV_SECTOR,"2025-05-18 21:58:50",1896,1174,987,187,0,1155,19,2100,926,382,773
42,"MUNICIPIUL BUCUREŞTI","ŞCOALA GIMNAZIALĂ NR.116;",619,"BUCUREŞTI SECTORUL 3",179169,1,PART,PRCNCT,PRSD,PRSD_SV_SECTOR,"2025-05-18 22:20:38",2206,1353,1218,135,0,1339,14,2400,1047,423,916
42,"MUNICIPIUL BUCUREŞTI","ȘCOALA GIMNAZIALĂ NR.116;",620,"BUCUREŞTI SECTORUL 3",179169,1,PART,PRCNCT,PRSD,PRSD_SV_SECTOR,"2025-05-19 00:04:25",2551,1669,1506,163,0,1651,18,2600,931,344,1307
42,"MUNICIPIUL BUCUREŞTI","ŞCOALA GIMNAZIALĂ NR.55;",621,"BUCUREŞTI SECTORUL 3",179169,1,PART,PRCNCT,PRSD,PRSD_SV_SECTOR,"2025-05-18 21:17:00",3043,82,50,32,0,82,0,3300,3218,41,41
42,"MUNICIPIUL BUCUREŞTI","ŞCOALA GIMNAZIALĂ NR.55;",622,"BUCUREŞTI SECTORUL 3",179169,1,PART,PRCNCT,PRSD,PRSD_SV_SECTOR,"2025-05-18 21:38:57",1752,319,304,15,0,315,4,2000,1681,171,144
42,"MUNICIPIUL BUCUREŞTI","ŞCOALA GIMNAZIALĂ NR.55;",623,"BUCUREŞTI SECTORUL 3",179169,1,PART,PRCNCT,PRSD,PRSD_SV_SECTOR,"2025-05-18 21:38:07",1643,628,607,21,0,617,11,1800,1172,340,277
42,"MUNICIPIUL BUCUREŞTI","ŞCOALA GIMNAZIALĂ NR.55;",624,"BUCUREŞTI SECTORUL 3",179169,1,PART,PRCNCT,PRSD,PRSD_SV_SECTOR,"2025-05-18 21:24:28",1618,252,236,16,0,250,2,1800,1548,144,106
42,"MUNICIPIUL BUCUREŞTI","ŞCOALA GIMNAZIALĂ NR.55;",625,"BUCUREŞTI SECTORUL 3",179169,1,PART,PRCNCT,PRSD,PRSD_SV_SECTOR,"2025-05-18 21:21:15",1767,332,313,19,0,328,4,2000,1668,178,150
42,"MUNICIPIUL BUCUREŞTI","ŞCOALA GIMNAZIALĂ NR.55;",626,"BUCUREŞTI SECTORUL 3",179169,1,PART,PRCNCT,PRSD,PRSD_SV_SECTOR,"2025-05-18 21:29:57",1757,443,425,18,0,432,11,2000,1557,201,231
42,"MUNICIPIUL BUCUREŞTI","ŞCOALA GIMNAZIALĂ NR.55;",627,"BUCUREŞTI SECTORUL 3",179169,1,PART,PRCNCT,PRSD,PRSD_SV_SECTOR,"2025-05-18 21:39:11",3153,628,590,38,0,620,8,3400,2772,348,272
42,"MUNICIPIUL BUCUREŞTI","ŞCOALA GIMNAZIALĂ NR.55;",628,"BUCUREŞTI SECTORUL 3",179169,1,PART,PRCNCT,PRSD,PRSD_SV_SECTOR,"2025-05-18 21:45:51",2555,359,326,33,0,354,5,2900,2541,180,174
42,"MUNICIPIUL BUCUREŞTI","ŞCOALA GIMNAZIALĂ NR.55;",629,"BUCUREŞTI SECTORUL 3",179169,1,PART,PRCNCT,PRSD,PRSD_SV_SECTOR,"2025-05-18 21:28:17",1829,457,409,48,0,451,6,2000,1543,252,199
42,"MUNICIPIUL BUCUREŞTI","ŞCOALA GIMNAZIALĂ NR.55;",630,"BUCUREŞTI SECTORUL 3",179169,1,PART,PRCNCT,PRSD,PRSD_SV_SECTOR,"2025-05-18 21:50:05",3835,558,467,91,0,545,13,4200,3642,314,231
42,"MUNICIPIUL BUCUREŞTI","ŞCOALA GIMNAZIALĂ NR.55;",631,"BUCUREŞTI SECTORUL 3",179169,1,PART,PRCNCT,PRSD,PRSD_SV_SECTOR,"2025-05-18 21:21:58",1542,34,10,24,0,34,0,1700,1666,23,11
42,"MUNICIPIUL BUCUREŞTI","ŞCOALA GIMNAZIALĂ NR.55;",632,"BUCUREŞTI SECTORUL 3",179169,1,PART,PRCNCT,PRSD,PRSD_SV_SECTOR,"2025-05-18 21:36:20",1626,162,148,14,0,156,6,1800,1638,89,67
42,"MUNICIPIUL BUCUREŞTI","ŞCOALA GIMNAZIALĂ NR.55;",633,"BUCUREŞTI SECTORUL 3",179169,1,PART,PRCNCT,PRSD,PRSD_SV_SECTOR,"2025-05-18 21:46:10",1568,264,249,15,0,260,4,1700,1436,157,103
42,"MUNICIPIUL BUCUREŞTI","ŞCOALA GIMNAZIALĂ NR.55;",634,"BUCUREŞTI SECTORUL 3",179169,1,PART,PRCNCT,PRSD,PRSD_SV_SECTOR,"2025-05-18 21:16:17",1743,276,266,10,0,271,5,2000,1724,114,157
42,"MUNICIPIUL BUCUREŞTI","ŞCOALA GIMNAZIALĂ NR.55;",635,"BUCUREŞTI SECTORUL 3",179169,1,PART,PRCNCT,PRSD,PRSD_SV_SECTOR,"2025-05-18 21:23:55",2222,65,53,12,0,63,2,2500,2435,31,32
42,"MUNICIPIUL BUCUREŞTI","ŞCOALA GIMNAZIALĂ NR.55;",636,"BUCUREŞTI SECTORUL 3",179169,1,PART,PRCNCT,PRSD,PRSD_SV_SECTOR,"2025-05-18 21:36:04",1671,358,344,12,2,352,6,1800,1442,170,182
42,"MUNICIPIUL BUCUREŞTI","ŞCOALA GIMNAZIALĂ NR.55;",637,"BUCUREŞTI SECTORUL 3",179169,1,PART,PRCNCT,PRSD,PRSD_SV_SECTOR,"2025-05-18 21:20:12",1810,384,364,20,0,374,10,2000,1616,128,246
42,"MUNICIPIUL BUCUREŞTI","ŞCOALA GIMNAZIALĂ NR.55;",638,"BUCUREŞTI SECTORUL 3",179169,1,PART,PRCNCT,PRSD,PRSD_SV_SECTOR,"2025-05-18 21:37:15",1804,187,174,12,1,185,2,1800,1613,114,71
42,"MUNICIPIUL BUCUREŞTI","ŞCOALA GIMNAZIALĂ NR.55;",639,"BUCUREŞTI SECTORUL 3",179169,1,PART,PRCNCT,PRSD,PRSD_SV_SECTOR,"2025-05-18 21:23:32",1562,125,93,32,0,123,2,1700,1575,91,32
42,"MUNICIPIUL BUCUREŞTI","ȘCOALA GIMNAZIALĂ NR.55;",640,"BUCUREŞTI SECTORUL 3",179169,1,PART,PRCNCT,PRSD,PRSD_SV_SECTOR,"2025-05-18 21:29:29",2569,195,167,28,0,194,1,2900,2705,109,85
42,"MUNICIPIUL BUCUREŞTI","ŞCOALA GIMNAZIALĂ NR.47;",641,"BUCUREŞTI SECTORUL 3",179169,1,PART,PRCNCT,PRSD,PRSD_SV_SECTOR,"2025-05-18 21:19:35",3200,71,55,16,0,71,0,2601,2530,30,41
42,"MUNICIPIUL BUCUREŞTI","ŞCOALA GIMNAZIALĂ NR.47;",642,"BUCUREŞTI SECTORUL 3",179169,1,PART,PRCNCT,PRSD,PRSD_SV_SECTOR,"2025-05-18 21:24:30",2756,142,131,11,0,141,1,2200,2058,97,44
42,"MUNICIPIUL BUCUREŞTI","ŞCOALA GIMNAZIALĂ NR.47;",643,"BUCUREŞTI SECTORUL 3",179169,1,PART,PRCNCT,PRSD,PRSD_SV_SECTOR,"2025-05-18 21:19:16",2810,226,213,13,0,225,1,2200,1974,134,91
42,"MUNICIPIUL BUCUREŞTI","ŞCOALA GIMNAZIALĂ NR.47;",644,"BUCUREŞTI SECTORUL 3",179169,1,PART,PRCNCT,PRSD,PRSD_SV_SECTOR,"2025-05-18 21:25:42",1580,121,103,18,0,121,0,900,779,64,57
42,"MUNICIPIUL BUCUREŞTI","ŞCOALA GIMNAZIALĂ NR.47;",645,"BUCUREŞTI SECTORUL 3",179169,1,PART,PRCNCT,PRSD,PRSD_SV_SECTOR,"2025-05-18 21:21:24",2222,90,49,41,0,89,1,2500,2410,47,42
42,"MUNICIPIUL BUCUREŞTI","ŞCOALA GIMNAZIALĂ NR.47;",646,"BUCUREŞTI SECTORUL 3",179169,1,PART,PRCNCT,PRSD,PRSD_SV_SECTOR,"2025-05-18 21:28:20",1581,98,85,13,0,97,1,1700,1602,59,38
42,"MUNICIPIUL BUCUREŞTI","ŞCOALA GIMNAZIALĂ NR.47;",647,"BUCUREŞTI SECTORUL 3",179169,1,PART,PRCNCT,PRSD,PRSD_SV_SECTOR,"2025-05-18 21:52:53",1613,237,224,13,0,235,2,1800,1563,145,90
42,"MUNICIPIUL BUCUREŞTI","ŞCOALA GIMNAZIALĂ NR.47;",648,"BUCUREŞTI SECTORUL 3",179169,1,PART,PRCNCT,PRSD,PRSD_SV_SECTOR,"2025-05-18 21:44:39",3149,51,35,14,2,51,0,2600,2549,26,25
42,"MUNICIPIUL BUCUREŞTI","ȘCOALA GIMNAZIALĂ NR.47;",649,"BUCUREŞTI SECTORUL 3",179169,1,PART,PRCNCT,PRSD,PRSD_SV_SECTOR,"2025-05-18 21:51:20",1715,477,449,28,0,471,6,1800,1323,261,210
42,"MUNICIPIUL BUCUREŞTI","ŞCOALA GIMNAZIALĂ NR.47;",650,"BUCUREŞTI SECTORUL 3",179169,1,PART,PRCNCT,PRSD,PRSD_SV_SECTOR,"2025-05-18 21:45:16",1661,510,481,29,0,504,6,1800,1290,286,218
42,"MUNICIPIUL BUCUREŞTI","ŞCOALA GIMNAZIALĂ NR.78;",651,"BUCUREŞTI SECTORUL 3",179169,1,PART,PRCNCT,PRSD,PRSD_SV_SECTOR,"2025-05-18 21:36:47",1543,516,472,44,0,510,6,1700,1184,218,292
42,"MUNICIPIUL BUCUREŞTI","ŞCOALA GIMNAZIALĂ NR.78;",652,"BUCUREŞTI SECTORUL 3",179169,1,PART,PRCNCT,PRSD,PRSD_SV_SECTOR,"2025-05-18 21:22:28",1798,774,762,12,0,759,15,2000,1226,361,398
42,"MUNICIPIUL BUCUREŞTI","ŞCOALA GIMNAZIALĂ NR.78;",653,"BUCUREŞTI SECTORUL 3",179169,1,PART,PRCNCT,PRSD,PRSD_SV_SECTOR,"2025-05-18 21:32:08",1412,104,95,9,0,102,2,1600,1496,39,63
42,"MUNICIPIUL BUCUREŞTI","ŞCOALA GIMNAZIALĂ NR.78;",654,"BUCUREŞTI SECTORUL 3",179169,1,PART,PRCNCT,PRSD,PRSD_SV_SECTOR,"2025-05-18 21:26:14",1410,226,215,11,0,220,6,1600,1374,99,121
42,"MUNICIPIUL BUCUREŞTI","ŞCOALA GIMNAZIALĂ NR.78;",655,"BUCUREŞTI SECTORUL 3",179169,1,PART,PRCNCT,PRSD,PRSD_SV_SECTOR,"2025-05-18 21:35:40",1614,155,138,17,0,154,1,1800,1645,79,75
42,"MUNICIPIUL BUCUREŞTI","ŞCOALA GIMNAZIALĂ NR.78;",656,"BUCUREŞTI SECTORUL 3",179169,1,PART,PRCNCT,PRSD,PRSD_SV_SECTOR,"2025-05-18 21:35:34",1578,541,516,24,1,530,11,1700,1159,244,286
42,"MUNICIPIUL BUCUREŞTI","ŞCOALA GIMNAZIALĂ NR.78;",657,"BUCUREŞTI SECTORUL 3",179169,1,PART,PRCNCT,PRSD,PRSD_SV_SECTOR,"2025-05-18 21:14:20",1769,22,11,11,0,22,0,1799,1777,7,15
42,"MUNICIPIUL BUCUREŞTI","ŞCOALA GIMNAZIALĂ NR.78;",658,"BUCUREŞTI SECTORUL 3",179169,1,PART,PRCNCT,PRSD,PRSD_SV_SECTOR,"2025-05-18 21:16:35",1686,21,5,16,0,21,0,1800,1779,12,9
42,"MUNICIPIUL BUCUREŞTI","ȘCOALA GIMNAZIALĂ NR.78;",659,"BUCUREŞTI SECTORUL 3",179169,1,PART,PRCNCT,PRSD,PRSD_SV_SECTOR,"2025-05-18 21:24:13",1809,54,6,48,0,53,1,2100,2046,23,30
42,"MUNICIPIUL BUCUREŞTI","ȘCOALA GIMNAZIALĂ NR.78;",660,"BUCUREŞTI SECTORUL 3",179169,1,PART,PRCNCT,PRSD,PRSD_SV_SECTOR,"2025-05-18 21:27:45",1836,69,7,62,0,69,0,2100,2031,31,38
42,"MUNICIPIUL BUCUREŞTI","ŞCOALA GIMNAZIALĂ NR.67;",661,"BUCUREŞTI SECTORUL 3",179169,1,PART,PRCNCT,PRSD,PRSD_SV_SECTOR,"2025-05-18 21:52:56",1540,915,848,64,3,899,16,1700,785,378,521
42,"MUNICIPIUL BUCUREŞTI","ŞCOALA GIMNAZIALĂ NR.67;",662,"BUCUREŞTI SECTORUL 3",179169,1,PART,PRCNCT,PRSD,PRSD_SV_SECTOR,"2025-05-18 22:32:58",1758,987,927,60,0,977,10,2000,1013,374,603
42,"MUNICIPIUL BUCUREŞTI","COLEGIUL NAȚIONAL ”MIHAI EMINESCU”",663,"BUCUREŞTI SECTORUL 4",179178,1,PART,PRCNCT,PRSD,PRSD_SV_SECTOR,"2025-05-18 21:50:09",1802,1057,785,272,0,1044,13,2000,943,292,752
42,"MUNICIPIUL BUCUREŞTI","COLEGIUL NAȚIONAL ”MIHAI EMINESCU”",664,"BUCUREŞTI SECTORUL 4",179178,1,PART,PRCNCT,PRSD,PRSD_SV_SECTOR,"2025-05-18 22:45:36",1268,963,617,287,59,958,5,1400,437,340,618
42,"MUNICIPIUL BUCUREŞTI","COLEGIUL NAȚIONAL ”MIHAI EMINESCU”",665,"BUCUREŞTI SECTORUL 4",179178,1,PART,PRCNCT,PRSD,PRSD_SV_SECTOR,"2025-05-18 21:59:23",1268,775,622,152,1,762,13,1400,625,237,525
42,"MUNICIPIUL BUCUREŞTI","COLEGIUL NAȚIONAL ”MIHAI EMINESCU”",666,"BUCUREŞTI SECTORUL 4",179178,1,PART,PRCNCT,PRSD,PRSD_SV_SECTOR,"2025-05-18 21:57:46",1083,627,560,67,0,616,11,1200,573,163,453
42,"MUNICIPIUL BUCUREŞTI","COLEGIUL NAȚIONAL ”MIHAI EMINESCU”",667,"BUCUREŞTI SECTORUL 4",179178,1,PART,PRCNCT,PRSD,PRSD_SV_SECTOR,"2025-05-18 21:47:28",1305,757,651,106,0,739,18,1400,643,197,542
42,"MUNICIPIUL BUCUREŞTI","ŞCOALA GIMNAZIALĂ ”IENĂCHIŢĂ VĂCĂRESCU”",668,"BUCUREŞTI SECTORUL 4",179178,1,PART,PRCNCT,PRSD,PRSD_SV_SECTOR,"2025-05-18 22:33:32",976,816,540,276,0,800,16,1100,284,249,551
42,"MUNICIPIUL BUCUREŞTI","ŞCOALA GIMNAZIALĂ ”IENĂCHIŢĂ VĂCĂRESCU”",669,"BUCUREŞTI SECTORUL 4",179178,1,PART,PRCNCT,PRSD,PRSD_SV_SECTOR,"2025-05-18 23:45:25",1100,792,582,191,19,772,20,1200,408,240,532
42,"MUNICIPIUL BUCUREŞTI","ŞCOALA GIMNAZIALĂ ”IENĂCHIŢĂ VĂCĂRESCU”",670,"BUCUREŞTI SECTORUL 4",179178,1,PART,PRCNCT,PRSD,PRSD_SV_SECTOR,"2025-05-18 22:08:12",1015,744,524,220,0,736,8,1100,356,219,517
42,"MUNICIPIUL BUCUREŞTI","ŞCOALA GIMNAZIALĂ ”IENĂCHIŢĂ VĂCĂRESCU”",671,"BUCUREŞTI SECTORUL 4",179178,1,PART,PRCNCT,PRSD,PRSD_SV_SECTOR,"2025-05-18 22:50:12",1571,1030,855,174,1,1018,12,1700,670,260,758
42,"MUNICIPIUL BUCUREŞTI","ŞCOALA GIMNAZIALĂ NR. 79",672,"BUCUREŞTI SECTORUL 4",179178,1,PART,PRCNCT,PRSD,PRSD_SV_SECTOR,"2025-05-18 22:27:19",858,615,459,156,0,606,9,900,285,173,433
42,"MUNICIPIUL BUCUREŞTI","ŞCOALA GIMNAZIALĂ NR. 79",673,"BUCUREŞTI SECTORUL 4",179178,1,PART,PRCNCT,PRSD,PRSD_SV_SECTOR,"2025-05-18 22:17:03",935,663,499,162,2,652,11,1000,337,169,483
42,"MUNICIPIUL BUCUREŞTI","ŞCOALA GIMNAZIALĂ NR. 79",674,"BUCUREŞTI SECTORUL 4",179178,1,PART,PRCNCT,PRSD,PRSD_SV_SECTOR,"2025-05-18 22:17:51",1291,814,676,125,13,801,13,1400,586,229,572
42,"MUNICIPIUL BUCUREŞTI","COLEGIUL NAŢIONAL ION CREANGĂ",675,"BUCUREŞTI SECTORUL 4",179178,1,PART,PRCNCT,PRSD,PRSD_SV_SECTOR,"2025-05-18 22:23:35",1373,1146,797,349,0,1137,9,1500,354,312,825
42,"MUNICIPIUL BUCUREŞTI","COLEGIUL NAŢIONAL ION CREANGĂ",676,"BUCUREŞTI SECTORUL 4",179178,1,PART,PRCNCT,PRSD,PRSD_SV_SECTOR,"2025-05-18 21:47:10",931,617,481,136,0,603,14,1000,383,130,473
42,"MUNICIPIUL BUCUREŞTI","COLEGIUL TEHNIC GRIGORE CERCHEZ",677,"BUCUREŞTI SECTORUL 4",179178,1,PART,PRCNCT,PRSD,PRSD_SV_SECTOR,"2025-05-18 22:31:10",905,702,509,192,1,695,7,999,297,164,531
42,"MUNICIPIUL BUCUREŞTI","COLEGIUL TEHNIC GRIGORE CERCHEZ",678,"BUCUREŞTI SECTORUL 4",179178,1,PART,PRCNCT,PRSD,PRSD_SV_SECTOR,"2025-05-18 22:04:31",1333,892,751,141,0,883,9,1500,608,282,601
42,"MUNICIPIUL BUCUREŞTI","ŞCOALA GIMNAZIALĂ NR. 97",679,"BUCUREŞTI SECTORUL 4",179178,1,PART,PRCNCT,PRSD,PRSD_SV_SECTOR,"2025-05-18 21:35:14",1091,670,610,58,2,657,13,1200,530,154,503
42,"MUNICIPIUL BUCUREŞTI","ŞCOALA GIMNAZIALĂ NR. 97",680,"BUCUREŞTI SECTORUL 4",179178,1,PART,PRCNCT,PRSD,PRSD_SV_SECTOR,"2025-05-18 21:30:33",1110,726,631,94,1,712,14,1200,474,132,580
42,"MUNICIPIUL BUCUREŞTI","ŞCOALA GIMNAZIALĂ NR. 97",681,"BUCUREŞTI SECTORUL 4",179178,1,PART,PRCNCT,PRSD,PRSD_SV_SECTOR,"2025-05-18 22:02:27",1112,755,646,105,4,746,9,1200,445,151,595
42,"MUNICIPIUL BUCUREŞTI","ŞCOALA GIMNAZIALĂ NR. 97",682,"BUCUREŞTI SECTORUL 4",179178,2,PART,PRCNCT,PRSD,PRSD_SV_SECTOR,"2025-05-19 00:45:47",1000,638,554,84,0,626,12,1100,462,139,487
42,"MUNICIPIUL BUCUREŞTI","ŞCOALA GIMNAZIALĂ NR. 97",683,"BUCUREŞTI SECTORUL 4",179178,1,PART,PRCNCT,PRSD,PRSD_SV_SECTOR,"2025-05-18 23:00:12",1327,860,784,76,0,848,12,1500,640,191,657
42,"MUNICIPIUL BUCUREŞTI","ŞCOALA GIMNAZIALĂ NR. 97",684,"BUCUREŞTI SECTORUL 4",179178,1,PART,PRCNCT,PRSD,PRSD_SV_SECTOR,"2025-05-18 22:45:09",1151,992,681,309,2,985,7,1301,309,216,769
42,"MUNICIPIUL BUCUREŞTI","ŞCOALA GIMNAZIALĂ NR. 97",685,"BUCUREŞTI SECTORUL 4",179178,2,PART,PRCNCT,PRSD,PRSD_SV_SECTOR,"2025-05-19 01:18:26",1263,946,714,232,0,938,8,1403,457,195,743
42,"MUNICIPIUL BUCUREŞTI","ŞCOALA GIMNAZIALĂ NR. 97",686,"BUCUREŞTI SECTORUL 4",179178,1,PART,PRCNCT,PRSD,PRSD_SV_SECTOR,"2025-05-18 21:44:50",1191,904,721,183,0,885,19,1300,396,200,685
42,"MUNICIPIUL BUCUREŞTI","ŞCOALA GIMNAZIALĂ NR. 97",687,"BUCUREŞTI SECTORUL 4",179178,1,PART,PRCNCT,PRSD,PRSD_SV_SECTOR,"2025-05-18 22:24:25",1154,951,678,273,0,938,13,1300,349,161,777
42,"MUNICIPIUL BUCUREŞTI","ŞCOALA GIMNAZIALĂ NR. 97",688,"BUCUREŞTI SECTORUL 4",179178,1,PART,PRCNCT,PRSD,PRSD_SV_SECTOR,"2025-05-18 22:14:17",946,708,561,146,1,696,12,1000,292,121,575
42,"MUNICIPIUL BUCUREŞTI","ȘCOALA GIMNAZIALĂ NR. 97",689,"BUCUREŞTI SECTORUL 4",179178,1,PART,PRCNCT,PRSD,PRSD_SV_SECTOR,"2025-05-18 22:05:02",1080,812,619,193,0,783,29,1200,388,181,602
42,"MUNICIPIUL BUCUREŞTI","ȘCOALA GIMNAZIALĂ NR. 97",690,"BUCUREŞTI SECTORUL 4",179178,1,PART,PRCNCT,PRSD,PRSD_SV_SECTOR,"2025-05-18 22:37:33",1408,1207,824,382,1,1191,16,1600,393,217,974
42,"MUNICIPIUL BUCUREŞTI","ȘCOALA GIMNAZIALĂ NR. 97",691,"BUCUREŞTI SECTORUL 4",179178,1,PART,PRCNCT,PRSD,PRSD_SV_SECTOR,"2025-05-18 22:17:00",973,817,571,246,0,804,13,1100,283,179,625
42,"MUNICIPIUL BUCUREŞTI","ȘCOALA GIMNAZIALĂ NR. 97",692,"BUCUREŞTI SECTORUL 4",179178,1,PART,PRCNCT,PRSD,PRSD_SV_SECTOR,"2025-05-18 22:20:20",897,620,523,96,1,613,7,1000,380,146,467
42,"MUNICIPIUL BUCUREŞTI","ȘCOALA GIMNAZIALĂ NR. 190",693,"BUCUREŞTI SECTORUL 4",179178,1,PART,PRCNCT,PRSD,PRSD_SV_SECTOR,"2025-05-18 22:32:44",1560,1038,879,158,1,1022,16,1700,662,194,828
42,"MUNICIPIUL BUCUREŞTI","ȘCOALA GIMNAZIALĂ NR. 190",694,"BUCUREŞTI SECTORUL 4",179178,1,PART,PRCNCT,PRSD,PRSD_SV_SECTOR,"2025-05-18 22:01:26",1237,837,662,173,2,819,18,1400,563,179,640
42,"MUNICIPIUL BUCUREŞTI","ȘCOALA GIMNAZIALĂ NR. 190",695,"BUCUREŞTI SECTORUL 4",179178,1,PART,PRCNCT,PRSD,PRSD_SV_SECTOR,"2025-05-18 21:41:09",1060,767,594,173,0,759,8,1200,433,154,605
42,"MUNICIPIUL BUCUREŞTI","ȘCOALA GIMNAZIALĂ NR. 190",696,"BUCUREŞTI SECTORUL 4",179178,1,PART,PRCNCT,PRSD,PRSD_SV_SECTOR,"2025-05-18 22:19:10",1590,1176,962,214,0,1164,12,1800,624,225,939
42,"MUNICIPIUL BUCUREŞTI","ȘCOALA GIMNAZIALĂ NR. 190",697,"BUCUREŞTI SECTORUL 4",179178,1,PART,PRCNCT,PRSD,PRSD_SV_SECTOR,"2025-05-18 22:23:43",1452,941,836,105,0,922,19,1600,659,244,678
42,"MUNICIPIUL BUCUREŞTI","ŞCOALA GIMNAZIALĂ NR. 190",698,"BUCUREŞTI SECTORUL 4",179178,1,PART,PRCNCT,PRSD,PRSD_SV_SECTOR,"2025-05-18 23:23:23",1547,1128,879,247,2,1096,32,1700,572,329,767
42,"MUNICIPIUL BUCUREŞTI","ŞCOALA GIMNAZIALĂ NR. 190",699,"BUCUREŞTI SECTORUL 4",179178,1,PART,PRCNCT,PRSD,PRSD_SV_SECTOR,"2025-05-18 22:19:47",1207,891,656,233,2,880,11,1300,409,216,664
42,"MUNICIPIUL BUCUREŞTI","ŞCOALA GIMNAZIALĂ NR. 190",700,"BUCUREŞTI SECTORUL 4",179178,2,PART,PRCNCT,PRSD,PRSD_SV_SECTOR,"2025-05-19 01:45:50",1175,943,703,239,1,932,11,1299,356,228,704
42,"MUNICIPIUL BUCUREŞTI","ŞCOALA GIMNAZIALĂ NR. 190",701,"BUCUREŞTI SECTORUL 4",179178,1,PART,PRCNCT,PRSD,PRSD_SV_SECTOR,"2025-05-18 23:02:52",1279,802,702,100,0,785,17,1400,598,278,507
42,"MUNICIPIUL BUCUREŞTI","ŞCOALA GIMNAZIALĂ NR. 190",702,"BUCUREŞTI SECTORUL 4",179178,1,PART,PRCNCT,PRSD,PRSD_SV_SECTOR,"2025-05-18 22:02:18",1184,730,636,91,3,723,7,1299,569,213,510
42,"MUNICIPIUL BUCUREŞTI","ŞCOALA GIMNAZIALĂ NR. 190",703,"BUCUREŞTI SECTORUL 4",179178,1,PART,PRCNCT,PRSD,PRSD_SV_SECTOR,"2025-05-18 21:43:59",1028,587,534,53,0,581,6,1100,513,156,425
42,"MUNICIPIUL BUCUREŞTI","ŞCOALA GIMNAZIALĂ NR. 190",704,"BUCUREŞTI SECTORUL 4",179178,1,PART,PRCNCT,PRSD,PRSD_SV_SECTOR,"2025-05-18 21:36:59",1176,725,672,53,0,718,7,1300,575,195,523
42,"MUNICIPIUL BUCUREŞTI","ŞCOALA GIMNAZIALĂ NR. 190",705,"BUCUREŞTI SECTORUL 4",179178,1,PART,PRCNCT,PRSD,PRSD_SV_SECTOR,"2025-05-18 22:27:13",1608,1044,908,115,21,1037,7,1800,756,286,751
42,"MUNICIPIUL BUCUREŞTI","ŞCOALA GIMNAZIALĂ NR. 190",706,"BUCUREŞTI SECTORUL 4",179178,1,PART,PRCNCT,PRSD,PRSD_SV_SECTOR,"2025-05-18 22:10:44",1674,1135,1045,90,0,1120,15,1800,665,329,791
42,"MUNICIPIUL BUCUREŞTI","ŞCOALA GIMNAZIALĂ NR. 190",707,"BUCUREŞTI SECTORUL 4",179178,1,PART,PRCNCT,PRSD,PRSD_SV_SECTOR,"2025-05-18 21:37:25",1205,783,615,140,28,775,8,1300,517,271,504
42,"MUNICIPIUL BUCUREŞTI","ȘCOALA GIMNAZIALĂ NR. 190",708,"BUCUREŞTI SECTORUL 4",179178,1,PART,PRCNCT,PRSD,PRSD_SV_SECTOR,"2025-05-18 21:34:43",1126,661,540,121,0,652,9,1200,539,212,440
42,"MUNICIPIUL BUCUREŞTI","LICEUL TEHNOLOGIC DACIA",709,"BUCUREŞTI SECTORUL 4",179178,1,PART,PRCNCT,PRSD,PRSD_SV_SECTOR,"2025-05-18 21:51:16",1717,1193,1022,170,1,1183,10,1900,707,340,843
42,"MUNICIPIUL BUCUREŞTI","LICEUL TEHNOLOGIC DACIA",710,"BUCUREŞTI SECTORUL 4",179178,1,PART,PRCNCT,PRSD,PRSD_SV_SECTOR,"2025-05-18 22:09:46",1711,1191,973,218,0,1174,17,1900,709,424,750
42,"MUNICIPIUL BUCUREŞTI","LICEUL TEHNOLOGIC DACIA",711,"BUCUREŞTI SECTORUL 4",179178,2,PART,PRCNCT,PRSD,PRSD_SV_SECTOR,"2025-05-19 00:33:37",1507,1019,808,187,24,1004,15,1700,681,306,698
42,"MUNICIPIUL BUCUREŞTI","LICEUL TEHNOLOGIC DACIA",712,"BUCUREŞTI SECTORUL 4",179178,1,PART,PRCNCT,PRSD,PRSD_SV_SECTOR,"2025-05-18 21:52:46",1656,1131,963,168,0,1118,13,1800,669,344,774
42,"MUNICIPIUL BUCUREŞTI","LICEUL TEHNOLOGIC DACIA",713,"BUCUREŞTI SECTORUL 4",179178,1,PART,PRCNCT,PRSD,PRSD_SV_SECTOR,"2025-05-18 22:08:54",1883,1310,1136,174,0,1299,11,2100,790,386,913
42,"MUNICIPIUL BUCUREŞTI","LICEUL TEHNOLOGIC DACIA",714,"BUCUREŞTI SECTORUL 4",179178,1,PART,PRCNCT,PRSD,PRSD_SV_SECTOR,"2025-05-18 22:16:46",1908,1102,927,175,0,1090,12,2100,998,411,679
42,"MUNICIPIUL BUCUREŞTI","LICEUL TEHNOLOGIC DACIA",715,"BUCUREŞTI SECTORUL 4",179178,1,PART,PRCNCT,PRSD,PRSD_SV_SECTOR,"2025-05-18 21:43:40",1825,959,772,187,0,945,14,2000,1041,445,500
42,"MUNICIPIUL BUCUREŞTI","LICEUL TEHNOLOGIC DACIA",716,"BUCUREŞTI SECTORUL 4",179178,1,PART,PRCNCT,PRSD,PRSD_SV_SECTOR,"2025-05-18 22:16:56",1854,1109,898,211,0,1103,6,1996,887,546,557
42,"MUNICIPIUL BUCUREŞTI","LICEUL TEHNOLOGIC DACIA",717,"BUCUREŞTI SECTORUL 4",179178,1,PART,PRCNCT,PRSD,PRSD_SV_SECTOR,"2025-05-18 22:30:46",1872,1474,1085,389,0,1464,10,2100,626,326,1138
42,"MUNICIPIUL BUCUREŞTI","LICEUL TEHNOLOGIC DACIA",718,"BUCUREŞTI SECTORUL 4",179178,1,PART,PRCNCT,PRSD,PRSD_SV_SECTOR,"2025-05-18 22:47:03",1993,1581,1233,348,0,1566,15,2200,619,407,1159
42,"MUNICIPIUL BUCUREŞTI","LICEUL TEHNOLOGIC DACIA",719,"BUCUREŞTI SECTORUL 4",179178,1,PART,PRCNCT,PRSD,PRSD_SV_SECTOR,"2025-05-18 21:45:58",1805,1340,1009,331,0,1326,14,2000,660,346,980
42,"MUNICIPIUL BUCUREŞTI","GRĂDINIȚA PANSELUȚA",720,"BUCUREŞTI SECTORUL 4",179178,1,PART,PRCNCT,PRSD,PRSD_SV_SECTOR,"2025-05-18 21:41:42",1275,846,729,117,0,831,15,1400,554,303,528
42,"MUNICIPIUL BUCUREŞTI","GRĂDINIȚA PANSELUȚA",721,"BUCUREŞTI SECTORUL 4",179178,1,PART,PRCNCT,PRSD,PRSD_SV_SECTOR,"2025-05-18 21:41:27",1529,932,812,120,0,925,7,1700,768,327,598
42,"MUNICIPIUL BUCUREŞTI","GRĂDINIȚA PANSELUȚA",722,"BUCUREŞTI SECTORUL 4",179178,1,PART,PRCNCT,PRSD,PRSD_SV_SECTOR,"2025-05-18 21:58:39",1575,906,797,109,0,885,21,1700,794,325,560
42,"MUNICIPIUL BUCUREŞTI","GRĂDINIȚA PANSELUȚA",723,"BUCUREŞTI SECTORUL 4",179178,1,PART,PRCNCT,PRSD,PRSD_SV_SECTOR,"2025-05-18 21:36:42",1066,683,564,118,1,678,5,1200,517,262,416
42,"MUNICIPIUL BUCUREŞTI","ȘCOALA GIMNAZIALĂ NR. 133",724,"BUCUREŞTI SECTORUL 4",179178,1,PART,PRCNCT,PRSD,PRSD_SV_SECTOR,"2025-05-18 22:51:07",1687,1156,849,267,40,1143,13,1900,744,358,785
42,"MUNICIPIUL BUCUREŞTI","ȘCOALA GIMNAZIALĂ NR. 133",725,"BUCUREŞTI SECTORUL 4",179178,1,PART,PRCNCT,PRSD,PRSD_SV_SECTOR,"2025-05-18 22:05:02",1424,934,694,202,38,922,12,1600,666,295,627
42,"MUNICIPIUL BUCUREŞTI","ŞCOALA GIMNAZIALĂ NR. 133",726,"BUCUREŞTI SECTORUL 4",179178,1,PART,PRCNCT,PRSD,PRSD_SV_SECTOR,"2025-05-18 22:04:59",1435,947,754,150,43,928,19,1600,653,323,605
42,"MUNICIPIUL BUCUREŞTI","ŞCOALA GIMNAZIALĂ NR. 133",727,"BUCUREŞTI SECTORUL 4",179178,1,PART,PRCNCT,PRSD,PRSD_SV_SECTOR,"2025-05-18 22:09:01",1429,963,819,101,43,943,20,1600,637,298,645
42,"MUNICIPIUL BUCUREŞTI","ŞCOALA GIMNAZIALĂ G-RAL EREMIA GRIGORESCU",728,"BUCUREŞTI SECTORUL 4",179178,1,PART,PRCNCT,PRSD,PRSD_SV_SECTOR,"2025-05-18 22:05:46",1790,980,915,65,0,967,13,2000,1020,343,624
42,"MUNICIPIUL BUCUREŞTI","ŞCOALA GIMNAZIALĂ G-RAL EREMIA GRIGORESCU",729,"BUCUREŞTI SECTORUL 4",179178,1,PART,PRCNCT,PRSD,PRSD_SV_SECTOR,"2025-05-18 21:34:47",1503,926,781,143,2,910,16,1700,774,289,621
42,"MUNICIPIUL BUCUREŞTI","ŞCOALA GIMNAZIALĂ G-RAL EREMIA GRIGORESCU",730,"BUCUREŞTI SECTORUL 4",179178,1,PART,PRCNCT,PRSD,PRSD_SV_SECTOR,"2025-05-18 21:39:33",1606,1154,914,239,1,1147,7,1800,646,345,802
42,"MUNICIPIUL BUCUREŞTI","ŞCOALA GIMNAZIALĂ G-RAL EREMIA GRIGORESCU",731,"BUCUREŞTI SECTORUL 4",179178,1,PART,PRCNCT,PRSD,PRSD_SV_SECTOR,"2025-05-18 22:19:20",2009,1285,1026,259,0,1271,14,2200,915,399,872
42,"MUNICIPIUL BUCUREŞTI","ŞCOALA GIMNAZIALĂ G-RAL EREMIA GRIGORESCU",732,"BUCUREŞTI SECTORUL 4",179178,2,PART,PRCNCT,PRSD,PRSD_SV_SECTOR,"2025-05-19 01:41:05",1883,1306,1023,156,127,1285,21,2100,794,399,886
42,"MUNICIPIUL BUCUREŞTI","ŞCOALA GIMNAZIALĂ G-RAL EREMIA GRIGORESCU",733,"BUCUREŞTI SECTORUL 4",179178,1,PART,PRCNCT,PRSD,PRSD_SV_SECTOR,"2025-05-18 21:34:53",1670,1110,872,176,62,1094,16,1800,690,358,736
42,"MUNICIPIUL BUCUREŞTI","ŞCOALA GIMNAZIALĂ G-RAL EREMIA GRIGORESCU",734,"BUCUREŞTI SECTORUL 4",179178,1,PART,PRCNCT,PRSD,PRSD_SV_SECTOR,"2025-05-18 22:28:09",1626,1024,875,89,60,1014,10,1800,776,372,642
42,"MUNICIPIUL BUCUREŞTI","ŞCOALA GIMNAZIALĂ NR. 113",735,"BUCUREŞTI SECTORUL 4",179178,1,PART,PRCNCT,PRSD,PRSD_SV_SECTOR,"2025-05-18 22:06:20",1373,935,747,188,0,919,16,1500,565,305,614
42,"MUNICIPIUL BUCUREŞTI","ŞCOALA GIMNAZIALĂ NR. 113",736,"BUCUREŞTI SECTORUL 4",179178,1,PART,PRCNCT,PRSD,PRSD_SV_SECTOR,"2025-05-18 22:12:29",1450,962,746,124,92,938,24,1600,638,297,641
42,"MUNICIPIUL BUCUREŞTI","ŞCOALA GIMNAZIALĂ NR. 113",737,"BUCUREŞTI SECTORUL 4",179178,1,PART,PRCNCT,PRSD,PRSD_SV_SECTOR,"2025-05-18 21:54:53",1453,894,774,39,81,876,18,1600,706,317,559
42,"MUNICIPIUL BUCUREŞTI","ŞCOALA GIMNAZIALĂ NR. 113",738,"BUCUREŞTI SECTORUL 4",179178,1,PART,PRCNCT,PRSD,PRSD_SV_SECTOR,"2025-05-18 21:59:13",1397,953,743,150,60,939,14,1500,547,277,662
42,"MUNICIPIUL BUCUREŞTI","ŞCOALA GIMNAZIALĂ NR. 113",739,"BUCUREŞTI SECTORUL 4",179178,1,PART,PRCNCT,PRSD,PRSD_SV_SECTOR,"2025-05-18 21:46:41",1622,1063,924,100,39,1045,18,1800,737,321,724
42,"MUNICIPIUL BUCUREŞTI","ŞCOALA GIMNAZIALĂ NR. 113",740,"BUCUREŞTI SECTORUL 4",179178,1,PART,PRCNCT,PRSD,PRSD_SV_SECTOR,"2025-05-18 21:41:48",1682,1021,896,74,51,1004,17,1900,879,319,685
42,"MUNICIPIUL BUCUREŞTI","ŞCOALA GIMNAZIALĂ NR. 113",741,"BUCUREŞTI SECTORUL 4",179178,1,PART,PRCNCT,PRSD,PRSD_SV_SECTOR,"2025-05-18 21:54:28",1620,886,835,51,0,873,13,1799,913,235,638
42,"MUNICIPIUL BUCUREŞTI","ŞCOALA GIMNAZIALĂ NR. 113",742,"BUCUREŞTI SECTORUL 4",179178,1,PART,PRCNCT,PRSD,PRSD_SV_SECTOR,"2025-05-18 21:40:57",1704,1023,978,45,0,1009,14,1900,877,286,723
42,"MUNICIPIUL BUCUREŞTI","ŞCOALA GIMNAZIALĂ NR. 113",743,"BUCUREŞTI SECTORUL 4",179178,1,PART,PRCNCT,PRSD,PRSD_SV_SECTOR,"2025-05-18 21:47:20",1888,1102,1043,59,0,1086,16,2100,998,327,759
42,"MUNICIPIUL BUCUREŞTI","ŞCOALA GIMNAZIALĂ NR. 113",744,"BUCUREŞTI SECTORUL 4",179178,1,PART,PRCNCT,PRSD,PRSD_SV_SECTOR,"2025-05-18 22:19:47",1814,1030,985,45,0,1014,16,2000,970,261,753
42,"MUNICIPIUL BUCUREŞTI","ŞCOALA GIMNAZIALĂ ”MĂRŢIŞOR”",745,"BUCUREŞTI SECTORUL 4",179178,1,PART,PRCNCT,PRSD,PRSD_SV_SECTOR,"2025-05-18 22:05:09",1549,920,793,125,2,907,13,1700,780,265,642
42,"MUNICIPIUL BUCUREŞTI","ŞCOALA GIMNAZIALĂ ”MĂRŢIŞOR”",746,"BUCUREŞTI SECTORUL 4",179178,1,PART,PRCNCT,PRSD,PRSD_SV_SECTOR,"2025-05-18 23:23:40",1864,1353,1062,291,0,1341,12,2100,747,306,1035
42,"MUNICIPIUL BUCUREŞTI","ŞCOALA GIMNAZIALĂ ”MĂRŢIŞOR”",747,"BUCUREŞTI SECTORUL 4",179178,1,PART,PRCNCT,PRSD,PRSD_SV_SECTOR,"2025-05-18 22:06:30",1954,1326,1193,133,0,1308,18,2200,874,308,1000
42,"MUNICIPIUL BUCUREŞTI","ŞCOALA GIMNAZIALĂ ”MĂRŢIŞOR”",748,"BUCUREŞTI SECTORUL 4",179178,1,PART,PRCNCT,PRSD,PRSD_SV_SECTOR,"2025-05-18 21:51:41",1219,802,657,145,0,797,5,1300,498,194,603
42,"MUNICIPIUL BUCUREŞTI","ŞCOALA GIMNAZIALĂ ”MĂRŢIŞOR”",749,"BUCUREŞTI SECTORUL 4",179178,1,PART,PRCNCT,PRSD,PRSD_SV_SECTOR,"2025-05-18 22:14:44",1488,968,816,151,1,949,19,1600,632,281,668
42,"MUNICIPIUL BUCUREŞTI","ŞCOALA GIMNAZIALĂ NR. 96",750,"BUCUREŞTI SECTORUL 4",179178,1,PART,PRCNCT,PRSD,PRSD_SV_SECTOR,"2025-05-18 21:44:53",875,583,497,86,0,573,10,1000,417,166,407
42,"MUNICIPIUL BUCUREŞTI","ŞCOALA GIMNAZIALĂ NR. 96",751,"BUCUREŞTI SECTORUL 4",179178,1,PART,PRCNCT,PRSD,PRSD_SV_SECTOR,"2025-05-18 21:40:29",1070,698,610,88,0,690,8,1200,502,221,469
42,"MUNICIPIUL BUCUREŞTI","ŞCOALA GIMNAZIALĂ NR. 96",752,"BUCUREŞTI SECTORUL 4",179178,1,PART,PRCNCT,PRSD,PRSD_SV_SECTOR,"2025-05-18 22:03:53",1016,610,524,85,1,599,11,1100,490,207,392
42,"MUNICIPIUL BUCUREŞTI","ŞCOALA GIMNAZIALĂ NR. 96",753,"BUCUREŞTI SECTORUL 4",179178,1,PART,PRCNCT,PRSD,PRSD_SV_SECTOR,"2025-05-18 22:15:15",1467,867,797,70,0,846,21,1600,733,273,573
42,"MUNICIPIUL BUCUREŞTI","ŞCOALA GIMNAZIALĂ NR. 96",754,"BUCUREŞTI SECTORUL 4",179178,1,PART,PRCNCT,PRSD,PRSD_SV_SECTOR,"2025-05-18 21:49:19",1092,616,560,56,0,602,14,1200,584,186,416
42,"MUNICIPIUL BUCUREŞTI","COLEGIUL NAŢIONAL OCTAV ONICESCU",755,"BUCUREŞTI SECTORUL 4",179178,1,PART,PRCNCT,PRSD,PRSD_SV_SECTOR,"2025-05-18 22:00:08",1646,1118,935,183,0,1096,22,1800,682,381,715
42,"MUNICIPIUL BUCUREŞTI","COLEGIUL NAŢIONAL OCTAV ONICESCU",756,"BUCUREŞTI SECTORUL 4",179178,1,PART,PRCNCT,PRSD,PRSD_SV_SECTOR,"2025-05-18 22:01:28",1081,732,583,149,0,717,15,1200,468,209,508
42,"MUNICIPIUL BUCUREŞTI","COLEGIUL NAŢIONAL OCTAV ONICESCU",757,"BUCUREŞTI SECTORUL 4",179178,1,PART,PRCNCT,PRSD,PRSD_SV_SECTOR,"2025-05-18 22:05:14",1387,842,734,107,1,825,17,1500,658,302,523
42,"MUNICIPIUL BUCUREŞTI","COLEGIUL NAŢIONAL OCTAV ONICESCU",758,"BUCUREŞTI SECTORUL 4",179178,1,PART,PRCNCT,PRSD,PRSD_SV_SECTOR,"2025-05-18 22:00:34",1298,863,753,110,0,856,7,1400,537,209,647
42,"MUNICIPIUL BUCUREŞTI","ŞCOALA GIMNAZIALĂ NR. 108",759,"BUCUREŞTI SECTORUL 4",179178,1,PART,PRCNCT,PRSD,PRSD_SV_SECTOR,"2025-05-18 21:48:21",1242,798,720,77,1,784,14,1400,602,260,524
42,"MUNICIPIUL BUCUREŞTI","ŞCOALA GIMNAZIALĂ NR. 108",760,"BUCUREŞTI SECTORUL 4",179178,1,PART,PRCNCT,PRSD,PRSD_SV_SECTOR,"2025-05-18 22:11:43",1214,747,676,70,1,733,14,1300,553,192,541
42,"MUNICIPIUL BUCUREŞTI","ŞCOALA GIMNAZIALĂ NR. 108",761,"BUCUREŞTI SECTORUL 4",179178,1,PART,PRCNCT,PRSD,PRSD_SV_SECTOR,"2025-05-18 22:08:11",1315,777,705,72,0,764,13,1500,723,214,550
42,"MUNICIPIUL BUCUREŞTI","ŞCOALA GIMNAZIALĂ NR. 108",762,"BUCUREŞTI SECTORUL 4",179178,1,PART,PRCNCT,PRSD,PRSD_SV_SECTOR,"2025-05-18 22:01:13",1393,831,735,95,1,821,10,1500,669,238,583
42,"MUNICIPIUL BUCUREŞTI","ŞCOALA GIMNAZIALĂ NR. 108",763,"BUCUREŞTI SECTORUL 4",179178,1,PART,PRCNCT,PRSD,PRSD_SV_SECTOR,"2025-05-18 22:20:44",1246,760,686,74,0,748,12,1401,641,236,512
42,"MUNICIPIUL BUCUREŞTI","ŞCOALA GIMNAZIALĂ AVRAM IANCU",764,"BUCUREŞTI SECTORUL 4",179178,1,PART,PRCNCT,PRSD,PRSD_SV_SECTOR,"2025-05-18 22:14:19",1908,1276,1083,192,1,1261,15,2100,824,396,865
42,"MUNICIPIUL BUCUREŞTI","ŞCOALA GIMNAZIALĂ AVRAM IANCU",765,"BUCUREŞTI SECTORUL 4",179178,1,PART,PRCNCT,PRSD,PRSD_SV_SECTOR,"2025-05-18 22:21:46",1713,1157,1033,123,1,1140,17,1900,743,342,798
42,"MUNICIPIUL BUCUREŞTI","ŞCOALA GIMNAZIALĂ AVRAM IANCU",766,"BUCUREŞTI SECTORUL 4",179178,1,PART,PRCNCT,PRSD,PRSD_SV_SECTOR,"2025-05-18 23:08:46",1916,1162,1036,125,1,1148,14,2100,938,400,748
42,"MUNICIPIUL BUCUREŞTI","ŞCOALA GIMNAZIALĂ AVRAM IANCU",767,"BUCUREŞTI SECTORUL 4",179178,1,PART,PRCNCT,PRSD,PRSD_SV_SECTOR,"2025-05-18 22:06:01",1847,1165,1004,161,0,1155,10,1984,819,408,747
42,"MUNICIPIUL BUCUREŞTI","ŞCOALA GIMNAZIALĂ AVRAM IANCU",768,"BUCUREŞTI SECTORUL 4",179178,1,PART,PRCNCT,PRSD,PRSD_SV_SECTOR,"2025-05-18 21:57:20",1770,1064,1002,60,2,1048,16,1900,836,315,733
42,"MUNICIPIUL BUCUREŞTI","GRĂDINIȚA VISTA",769,"BUCUREŞTI SECTORUL 4",179178,1,PART,PRCNCT,PRSD,PRSD_SV_SECTOR,"2025-05-18 22:02:54",1803,1257,1043,214,0,1240,17,2000,743,424,816
42,"MUNICIPIUL BUCUREŞTI","GRĂDINIȚA VISTA",770,"BUCUREŞTI SECTORUL 4",179178,1,PART,PRCNCT,PRSD,PRSD_SV_SECTOR,"2025-05-18 23:13:29",1777,1213,989,224,0,1198,15,2000,787,498,700
42,"MUNICIPIUL BUCUREŞTI","ŞCOALA GIMNAZIALĂ NR. 189",771,"BUCUREŞTI SECTORUL 4",179178,1,PART,PRCNCT,PRSD,PRSD_SV_SECTOR,"2025-05-18 22:07:13",920,495,460,35,0,479,16,1000,505,167,312
42,"MUNICIPIUL BUCUREŞTI","ŞCOALA GIMNAZIALĂ NR. 189",772,"BUCUREŞTI SECTORUL 4",179178,1,PART,PRCNCT,PRSD,PRSD_SV_SECTOR,"2025-05-18 21:56:19",1256,706,658,46,2,695,11,1395,689,230,465
42,"MUNICIPIUL BUCUREŞTI","ŞCOALA GIMNAZIALĂ NR. 189",773,"BUCUREŞTI SECTORUL 4",179178,1,PART,PRCNCT,PRSD,PRSD_SV_SECTOR,"2025-05-18 22:36:20",1761,957,897,59,1,946,11,1900,943,311,635
42,"MUNICIPIUL BUCUREŞTI","ŞCOALA GIMNAZIALĂ NR. 189",774,"BUCUREŞTI SECTORUL 4",179178,1,PART,PRCNCT,PRSD,PRSD_SV_SECTOR,"2025-05-18 22:49:57",1499,872,826,45,1,854,18,1708,836,286,568
42,"MUNICIPIUL BUCUREŞTI","ȘCOALA GIMNAZIALĂ NR. 189",775,"BUCUREŞTI SECTORUL 4",179178,1,PART,PRCNCT,PRSD,PRSD_SV_SECTOR,"2025-05-18 22:03:00",1176,822,650,172,0,796,26,1300,478,273,523
42,"MUNICIPIUL BUCUREŞTI","ȘCOALA GIMNAZIALĂ NR. 189",776,"BUCUREŞTI SECTORUL 4",179178,1,PART,PRCNCT,PRSD,PRSD_SV_SECTOR,"2025-05-18 22:25:52",941,611,531,78,2,601,10,1000,389,185,416
42,"MUNICIPIUL BUCUREŞTI","ȘCOALA GIMNAZIALĂ NR. 189",777,"BUCUREŞTI SECTORUL 4",179178,2,PART,PRCNCT,PRSD,PRSD_SV_SECTOR,"2025-05-18 23:33:32",1312,855,782,72,1,841,14,1400,545,270,571
42,"MUNICIPIUL BUCUREŞTI","ŞCOALA GIMNAZIALĂ EMIL RACOVIŢĂ",778,"BUCUREŞTI SECTORUL 4",179178,1,PART,PRCNCT,PRSD,PRSD_SV_SECTOR,"2025-05-18 22:31:57",1421,914,764,150,0,905,9,1600,686,299,606
42,"MUNICIPIUL BUCUREŞTI","ŞCOALA GIMNAZIALĂ EMIL RACOVIŢĂ",779,"BUCUREŞTI SECTORUL 4",179178,1,PART,PRCNCT,PRSD,PRSD_SV_SECTOR,"2025-05-18 23:16:11",1861,1289,1052,236,1,1264,25,2008,719,367,897
42,"MUNICIPIUL BUCUREŞTI","ŞCOALA GIMNAZIALĂ EMIL RACOVIŢĂ",780,"BUCUREŞTI SECTORUL 4",179178,1,PART,PRCNCT,PRSD,PRSD_SV_SECTOR,"2025-05-18 22:34:08",1498,846,732,113,1,834,12,1600,754,317,517
42,"MUNICIPIUL BUCUREŞTI","ŞCOALA GIMNAZIALĂ EMIL RACOVIŢĂ",781,"BUCUREŞTI SECTORUL 4",179178,1,PART,PRCNCT,PRSD,PRSD_SV_SECTOR,"2025-05-18 23:08:59",1465,877,761,116,0,866,11,1600,723,289,577
42,"MUNICIPIUL BUCUREŞTI","ŞCOALA GIMNAZIALĂ NR. 194",782,"BUCUREŞTI SECTORUL 4",179178,1,PART,PRCNCT,PRSD,PRSD_SV_SECTOR,"2025-05-18 21:34:21",934,553,519,34,0,545,8,1000,447,142,403
42,"MUNICIPIUL BUCUREŞTI","ŞCOALA GIMNAZIALĂ NR. 194",783,"BUCUREŞTI SECTORUL 4",179178,1,PART,PRCNCT,PRSD,PRSD_SV_SECTOR,"2025-05-18 21:30:55",843,518,464,54,0,505,13,900,382,169,336
42,"MUNICIPIUL BUCUREŞTI","ŞCOALA GIMNAZIALĂ NR. 194",784,"BUCUREŞTI SECTORUL 4",179178,1,PART,PRCNCT,PRSD,PRSD_SV_SECTOR,"2025-05-18 21:47:57",1164,708,650,58,0,702,6,1300,592,209,493
42,"MUNICIPIUL BUCUREŞTI","ŞCOALA GIMNAZIALĂ NR. 194",785,"BUCUREŞTI SECTORUL 4",179178,1,PART,PRCNCT,PRSD,PRSD_SV_SECTOR,"2025-05-18 21:47:01",1403,779,731,48,0,768,11,1500,721,211,557
42,"MUNICIPIUL BUCUREŞTI","ŞCOALA GIMNAZIALĂ NR. 194",786,"BUCUREŞTI SECTORUL 4",179178,1,PART,PRCNCT,PRSD,PRSD_SV_SECTOR,"2025-05-18 21:35:10",1059,627,557,70,0,617,10,1200,573,189,428
42,"MUNICIPIUL BUCUREŞTI","ŞCOALA GIMNAZIALĂ NR. 194",787,"BUCUREŞTI SECTORUL 4",179178,1,PART,PRCNCT,PRSD,PRSD_SV_SECTOR,"2025-05-18 21:39:49",1113,735,632,93,10,723,12,1200,465,205,518
42,"MUNICIPIUL BUCUREŞTI","ȘCOALA GIMNAZIALĂ NR. 194",788,"BUCUREŞTI SECTORUL 4",179178,1,PART,PRCNCT,PRSD,PRSD_SV_SECTOR,"2025-05-18 21:50:16",905,635,486,149,0,625,10,1000,365,184,441
42,"MUNICIPIUL BUCUREŞTI","ȘCOALA GIMNAZIALĂ NR. 194",789,"BUCUREŞTI SECTORUL 4",179178,1,PART,PRCNCT,PRSD,PRSD_SV_SECTOR,"2025-05-18 22:04:58",1123,685,614,71,0,670,15,1200,515,212,458
42,"MUNICIPIUL BUCUREŞTI","ŞCOALA GIMNAZIALĂ ”GEORGE BACOVIA”",790,"BUCUREŞTI SECTORUL 4",179178,1,PART,PRCNCT,PRSD,PRSD_SV_SECTOR,"2025-05-18 21:40:49",1343,834,742,92,0,822,12,1500,666,204,618
42,"MUNICIPIUL BUCUREŞTI","ŞCOALA GIMNAZIALĂ ”GEORGE BACOVIA”",791,"BUCUREŞTI SECTORUL 4",179178,1,PART,PRCNCT,PRSD,PRSD_SV_SECTOR,"2025-05-18 22:08:07",1193,777,698,78,1,762,15,1300,523,214,548
42,"MUNICIPIUL BUCUREŞTI","ŞCOALA GIMNAZIALĂ ”GEORGE BACOVIA”",792,"BUCUREŞTI SECTORUL 4",179178,1,PART,PRCNCT,PRSD,PRSD_SV_SECTOR,"2025-05-18 22:08:42",1734,1042,938,102,2,1025,17,1900,858,312,713
42,"MUNICIPIUL BUCUREŞTI","ŞCOALA GIMNAZIALĂ ”GEORGE BACOVIA”",793,"BUCUREŞTI SECTORUL 4",179178,1,PART,PRCNCT,PRSD,PRSD_SV_SECTOR,"2025-05-18 21:46:23",1770,1143,973,170,0,1132,11,1900,757,339,793
42,"MUNICIPIUL BUCUREŞTI","ŞCOALA GIMNAZIALĂ ”GEORGE BACOVIA”",794,"BUCUREŞTI SECTORUL 4",179178,1,PART,PRCNCT,PRSD,PRSD_SV_SECTOR,"2025-05-18 21:43:16",1631,1023,901,120,2,1003,20,1800,777,298,705
42,"MUNICIPIUL BUCUREŞTI","ŞCOALA GIMNAZIALĂ ”GEORGE BACOVIA”",795,"BUCUREŞTI SECTORUL 4",179178,1,PART,PRCNCT,PRSD,PRSD_SV_SECTOR,"2025-05-18 21:52:44",1622,1104,953,148,3,1090,14,1800,696,237,853
42,"MUNICIPIUL BUCUREŞTI","ŞCOALA GIMNAZIALĂ ”GEORGE BACOVIA”",796,"BUCUREŞTI SECTORUL 4",179178,1,PART,PRCNCT,PRSD,PRSD_SV_SECTOR,"2025-05-18 21:38:28",1670,1056,923,133,0,1033,23,1800,744,263,770
42,"MUNICIPIUL BUCUREŞTI","GRĂDINIŢA ”ALBĂ CA ZĂPADA ȘI PITICII”",797,"BUCUREŞTI SECTORUL 4",179178,1,PART,PRCNCT,PRSD,PRSD_SV_SECTOR,"2025-05-18 21:30:50",1034,664,619,43,2,654,10,1100,436,190,464
42,"MUNICIPIUL BUCUREŞTI","GRĂDINIŢA ”ALBĂ CA ZĂPADA ȘI PITICII”",798,"BUCUREŞTI SECTORUL 4",179178,1,PART,PRCNCT,PRSD,PRSD_SV_SECTOR,"2025-05-18 21:31:32",1238,687,637,50,0,679,8,1400,713,232,447
42,"MUNICIPIUL BUCUREŞTI","GRĂDINIŢA ”ALBĂ CA ZĂPADA ȘI PITICII”",799,"BUCUREŞTI SECTORUL 4",179178,1,PART,PRCNCT,PRSD,PRSD_SV_SECTOR,"2025-05-18 21:39:50",1216,684,604,79,1,678,6,1300,616,231,447
42,"MUNICIPIUL BUCUREŞTI","GRĂDINIŢA ”ALBĂ CA ZĂPADA ȘI PITICII”",800,"BUCUREŞTI SECTORUL 4",179178,1,PART,PRCNCT,PRSD,PRSD_SV_SECTOR,"2025-05-18 21:40:31",1095,573,534,39,0,565,8,1200,627,193,372
42,"MUNICIPIUL BUCUREŞTI","ŞCOALA GIMNAZIALĂ ”ŞERBAN VODĂ”",801,"BUCUREŞTI SECTORUL 4",179178,1,PART,PRCNCT,PRSD,PRSD_SV_SECTOR,"2025-05-18 21:42:06",1550,883,772,110,1,864,19,1700,817,337,527
42,"MUNICIPIUL BUCUREŞTI","ŞCOALA GIMNAZIALĂ ”ŞERBAN VODĂ”",802,"BUCUREŞTI SECTORUL 4",179178,1,PART,PRCNCT,PRSD,PRSD_SV_SECTOR,"2025-05-18 21:44:00",1807,1119,1029,89,1,1107,12,2000,881,437,670
42,"MUNICIPIUL BUCUREŞTI","ŞCOALA GIMNAZIALĂ ”ŞERBAN VODĂ”",803,"BUCUREŞTI SECTORUL 4",179178,2,PART,PRCNCT,PRSD,PRSD_SV_SECTOR,"2025-05-19 00:03:34",1420,800,732,68,0,791,9,1600,800,300,491
42,"MUNICIPIUL BUCUREŞTI","ŞCOALA GIMNAZIALĂ ”ŞERBAN VODĂ”",804,"BUCUREŞTI SECTORUL 4",179178,2,PART,PRCNCT,PRSD,PRSD_SV_SECTOR,"2025-05-18 23:53:40",1377,807,750,57,0,801,6,1500,693,287,514
42,"MUNICIPIUL BUCUREŞTI","ŞCOALA GIMNAZIALĂ ”ŞERBAN VODĂ”",805,"BUCUREŞTI SECTORUL 4",179178,1,PART,PRCNCT,PRSD,PRSD_SV_SECTOR,"2025-05-18 21:52:49",1318,838,775,62,1,832,6,1400,562,302,530
42,"MUNICIPIUL BUCUREŞTI","ŞCOALA GIMNAZIALĂ NR. 308",806,"BUCUREŞTI SECTORUL 4",179178,1,PART,PRCNCT,PRSD,PRSD_SV_SECTOR,"2025-05-18 21:27:43",1369,745,692,52,1,729,16,1500,755,298,431
42,"MUNICIPIUL BUCUREŞTI","ȘCOALA GIMNAZIALĂ NR. 308",807,"BUCUREŞTI SECTORUL 4",179178,1,PART,PRCNCT,PRSD,PRSD_SV_SECTOR,"2025-05-18 21:59:19",1307,745,720,25,0,732,13,1400,655,239,493
42,"MUNICIPIUL BUCUREŞTI","ŞCOALA GIMNAZIALĂ NR. 308",808,"BUCUREŞTI SECTORUL 4",179178,1,PART,PRCNCT,PRSD,PRSD_SV_SECTOR,"2025-05-18 21:44:46",1236,746,721,24,1,742,4,1400,654,278,464
42,"MUNICIPIUL BUCUREŞTI","ŞCOALA GIMNAZIALĂ NR. 308",809,"BUCUREŞTI SECTORUL 4",179178,1,PART,PRCNCT,PRSD,PRSD_SV_SECTOR,"2025-05-18 21:44:06",1141,675,629,46,0,657,18,1300,625,249,408
42,"MUNICIPIUL BUCUREŞTI","ŞCOALA GIMNAZIALĂ NR. 308",810,"BUCUREŞTI SECTORUL 4",179178,1,PART,PRCNCT,PRSD,PRSD_SV_SECTOR,"2025-05-18 21:45:37",1310,760,676,84,0,751,9,1400,640,273,478
42,"MUNICIPIUL BUCUREŞTI","ŞCOALA GIMNAZIALĂ NR. 308",811,"BUCUREŞTI SECTORUL 4",179178,1,PART,PRCNCT,PRSD,PRSD_SV_SECTOR,"2025-05-18 21:43:48",1434,766,709,57,0,757,9,1600,834,347,410
42,"MUNICIPIUL BUCUREŞTI","ŞCOALA GIMNAZIALĂ NR. 165",812,"BUCUREŞTI SECTORUL 4",179178,1,PART,PRCNCT,PRSD,PRSD_SV_SECTOR,"2025-05-18 22:00:34",1647,823,767,55,1,798,25,1800,977,306,492
42,"MUNICIPIUL BUCUREŞTI","ŞCOALA GIMNAZIALĂ NR. 165",813,"BUCUREŞTI SECTORUL 4",179178,1,PART,PRCNCT,PRSD,PRSD_SV_SECTOR,"2025-05-18 21:53:36",1733,906,841,64,1,894,12,1900,994,318,576
42,"MUNICIPIUL BUCUREŞTI","ŞCOALA GIMNAZIALĂ NR. 165",814,"BUCUREŞTI SECTORUL 4",179178,1,PART,PRCNCT,PRSD,PRSD_SV_SECTOR,"2025-05-18 21:40:55",1642,925,804,121,0,916,9,1800,875,397,519
42,"MUNICIPIUL BUCUREŞTI","ŞCOALA GIMNAZIALĂ NR. 165",815,"BUCUREŞTI SECTORUL 4",179178,1,PART,PRCNCT,PRSD,PRSD_SV_SECTOR,"2025-05-18 21:31:36",1683,904,793,111,0,885,19,1900,996,369,516
42,"MUNICIPIUL BUCUREŞTI","ŞCOALA GIMNAZIALĂ NR. 165",816,"BUCUREŞTI SECTORUL 4",179178,1,PART,PRCNCT,PRSD,PRSD_SV_SECTOR,"2025-05-18 21:38:49",1509,839,773,65,1,825,14,1700,861,372,453
42,"MUNICIPIUL BUCUREŞTI","ŞCOALA GIMNAZIALĂ NR. 165",817,"BUCUREŞTI SECTORUL 4",179178,1,PART,PRCNCT,PRSD,PRSD_SV_SECTOR,"2025-05-18 21:40:23",1725,923,861,61,1,912,11,1900,977,412,500
42,"MUNICIPIUL BUCUREŞTI","ŞCOALA GIMNAZIALĂ NR. 165",818,"BUCUREŞTI SECTORUL 4",179178,1,PART,PRCNCT,PRSD,PRSD_SV_SECTOR,"2025-05-18 22:30:20",2015,1247,1144,102,1,1228,19,2200,953,433,795
42,"MUNICIPIUL BUCUREŞTI","ŞCOALA GIMNAZIALĂ NR. 165",819,"BUCUREŞTI SECTORUL 4",179178,1,PART,PRCNCT,PRSD,PRSD_SV_SECTOR,"2025-05-18 21:41:12",1913,1072,1018,54,0,1062,10,2100,1028,410,652
42,"MUNICIPIUL BUCUREŞTI","ŞCOALA GIMNAZIALĂ NR. 165",820,"BUCUREŞTI SECTORUL 4",179178,1,PART,PRCNCT,PRSD,PRSD_SV_SECTOR,"2025-05-18 22:18:29",1679,926,793,133,0,918,8,1800,874,400,518
42,"MUNICIPIUL BUCUREŞTI","ŞCOALA GIMNAZIALĂ NR. 119",821,"BUCUREŞTI SECTORUL 4",179178,1,PART,PRCNCT,PRSD,PRSD_SV_SECTOR,"2025-05-18 21:55:08",1661,856,764,92,0,849,7,1800,944,426,423
42,"MUNICIPIUL BUCUREŞTI","ŞCOALA GIMNAZIALĂ NR. 119",822,"BUCUREŞTI SECTORUL 4",179178,2,PART,PRCNCT,PRSD,PRSD_SV_SECTOR,"2025-05-18 23:13:13",1432,770,711,58,1,759,11,1599,829,350,409
42,"MUNICIPIUL BUCUREŞTI","ŞCOALA GIMNAZIALĂ NR. 119",823,"BUCUREŞTI SECTORUL 4",179178,1,PART,PRCNCT,PRSD,PRSD_SV_SECTOR,"2025-05-18 22:01:19",1774,994,959,34,1,980,14,1900,906,338,642
42,"MUNICIPIUL BUCUREŞTI","ŞCOALA GIMNAZIALĂ NR. 119",824,"BUCUREŞTI SECTORUL 4",179178,1,PART,PRCNCT,PRSD,PRSD_SV_SECTOR,"2025-05-18 21:45:02",1799,1032,932,100,0,1018,14,2000,968,395,623
42,"MUNICIPIUL BUCUREŞTI","ŞCOALA GIMNAZIALĂ NR. 119",825,"BUCUREŞTI SECTORUL 4",179178,1,PART,PRCNCT,PRSD,PRSD_SV_SECTOR,"2025-05-18 22:19:06",1819,1051,985,64,2,1035,16,2000,949,385,650
42,"MUNICIPIUL BUCUREŞTI","ŞCOALA GIMNAZIALĂ NR. 119",826,"BUCUREŞTI SECTORUL 4",179178,1,PART,PRCNCT,PRSD,PRSD_SV_SECTOR,"2025-05-18 21:59:17",1826,902,856,45,1,895,7,2000,1098,420,475
42,"MUNICIPIUL BUCUREŞTI","GRĂDINIŢA ”ÎNȘIR”TE MĂRGĂRITE”",827,"BUCUREŞTI SECTORUL 4",179178,1,PART,PRCNCT,PRSD,PRSD_SV_SECTOR,"2025-05-18 21:40:48",1224,670,615,55,0,653,17,1300,630,241,412
42,"MUNICIPIUL BUCUREŞTI","GRĂDINIŢA ”ÎNȘIR”TE MĂRGĂRITE”",828,"BUCUREŞTI SECTORUL 4",179178,1,PART,PRCNCT,PRSD,PRSD_SV_SECTOR,"2025-05-18 21:56:40",1228,671,621,49,1,663,8,1300,629,286,377
42,"MUNICIPIUL BUCUREŞTI","ŞCOALA GIMNAZIALĂ GEORGE TOPÂRCEANU",829,"BUCUREŞTI SECTORUL 4",179178,1,PART,PRCNCT,PRSD,PRSD_SV_SECTOR,"2025-05-18 21:47:29",1371,765,686,79,0,747,18,1500,735,320,427
42,"MUNICIPIUL BUCUREŞTI","ŞCOALA GIMNAZIALĂ GEORGE TOPÂRCEANU",830,"BUCUREŞTI SECTORUL 4",179178,1,PART,PRCNCT,PRSD,PRSD_SV_SECTOR,"2025-05-18 21:40:14",1360,845,744,101,0,828,17,1500,655,355,473
42,"MUNICIPIUL BUCUREŞTI","ŞCOALA GIMNAZIALĂ GEORGE TOPÂRCEANU",831,"BUCUREŞTI SECTORUL 4",179178,1,PART,PRCNCT,PRSD,PRSD_SV_SECTOR,"2025-05-18 22:01:02",1260,681,635,46,0,669,12,1400,719,293,376
42,"MUNICIPIUL BUCUREŞTI","ŞCOALA GIMNAZIALĂ GEORGE TOPÂRCEANU",832,"BUCUREŞTI SECTORUL 4",179178,1,PART,PRCNCT,PRSD,PRSD_SV_SECTOR,"2025-05-18 21:50:58",1454,849,805,44,0,835,14,1600,751,348,487
42,"MUNICIPIUL BUCUREŞTI","ŞCOALA GIMNAZIALĂ NR. 129",833,"BUCUREŞTI SECTORUL 4",179178,2,PART,PRCNCT,PRSD,PRSD_SV_SECTOR,"2025-05-19 01:02:06",1308,860,732,127,1,844,16,1400,540,272,572
42,"MUNICIPIUL BUCUREŞTI","ŞCOALA GIMNAZIALĂ NR. 129",834,"BUCUREŞTI SECTORUL 4",179178,1,PART,PRCNCT,PRSD,PRSD_SV_SECTOR,"2025-05-18 22:04:23",1406,889,788,101,0,878,11,1500,611,242,636
42,"MUNICIPIUL BUCUREŞTI","ŞCOALA GIMNAZIALĂ NR. 129",835,"BUCUREŞTI SECTORUL 4",179178,1,PART,PRCNCT,PRSD,PRSD_SV_SECTOR,"2025-05-18 21:44:35",1540,877,826,50,1,854,23,1700,823,270,584
42,"MUNICIPIUL BUCUREŞTI","ŞCOALA GIMNAZIALĂ NR. 129",836,"BUCUREŞTI SECTORUL 4",179178,1,PART,PRCNCT,PRSD,PRSD_SV_SECTOR,"2025-05-18 22:11:00",1520,887,851,33,3,872,15,1700,813,272,600
42,"MUNICIPIUL BUCUREŞTI","ŞCOALA GIMNAZIALĂ NR. 129",837,"BUCUREŞTI SECTORUL 4",179178,1,PART,PRCNCT,PRSD,PRSD_SV_SECTOR,"2025-05-18 21:53:37",1253,666,631,35,0,654,12,1400,734,190,464
42,"MUNICIPIUL BUCUREŞTI","ȘCOALA GIMNAZIALĂ NR. 129",838,"BUCUREŞTI SECTORUL 4",179178,1,PART,PRCNCT,PRSD,PRSD_SV_SECTOR,"2025-05-18 22:03:18",1307,753,718,33,2,739,14,1400,647,226,513
42,"MUNICIPIUL BUCUREŞTI","ŞCOALA GIMNAZIALĂ ”IONEL TEODOREANU”",839,"BUCUREŞTI SECTORUL 4",179178,1,PART,PRCNCT,PRSD,PRSD_SV_SECTOR,"2025-05-18 22:20:34",1233,775,667,107,1,765,10,1400,625,290,475
42,"MUNICIPIUL BUCUREŞTI","ŞCOALA GIMNAZIALĂ ”IONEL TEODOREANU”",840,"BUCUREŞTI SECTORUL 4",179178,1,PART,PRCNCT,PRSD,PRSD_SV_SECTOR,"2025-05-18 22:09:25",1383,765,730,33,2,753,12,1500,735,239,514
42,"MUNICIPIUL BUCUREŞTI","ŞCOALA GIMNAZIALĂ ”IONEL TEODOREANU”",841,"BUCUREŞTI SECTORUL 4",179178,1,PART,PRCNCT,PRSD,PRSD_SV_SECTOR,"2025-05-18 22:30:23",1433,812,772,39,1,802,10,1600,788,331,471
42,"MUNICIPIUL BUCUREŞTI","ŞCOALA GIMNAZIALĂ ”IONEL TEODOREANU”",842,"BUCUREŞTI SECTORUL 4",179178,1,PART,PRCNCT,PRSD,PRSD_SV_SECTOR,"2025-05-18 21:57:18",1499,767,679,88,0,752,15,1600,833,431,321
42,"MUNICIPIUL BUCUREŞTI","ŞCOALA GIMNAZIALĂ ”IONEL TEODOREANU”",843,"BUCUREŞTI SECTORUL 4",179178,1,PART,PRCNCT,PRSD,PRSD_SV_SECTOR,"2025-05-18 21:48:38",1544,776,725,51,0,762,14,1700,924,377,385
42,"MUNICIPIUL BUCUREŞTI","ŞCOALA GIMNAZIALĂ ”IONEL TEODOREANU”",844,"BUCUREŞTI SECTORUL 4",179178,1,PART,PRCNCT,PRSD,PRSD_SV_SECTOR,"2025-05-18 21:44:17",1389,727,692,34,1,719,8,1500,773,268,451
42,"MUNICIPIUL BUCUREŞTI","ŞCOALA GIMNAZIALĂ NR. 99",845,"BUCUREŞTI SECTORUL 4",179178,1,PART,PRCNCT,PRSD,PRSD_SV_SECTOR,"2025-05-18 21:48:19",1423,855,771,81,3,834,21,1600,745,322,512
42,"MUNICIPIUL BUCUREŞTI","ŞCOALA GIMNAZIALĂ NR. 99",846,"BUCUREŞTI SECTORUL 4",179178,1,PART,PRCNCT,PRSD,PRSD_SV_SECTOR,"2025-05-18 22:19:32",1744,1032,901,131,0,1017,15,1900,868,373,644
42,"MUNICIPIUL BUCUREŞTI","ŞCOALA GIMNAZIALĂ NR. 99",847,"BUCUREŞTI SECTORUL 4",179178,1,PART,PRCNCT,PRSD,PRSD_SV_SECTOR,"2025-05-18 21:36:13",1419,885,744,141,0,875,10,1600,715,387,488
42,"MUNICIPIUL BUCUREŞTI","ŞCOALA GIMNAZIALĂ NR. 99",848,"BUCUREŞTI SECTORUL 4",179178,1,PART,PRCNCT,PRSD,PRSD_SV_SECTOR,"2025-05-18 21:40:44",1641,888,836,52,0,873,15,1800,912,392,481
42,"MUNICIPIUL BUCUREŞTI","GRAND ARENA - GRĂDINIȚA NR.4",849,"BUCUREŞTI SECTORUL 4",179178,1,PART,PRCNCT,PRSD,PRSD_SV_SECTOR,"2025-05-18 22:30:55",1959,1661,1193,468,0,1638,23,2200,539,407,1231
42,"MUNICIPIUL BUCUREŞTI","GRAND ARENA - GRĂDINIȚA NR.62",850,"BUCUREŞTI SECTORUL 4",179178,1,PART,PRCNCT,PRSD,PRSD_SV_SECTOR,"2025-05-18 23:15:53",1919,1467,1130,336,1,1451,16,2100,633,354,1097
42,"MUNICIPIUL BUCUREŞTI","GRAND ARENA - GRĂDINIȚA NR.62",851,"BUCUREŞTI SECTORUL 4",179178,1,PART,PRCNCT,PRSD,PRSD_SV_SECTOR,"2025-05-18 22:40:05",1934,1654,1198,456,0,1642,12,2100,446,405,1237
42,"MUNICIPIUL BUCUREŞTI","ȘCOALA GIMNAZIALĂ NR.134",852,"BUCUREŞTI SECTORUL 5",179187,1,PART,PRCNCT,PRSD,PRSD_SV_SECTOR,"2025-05-18 22:07:38",1807,556,424,132,0,545,11,800,244,295,250
42,"MUNICIPIUL BUCUREŞTI","ȘCOALA GIMNAZIALĂ NR.134",853,"BUCUREŞTI SECTORUL 5",179187,1,PART,PRCNCT,PRSD,PRSD_SV_SECTOR,"2025-05-18 22:44:56",1893,1006,936,70,0,989,17,2000,994,527,462
42,"MUNICIPIUL BUCUREŞTI","ȘCOALA GIMNAZIALĂ NR.134",854,"BUCUREŞTI SECTORUL 5",179187,1,PART,PRCNCT,PRSD,PRSD_SV_SECTOR,"2025-05-18 22:21:27",1419,734,704,30,0,727,7,1608,874,347,380
42,"MUNICIPIUL BUCUREŞTI","ȘCOALA GIMNAZIALĂ NR.134",855,"BUCUREŞTI SECTORUL 5",179187,1,PART,PRCNCT,PRSD,PRSD_SV_SECTOR,"2025-05-18 22:16:45",1623,722,689,31,2,721,1,1200,478,448,273
42,"MUNICIPIUL BUCUREŞTI","ȘCOALA GIMNAZIALĂ NR.134",856,"BUCUREŞTI SECTORUL 5",179187,1,PART,PRCNCT,PRSD,PRSD_SV_SECTOR,"2025-05-18 22:00:45",1411,716,696,19,1,708,7,1600,884,384,324
42,"MUNICIPIUL BUCUREŞTI","ȘCOALA GIMNAZIALĂ NR.134",857,"BUCUREŞTI SECTORUL 5",179187,1,PART,PRCNCT,PRSD,PRSD_SV_SECTOR,"2025-05-18 22:19:02",1398,689,675,14,0,675,14,1600,911,370,305
42,"MUNICIPIUL BUCUREŞTI","ȘCOALA GIMNAZIALĂ NR.134",858,"BUCUREŞTI SECTORUL 5",179187,1,PART,PRCNCT,PRSD,PRSD_SV_SECTOR,"2025-05-18 22:41:52",1957,880,851,29,0,874,6,2000,1120,515,359
42,"MUNICIPIUL BUCUREŞTI","ȘCOALA GIMNAZIALĂ NR.134",859,"BUCUREŞTI SECTORUL 5",179187,1,PART,PRCNCT,PRSD,PRSD_SV_SECTOR,"2025-05-18 22:39:38",1616,697,663,34,0,687,10,1700,1003,424,263
42,"MUNICIPIUL BUCUREŞTI","ȘCOALA GIMNAZIALĂ NR.134",860,"BUCUREŞTI SECTORUL 5",179187,1,PART,PRCNCT,PRSD,PRSD_SV_SECTOR,"2025-05-18 21:50:36",1652,611,580,30,1,605,6,1700,1089,380,225
42,"MUNICIPIUL BUCUREŞTI","ȘCOALA GIMNAZIALĂ NR.134",861,"BUCUREŞTI SECTORUL 5",179187,1,PART,PRCNCT,PRSD,PRSD_SV_SECTOR,"2025-05-18 21:42:30",1626,604,583,21,0,594,10,1701,1097,376,218
42,"MUNICIPIUL BUCUREŞTI","ȘCOALA GIMNAZIALĂ NR.134",862,"BUCUREŞTI SECTORUL 5",179187,2,PART,PRCNCT,PRSD,PRSD_SV_SECTOR,"2025-05-18 23:30:02",1495,608,590,18,0,598,10,1600,992,316,282
42,"MUNICIPIUL BUCUREŞTI","COLEGIUL TEHNIC ENERGETIC",863,"BUCUREŞTI SECTORUL 5",179187,1,PART,PRCNCT,PRSD,PRSD_SV_SECTOR,"2025-05-18 21:46:34",1156,677,595,82,0,658,19,1300,623,241,417
42,"MUNICIPIUL BUCUREŞTI","COLEGIUL TEHNIC ENERGETIC",864,"BUCUREŞTI SECTORUL 5",179187,1,PART,PRCNCT,PRSD,PRSD_SV_SECTOR,"2025-05-18 22:02:13",1290,776,664,112,0,764,12,1400,624,299,465
42,"MUNICIPIUL BUCUREŞTI","COLEGIUL TEHNIC ENERGETIC",865,"BUCUREŞTI SECTORUL 5",179187,1,PART,PRCNCT,PRSD,PRSD_SV_SECTOR,"2025-05-18 21:39:26",993,618,536,82,0,609,9,1100,482,218,391
42,"MUNICIPIUL BUCUREŞTI","COLEGIUL TEHNIC ENERGETIC",866,"BUCUREŞTI SECTORUL 5",179187,1,PART,PRCNCT,PRSD,PRSD_SV_SECTOR,"2025-05-18 22:45:16",1020,557,497,60,0,547,10,1100,543,209,338
42,"MUNICIPIUL BUCUREŞTI","ȘCOALA GIMNAZIALĂ NR.136",867,"BUCUREŞTI SECTORUL 5",179187,1,PART,PRCNCT,PRSD,PRSD_SV_SECTOR,"2025-05-18 22:05:49",1738,714,680,33,1,702,12,1800,1086,452,250
42,"MUNICIPIUL BUCUREŞTI","ȘCOALA GIMNAZIALĂ NR.136",868,"BUCUREŞTI SECTORUL 5",179187,1,PART,PRCNCT,PRSD,PRSD_SV_SECTOR,"2025-05-18 21:53:59",1230,506,444,62,0,500,6,1300,794,352,148
42,"MUNICIPIUL BUCUREŞTI","ȘCOALA GIMNAZIALĂ NR.136",869,"BUCUREŞTI SECTORUL 5",179187,1,PART,PRCNCT,PRSD,PRSD_SV_SECTOR,"2025-05-18 22:26:41",1755,531,484,47,0,525,6,1800,1269,386,139
42,"MUNICIPIUL BUCUREŞTI","ȘCOALA GIMNAZIALĂ NR.136",870,"BUCUREŞTI SECTORUL 5",179187,1,PART,PRCNCT,PRSD,PRSD_SV_SECTOR,"2025-05-18 21:53:14",1200,555,510,45,0,548,7,1300,745,354,194
42,"MUNICIPIUL BUCUREŞTI","ȘCOALA GIMNAZIALĂ NR.136",871,"BUCUREŞTI SECTORUL 5",179187,1,PART,PRCNCT,PRSD,PRSD_SV_SECTOR,"2025-05-18 21:57:41",1424,638,607,31,0,632,6,1600,962,416,216
42,"MUNICIPIUL BUCUREŞTI","ȘCOALA GIMNAZIALĂ NR.136",872,"BUCUREŞTI SECTORUL 5",179187,1,PART,PRCNCT,PRSD,PRSD_SV_SECTOR,"2025-05-18 22:20:26",1436,636,611,25,0,626,10,1600,964,379,247
42,"MUNICIPIUL BUCUREŞTI","ȘCOALA GIMNAZIALĂ NR.136",873,"BUCUREŞTI SECTORUL 5",179187,1,PART,PRCNCT,PRSD,PRSD_SV_SECTOR,"2025-05-18 21:46:23",1397,654,600,54,0,644,10,1600,946,408,236
42,"MUNICIPIUL BUCUREŞTI","ȘCOALA GIMNAZIALĂ NR.2",874,"BUCUREŞTI SECTORUL 5",179187,1,PART,PRCNCT,PRSD,PRSD_SV_SECTOR,"2025-05-18 22:25:27",1175,700,546,154,0,684,16,1200,500,363,321
42,"MUNICIPIUL BUCUREŞTI","ȘCOALA GIMNAZIALĂ NR.2",875,"BUCUREŞTI SECTORUL 5",179187,1,PART,PRCNCT,PRSD,PRSD_SV_SECTOR,"2025-05-18 21:32:21",1380,662,623,37,2,654,8,1600,938,369,285
42,"MUNICIPIUL BUCUREŞTI","ȘCOALA GIMNAZIALĂ NR.2",876,"BUCUREŞTI SECTORUL 5",179187,1,PART,PRCNCT,PRSD,PRSD_SV_SECTOR,"2025-05-18 21:38:55",1150,540,522,18,0,530,10,1200,660,283,247
42,"MUNICIPIUL BUCUREŞTI","ȘCOALA GIMNAZIALĂ NR.2",877,"BUCUREŞTI SECTORUL 5",179187,2,PART,PRCNCT,PRSD,PRSD_SV_SECTOR,"2025-05-18 23:19:20",1009,486,457,28,1,479,7,1100,614,274,205
42,"MUNICIPIUL BUCUREŞTI","ȘCOALA GIMNAZIALĂ NR.2",878,"BUCUREŞTI SECTORUL 5",179187,1,PART,PRCNCT,PRSD,PRSD_SV_SECTOR,"2025-05-18 21:36:06",1365,650,633,17,0,639,11,1600,950,357,282
42,"MUNICIPIUL BUCUREŞTI","ȘCOALA GIMNAZIALĂ NR.188",879,"BUCUREŞTI SECTORUL 5",179187,3,PART,PRCNCT,PRSD,PRSD_SV_SECTOR,"2025-05-19 01:57:06",938,579,489,89,1,565,14,1000,421,238,327
42,"MUNICIPIUL BUCUREŞTI","ȘCOALA GIMNAZIALĂ NR.188",880,"BUCUREŞTI SECTORUL 5",179187,3,PART,PRCNCT,PRSD,PRSD_SV_SECTOR,"2025-05-19 01:40:03",1312,846,767,78,1,829,17,1400,554,322,507
42,"MUNICIPIUL BUCUREŞTI","ȘCOALA GIMNAZIALĂ NR.188",881,"BUCUREŞTI SECTORUL 5",179187,2,PART,PRCNCT,PRSD,PRSD_SV_SECTOR,"2025-05-18 23:19:07",838,576,492,84,0,566,10,900,324,160,406
42,"MUNICIPIUL BUCUREŞTI","ȘCOALA GIMNAZIALĂ NR.188",882,"BUCUREŞTI SECTORUL 5",179187,1,PART,PRCNCT,PRSD,PRSD_SV_SECTOR,"2025-05-18 21:50:26",979,511,475,35,1,501,10,1100,589,183,318
42,"MUNICIPIUL BUCUREŞTI","ȘCOALA GIMNAZIALĂ NR.188",883,"BUCUREŞTI SECTORUL 5",179187,1,PART,PRCNCT,PRSD,PRSD_SV_SECTOR,"2025-05-18 21:43:33",767,441,410,31,0,437,4,900,459,171,266
42,"MUNICIPIUL BUCUREŞTI","ȘCOALA GIMNAZIALĂ ”LUCEAFĂRUL”",884,"BUCUREŞTI SECTORUL 5",179187,1,PART,PRCNCT,PRSD,PRSD_SV_SECTOR,"2025-05-18 22:18:23",1053,931,573,358,0,912,19,1200,269,310,602
42,"MUNICIPIUL BUCUREŞTI","ȘCOALA GIMNAZIALĂ ”LUCEAFĂRUL”",885,"BUCUREŞTI SECTORUL 5",179187,1,PART,PRCNCT,PRSD,PRSD_SV_SECTOR,"2025-05-18 21:55:26",1306,818,694,124,0,807,11,1300,482,263,544
42,"MUNICIPIUL BUCUREŞTI","ȘCOALA GIMNAZIALĂ ”LUCEAFĂRUL”",886,"BUCUREŞTI SECTORUL 5",179187,1,PART,PRCNCT,PRSD,PRSD_SV_SECTOR,"2025-05-18 21:38:33",1003,652,535,117,0,637,15,1100,448,239,398
42,"MUNICIPIUL BUCUREŞTI","ȘCOALA GIMNAZIALĂ ”LUCEAFĂRUL”",887,"BUCUREŞTI SECTORUL 5",179187,1,PART,PRCNCT,PRSD,PRSD_SV_SECTOR,"2025-05-18 22:23:21",1142,868,631,237,0,854,14,1300,432,272,582
42,"MUNICIPIUL BUCUREŞTI","ȘCOALA GIMNAZIALĂ ”LUCEAFĂRUL”",888,"BUCUREŞTI SECTORUL 5",179187,1,PART,PRCNCT,PRSD,PRSD_SV_SECTOR,"2025-05-18 21:37:24",1343,886,717,168,1,879,7,1500,614,232,647
42,"MUNICIPIUL BUCUREŞTI","ȘCOALA GIMNAZIALĂ ”LUCEAFĂRUL”",889,"BUCUREŞTI SECTORUL 5",179187,1,PART,PRCNCT,PRSD,PRSD_SV_SECTOR,"2025-05-18 21:57:05",1258,728,651,77,0,713,15,1400,672,236,477
42,"MUNICIPIUL BUCUREŞTI","ȘCOALA GIMNAZIALĂ ”LUCEAFĂRUL”",890,"BUCUREŞTI SECTORUL 5",179187,1,PART,PRCNCT,PRSD,PRSD_SV_SECTOR,"2025-05-18 22:14:17",1034,676,551,125,0,667,9,1100,424,213,454
42,"MUNICIPIUL BUCUREŞTI","ȘCOALA GIMNAZIALĂ NR.135",891,"BUCUREŞTI SECTORUL 5",179187,1,PART,PRCNCT,PRSD,PRSD_SV_SECTOR,"2025-05-18 22:31:00",1039,708,591,117,0,694,14,1100,392,276,418
42,"MUNICIPIUL BUCUREŞTI","ȘCOALA GIMNAZIALĂ NR.135",892,"BUCUREŞTI SECTORUL 5",179187,1,PART,PRCNCT,PRSD,PRSD_SV_SECTOR,"2025-05-18 21:55:37",1248,745,696,49,0,726,19,1300,555,252,474
42,"MUNICIPIUL BUCUREŞTI","ȘCOALA GIMNAZIALĂ NR.135",893,"BUCUREŞTI SECTORUL 5",179187,1,PART,PRCNCT,PRSD,PRSD_SV_SECTOR,"2025-05-18 22:27:26",1198,651,610,40,1,641,10,1300,649,281,360
42,"MUNICIPIUL BUCUREŞTI","ȘCOALA GIMNAZIALĂ NR.135",894,"BUCUREŞTI SECTORUL 5",179187,1,PART,PRCNCT,PRSD,PRSD_SV_SECTOR,"2025-05-18 22:41:49",1641,883,852,31,0,871,12,1720,837,413,458
42,"MUNICIPIUL BUCUREŞTI","ȘCOALA GIMNAZIALĂ ION I.C. BRĂTIANU",895,"BUCUREŞTI SECTORUL 5",179187,1,PART,PRCNCT,PRSD,PRSD_SV_SECTOR,"2025-05-18 21:39:52",1010,574,514,60,0,568,6,1100,526,213,355
42,"MUNICIPIUL BUCUREŞTI","ȘCOALA GIMNAZIALĂ ION I.C. BRĂTIANU",896,"BUCUREŞTI SECTORUL 5",179187,1,PART,PRCNCT,PRSD,PRSD_SV_SECTOR,"2025-05-18 22:03:08",994,616,545,70,1,596,20,1100,484,225,371
42,"MUNICIPIUL BUCUREŞTI","ȘCOALA GIMNAZIALĂ ION I.C. BRĂTIANU",897,"BUCUREŞTI SECTORUL 5",179187,1,PART,PRCNCT,PRSD,PRSD_SV_SECTOR,"2025-05-18 21:39:32",1325,751,700,51,0,735,16,1500,749,318,417
42,"MUNICIPIUL BUCUREŞTI","ȘCOALA GIMNAZIALĂ ION I.C. BRĂTIANU",898,"BUCUREŞTI SECTORUL 5",179187,1,PART,PRCNCT,PRSD,PRSD_SV_SECTOR,"2025-05-18 22:24:41",1206,690,615,74,1,679,11,1300,610,297,382
42,"MUNICIPIUL BUCUREŞTI","ȘCOALA GIMNAZIALĂ ION I.C. BRĂTIANU",899,"BUCUREŞTI SECTORUL 5",179187,1,PART,PRCNCT,PRSD,PRSD_SV_SECTOR,"2025-05-18 21:53:13",1284,708,631,76,1,690,18,1400,692,317,373
42,"MUNICIPIUL BUCUREŞTI","ȘCOALA GIMNAZIALĂ ION I.C. BRĂTIANU",900,"BUCUREŞTI SECTORUL 5",179187,1,PART,PRCNCT,PRSD,PRSD_SV_SECTOR,"2025-05-18 22:00:27",1087,538,512,24,2,523,15,1200,662,185,338
42,"MUNICIPIUL BUCUREŞTI","ȘCOALA GIMNAZIALĂ ION I.C. BRĂTIANU",901,"BUCUREŞTI SECTORUL 5",179187,1,PART,PRCNCT,PRSD,PRSD_SV_SECTOR,"2025-05-18 21:54:56",1290,499,474,25,0,494,5,1400,901,363,131
42,"MUNICIPIUL BUCUREŞTI","ȘCOALA GIMNAZIALĂ ION I.C. BRĂTIANU",902,"BUCUREŞTI SECTORUL 5",179187,1,PART,PRCNCT,PRSD,PRSD_SV_SECTOR,"2025-05-18 23:07:45",1615,593,550,26,17,584,9,1700,1107,394,190
42,"MUNICIPIUL BUCUREŞTI","ȘCOALA GIMNAZIALĂ ION I.C. BRĂTIANU",903,"BUCUREŞTI SECTORUL 5",179187,1,PART,PRCNCT,PRSD,PRSD_SV_SECTOR,"2025-05-18 21:26:52",1361,571,524,47,0,562,9,1600,1029,301,261
42,"MUNICIPIUL BUCUREŞTI","ȘCOALA GIMNAZIALĂ ION I.C. BRĂTIANU",904,"BUCUREŞTI SECTORUL 5",179187,1,PART,PRCNCT,PRSD,PRSD_SV_SECTOR,"2025-05-18 21:45:11",1165,566,538,28,0,560,6,1200,634,250,310
42,"MUNICIPIUL BUCUREŞTI","ȘCOALA GIMNAZIALĂ ION I.C. BRĂTIANU",905,"BUCUREŞTI SECTORUL 5",179187,1,PART,PRCNCT,PRSD,PRSD_SV_SECTOR,"2025-05-18 22:14:35",1402,636,593,43,0,630,6,1600,964,277,353
42,"MUNICIPIUL BUCUREŞTI","ȘCOALA GIMNAZIALĂ ”GEORGE CĂLINESCU”",906,"BUCUREŞTI SECTORUL 5",179187,1,PART,PRCNCT,PRSD,PRSD_SV_SECTOR,"2025-05-18 21:41:48",1292,658,617,41,0,645,13,1400,742,357,288
42,"MUNICIPIUL BUCUREŞTI","ȘCOALA GIMNAZIALĂ ”GEORGE CĂLINESCU”",907,"BUCUREŞTI SECTORUL 5",179187,1,PART,PRCNCT,PRSD,PRSD_SV_SECTOR,"2025-05-18 21:37:36",1244,721,628,92,1,701,20,1300,579,365,336
42,"MUNICIPIUL BUCUREŞTI","ȘCOALA GIMNAZIALĂ ”GEORGE CĂLINESCU”",908,"BUCUREŞTI SECTORUL 5",179187,1,PART,PRCNCT,PRSD,PRSD_SV_SECTOR,"2025-05-18 21:48:47",1513,800,742,58,0,793,7,1600,800,374,419
42,"MUNICIPIUL BUCUREŞTI","ȘCOALA GIMNAZIALĂ ”GEORGE CĂLINESCU”",909,"BUCUREŞTI SECTORUL 5",179187,1,PART,PRCNCT,PRSD,PRSD_SV_SECTOR,"2025-05-18 21:55:28",1611,823,780,43,0,811,12,1700,877,446,365
42,"MUNICIPIUL BUCUREŞTI","ȘCOALA GIMNAZIALĂ ”GEORGE CĂLINESCU”",910,"BUCUREŞTI SECTORUL 5",179187,1,PART,PRCNCT,PRSD,PRSD_SV_SECTOR,"2025-05-18 21:52:56",1550,813,784,29,0,798,15,1600,787,411,387
42,"MUNICIPIUL BUCUREŞTI","ȘCOALA GIMNAZIALĂ ”PETRACHE POENARU”",911,"BUCUREŞTI SECTORUL 5",179187,1,PART,PRCNCT,PRSD,PRSD_SV_SECTOR,"2025-05-18 21:54:22",1616,820,722,98,0,802,18,1700,880,483,319
42,"MUNICIPIUL BUCUREŞTI","ȘCOALA GIMNAZIALĂ ”PETRACHE POENARU”",912,"BUCUREŞTI SECTORUL 5",179187,1,PART,PRCNCT,PRSD,PRSD_SV_SECTOR,"2025-05-18 22:24:37",1657,886,743,143,0,877,9,1700,814,501,376
42,"MUNICIPIUL BUCUREŞTI","ȘCOALA GIMNAZIALĂ ”PETRACHE POENARU”",913,"BUCUREŞTI SECTORUL 5",179187,1,PART,PRCNCT,PRSD,PRSD_SV_SECTOR,"2025-05-18 21:50:26",1938,1060,971,89,0,1044,16,2000,940,543,501
42,"MUNICIPIUL BUCUREŞTI","ȘCOALA GIMNAZIALĂ ”PETRACHE POENARU”",914,"BUCUREŞTI SECTORUL 5",179187,2,PART,PRCNCT,PRSD,PRSD_SV_SECTOR,"2025-05-19 01:23:20",1678,951,878,70,3,936,15,1700,749,369,567
42,"MUNICIPIUL BUCUREŞTI","ȘCOALA GIMNAZIALĂ ”PETRACHE POENARU”",915,"BUCUREŞTI SECTORUL 5",179187,1,PART,PRCNCT,PRSD,PRSD_SV_SECTOR,"2025-05-18 22:15:57",1807,978,936,40,2,967,11,1900,922,546,421
42,"MUNICIPIUL BUCUREŞTI","ȘCOALA GIMNAZIALĂ ”PETRACHE POENARU”",916,"BUCUREŞTI SECTORUL 5",179187,1,PART,PRCNCT,PRSD,PRSD_SV_SECTOR,"2025-05-18 22:33:23",1802,961,910,51,0,945,16,1900,939,500,445
42,"MUNICIPIUL BUCUREŞTI","ȘCOALA GIMNAZIALĂ ”PETRACHE POENARU”",917,"BUCUREŞTI SECTORUL 5",179187,1,PART,PRCNCT,PRSD,PRSD_SV_SECTOR,"2025-05-18 22:38:39",1615,709,679,30,0,699,10,1700,991,445,254
42,"MUNICIPIUL BUCUREŞTI","ȘCOALA GIMNAZIALĂ ”PETRACHE POENARU”",918,"BUCUREŞTI SECTORUL 5",179187,1,PART,PRCNCT,PRSD,PRSD_SV_SECTOR,"2025-05-18 21:49:42",1845,903,873,30,0,891,12,1900,997,507,384
42,"MUNICIPIUL BUCUREŞTI","ȘCOALA GIMNAZIALĂ ”PETRACHE POENARU”",919,"BUCUREŞTI SECTORUL 5",179187,1,PART,PRCNCT,PRSD,PRSD_SV_SECTOR,"2025-05-18 22:15:44",1682,897,859,38,0,886,11,1700,803,455,431
42,"MUNICIPIUL BUCUREŞTI","ȘCOALA GIMNAZIALĂ ”PRINCIPESA MARGARETA”",920,"BUCUREŞTI SECTORUL 5",179187,1,PART,PRCNCT,PRSD,PRSD_SV_SECTOR,"2025-05-18 22:25:36",962,658,579,79,0,651,7,1100,442,205,446
42,"MUNICIPIUL BUCUREŞTI","ȘCOALA GIMNAZIALĂ ”PRINCIPESA MARGARETA”",921,"BUCUREŞTI SECTORUL 5",179187,1,PART,PRCNCT,PRSD,PRSD_SV_SECTOR,"2025-05-18 21:58:18",1075,588,466,122,0,577,11,1200,612,253,324
42,"MUNICIPIUL BUCUREŞTI","ȘCOALA GIMNAZIALĂ ”PRINCIPESA MARGARETA”",922,"BUCUREŞTI SECTORUL 5",179187,1,PART,PRCNCT,PRSD,PRSD_SV_SECTOR,"2025-05-18 21:48:25",1642,605,493,112,0,600,5,1700,1095,328,272
42,"MUNICIPIUL BUCUREŞTI","ȘCOALA GIMNAZIALĂ ”PRINCIPESA MARGARETA”",923,"BUCUREŞTI SECTORUL 5",179187,1,PART,PRCNCT,PRSD,PRSD_SV_SECTOR,"2025-05-18 21:38:28",1034,608,538,70,0,601,7,1200,592,189,412
42,"MUNICIPIUL BUCUREŞTI","GRĂDINIȚA NR.168",924,"BUCUREŞTI SECTORUL 5",179187,2,PART,PRCNCT,PRSD,PRSD_SV_SECTOR,"2025-05-19 01:07:10",1324,941,740,157,44,929,10,1499,558,288,641
42,"MUNICIPIUL BUCUREŞTI","GRĂDINIȚA NR.168",925,"BUCUREŞTI SECTORUL 5",179187,1,PART,PRCNCT,PRSD,PRSD_SV_SECTOR,"2025-05-18 22:40:43",1110,909,607,258,44,897,12,1200,291,220,677
42,"MUNICIPIUL BUCUREŞTI","GRĂDINIȚA DIN CADRUL COLEGIULUI TEHNIC DE INDUSTRIE ALIMENTARĂ”DUMITRU MOȚOC”",926,"BUCUREŞTI SECTORUL 5",179187,1,PART,PRCNCT,PRSD,PRSD_SV_SECTOR,"2025-05-18 22:10:52",1226,824,635,189,0,817,7,1300,476,260,557
42,"MUNICIPIUL BUCUREŞTI","GRĂDINIȚA DIN CADRUL COLEGIULUI TEHNIC DE INDUSTRIE ALIMENTARĂ”DUMITRU MOȚOC”",927,"BUCUREŞTI SECTORUL 5",179187,1,PART,PRCNCT,PRSD,PRSD_SV_SECTOR,"2025-05-18 21:53:55",1253,797,639,158,0,781,16,1300,503,266,515
42,"MUNICIPIUL BUCUREŞTI","ȘCOALA GIMNAZIALĂ NR.280",928,"BUCUREŞTI SECTORUL 5",179187,1,PART,PRCNCT,PRSD,PRSD_SV_SECTOR,"2025-05-18 21:56:45",1319,766,735,30,1,754,12,1500,734,250,504
42,"MUNICIPIUL BUCUREŞTI","ȘCOALA GIMNAZIALĂ NR.280",929,"BUCUREŞTI SECTORUL 5",179187,1,PART,PRCNCT,PRSD,PRSD_SV_SECTOR,"2025-05-19 00:17:55",1057,652,531,118,3,648,4,1100,448,254,394
42,"MUNICIPIUL BUCUREŞTI","ȘCOALA GIMNAZIALĂ NR.280",930,"BUCUREŞTI SECTORUL 5",179187,2,PART,PRCNCT,PRSD,PRSD_SV_SECTOR,"2025-05-18 23:21:37",926,670,495,175,0,661,9,1099,429,199,462
42,"MUNICIPIUL BUCUREŞTI","ȘCOALA GIMNAZIALĂ NR.280",931,"BUCUREŞTI SECTORUL 5",179187,1,PART,PRCNCT,PRSD,PRSD_SV_SECTOR,"2025-05-18 21:48:39",1018,610,550,60,0,600,10,1100,490,170,430
42,"MUNICIPIUL BUCUREŞTI","ȘCOALA GIMNAZIALĂ NR.280",932,"BUCUREŞTI SECTORUL 5",179187,1,PART,PRCNCT,PRSD,PRSD_SV_SECTOR,"2025-05-18 21:36:07",967,613,534,79,0,609,4,1100,487,212,397
42,"MUNICIPIUL BUCUREŞTI","ȘCOALA GIMNAZIALĂ NR.280",933,"BUCUREŞTI SECTORUL 5",179187,1,PART,PRCNCT,PRSD,PRSD_SV_SECTOR,"2025-05-18 21:58:07",1142,596,540,55,1,586,10,1200,604,207,379
42,"MUNICIPIUL BUCUREŞTI","ȘCOALA GIMNAZIALĂ NR.280",934,"BUCUREŞTI SECTORUL 5",179187,1,PART,PRCNCT,PRSD,PRSD_SV_SECTOR,"2025-05-18 22:50:17",1109,564,540,23,1,557,7,1200,636,212,345
42,"MUNICIPIUL BUCUREŞTI","ȘCOALA GIMNAZIALĂ NR.280",935,"BUCUREŞTI SECTORUL 5",179187,1,PART,PRCNCT,PRSD,PRSD_SV_SECTOR,"2025-05-18 21:49:49",969,498,464,34,0,491,7,1100,602,182,309
42,"MUNICIPIUL BUCUREŞTI","LICEUL TEHNOLOGIC ”DIMITRIE GUSTI”",936,"BUCUREŞTI SECTORUL 5",179187,1,PART,PRCNCT,PRSD,PRSD_SV_SECTOR,"2025-05-18 22:00:45",1219,850,691,156,3,834,16,1300,450,234,600
42,"MUNICIPIUL BUCUREŞTI","LICEUL TEHNOLOGIC ”DIMITRIE GUSTI”",937,"BUCUREŞTI SECTORUL 5",179187,1,PART,PRCNCT,PRSD,PRSD_SV_SECTOR,"2025-05-18 21:51:45",1186,795,623,172,0,785,10,1300,505,234,551
42,"MUNICIPIUL BUCUREŞTI","LICEUL TEHNOLOGIC ”DIMITRIE GUSTI”",938,"BUCUREŞTI SECTORUL 5",179187,2,PART,PRCNCT,PRSD,PRSD_SV_SECTOR,"2025-05-19 00:48:28",1160,744,640,104,0,736,8,1200,456,226,510
42,"MUNICIPIUL BUCUREŞTI","GRĂDINIȚA NR.205",939,"BUCUREŞTI SECTORUL 5",179187,1,PART,PRCNCT,PRSD,PRSD_SV_SECTOR,"2025-05-18 21:48:38",1243,745,686,59,0,735,10,1300,555,257,478
42,"MUNICIPIUL BUCUREŞTI","GRĂDINIȚA NR.205",940,"BUCUREŞTI SECTORUL 5",179187,1,PART,PRCNCT,PRSD,PRSD_SV_SECTOR,"2025-05-18 22:02:46",1005,670,546,124,0,659,11,1100,430,246,413
42,"MUNICIPIUL BUCUREŞTI","GRĂDINIȚA NR.205",941,"BUCUREŞTI SECTORUL 5",179187,1,PART,PRCNCT,PRSD,PRSD_SV_SECTOR,"2025-05-18 21:42:56",1186,769,664,105,0,752,17,1300,531,221,531
42,"MUNICIPIUL BUCUREŞTI","GRĂDINIȚA NR.205",942,"BUCUREŞTI SECTORUL 5",179187,1,PART,PRCNCT,PRSD,PRSD_SV_SECTOR,"2025-05-18 22:08:22",963,598,542,55,1,591,7,1100,502,226,365
42,"MUNICIPIUL BUCUREŞTI","GRĂDINIȚA NR.205",943,"BUCUREŞTI SECTORUL 5",179187,1,PART,PRCNCT,PRSD,PRSD_SV_SECTOR,"2025-05-18 22:00:00",1100,629,595,34,0,616,13,1208,579,219,397
42,"MUNICIPIUL BUCUREŞTI","LICEUL TEORETIC ”DIMITRIE BOLINTINEANU”",944,"BUCUREŞTI SECTORUL 5",179187,1,PART,PRCNCT,PRSD,PRSD_SV_SECTOR,"2025-05-18 22:06:01",957,620,500,120,0,608,12,1200,580,238,370
42,"MUNICIPIUL BUCUREŞTI","LICEUL TEORETIC ”DIMITRIE BOLINTINEANU”",945,"BUCUREŞTI SECTORUL 5",179187,1,PART,PRCNCT,PRSD,PRSD_SV_SECTOR,"2025-05-18 22:06:13",845,516,457,59,0,508,8,1000,484,172,336
42,"MUNICIPIUL BUCUREŞTI","LICEUL TEORETIC ”DIMITRIE BOLINTINEANU”",946,"BUCUREŞTI SECTORUL 5",179187,1,PART,PRCNCT,PRSD,PRSD_SV_SECTOR,"2025-05-18 21:58:31",1043,703,528,173,2,690,13,1200,497,223,467
42,"MUNICIPIUL BUCUREŞTI","LICEUL TEORETIC ”DIMITRIE BOLINTINEANU”",947,"BUCUREŞTI SECTORUL 5",179187,1,PART,PRCNCT,PRSD,PRSD_SV_SECTOR,"2025-05-18 21:49:21",1224,774,653,121,0,759,15,1300,526,310,449
42,"MUNICIPIUL BUCUREŞTI","LICEUL TEORETIC ”DIMITRIE BOLINTINEANU”",948,"BUCUREŞTI SECTORUL 5",179187,1,PART,PRCNCT,PRSD,PRSD_SV_SECTOR,"2025-05-18 22:24:21",1142,688,599,89,0,681,7,1300,612,248,433
42,"MUNICIPIUL BUCUREŞTI","LICEUL TEORETIC ”DIMITRIE BOLINTINEANU”",949,"BUCUREŞTI SECTORUL 5",179187,1,PART,PRCNCT,PRSD,PRSD_SV_SECTOR,"2025-05-18 22:02:43",1293,639,589,50,0,626,13,1600,961,250,376
42,"MUNICIPIUL BUCUREŞTI","LICEUL TEORETIC ”DIMITRIE BOLINTINEANU”",950,"BUCUREŞTI SECTORUL 5",179187,2,PART,PRCNCT,PRSD,PRSD_SV_SECTOR,"2025-05-19 00:08:28",1146,641,603,38,0,631,10,1200,559,233,398
42,"MUNICIPIUL BUCUREŞTI","LICEUL TEORETIC ”DIMITRIE BOLINTINEANU”",951,"BUCUREŞTI SECTORUL 5",179187,1,PART,PRCNCT,PRSD,PRSD_SV_SECTOR,"2025-05-18 22:03:43",1163,627,584,43,0,618,9,1300,673,253,365
42,"MUNICIPIUL BUCUREŞTI","LICEUL TEORETIC ”DIMITRIE BOLINTINEANU”",952,"BUCUREŞTI SECTORUL 5",179187,1,PART,PRCNCT,PRSD,PRSD_SV_SECTOR,"2025-05-18 21:50:28",862,502,460,41,1,498,4,1000,498,198,300
42,"MUNICIPIUL BUCUREŞTI","FACULTATEA DE DREPT",953,"BUCUREŞTI SECTORUL 5",179187,1,PART,PRCNCT,PRSD,PRSD_SV_SECTOR,"2025-05-18 22:37:13",623,649,346,302,1,642,7,900,251,105,537
42,"MUNICIPIUL BUCUREŞTI","FACULTATEA DE DREPT",954,"BUCUREŞTI SECTORUL 5",179187,1,PART,PRCNCT,PRSD,PRSD_SV_SECTOR,"2025-05-18 22:45:29",569,552,283,267,2,549,3,800,248,89,460
42,"MUNICIPIUL BUCUREŞTI","FACULTATEA DE DREPT",955,"BUCUREŞTI SECTORUL 5",179187,1,PART,PRCNCT,PRSD,PRSD_SV_SECTOR,"2025-05-18 21:58:13",551,550,237,311,2,541,9,800,250,109,432
42,"MUNICIPIUL BUCUREŞTI","COLEGIUL NAȚIONAL ”GHEORGHE LAZĂR”",956,"BUCUREŞTI SECTORUL 5",179187,1,PART,PRCNCT,PRSD,PRSD_SV_SECTOR,"2025-05-18 22:17:17",620,736,340,396,0,728,8,1200,464,135,593
42,"MUNICIPIUL BUCUREŞTI","COLEGIUL NAȚIONAL ”GHEORGHE LAZĂR”",957,"BUCUREŞTI SECTORUL 5",179187,1,PART,PRCNCT,PRSD,PRSD_SV_SECTOR,"2025-05-18 22:00:11",784,629,366,263,0,620,9,1000,371,150,470
42,"MUNICIPIUL BUCUREŞTI","COLEGIUL NAȚIONAL ”GHEORGHE LAZĂR”",958,"BUCUREŞTI SECTORUL 5",179187,1,PART,PRCNCT,PRSD,PRSD_SV_SECTOR,"2025-05-18 23:01:18",399,540,178,361,1,533,7,1001,461,138,395
42,"MUNICIPIUL BUCUREŞTI","COLEGIUL NAȚIONAL ”GHEORGHE LAZĂR”",959,"BUCUREŞTI SECTORUL 5",179187,1,PART,PRCNCT,PRSD,PRSD_SV_SECTOR,"2025-05-18 22:10:37",680,695,333,361,1,676,19,1200,505,132,544
42,"MUNICIPIUL BUCUREŞTI","COLEGIUL NAȚIONAL ”GHEORGHE LAZĂR”",960,"BUCUREŞTI SECTORUL 5",179187,1,PART,PRCNCT,PRSD,PRSD_SV_SECTOR,"2025-05-18 21:59:46",567,561,269,291,1,557,4,1200,639,115,442
42,"MUNICIPIUL BUCUREŞTI","GRĂDINȚA NR.178",961,"BUCUREŞTI SECTORUL 5",179187,1,PART,PRCNCT,PRSD,PRSD_SV_SECTOR,"2025-05-18 22:37:36",1760,1076,944,132,0,1055,21,1800,724,424,631
42,"MUNICIPIUL BUCUREŞTI","GRĂDINȚA NR.178",962,"BUCUREŞTI SECTORUL 5",179187,1,PART,PRCNCT,PRSD,PRSD_SV_SECTOR,"2025-05-18 21:42:48",926,527,442,84,1,520,7,1000,473,206,314
42,"MUNICIPIUL BUCUREŞTI","GRĂDINȚA NR.178",963,"BUCUREŞTI SECTORUL 5",179187,1,PART,PRCNCT,PRSD,PRSD_SV_SECTOR,"2025-05-18 22:08:56",1784,973,903,70,0,962,11,1800,827,365,597
42,"MUNICIPIUL BUCUREŞTI","LICEUL TEORETIC ”ION BARBU”",964,"BUCUREŞTI SECTORUL 5",179187,2,PART,PRCNCT,PRSD,PRSD_SV_SECTOR,"2025-05-19 01:15:28",1101,741,589,151,1,734,7,1200,459,186,548
42,"MUNICIPIUL BUCUREŞTI","LICEUL TEORETIC ”ION BARBU”",965,"BUCUREŞTI SECTORUL 5",179187,1,PART,PRCNCT,PRSD,PRSD_SV_SECTOR,"2025-05-18 21:56:08",1254,973,697,275,1,965,8,1400,427,254,711
42,"MUNICIPIUL BUCUREŞTI","LICEUL TEORETIC ”ION BARBU”",966,"BUCUREŞTI SECTORUL 5",179187,1,PART,PRCNCT,PRSD,PRSD_SV_SECTOR,"2025-05-18 22:08:27",938,687,545,140,2,677,10,1100,413,156,521
42,"MUNICIPIUL BUCUREŞTI","LICEUL TEORETIC ”ION BARBU”",967,"BUCUREŞTI SECTORUL 5",179187,1,PART,PRCNCT,PRSD,PRSD_SV_SECTOR,"2025-05-18 21:56:40",1049,659,609,49,1,652,7,1100,441,205,447
42,"MUNICIPIUL BUCUREŞTI","LICEUL TEORETIC ”ION BARBU”",968,"BUCUREŞTI SECTORUL 5",179187,2,PART,PRCNCT,PRSD,PRSD_SV_SECTOR,"2025-05-19 00:24:45",1167,705,657,47,1,694,11,1200,495,190,504
42,"MUNICIPIUL BUCUREŞTI","LICEUL TEORETIC ”ION BARBU”",969,"BUCUREŞTI SECTORUL 5",179187,1,PART,PRCNCT,PRSD,PRSD_SV_SECTOR,"2025-05-18 22:13:45",1821,1092,1037,54,1,1068,24,1900,808,352,716
42,"MUNICIPIUL BUCUREŞTI","LICEUL TEORETIC ”ION BARBU”",970,"BUCUREŞTI SECTORUL 5",179187,1,PART,PRCNCT,PRSD,PRSD_SV_SECTOR,"2025-05-18 21:38:52",886,554,524,30,0,549,5,1000,446,147,402
42,"MUNICIPIUL BUCUREŞTI","LICEUL TEORETIC ”ION BARBU”",971,"BUCUREŞTI SECTORUL 5",179187,1,PART,PRCNCT,PRSD,PRSD_SV_SECTOR,"2025-05-18 21:41:52",819,469,440,29,0,467,2,1000,531,126,341
42,"MUNICIPIUL BUCUREŞTI","LICEUL TEORETIC ”ION BARBU”",972,"BUCUREŞTI SECTORUL 5",179187,1,PART,PRCNCT,PRSD,PRSD_SV_SECTOR,"2025-05-18 21:56:27",1296,809,757,50,2,796,13,1400,591,210,586
42,"MUNICIPIUL BUCUREŞTI","ȘCOALA GIMNAZIALĂ NR.115",973,"BUCUREŞTI SECTORUL 5",179187,1,PART,PRCNCT,PRSD,PRSD_SV_SECTOR,"2025-05-18 22:31:22",1308,881,693,154,34,866,15,1600,719,250,616
42,"MUNICIPIUL BUCUREŞTI","ȘCOALA GIMNAZIALĂ NR.115",974,"BUCUREŞTI SECTORUL 5",179187,1,PART,PRCNCT,PRSD,PRSD_SV_SECTOR,"2025-05-18 22:12:03",1128,781,618,126,37,763,18,1300,519,228,535
42,"MUNICIPIUL BUCUREŞTI","ȘCOALA GIMNAZIALĂ NR.115",975,"BUCUREŞTI SECTORUL 5",179187,1,PART,PRCNCT,PRSD,PRSD_SV_SECTOR,"2025-05-18 22:55:51",1283,828,725,67,36,818,10,1400,572,275,543
42,"MUNICIPIUL BUCUREŞTI","ȘCOALA GIMNAZIALĂ NR.115",976,"BUCUREŞTI SECTORUL 5",179187,1,PART,PRCNCT,PRSD,PRSD_SV_SECTOR,"2025-05-18 22:23:58",1073,701,585,85,31,693,8,1200,499,202,491
42,"MUNICIPIUL BUCUREŞTI","ȘCOALA GIMNAZIALĂ NR.115",977,"BUCUREŞTI SECTORUL 5",179187,1,PART,PRCNCT,PRSD,PRSD_SV_SECTOR,"2025-05-18 22:02:39",1162,877,689,188,0,865,12,1200,323,229,636
42,"MUNICIPIUL BUCUREŞTI","ȘCOALA GIMNAZIALĂ NR.115",978,"BUCUREŞTI SECTORUL 5",179187,1,PART,PRCNCT,PRSD,PRSD_SV_SECTOR,"2025-05-18 21:40:59",1121,798,631,161,6,784,14,1200,402,238,546
42,"MUNICIPIUL BUCUREŞTI","ȘCOALA GIMNAZIALĂ NR.128",979,"BUCUREŞTI SECTORUL 5",179187,1,PART,PRCNCT,PRSD,PRSD_SV_SECTOR,"2025-05-18 21:36:16",1014,684,585,99,0,676,8,1200,516,184,492
42,"MUNICIPIUL BUCUREŞTI","ȘCOALA GIMNAZIALĂ NR.128",980,"BUCUREŞTI SECTORUL 5",179187,1,PART,PRCNCT,PRSD,PRSD_SV_SECTOR,"2025-05-18 22:11:21",914,584,512,69,3,573,11,1109,525,153,420
42,"MUNICIPIUL BUCUREŞTI","ȘCOALA GIMNAZIALĂ NR.128",981,"BUCUREŞTI SECTORUL 5",179187,1,PART,PRCNCT,PRSD,PRSD_SV_SECTOR,"2025-05-18 21:34:33",1027,606,524,80,2,597,9,1200,594,115,482
42,"MUNICIPIUL BUCUREŞTI","ȘCOALA GIMNAZIALĂ NR.128",982,"BUCUREŞTI SECTORUL 5",179187,1,PART,PRCNCT,PRSD,PRSD_SV_SECTOR,"2025-05-18 21:57:07",845,514,458,55,1,505,9,1000,486,126,379
42,"MUNICIPIUL BUCUREŞTI","ȘCOALA GIMNAZIALĂ NR.128",983,"BUCUREŞTI SECTORUL 5",179187,1,PART,PRCNCT,PRSD,PRSD_SV_SECTOR,"2025-05-18 21:56:27",1073,670,629,41,0,662,8,1208,538,136,526
42,"MUNICIPIUL BUCUREŞTI","ȘCOALA GIMNAZIALĂ NR.128",984,"BUCUREŞTI SECTORUL 5",179187,1,PART,PRCNCT,PRSD,PRSD_SV_SECTOR,"2025-05-18 21:49:24",871,671,479,192,0,663,8,1000,329,185,478
42,"MUNICIPIUL BUCUREŞTI","ȘCOALA GIMNAZIALĂ NR.128",985,"BUCUREŞTI SECTORUL 5",179187,1,PART,PRCNCT,PRSD,PRSD_SV_SECTOR,"2025-05-18 22:07:21",841,567,393,174,0,564,3,1000,433,225,339
42,"MUNICIPIUL BUCUREŞTI","ȘCOALA GIMNAZIALĂ NR.128",986,"BUCUREŞTI SECTORUL 5",179187,1,PART,PRCNCT,PRSD,PRSD_SV_SECTOR,"2025-05-18 21:47:40",900,601,473,127,1,586,15,1000,399,131,455
42,"MUNICIPIUL BUCUREŞTI","ȘCOALA GIMNAZIALĂ NR.128",987,"BUCUREŞTI SECTORUL 5",179187,1,PART,PRCNCT,PRSD,PRSD_SV_SECTOR,"2025-05-18 21:43:12",671,472,399,73,0,469,3,800,328,101,368
42,"MUNICIPIUL BUCUREŞTI","ȘCOALA GIMNAZIALĂ NR.128",988,"BUCUREŞTI SECTORUL 5",179187,1,PART,PRCNCT,PRSD,PRSD_SV_SECTOR,"2025-05-18 21:40:05",645,399,362,35,2,395,4,800,401,114,281
42,"MUNICIPIUL BUCUREŞTI","ȘCOALA GIMNAZIALĂ NR.128",989,"BUCUREŞTI SECTORUL 5",179187,1,PART,PRCNCT,PRSD,PRSD_SV_SECTOR,"2025-05-18 22:07:06",1139,686,654,32,0,675,11,1400,714,197,478
42,"MUNICIPIUL BUCUREŞTI","ȘCOALA GIMNAZIALĂ NR.128",990,"BUCUREŞTI SECTORUL 5",179187,1,PART,PRCNCT,PRSD,PRSD_SV_SECTOR,"2025-05-18 22:09:16",779,494,468,22,4,489,5,900,406,108,381
42,"MUNICIPIUL BUCUREŞTI","ȘCOALA GIMNAZIALĂ NR.150",991,"BUCUREŞTI SECTORUL 5",179187,1,PART,PRCNCT,PRSD,PRSD_SV_SECTOR,"2025-05-18 22:57:54",627,555,331,188,36,550,5,800,245,133,417
42,"MUNICIPIUL BUCUREŞTI","ȘCOALA GIMNAZIALĂ NR.150",992,"BUCUREŞTI SECTORUL 5",179187,1,PART,PRCNCT,PRSD,PRSD_SV_SECTOR,"2025-05-18 21:36:30",655,618,369,200,49,607,11,800,182,123,484
42,"MUNICIPIUL BUCUREŞTI","ȘCOALA GIMNAZIALĂ NR.150",993,"BUCUREŞTI SECTORUL 5",179187,1,PART,PRCNCT,PRSD,PRSD_SV_SECTOR,"2025-05-18 22:48:59",688,558,374,137,47,548,10,800,242,154,394
42,"MUNICIPIUL BUCUREŞTI","ȘCOALA GIMNAZIALĂ NR.150",994,"BUCUREŞTI SECTORUL 5",179187,1,PART,PRCNCT,PRSD,PRSD_SV_SECTOR,"2025-05-18 22:15:50",636,571,370,147,54,563,8,800,229,141,422
42,"MUNICIPIUL BUCUREŞTI","ȘCOALA GIMNAZIALĂ NR.150",995,"BUCUREŞTI SECTORUL 5",179187,1,PART,PRCNCT,PRSD,PRSD_SV_SECTOR,"2025-05-18 21:58:21",638,547,359,153,35,539,8,800,253,111,428
42,"MUNICIPIUL BUCUREŞTI","ȘCOALA GIMNAZIALĂ NR.150",996,"BUCUREŞTI SECTORUL 5",179187,1,PART,PRCNCT,PRSD,PRSD_SV_SECTOR,"2025-05-18 22:07:34",726,654,424,162,68,649,5,1000,346,122,527
42,"MUNICIPIUL BUCUREŞTI","ȘCOALA GIMNAZIALĂ NR.127",997,"BUCUREŞTI SECTORUL 5",179187,1,PART,PRCNCT,PRSD,PRSD_SV_SECTOR,"2025-05-18 22:23:35",1869,1052,936,115,1,1040,12,2000,948,527,513
42,"MUNICIPIUL BUCUREŞTI","ȘCOALA GIMNAZIALĂ NR.127",998,"BUCUREŞTI SECTORUL 5",179187,1,PART,PRCNCT,PRSD,PRSD_SV_SECTOR,"2025-05-18 21:58:13",1941,1097,996,99,2,1074,23,2000,903,562,512
42,"MUNICIPIUL BUCUREŞTI","ȘCOALA GIMNAZIALĂ NR.127",999,"BUCUREŞTI SECTORUL 5",179187,1,PART,PRCNCT,PRSD,PRSD_SV_SECTOR,"2025-05-18 22:30:53",1980,1173,1030,143,0,1163,10,2000,827,554,609
42,"MUNICIPIUL BUCUREŞTI","ȘCOALA GIMNAZIALĂ NR.127",1000,"BUCUREŞTI SECTORUL 5",179187,1,PART,PRCNCT,PRSD,PRSD_SV_SECTOR,"2025-05-18 22:49:21",1918,1064,997,67,0,1035,29,2000,936,505,530
42,"MUNICIPIUL BUCUREŞTI","ȘCOALA GIMNAZIALĂ NR.127",1001,"BUCUREŞTI SECTORUL 5",179187,1,PART,PRCNCT,PRSD,PRSD_SV_SECTOR,"2025-05-18 22:29:38",1949,1142,1086,54,2,1127,15,2000,858,559,568
42,"MUNICIPIUL BUCUREŞTI","ȘCOALA GIMNAZIALĂ NR.125",1002,"BUCUREŞTI SECTORUL 5",179187,1,PART,PRCNCT,PRSD,PRSD_SV_SECTOR,"2025-05-18 22:04:23",1833,1222,1045,128,49,1205,17,2000,778,611,594
42,"MUNICIPIUL BUCUREŞTI","ȘCOALA GIMNAZIALĂ NR.125",1003,"BUCUREŞTI SECTORUL 5",179187,1,PART,PRCNCT,PRSD,PRSD_SV_SECTOR,"2025-05-18 22:23:23",1899,1154,1025,66,63,1134,20,2000,846,600,534
42,"MUNICIPIUL BUCUREŞTI","ȘCOALA GIMNAZIALĂ NR.125",1004,"BUCUREŞTI SECTORUL 5",179187,1,PART,PRCNCT,PRSD,PRSD_SV_SECTOR,"2025-05-18 22:08:46",1512,961,802,83,76,946,15,1800,839,490,456
42,"MUNICIPIUL BUCUREŞTI","ȘCOALA GIMNAZIALĂ NR.131",1005,"BUCUREŞTI SECTORUL 5",179187,1,PART,PRCNCT,PRSD,PRSD_SV_SECTOR,"2025-05-18 22:23:23",1418,942,757,85,100,932,10,1600,658,578,354
42,"MUNICIPIUL BUCUREŞTI","ȘCOALA GIMNAZIALĂ NR.131",1006,"BUCUREŞTI SECTORUL 5",179187,1,PART,PRCNCT,PRSD,PRSD_SV_SECTOR,"2025-05-18 22:28:24",1625,1044,840,94,110,1032,12,1800,756,628,404
42,"MUNICIPIUL BUCUREŞTI","ȘCOALA GIMNAZIALĂ NR.131",1007,"BUCUREŞTI SECTORUL 5",179187,1,PART,PRCNCT,PRSD,PRSD_SV_SECTOR,"2025-05-18 22:17:43",1355,895,671,56,168,883,12,1600,705,519,364
42,"MUNICIPIUL BUCUREŞTI","ȘCOALA GIMNAZIALĂ NR.131",1008,"BUCUREŞTI SECTORUL 5",179187,1,PART,PRCNCT,PRSD,PRSD_SV_SECTOR,"2025-05-18 22:37:50",1856,1056,918,44,94,1041,15,2000,944,563,478
42,"MUNICIPIUL BUCUREŞTI","ȘCOALA GIMNAZIALĂ NR.131",1009,"BUCUREŞTI SECTORUL 5",179187,1,PART,PRCNCT,PRSD,PRSD_SV_SECTOR,"2025-05-18 23:03:40",1490,1033,789,38,206,1012,21,1600,567,597,415
42,"MUNICIPIUL BUCUREŞTI","ȘCOALA GIMNAZIALĂ NR.131",1010,"BUCUREŞTI SECTORUL 5",179187,1,PART,PRCNCT,PRSD,PRSD_SV_SECTOR,"2025-05-18 21:54:54",1916,996,954,41,1,987,9,2000,1004,487,500
42,"MUNICIPIUL BUCUREŞTI","ȘCOALA GIMNAZIALĂ NR.126",1011,"BUCUREŞTI SECTORUL 5",179187,1,PART,PRCNCT,PRSD,PRSD_SV_SECTOR,"2025-05-18 21:54:14",1884,1213,1117,96,0,1201,12,2000,787,430,771
42,"MUNICIPIUL BUCUREŞTI","ȘCOALA GIMNAZIALĂ NR.126",1012,"BUCUREŞTI SECTORUL 5",179187,1,PART,PRCNCT,PRSD,PRSD_SV_SECTOR,"2025-05-18 21:52:36",1255,870,645,35,190,851,19,1600,730,476,375
42,"MUNICIPIUL BUCUREŞTI","ȘCOALA GIMNAZIALĂ NR.126",1013,"BUCUREŞTI SECTORUL 5",179187,1,PART,PRCNCT,PRSD,PRSD_SV_SECTOR,"2025-05-18 21:52:58",1192,698,597,54,47,687,11,1400,702,305,382
42,"MUNICIPIUL BUCUREŞTI","ȘCOALA GIMNAZIALĂ NR.126",1014,"BUCUREŞTI SECTORUL 5",179187,1,PART,PRCNCT,PRSD,PRSD_SV_SECTOR,"2025-05-18 21:48:25",1539,748,619,73,56,734,14,1600,852,435,299
42,"MUNICIPIUL BUCUREŞTI","ȘCOALA GIMNAZIALĂ ”MIRCEA SÂNTIMBREANU”",1015,"BUCUREŞTI SECTORUL 5",179187,1,PART,PRCNCT,PRSD,PRSD_SV_SECTOR,"2025-05-18 21:35:49",937,613,557,55,1,601,12,1100,487,232,369
42,"MUNICIPIUL BUCUREŞTI","ȘCOALA GIMNAZIALĂ ”MIRCEA SÂNTIMBREANU”",1016,"BUCUREŞTI SECTORUL 5",179187,1,PART,PRCNCT,PRSD,PRSD_SV_SECTOR,"2025-05-18 21:29:25",905,533,484,49,0,521,12,1000,467,205,316
42,"MUNICIPIUL BUCUREŞTI","ȘCOALA GIMNAZIALĂ ”MIRCEA SÂNTIMBREANU”",1017,"BUCUREŞTI SECTORUL 5",179187,1,PART,PRCNCT,PRSD,PRSD_SV_SECTOR,"2025-05-18 21:33:27",877,550,493,57,0,541,9,1000,450,163,378
42,"MUNICIPIUL BUCUREŞTI","ȘCOALA GIMNAZIALĂ ”MIRCEA SÂNTIMBREANU”",1018,"BUCUREŞTI SECTORUL 5",179187,1,PART,PRCNCT,PRSD,PRSD_SV_SECTOR,"2025-05-18 21:34:42",919,538,515,23,0,520,18,1000,462,196,324
42,"MUNICIPIUL BUCUREŞTI","ȘCOALA GIMNAZIALĂ ”MIRCEA SÂNTIMBREANU”",1019,"BUCUREŞTI SECTORUL 5",179187,1,PART,PRCNCT,PRSD,PRSD_SV_SECTOR,"2025-05-18 21:39:19",895,484,463,19,2,478,6,1000,516,176,302
42,"MUNICIPIUL BUCUREŞTI","ȘCOALA GIMNAZIALĂ NR.124",1020,"BUCUREŞTI SECTORUL 5",179187,1,PART,PRCNCT,PRSD,PRSD_SV_SECTOR,"2025-05-18 22:06:27",1069,635,587,48,0,626,9,1200,565,248,378
42,"MUNICIPIUL BUCUREŞTI","ȘCOALA GIMNAZIALĂ NR.124",1021,"BUCUREŞTI SECTORUL 5",179187,1,PART,PRCNCT,PRSD,PRSD_SV_SECTOR,"2025-05-18 21:41:40",976,560,518,42,0,552,8,1100,540,210,342
42,"MUNICIPIUL BUCUREŞTI","ȘCOALA GIMNAZIALĂ NR.124",1022,"BUCUREŞTI SECTORUL 5",179187,1,PART,PRCNCT,PRSD,PRSD_SV_SECTOR,"2025-05-18 21:37:43",1131,621,599,22,0,609,12,1300,679,229,380
42,"MUNICIPIUL BUCUREŞTI","ȘCOALA GIMNAZIALĂ NR.124",1023,"BUCUREŞTI SECTORUL 5",179187,1,PART,PRCNCT,PRSD,PRSD_SV_SECTOR,"2025-05-18 21:55:09",1051,571,546,25,0,559,12,1200,629,218,341
42,"MUNICIPIUL BUCUREŞTI","ȘCOALA GIMNAZIALĂ NR.124",1024,"BUCUREŞTI SECTORUL 5",179187,1,PART,PRCNCT,PRSD,PRSD_SV_SECTOR,"2025-05-18 21:59:14",1037,597,509,88,0,590,7,1200,603,215,375
42,"MUNICIPIUL BUCUREŞTI","ȘCOALA GIMNAZIALĂ NR.124",1025,"BUCUREŞTI SECTORUL 5",179187,1,PART,PRCNCT,PRSD,PRSD_SV_SECTOR,"2025-05-18 21:34:10",900,560,468,92,0,548,12,1000,440,216,332
42,"MUNICIPIUL BUCUREŞTI","ȘCOALA GIMNAZIALĂ NR.124",1026,"BUCUREŞTI SECTORUL 5",179187,1,PART,PRCNCT,PRSD,PRSD_SV_SECTOR,"2025-05-18 21:53:29",938,524,489,34,1,512,12,1000,476,208,304
42,"MUNICIPIUL BUCUREŞTI","ȘCOALA GIMNAZIALĂ NR.124",1027,"BUCUREŞTI SECTORUL 5",179187,1,PART,PRCNCT,PRSD,PRSD_SV_SECTOR,"2025-05-18 21:33:16",985,563,532,31,0,553,10,1100,537,193,360
42,"MUNICIPIUL BUCUREŞTI","ȘCOALA GIMNAZIALĂ NR.124",1028,"BUCUREŞTI SECTORUL 5",179187,1,PART,PRCNCT,PRSD,PRSD_SV_SECTOR,"2025-05-18 21:30:46",997,585,558,26,1,579,6,1100,515,220,359
42,"MUNICIPIUL BUCUREŞTI","ȘCOALA GIMNAZIALĂ NR.124",1029,"BUCUREŞTI SECTORUL 5",179187,1,PART,PRCNCT,PRSD,PRSD_SV_SECTOR,"2025-05-18 22:09:36",1057,587,537,50,0,575,12,1200,613,219,356
42,"MUNICIPIUL BUCUREŞTI","ȘCOALA GIMNAZIALĂ NR.124",1030,"BUCUREŞTI SECTORUL 5",179187,1,PART,PRCNCT,PRSD,PRSD_SV_SECTOR,"2025-05-18 21:45:52",1143,617,582,34,1,610,7,1200,583,289,321
42,"MUNICIPIUL BUCUREŞTI","ȘCOALA GIMNAZIALĂ NR.124",1031,"BUCUREŞTI SECTORUL 5",179187,1,PART,PRCNCT,PRSD,PRSD_SV_SECTOR,"2025-05-18 22:11:41",1045,522,494,26,2,515,7,1200,678,279,236
42,"MUNICIPIUL BUCUREŞTI","ȘCOALA GIMNAZIALĂ NR.144",1032,"BUCUREŞTI SECTORUL 5",179187,1,PART,PRCNCT,PRSD,PRSD_SV_SECTOR,"2025-05-18 21:56:23",1567,1114,932,180,2,1099,15,1600,486,350,749
42,"MUNICIPIUL BUCUREŞTI","ȘCOALA GIMNAZIALĂ NR.144",1033,"BUCUREŞTI SECTORUL 5",179187,1,PART,PRCNCT,PRSD,PRSD_SV_SECTOR,"2025-05-18 22:38:54",1868,1275,1045,222,8,1260,15,2000,725,527,733
42,"MUNICIPIUL BUCUREŞTI","ȘCOALA GIMNAZIALĂ NR.144",1034,"BUCUREŞTI SECTORUL 5",179187,1,PART,PRCNCT,PRSD,PRSD_SV_SECTOR,"2025-05-18 23:00:30",1703,1121,986,123,12,1103,18,1800,679,382,721
42,"MUNICIPIUL BUCUREŞTI","ȘCOALA GIMNAZIALĂ NR.144",1035,"BUCUREŞTI SECTORUL 5",179187,1,PART,PRCNCT,PRSD,PRSD_SV_SECTOR,"2025-05-18 22:26:02",1213,892,786,103,3,883,9,1300,408,259,624
42,"MUNICIPIUL BUCUREŞTI","ȘCOALA GIMNAZIALĂ NR.143",1036,"BUCUREŞTI SECTORUL 5",179187,1,PART,PRCNCT,PRSD,PRSD_SV_SECTOR,"2025-05-18 21:34:22",996,532,517,15,0,524,8,1100,568,196,328
42,"MUNICIPIUL BUCUREŞTI","ȘCOALA GIMNAZIALĂ NR.143",1037,"BUCUREŞTI SECTORUL 5",179187,1,PART,PRCNCT,PRSD,PRSD_SV_SECTOR,"2025-05-18 21:45:52",1120,654,548,106,0,634,20,1200,546,215,419
42,"MUNICIPIUL BUCUREŞTI","ȘCOALA GIMNAZIALĂ NR.143",1038,"BUCUREŞTI SECTORUL 5",179187,1,PART,PRCNCT,PRSD,PRSD_SV_SECTOR,"2025-05-18 21:49:08",1043,618,494,124,0,606,12,1200,582,205,401
42,"MUNICIPIUL BUCUREŞTI","ȘCOALA GIMNAZIALĂ NR.143",1039,"BUCUREŞTI SECTORUL 5",179187,1,PART,PRCNCT,PRSD,PRSD_SV_SECTOR,"2025-05-18 21:40:22",1040,658,580,78,0,652,6,1200,542,229,423
42,"MUNICIPIUL BUCUREŞTI","ȘCOALA GIMNAZIALĂ NR.143",1040,"BUCUREŞTI SECTORUL 5",179187,1,PART,PRCNCT,PRSD,PRSD_SV_SECTOR,"2025-05-18 21:40:32",916,563,503,58,2,554,9,1000,437,197,357
42,"MUNICIPIUL BUCUREŞTI","ȘCOALA GIMNAZIALĂ NR.143",1041,"BUCUREŞTI SECTORUL 5",179187,1,PART,PRCNCT,PRSD,PRSD_SV_SECTOR,"2025-05-18 21:33:25",1164,612,556,56,0,592,20,1200,588,248,344
42,"MUNICIPIUL BUCUREŞTI","ȘCOALA GIMNAZIALĂ NR.143",1042,"BUCUREŞTI SECTORUL 5",179187,1,PART,PRCNCT,PRSD,PRSD_SV_SECTOR,"2025-05-18 21:39:47",989,525,488,37,0,514,11,1100,575,190,324
42,"MUNICIPIUL BUCUREŞTI","ȘCOALA GIMNAZIALĂ NR.143",1043,"BUCUREŞTI SECTORUL 5",179187,1,PART,PRCNCT,PRSD,PRSD_SV_SECTOR,"2025-05-18 21:37:54",973,551,513,37,1,548,3,1100,549,185,363
42,"MUNICIPIUL BUCUREŞTI","ȘCOALA GIMNAZIALĂ NR.143",1044,"BUCUREŞTI SECTORUL 5",179187,1,PART,PRCNCT,PRSD,PRSD_SV_SECTOR,"2025-05-18 21:42:51",1205,678,643,34,1,669,9,1400,722,240,429
42,"MUNICIPIUL BUCUREŞTI","ȘCOALA GIMNAZIALĂ NR.143",1045,"BUCUREŞTI SECTORUL 5",179187,1,PART,PRCNCT,PRSD,PRSD_SV_SECTOR,"2025-05-18 21:40:06",1029,536,512,23,1,530,6,1200,664,210,320
42,"MUNICIPIUL BUCUREŞTI","ȘCOALA GIMNAZIALĂ NR.143",1046,"BUCUREŞTI SECTORUL 5",179187,1,PART,PRCNCT,PRSD,PRSD_SV_SECTOR,"2025-05-18 21:50:48",1102,551,526,25,0,542,9,1200,649,180,362
42,"MUNICIPIUL BUCUREŞTI","ȘCOALA GIMNAZIALĂ NR.143",1047,"BUCUREŞTI SECTORUL 5",179187,1,PART,PRCNCT,PRSD,PRSD_SV_SECTOR,"2025-05-18 21:41:57",881,463,438,23,2,454,9,1000,537,156,298
42,"MUNICIPIUL BUCUREŞTI","ȘCOALA GIMNAZIALĂ NR.143",1048,"BUCUREŞTI SECTORUL 5",179187,1,PART,PRCNCT,PRSD,PRSD_SV_SECTOR,"2025-05-18 21:48:41",1043,480,449,31,0,477,3,1100,620,189,288
42,"MUNICIPIUL BUCUREŞTI","ȘCOALA GIMNAZIALĂ NR.143",1049,"BUCUREŞTI SECTORUL 5",179187,1,PART,PRCNCT,PRSD,PRSD_SV_SECTOR,"2025-05-18 21:34:16",942,482,461,21,0,475,7,1096,614,183,292
42,"MUNICIPIUL BUCUREŞTI","CLUBUL SENIORILOR MIHAI EMINESCU",1050,"BUCUREŞTI SECTORUL 6",179196,1,PART,PRCNCT,PRSD,PRSD_SV_SECTOR,"2025-05-18 22:53:35",1143,1652,532,1071,49,1634,18,2200,548,291,1343
42,"MUNICIPIUL BUCUREŞTI","SERVICIUL STARE CIVILĂ SECTOR 6",1051,"BUCUREŞTI SECTORUL 6",179196,1,PART,PRCNCT,PRSD,PRSD_SV_SECTOR,"2025-05-18 21:58:21",1250,741,541,200,0,725,16,1300,559,193,532
42,"MUNICIPIUL BUCUREŞTI","SERVICIUL STARE CIVILĂ SECTOR 6",1052,"BUCUREŞTI SECTORUL 6",179196,1,PART,PRCNCT,PRSD,PRSD_SV_SECTOR,"2025-05-18 22:18:50",1177,881,727,153,1,869,12,1200,319,223,646
42,"MUNICIPIUL BUCUREŞTI","ŞCOALA GIMNAZIALĂ NR.311",1053,"BUCUREŞTI SECTORUL 6",179196,1,PART,PRCNCT,PRSD,PRSD_SV_SECTOR,"2025-05-18 22:41:43",1400,902,821,80,1,890,12,1400,498,252,638
42,"MUNICIPIUL BUCUREŞTI","ŞCOALA GIMNAZIALĂ NR.311",1054,"BUCUREŞTI SECTORUL 6",179196,1,PART,PRCNCT,PRSD,PRSD_SV_SECTOR,"2025-05-18 22:18:49",1314,850,668,182,0,831,19,1300,450,237,594
42,"MUNICIPIUL BUCUREŞTI","ŞCOALA GIMNAZIALĂ NR.311",1055,"BUCUREŞTI SECTORUL 6",179196,1,PART,PRCNCT,PRSD,PRSD_SV_SECTOR,"2025-05-18 22:11:21",1376,919,806,111,2,911,8,1400,481,245,666
42,"MUNICIPIUL BUCUREŞTI","ŞCOALA GIMNAZIALĂ NR.311",1056,"BUCUREŞTI SECTORUL 6",179196,1,PART,PRCNCT,PRSD,PRSD_SV_SECTOR,"2025-05-18 21:53:32",1369,852,798,54,0,838,14,1400,548,233,605
42,"MUNICIPIUL BUCUREŞTI","ŞCOALA GIMNAZIALĂ NR.311",1057,"BUCUREŞTI SECTORUL 6",179196,1,PART,PRCNCT,PRSD,PRSD_SV_SECTOR,"2025-05-18 22:27:39",1208,733,672,59,2,722,11,1200,467,216,506
42,"MUNICIPIUL BUCUREŞTI","ŞCOALA GIMNAZIALĂ NR.311",1058,"BUCUREŞTI SECTORUL 6",179196,1,PART,PRCNCT,PRSD,PRSD_SV_SECTOR,"2025-05-18 21:47:25",1089,835,653,181,1,819,16,1100,265,232,587
42,"MUNICIPIUL BUCUREŞTI","ŞCOALA GIMNAZIALĂ NR.59",1059,"BUCUREŞTI SECTORUL 6",179196,1,PART,PRCNCT,PRSD,PRSD_SV_SECTOR,"2025-05-18 21:27:02",888,642,513,129,0,630,12,900,258,186,444
42,"MUNICIPIUL BUCUREŞTI","ŞCOALA GIMNAZIALĂ NR.59",1060,"BUCUREŞTI SECTORUL 6",179196,1,PART,PRCNCT,PRSD,PRSD_SV_SECTOR,"2025-05-18 21:38:14",1107,764,648,116,0,743,21,1200,436,229,514
42,"MUNICIPIUL BUCUREŞTI","ŞCOALA GIMNAZIALĂ NR.59",1061,"BUCUREŞTI SECTORUL 6",179196,1,PART,PRCNCT,PRSD,PRSD_SV_SECTOR,"2025-05-18 21:41:20",1107,716,610,105,1,705,11,1200,484,197,508
42,"MUNICIPIUL BUCUREŞTI","ŞCOALA GIMNAZIALĂ NR.59",1062,"BUCUREŞTI SECTORUL 6",179196,1,PART,PRCNCT,PRSD,PRSD_SV_SECTOR,"2025-05-18 21:50:35",1355,864,714,150,0,849,15,1300,436,226,623
42,"MUNICIPIUL BUCUREŞTI","ŞCOALA GIMNAZIALĂ NR.59",1063,"BUCUREŞTI SECTORUL 6",179196,1,PART,PRCNCT,PRSD,PRSD_SV_SECTOR,"2025-05-18 22:17:50",1302,929,801,126,2,909,20,1300,371,209,700
42,"MUNICIPIUL BUCUREŞTI","ŞCOALA GIMNAZIALĂ NR.59",1064,"BUCUREŞTI SECTORUL 6",179196,1,PART,PRCNCT,PRSD,PRSD_SV_SECTOR,"2025-05-18 21:59:32",1169,811,687,123,1,794,17,1200,389,226,568
42,"MUNICIPIUL BUCUREŞTI","ŞCOALA GIMNAZIALĂ ”ADRIAN PĂUNESCU”",1065,"BUCUREŞTI SECTORUL 6",179196,1,PART,PRCNCT,PRSD,PRSD_SV_SECTOR,"2025-05-18 23:28:25",1124,843,630,211,2,828,15,1200,357,223,605
42,"MUNICIPIUL BUCUREŞTI","ŞCOALA GIMNAZIALĂ ”ADRIAN PĂUNESCU”",1066,"BUCUREŞTI SECTORUL 6",179196,1,PART,PRCNCT,PRSD,PRSD_SV_SECTOR,"2025-05-18 21:39:21",1270,820,695,125,0,804,16,1300,480,209,595
42,"MUNICIPIUL BUCUREŞTI","ŞCOALA GIMNAZIALĂ ”ADRIAN PĂUNESCU”",1067,"BUCUREŞTI SECTORUL 6",179196,1,PART,PRCNCT,PRSD,PRSD_SV_SECTOR,"2025-05-18 21:41:14",719,510,316,194,0,504,6,800,290,142,362
42,"MUNICIPIUL BUCUREŞTI","ŞCOALA GIMNAZIALĂ ”ADRIAN PĂUNESCU”",1068,"BUCUREŞTI SECTORUL 6",179196,3,PART,PRCNCT,PRSD,PRSD_SV_SECTOR,"2025-05-19 02:33:23",1233,813,691,122,0,801,12,1300,487,196,605
42,"MUNICIPIUL BUCUREŞTI","ŞCOALA GIMNAZIALĂ ”ADRIAN PĂUNESCU”",1069,"BUCUREŞTI SECTORUL 6",179196,1,PART,PRCNCT,PRSD,PRSD_SV_SECTOR,"2025-05-18 21:50:40",1280,797,710,87,0,784,13,1300,503,201,583
42,"MUNICIPIUL BUCUREŞTI","ŞCOALA GIMNAZIALĂ ”ADRIAN PĂUNESCU”",1070,"BUCUREŞTI SECTORUL 6",179196,1,PART,PRCNCT,PRSD,PRSD_SV_SECTOR,"2025-05-18 21:31:09",1134,693,599,94,0,679,14,1200,507,162,517
42,"MUNICIPIUL BUCUREŞTI","ŞCOALA GIMNAZIALĂ NR.197",1071,"BUCUREŞTI SECTORUL 6",179196,1,PART,PRCNCT,PRSD,PRSD_SV_SECTOR,"2025-05-18 22:30:04",1476,879,825,54,0,865,14,1400,521,196,669
42,"MUNICIPIUL BUCUREŞTI","ŞCOALA GIMNAZIALĂ NR.197",1072,"BUCUREŞTI SECTORUL 6",179196,1,PART,PRCNCT,PRSD,PRSD_SV_SECTOR,"2025-05-18 22:01:05",990,638,595,43,0,632,6,1200,562,150,482
42,"MUNICIPIUL BUCUREŞTI","ŞCOALA GIMNAZIALĂ NR.197",1073,"BUCUREŞTI SECTORUL 6",179196,2,PART,PRCNCT,PRSD,PRSD_SV_SECTOR,"2025-05-19 00:18:59",926,615,523,92,0,601,14,1200,585,159,442
42,"MUNICIPIUL BUCUREŞTI","ŞCOALA GIMNAZIALĂ NR.197",1074,"BUCUREŞTI SECTORUL 6",179196,1,PART,PRCNCT,PRSD,PRSD_SV_SECTOR,"2025-05-18 22:28:22",1261,858,751,107,0,843,15,1316,458,196,647
42,"MUNICIPIUL BUCUREŞTI","ŞCOALA GIMNAZIALĂ NR.197",1075,"BUCUREŞTI SECTORUL 6",179196,1,PART,PRCNCT,PRSD,PRSD_SV_SECTOR,"2025-05-19 01:22:08",1059,827,590,237,0,816,11,1100,273,195,621
42,"MUNICIPIUL BUCUREŞTI","ŞCOALA GIMNAZIALĂ NR.197",1076,"BUCUREŞTI SECTORUL 6",179196,1,PART,PRCNCT,PRSD,PRSD_SV_SECTOR,"2025-05-18 21:31:38",1009,789,602,187,0,780,9,1100,311,213,567
42,"MUNICIPIUL BUCUREŞTI","ŞCOALA GIMNAZIALĂ NR.197",1077,"BUCUREŞTI SECTORUL 6",179196,1,PART,PRCNCT,PRSD,PRSD_SV_SECTOR,"2025-05-18 21:35:18",866,605,493,112,0,597,8,900,295,128,469
42,"MUNICIPIUL BUCUREŞTI","A.D.P.D.U. SECTOR 6",1078,"BUCUREŞTI SECTORUL 6",179196,1,PART,PRCNCT,PRSD,PRSD_SV_SECTOR,"2025-05-18 22:27:22",1082,809,604,204,1,792,17,1108,299,190,602
42,"MUNICIPIUL BUCUREŞTI","ŞCOALA GIMNAZIALĂ NR.193",1079,"BUCUREŞTI SECTORUL 6",179196,1,PART,PRCNCT,PRSD,PRSD_SV_SECTOR,"2025-05-18 22:24:48",996,871,581,290,0,857,14,1192,321,201,656
42,"MUNICIPIUL BUCUREŞTI","ŞCOALA GIMNAZIALĂ NR.193",1080,"BUCUREŞTI SECTORUL 6",179196,1,PART,PRCNCT,PRSD,PRSD_SV_SECTOR,"2025-05-18 21:59:23",1033,888,595,293,0,872,16,1208,320,192,680
42,"MUNICIPIUL BUCUREŞTI","ŞCOALA GIMNAZIALĂ NR.193",1081,"BUCUREŞTI SECTORUL 6",179196,1,PART,PRCNCT,PRSD,PRSD_SV_SECTOR,"2025-05-18 21:52:04",871,968,491,476,1,956,12,1200,232,211,745
42,"MUNICIPIUL BUCUREŞTI","ŞCOALA GIMNAZIALĂ NR.193",1082,"BUCUREŞTI SECTORUL 6",179196,1,PART,PRCNCT,PRSD,PRSD_SV_SECTOR,"2025-05-18 22:26:19",1106,765,611,152,2,752,13,1200,435,187,565
42,"MUNICIPIUL BUCUREŞTI","COLEGIUL NAŢIONAL ”GRIGORE MOISIL”",1083,"BUCUREŞTI SECTORUL 6",179196,1,PART,PRCNCT,PRSD,PRSD_SV_SECTOR,"2025-05-18 22:45:10",1806,1742,1046,694,2,1719,23,2100,358,319,1400
42,"MUNICIPIUL BUCUREŞTI","COLEGIUL NAŢIONAL ”GRIGORE MOISIL”",1084,"BUCUREŞTI SECTORUL 6",179196,1,PART,PRCNCT,PRSD,PRSD_SV_SECTOR,"2025-05-18 23:02:02",1530,1444,890,554,0,1426,18,2100,656,217,1209
42,"MUNICIPIUL BUCUREŞTI","COLEGIUL NAŢIONAL ”GRIGORE MOISIL”",1085,"BUCUREŞTI SECTORUL 6",179196,3,PART,PRCNCT,PRSD,PRSD_SV_SECTOR,"2025-05-19 01:38:20",1765,1663,1023,638,2,1646,17,2103,440,243,1403
42,"MUNICIPIUL BUCUREŞTI","COLEGIUL NAŢIONAL ”GRIGORE MOISIL”",1086,"BUCUREŞTI SECTORUL 6",179196,1,PART,PRCNCT,PRSD,PRSD_SV_SECTOR,"2025-05-18 22:59:12",1726,1297,941,352,4,1286,11,2100,803,278,1008
42,"MUNICIPIUL BUCUREŞTI","ŞCOALA GIMNAZIALĂ NR.164",1087,"BUCUREŞTI SECTORUL 6",179196,1,PART,PRCNCT,PRSD,PRSD_SV_SECTOR,"2025-05-18 23:08:59",921,787,517,268,2,776,11,1200,413,179,597
42,"MUNICIPIUL BUCUREŞTI","ŞCOALA GIMNAZIALĂ NR.164",1088,"BUCUREŞTI SECTORUL 6",179196,1,PART,PRCNCT,PRSD,PRSD_SV_SECTOR,"2025-05-18 22:24:09",1050,848,582,263,3,833,15,1200,352,228,605
42,"MUNICIPIUL BUCUREŞTI","ŞCOALA GIMNAZIALĂ NR.164",1089,"BUCUREŞTI SECTORUL 6",179196,1,PART,PRCNCT,PRSD,PRSD_SV_SECTOR,"2025-05-18 22:56:04",885,648,485,161,2,641,7,1000,352,169,472
42,"MUNICIPIUL BUCUREŞTI","COLEGIUL TEHNIC ”GHEORGHE ASACHI”",1090,"BUCUREŞTI SECTORUL 6",179196,1,PART,PRCNCT,PRSD,PRSD_SV_SECTOR,"2025-05-18 22:34:43",1241,864,650,214,0,849,15,1300,436,203,646
42,"MUNICIPIUL BUCUREŞTI","COLEGIUL TEHNIC ”GHEORGHE ASACHI”",1091,"BUCUREŞTI SECTORUL 6",179196,1,PART,PRCNCT,PRSD,PRSD_SV_SECTOR,"2025-05-18 22:43:45",1040,678,536,142,0,667,11,1100,422,164,503
42,"MUNICIPIUL BUCUREŞTI","COLEGIUL TEHNIC ”GHEORGHE ASACHI”",1092,"BUCUREŞTI SECTORUL 6",179196,1,PART,PRCNCT,PRSD,PRSD_SV_SECTOR,"2025-05-18 23:31:02",1949,1398,1169,228,1,1386,12,2100,702,262,1124
42,"MUNICIPIUL BUCUREŞTI","COLEGIUL TEHNIC ”GHEORGHE ASACHI”",1093,"BUCUREŞTI SECTORUL 6",179196,1,PART,PRCNCT,PRSD,PRSD_SV_SECTOR,"2025-05-18 23:26:58",1060,699,549,150,0,690,9,1000,301,164,526
42,"MUNICIPIUL BUCUREŞTI","LICEUL TEHNOLOGIC ”ANTIM IVIREANU”",1094,"BUCUREŞTI SECTORUL 6",179196,1,PART,PRCNCT,PRSD,PRSD_SV_SECTOR,"2025-05-18 22:01:50",1128,793,611,182,0,781,12,1200,407,199,582
42,"MUNICIPIUL BUCUREŞTI","LICEUL TEHNOLOGIC ”ANTIM IVIREANU”",1095,"BUCUREŞTI SECTORUL 6",179196,1,PART,PRCNCT,PRSD,PRSD_SV_SECTOR,"2025-05-18 21:48:29",1072,781,630,149,2,770,11,1200,419,181,589
42,"MUNICIPIUL BUCUREŞTI","LICEUL TEHNOLOGIC ”ANTIM IVIREANU”",1096,"BUCUREŞTI SECTORUL 6",179196,1,PART,PRCNCT,PRSD,PRSD_SV_SECTOR,"2025-05-18 21:54:59",1033,797,625,171,1,788,9,1200,403,204,584
42,"MUNICIPIUL BUCUREŞTI","LICEUL TEHNOLOGIC ”ANTIM IVIREANU”",1097,"BUCUREŞTI SECTORUL 6",179196,1,PART,PRCNCT,PRSD,PRSD_SV_SECTOR,"2025-05-18 21:29:31",992,566,460,106,0,555,11,1200,634,176,379
42,"MUNICIPIUL BUCUREŞTI","LICEUL TEHNOLOGIC ”ANTIM IVIREANU”",1098,"BUCUREŞTI SECTORUL 6",179196,2,PART,PRCNCT,PRSD,PRSD_SV_SECTOR,"2025-05-19 00:08:42",1895,1089,996,93,0,1061,28,2000,911,277,784
42,"MUNICIPIUL BUCUREŞTI","LICEUL TEHNOLOGIC ”ANTIM IVIREANU”",1099,"BUCUREŞTI SECTORUL 6",179196,1,PART,PRCNCT,PRSD,PRSD_SV_SECTOR,"2025-05-18 22:06:01",1079,683,589,93,1,678,5,1200,517,158,520
42,"MUNICIPIUL BUCUREŞTI","LICEUL TEHNOLOGIC ”ANTIM IVIREANU”",1100,"BUCUREŞTI SECTORUL 6",179196,1,PART,PRCNCT,PRSD,PRSD_SV_SECTOR,"2025-05-18 21:54:35",1283,950,866,84,0,943,7,1600,650,116,827
42,"MUNICIPIUL BUCUREŞTI","LICEUL TEHNOLOGIC ”ANTIM IVIREANU”",1101,"BUCUREŞTI SECTORUL 6",179196,2,PART,PRCNCT,PRSD,PRSD_SV_SECTOR,"2025-05-19 00:20:21",1608,981,809,171,1,967,14,1700,719,236,731
42,"MUNICIPIUL BUCUREŞTI","ŞCOALA GIMNAZIALĂ NR.169 CORPII",1102,"BUCUREŞTI SECTORUL 6",179196,1,PART,PRCNCT,PRSD,PRSD_SV_SECTOR,"2025-05-18 21:39:44",1089,760,616,141,3,750,10,1200,440,168,582
42,"MUNICIPIUL BUCUREŞTI","ŞCOALA GIMNAZIALĂ NR.169 CORPII",1103,"BUCUREŞTI SECTORUL 6",179196,1,PART,PRCNCT,PRSD,PRSD_SV_SECTOR,"2025-05-18 21:41:33",1026,668,557,111,0,658,10,1000,332,196,462
42,"MUNICIPIUL BUCUREŞTI","ŞCOALA GIMNAZIALĂ NR.169 CORPII",1104,"BUCUREŞTI SECTORUL 6",179196,1,PART,PRCNCT,PRSD,PRSD_SV_SECTOR,"2025-05-18 22:06:21",1292,864,775,88,1,848,16,1300,436,205,643
42,"MUNICIPIUL BUCUREŞTI","ŞCOALA GIMNAZIALĂ NR.169 CORPII",1105,"BUCUREŞTI SECTORUL 6",179196,1,PART,PRCNCT,PRSD,PRSD_SV_SECTOR,"2025-05-18 21:40:01",1191,747,673,74,0,734,13,1200,453,199,535
42,"MUNICIPIUL BUCUREŞTI","ŞCOALA GIMNAZIALĂ NR.169 CORPII",1106,"BUCUREŞTI SECTORUL 6",179196,1,PART,PRCNCT,PRSD,PRSD_SV_SECTOR,"2025-05-18 21:49:08",1077,625,586,38,1,618,7,1000,375,145,473
42,"MUNICIPIUL BUCUREŞTI","ŞCOALA GIMNAZIALĂ NR.169 CORPII",1107,"BUCUREŞTI SECTORUL 6",179196,1,PART,PRCNCT,PRSD,PRSD_SV_SECTOR,"2025-05-18 22:08:08",1098,629,599,29,1,614,15,1100,471,181,433
42,"MUNICIPIUL BUCUREŞTI","ŞCOALA GIMNAZIALĂ NR.169 SALA DE SPORT",1108,"BUCUREŞTI SECTORUL 6",179196,1,PART,PRCNCT,PRSD,PRSD_SV_SECTOR,"2025-05-18 21:50:51",1263,851,693,158,0,842,9,1300,449,186,656
42,"MUNICIPIUL BUCUREŞTI","ŞCOALA GIMNAZIALĂ NR.169 SALA DE SPORT",1109,"BUCUREŞTI SECTORUL 6",179196,1,PART,PRCNCT,PRSD,PRSD_SV_SECTOR,"2025-05-18 21:34:58",1227,792,691,99,2,779,13,1300,508,199,580
42,"MUNICIPIUL BUCUREŞTI","ŞCOALA GIMNAZIALĂ NR.169 SALA DE SPORT",1110,"BUCUREŞTI SECTORUL 6",179196,1,PART,PRCNCT,PRSD,PRSD_SV_SECTOR,"2025-05-18 22:06:42",1181,822,707,114,1,813,9,1200,378,213,600
42,"MUNICIPIUL BUCUREŞTI","COLEGIUL NAŢIONAL ”ELENA CUZA”",1111,"BUCUREŞTI SECTORUL 6",179196,1,PART,PRCNCT,PRSD,PRSD_SV_SECTOR,"2025-05-18 21:57:14",1151,769,670,99,0,758,11,1200,431,229,529
42,"MUNICIPIUL BUCUREŞTI","COLEGIUL NAŢIONAL ”ELENA CUZA”",1112,"BUCUREŞTI SECTORUL 6",179196,1,PART,PRCNCT,PRSD,PRSD_SV_SECTOR,"2025-05-18 21:56:47",1007,714,589,124,1,699,15,1200,486,176,523
42,"MUNICIPIUL BUCUREŞTI","COLEGIUL NAŢIONAL ”ELENA CUZA”",1113,"BUCUREŞTI SECTORUL 6",179196,1,PART,PRCNCT,PRSD,PRSD_SV_SECTOR,"2025-05-18 22:13:46",1047,737,620,117,0,729,8,1200,463,190,539
42,"MUNICIPIUL BUCUREŞTI","COLEGIUL NAŢIONAL ”ELENA CUZA”",1114,"BUCUREŞTI SECTORUL 6",179196,1,PART,PRCNCT,PRSD,PRSD_SV_SECTOR,"2025-05-18 22:14:51",890,619,495,121,3,609,10,1000,381,126,483
42,"MUNICIPIUL BUCUREŞTI","LICEUL TEORETIC ”EUGEN LOVINESCU”",1115,"BUCUREŞTI SECTORUL 6",179196,1,PART,PRCNCT,PRSD,PRSD_SV_SECTOR,"2025-05-18 22:25:00",1445,911,814,97,0,899,12,1600,689,195,704
42,"MUNICIPIUL BUCUREŞTI","LICEUL TEORETIC ”EUGEN LOVINESCU”",1116,"BUCUREŞTI SECTORUL 6",179196,1,PART,PRCNCT,PRSD,PRSD_SV_SECTOR,"2025-05-18 22:11:37",1182,862,685,174,3,858,4,1200,338,211,647
42,"MUNICIPIUL BUCUREŞTI","LICEUL TEORETIC ”EUGEN LOVINESCU”",1117,"BUCUREŞTI SECTORUL 6",179196,1,PART,PRCNCT,PRSD,PRSD_SV_SECTOR,"2025-05-18 22:03:35",1483,1131,917,214,0,1111,20,1700,569,288,823
42,"MUNICIPIUL BUCUREŞTI","LICEUL TEORETIC ”EUGEN LOVINESCU”",1118,"BUCUREŞTI SECTORUL 6",179196,2,PART,PRCNCT,PRSD,PRSD_SV_SECTOR,"2025-05-18 22:57:18",1388,953,751,201,1,936,17,1600,647,245,691
42,"MUNICIPIUL BUCUREŞTI","LICEUL TEORETIC ”EUGEN LOVINESCU”",1119,"BUCUREŞTI SECTORUL 6",179196,1,PART,PRCNCT,PRSD,PRSD_SV_SECTOR,"2025-05-18 22:02:39",1273,845,771,71,3,837,8,1600,755,206,631
42,"MUNICIPIUL BUCUREŞTI","LICEUL TEORETIC ”EUGEN LOVINESCU”",1120,"BUCUREŞTI SECTORUL 6",179196,1,PART,PRCNCT,PRSD,PRSD_SV_SECTOR,"2025-05-18 22:08:18",1161,697,630,66,1,682,15,1100,403,185,497
42,"MUNICIPIUL BUCUREŞTI","LICEUL TEORETIC ”EUGEN LOVINESCU”",1121,"BUCUREŞTI SECTORUL 6",179196,1,PART,PRCNCT,PRSD,PRSD_SV_SECTOR,"2025-05-18 22:03:01",1102,655,593,61,1,641,14,1100,445,166,475
42,"MUNICIPIUL BUCUREŞTI","LICEUL TEORETIC ”EUGEN LOVINESCU”",1122,"BUCUREŞTI SECTORUL 6",179196,1,PART,PRCNCT,PRSD,PRSD_SV_SECTOR,"2025-05-18 21:46:05",1083,658,625,33,0,649,9,1200,542,163,486
42,"MUNICIPIUL BUCUREŞTI","LICEUL TEORETIC ”EUGEN LOVINESCU”",1123,"BUCUREŞTI SECTORUL 6",179196,1,PART,PRCNCT,PRSD,PRSD_SV_SECTOR,"2025-05-18 22:03:31",813,465,430,35,0,457,8,900,435,125,332
42,"MUNICIPIUL BUCUREŞTI","ŞCOALA GIMNAZIALĂ NR.279",1124,"BUCUREŞTI SECTORUL 6",179196,1,PART,PRCNCT,PRSD,PRSD_SV_SECTOR,"2025-05-18 21:51:34",1973,1110,1038,71,1,1101,9,2000,890,308,793
42,"MUNICIPIUL BUCUREŞTI","ŞCOALA GIMNAZIALĂ NR.279",1125,"BUCUREŞTI SECTORUL 6",179196,1,PART,PRCNCT,PRSD,PRSD_SV_SECTOR,"2025-05-18 22:21:27",1969,1105,1016,89,0,1101,4,2000,895,308,793
42,"MUNICIPIUL BUCUREŞTI","ŞCOALA GIMNAZIALĂ NR.279",1126,"BUCUREŞTI SECTORUL 6",179196,2,PART,PRCNCT,PRSD,PRSD_SV_SECTOR,"2025-05-19 01:46:41",1933,1204,1106,98,0,1190,14,2000,796,301,889
42,"MUNICIPIUL BUCUREŞTI","ŞCOALA GIMNAZIALĂ NR.279",1127,"BUCUREŞTI SECTORUL 6",179196,1,PART,PRCNCT,PRSD,PRSD_SV_SECTOR,"2025-05-18 21:44:40",1860,1071,963,107,1,1056,15,2000,929,306,750
42,"MUNICIPIUL BUCUREŞTI","ŞCOALA GIMNAZIALĂ NR.279",1128,"BUCUREŞTI SECTORUL 6",179196,1,PART,PRCNCT,PRSD,PRSD_SV_SECTOR,"2025-05-18 21:50:09",1685,1234,1017,217,0,1223,11,1800,566,318,905
42,"MUNICIPIUL BUCUREŞTI","ŞCOALA GIMNAZIALĂ NR.279",1129,"BUCUREŞTI SECTORUL 6",179196,1,PART,PRCNCT,PRSD,PRSD_SV_SECTOR,"2025-05-18 22:43:18",1991,1379,1166,212,1,1360,19,2000,621,396,964
42,"MUNICIPIUL BUCUREŞTI","ŞCOALA GIMNAZIALĂ NR.279",1130,"BUCUREŞTI SECTORUL 6",179196,1,PART,PRCNCT,PRSD,PRSD_SV_SECTOR,"2025-05-18 22:41:42",1902,1207,984,223,0,1192,15,2000,793,302,890
42,"MUNICIPIUL BUCUREŞTI","ŞCOALA GIMNAZIALĂ SPECIALĂ ”CONSTANTIN PĂUNESCU”",1131,"BUCUREŞTI SECTORUL 6",179196,1,PART,PRCNCT,PRSD,PRSD_SV_SECTOR,"2025-05-18 22:17:09",1585,941,846,94,1,925,16,1600,659,274,651
42,"MUNICIPIUL BUCUREŞTI","ŞCOALA GIMNAZIALĂ SPECIALĂ ”CONSTANTIN PĂUNESCU”",1132,"BUCUREŞTI SECTORUL 6",179196,1,PART,PRCNCT,PRSD,PRSD_SV_SECTOR,"2025-05-18 22:08:24",1432,916,824,92,0,895,21,1600,684,269,626
42,"MUNICIPIUL BUCUREŞTI","ŞCOALA GIMNAZIALĂ SPECIALĂ PENTRU DEFICIENŢI DE AUZ ”SF. MARIA”",1133,"BUCUREŞTI SECTORUL 6",179196,1,PART,PRCNCT,PRSD,PRSD_SV_SECTOR,"2025-05-18 22:43:46",1790,1133,955,176,2,1110,23,1900,767,290,820
42,"MUNICIPIUL BUCUREŞTI","ŞCOALA GIMNAZIALĂ SPECIALĂ PENTRU DEFICIENŢI DE AUZ ”SF. MARIA”",1134,"BUCUREŞTI SECTORUL 6",179196,1,PART,PRCNCT,PRSD,PRSD_SV_SECTOR,"2025-05-18 22:35:55",1659,1193,1043,150,0,1184,9,1900,707,233,951
42,"MUNICIPIUL BUCUREŞTI","ŞCOALA GIMNAZIALĂ ”SF. ANDREI”",1135,"BUCUREŞTI SECTORUL 6",179196,1,PART,PRCNCT,PRSD,PRSD_SV_SECTOR,"2025-05-18 22:22:58",1921,1309,1056,252,1,1290,19,2000,691,312,978
42,"MUNICIPIUL BUCUREŞTI","ŞCOALA GIMNAZIALĂ ”SF. ANDREI”",1136,"BUCUREŞTI SECTORUL 6",179196,1,PART,PRCNCT,PRSD,PRSD_SV_SECTOR,"2025-05-18 22:12:24",1450,949,733,215,1,936,13,1500,551,260,676
42,"MUNICIPIUL BUCUREŞTI","ŞCOALA GIMNAZIALĂ ”SF. ANDREI”",1137,"BUCUREŞTI SECTORUL 6",179196,1,PART,PRCNCT,PRSD,PRSD_SV_SECTOR,"2025-05-18 21:48:04",1334,889,760,128,1,877,12,1500,611,233,644
42,"MUNICIPIUL BUCUREŞTI","ŞCOALA GIMNAZIALĂ ”SF. ANDREI”",1138,"BUCUREŞTI SECTORUL 6",179196,1,PART,PRCNCT,PRSD,PRSD_SV_SECTOR,"2025-05-18 21:43:43",1457,856,801,55,0,839,17,1500,644,254,585
42,"MUNICIPIUL BUCUREŞTI","ŞCOALA GIMNAZIALĂ ”SF. ANDREI”",1139,"BUCUREŞTI SECTORUL 6",179196,1,PART,PRCNCT,PRSD,PRSD_SV_SECTOR,"2025-05-18 22:36:12",1715,1109,1052,57,0,1096,13,1900,791,307,789
42,"MUNICIPIUL BUCUREŞTI","ŞCOALA GIMNAZIALĂ ”SF. ANDREI”",1140,"BUCUREŞTI SECTORUL 6",179196,1,PART,PRCNCT,PRSD,PRSD_SV_SECTOR,"2025-05-18 22:12:28",1347,1003,723,278,2,985,18,1700,697,286,699
42,"MUNICIPIUL BUCUREŞTI","ŞCOALA GIMNAZIALĂ ”SF. ANDREI”",1141,"BUCUREŞTI SECTORUL 6",179196,1,PART,PRCNCT,PRSD,PRSD_SV_SECTOR,"2025-05-18 21:44:27",1348,992,787,202,3,971,21,1600,608,220,751
42,"MUNICIPIUL BUCUREŞTI","ŞCOALA GIMNAZIALĂ ”SF. ANDREI”",1142,"BUCUREŞTI SECTORUL 6",179196,1,PART,PRCNCT,PRSD,PRSD_SV_SECTOR,"2025-05-18 22:06:21",1842,1320,1059,261,0,1309,11,2000,680,334,975
42,"MUNICIPIUL BUCUREŞTI","ŞCOALA GIMNAZIALĂ ”SF. ANDREI”",1143,"BUCUREŞTI SECTORUL 6",179196,1,PART,PRCNCT,PRSD,PRSD_SV_SECTOR,"2025-05-18 22:53:47",1931,1345,1228,117,0,1322,23,2000,655,357,965
42,"MUNICIPIUL BUCUREŞTI","ŞCOALA GIMNAZIALĂ ”SF. ANDREI”",1144,"BUCUREŞTI SECTORUL 6",179196,1,PART,PRCNCT,PRSD,PRSD_SV_SECTOR,"2025-05-18 23:02:03",1907,1327,1214,113,0,1306,21,2100,773,251,1055
42,"MUNICIPIUL BUCUREŞTI","ŞCOALA GIMNAZIALĂ NR.206",1145,"BUCUREŞTI SECTORUL 6",179196,1,PART,PRCNCT,PRSD,PRSD_SV_SECTOR,"2025-05-18 22:04:34",1219,867,673,194,0,855,12,1300,433,249,606
42,"MUNICIPIUL BUCUREŞTI","ŞCOALA GIMNAZIALĂ NR.206",1146,"BUCUREŞTI SECTORUL 6",179196,1,PART,PRCNCT,PRSD,PRSD_SV_SECTOR,"2025-05-18 22:11:29",1316,831,703,128,0,809,22,1300,469,240,569
42,"MUNICIPIUL BUCUREŞTI","ŞCOALA GIMNAZIALĂ NR.206",1147,"BUCUREŞTI SECTORUL 6",179196,1,PART,PRCNCT,PRSD,PRSD_SV_SECTOR,"2025-05-18 21:45:51",1340,859,711,148,0,836,23,1300,441,259,577
42,"MUNICIPIUL BUCUREŞTI","ŞCOALA GIMNAZIALĂ NR.206",1148,"BUCUREŞTI SECTORUL 6",179196,1,PART,PRCNCT,PRSD,PRSD_SV_SECTOR,"2025-05-18 22:01:49",1188,777,685,92,0,769,8,1300,523,192,577
42,"MUNICIPIUL BUCUREŞTI","ŞCOALA GIMNAZIALĂ NR.206",1149,"BUCUREŞTI SECTORUL 6",179196,3,PART,PRCNCT,PRSD,PRSD_SV_SECTOR,"2025-05-19 00:28:43",1408,851,770,81,0,841,10,1400,549,235,606
42,"MUNICIPIUL BUCUREŞTI","ŞCOALA GIMNAZIALĂ NR.206",1150,"BUCUREŞTI SECTORUL 6",179196,1,PART,PRCNCT,PRSD,PRSD_SV_SECTOR,"2025-05-18 21:46:41",1374,843,753,89,1,830,13,1400,557,219,611
42,"MUNICIPIUL BUCUREŞTI","ŞCOALA GIMNAZIALĂ ”SF. CONSTANTIN ŞI ELENA”",1151,"BUCUREŞTI SECTORUL 6",179196,1,PART,PRCNCT,PRSD,PRSD_SV_SECTOR,"2025-05-18 22:00:00",1159,766,574,192,0,756,10,1200,434,194,562
42,"MUNICIPIUL BUCUREŞTI","ŞCOALA GIMNAZIALĂ ”SF. CONSTANTIN ŞI ELENA”",1152,"BUCUREŞTI SECTORUL 6",179196,1,PART,PRCNCT,PRSD,PRSD_SV_SECTOR,"2025-05-18 22:46:20",1391,1041,764,274,3,1026,15,1516,475,257,769
42,"MUNICIPIUL BUCUREŞTI","ŞCOALA GIMNAZIALĂ ”SF. CONSTANTIN ŞI ELENA”",1153,"BUCUREŞTI SECTORUL 6",179196,1,PART,PRCNCT,PRSD,PRSD_SV_SECTOR,"2025-05-18 22:37:37",1317,961,752,209,0,946,15,1500,539,205,741
42,"MUNICIPIUL BUCUREŞTI","ŞCOALA GIMNAZIALĂ ”SF. CONSTANTIN ŞI ELENA”",1154,"BUCUREŞTI SECTORUL 6",179196,1,PART,PRCNCT,PRSD,PRSD_SV_SECTOR,"2025-05-18 22:12:04",1177,840,680,160,0,830,10,1300,460,197,633
42,"MUNICIPIUL BUCUREŞTI","ŞCOALA GIMNAZIALĂ ”SF. CONSTANTIN ŞI ELENA”",1155,"BUCUREŞTI SECTORUL 6",179196,1,PART,PRCNCT,PRSD,PRSD_SV_SECTOR,"2025-05-18 22:02:24",1419,879,802,77,0,867,12,1300,421,246,621
42,"MUNICIPIUL BUCUREŞTI","ŞCOALA GIMNAZIALĂ ”SF. CONSTANTIN ŞI ELENA”",1156,"BUCUREŞTI SECTORUL 6",179196,1,PART,PRCNCT,PRSD,PRSD_SV_SECTOR,"2025-05-18 21:59:48",1029,591,514,77,0,582,9,900,309,213,369
42,"MUNICIPIUL BUCUREŞTI","SCOALA GIMNAZIALA SFINTII CONSTANTIN SI ELENA",1157,"BUCUREŞTI SECTORUL 6",179196,1,PART,PRCNCT,PRSD,PRSD_SV_SECTOR,"2025-05-18 21:59:24",1848,1061,972,87,2,1053,8,1900,839,229,824
42,"MUNICIPIUL BUCUREŞTI","ŞCOALA GIMNAZIALĂ NR.309",1158,"BUCUREŞTI SECTORUL 6",179196,1,PART,PRCNCT,PRSD,PRSD_SV_SECTOR,"2025-05-18 22:03:35",1410,904,716,187,1,896,8,1500,596,291,605
42,"MUNICIPIUL BUCUREŞTI","ŞCOALA GIMNAZIALĂ NR.309",1159,"BUCUREŞTI SECTORUL 6",179196,1,PART,PRCNCT,PRSD,PRSD_SV_SECTOR,"2025-05-18 21:47:59",1386,887,700,187,0,880,7,1500,613,240,640
42,"MUNICIPIUL BUCUREŞTI","ŞCOALA GIMNAZIALĂ NR.309",1160,"BUCUREŞTI SECTORUL 6",179196,3,PART,PRCNCT,PRSD,PRSD_SV_SECTOR,"2025-05-19 00:08:48",1352,794,664,129,1,785,9,1300,506,250,535
42,"MUNICIPIUL BUCUREŞTI","ŞCOALA GIMNAZIALĂ NR.309",1161,"BUCUREŞTI SECTORUL 6",179196,1,PART,PRCNCT,PRSD,PRSD_SV_SECTOR,"2025-05-18 21:57:06",1485,816,680,136,0,799,17,1500,684,262,537
42,"MUNICIPIUL BUCUREŞTI","ŞCOALA GIMNAZIALĂ NR.309",1162,"BUCUREŞTI SECTORUL 6",179196,1,PART,PRCNCT,PRSD,PRSD_SV_SECTOR,"2025-05-18 21:54:17",1286,728,647,80,1,718,10,1300,572,187,531
42,"MUNICIPIUL BUCUREŞTI","ŞCOALA GIMNAZIALĂ NR.309",1163,"BUCUREŞTI SECTORUL 6",179196,1,PART,PRCNCT,PRSD,PRSD_SV_SECTOR,"2025-05-18 22:15:41",1804,1080,983,95,2,1073,7,1800,720,306,767
42,"MUNICIPIUL BUCUREŞTI","ŞCOALA GIMNAZIALĂ ”ION DUMITRIU”",1164,"BUCUREŞTI SECTORUL 6",179196,1,PART,PRCNCT,PRSD,PRSD_SV_SECTOR,"2025-05-18 21:45:23",1180,835,615,220,0,829,6,1300,465,227,602
42,"MUNICIPIUL BUCUREŞTI","ŞCOALA GIMNAZIALĂ ”ION DUMITRIU”",1165,"BUCUREŞTI SECTORUL 6",179196,1,PART,PRCNCT,PRSD,PRSD_SV_SECTOR,"2025-05-18 21:54:18",1402,910,701,209,0,901,9,1300,390,222,679
42,"MUNICIPIUL BUCUREŞTI","ŞCOALA GIMNAZIALĂ ”ION DUMITRIU”",1166,"BUCUREŞTI SECTORUL 6",179196,1,PART,PRCNCT,PRSD,PRSD_SV_SECTOR,"2025-05-18 22:32:22",1126,860,573,287,0,843,17,1300,440,259,584
42,"MUNICIPIUL BUCUREŞTI","ŞCOALA GIMNAZIALĂ ”ION DUMITRIU”",1167,"BUCUREŞTI SECTORUL 6",179196,1,PART,PRCNCT,PRSD,PRSD_SV_SECTOR,"2025-05-18 21:49:20",1625,1017,843,174,0,1001,16,1700,683,309,692
42,"MUNICIPIUL BUCUREŞTI","ŞCOALA GIMNAZIALĂ ”ION DUMITRIU”",1168,"BUCUREŞTI SECTORUL 6",179196,1,PART,PRCNCT,PRSD,PRSD_SV_SECTOR,"2025-05-18 21:30:47",1203,696,642,54,0,681,15,1300,604,179,502
42,"MUNICIPIUL BUCUREŞTI","ŞCOALA GIMNAZIALĂ ”ION DUMITRIU”",1169,"BUCUREŞTI SECTORUL 6",179196,2,PART,PRCNCT,PRSD,PRSD_SV_SECTOR,"2025-05-18 23:19:22",1507,737,697,40,0,729,8,1600,863,247,482
42,"MUNICIPIUL BUCUREŞTI","ŞCOALA GIMNAZIALĂ ”ION DUMITRIU”",1170,"BUCUREŞTI SECTORUL 6",179196,1,PART,PRCNCT,PRSD,PRSD_SV_SECTOR,"2025-05-18 22:27:04",1167,622,560,61,1,608,14,1200,578,212,396
42,"MUNICIPIUL BUCUREŞTI","ŞCOALA GIMNAZIALĂ ”ION DUMITRIU”",1171,"BUCUREŞTI SECTORUL 6",179196,1,PART,PRCNCT,PRSD,PRSD_SV_SECTOR,"2025-05-18 22:03:47",1385,804,766,37,1,796,8,1300,496,242,554
42,"MUNICIPIUL BUCUREŞTI","ŞCOALA GIMNAZIALĂ ”ION DUMITRIU”",1172,"BUCUREŞTI SECTORUL 6",179196,1,PART,PRCNCT,PRSD,PRSD_SV_SECTOR,"2025-05-18 21:50:03",1626,976,880,96,0,963,13,1600,624,294,669
42,"MUNICIPIUL BUCUREŞTI","ŞCOALA GIMNAZIALĂ ”ION DUMITRIU”",1173,"BUCUREŞTI SECTORUL 6",179196,1,PART,PRCNCT,PRSD,PRSD_SV_SECTOR,"2025-05-18 22:07:38",1574,832,694,138,0,824,8,1600,768,330,494
42,"MUNICIPIUL BUCUREŞTI","CENTRUL EUROPEAN SECTOR 6",1174,"BUCUREŞTI SECTORUL 6",179196,1,PART,PRCNCT,PRSD,PRSD_SV_SECTOR,"2025-05-18 21:38:42",1303,1671,720,951,0,1655,16,2300,629,435,1220
42,"MUNICIPIUL BUCUREŞTI","LICEUL TEHNOLOGIC ”PETRU PONI”",1175,"BUCUREŞTI SECTORUL 6",179196,2,PART,PRCNCT,PRSD,PRSD_SV_SECTOR,"2025-05-19 00:21:33",1549,1413,751,662,0,1395,18,2300,887,458,937
42,"MUNICIPIUL BUCUREŞTI","LICEUL TEHNOLOGIC ”PETRU PONI”",1176,"BUCUREŞTI SECTORUL 6",179196,1,PART,PRCNCT,PRSD,PRSD_SV_SECTOR,"2025-05-18 22:29:49",1638,1478,1022,456,0,1473,5,2300,822,262,1211
42,"MUNICIPIUL BUCUREŞTI","LICEUL TEHNOLOGIC ”PETRU PONI”",1177,"BUCUREŞTI SECTORUL 6",179196,1,PART,PRCNCT,PRSD,PRSD_SV_SECTOR,"2025-05-18 22:22:30",1739,1562,990,561,11,1551,11,2300,738,253,1298
42,"MUNICIPIUL BUCUREŞTI","LICEUL TEHNOLOGIC ”PETRU PONI”",1178,"BUCUREŞTI SECTORUL 6",179196,1,PART,PRCNCT,PRSD,PRSD_SV_SECTOR,"2025-05-18 22:13:11",1672,1250,829,421,0,1244,6,2300,1050,314,930
42,"MUNICIPIUL BUCUREŞTI","ȘCOALA GIMNAZIALĂ ”SFÂNTA TREIME”",1179,"BUCUREŞTI SECTORUL 6",179196,1,PART,PRCNCT,PRSD,PRSD_SV_SECTOR,"2025-05-18 22:21:59",1982,1397,1091,306,0,1382,15,2000,603,478,904
42,"MUNICIPIUL BUCUREŞTI","ȘCOALA GIMNAZIALĂ ”SFÂNTA TREIME”",1180,"BUCUREŞTI SECTORUL 6",179196,1,PART,PRCNCT,PRSD,PRSD_SV_SECTOR,"2025-05-18 22:27:16",1780,1135,977,158,0,1121,14,1900,765,384,737
42,"MUNICIPIUL BUCUREŞTI","ŞCOALA GIMNAZIALĂ ”SFÂNTA TREIME”",1181,"BUCUREŞTI SECTORUL 6",179196,1,PART,PRCNCT,PRSD,PRSD_SV_SECTOR,"2025-05-18 21:49:00",1576,1031,860,169,2,1017,14,1600,569,353,664
42,"MUNICIPIUL BUCUREŞTI","ŞCOALA GIMNAZIALĂ ”SFÂNTA TREIME”",1182,"BUCUREŞTI SECTORUL 6",179196,1,PART,PRCNCT,PRSD,PRSD_SV_SECTOR,"2025-05-18 21:51:38",1781,1044,927,116,1,1035,9,1800,756,339,696
42,"MUNICIPIUL BUCUREŞTI","ŞCOALA GIMNAZIALĂ CONSTANTIN BRANCUSI",1183,"BUCUREŞTI SECTORUL 6",179196,2,PART,PRCNCT,PRSD,PRSD_SV_SECTOR,"2025-05-19 00:30:43",1828,1051,925,126,0,1039,12,1800,749,298,741
42,"MUNICIPIUL BUCUREŞTI","ŞCOALA GIMNAZIALĂ CONSTANTIN BRANCUSI",1184,"BUCUREŞTI SECTORUL 6",179196,1,PART,PRCNCT,PRSD,PRSD_SV_SECTOR,"2025-05-18 22:51:51",1765,1154,919,227,8,1141,13,1800,646,278,863
42,"MUNICIPIUL BUCUREŞTI","ŞCOALA GIMNAZIALĂ CONSTANTIN BRANCUSI",1185,"BUCUREŞTI SECTORUL 6",179196,1,PART,PRCNCT,PRSD,PRSD_SV_SECTOR,"2025-05-18 22:01:09",1792,1086,903,183,0,1066,20,1800,714,339,727
42,"MUNICIPIUL BUCUREŞTI","ŞCOALA GIMNAZIALĂ NR.198",1186,"BUCUREŞTI SECTORUL 6",179196,1,PART,PRCNCT,PRSD,PRSD_SV_SECTOR,"2025-05-18 22:36:41",1637,1073,831,242,0,1060,13,1700,627,330,730
42,"MUNICIPIUL BUCUREŞTI","ŞCOALA GIMNAZIALĂ NR.198",1187,"BUCUREŞTI SECTORUL 6",179196,1,PART,PRCNCT,PRSD,PRSD_SV_SECTOR,"2025-05-18 22:07:19",1633,1118,892,224,2,1104,14,1700,582,333,771
42,"MUNICIPIUL BUCUREŞTI","ŞCOALA GIMNAZIALĂ NR.198",1188,"BUCUREŞTI SECTORUL 6",179196,1,PART,PRCNCT,PRSD,PRSD_SV_SECTOR,"2025-05-18 22:34:44",1299,887,632,255,0,871,16,1300,413,248,623
42,"MUNICIPIUL BUCUREŞTI","ŞCOALA GIMNAZIALĂ NR.198",1189,"BUCUREŞTI SECTORUL 6",179196,1,PART,PRCNCT,PRSD,PRSD_SV_SECTOR,"2025-05-19 00:58:35",1389,983,821,160,2,973,10,1300,317,271,702
42,"MUNICIPIUL BUCUREŞTI","ŞCOALA GIMNAZIALĂ NR.198",1190,"BUCUREŞTI SECTORUL 6",179196,1,PART,PRCNCT,PRSD,PRSD_SV_SECTOR,"2025-05-18 21:49:23",1638,1058,856,200,2,1041,17,1700,642,305,736
42,"MUNICIPIUL BUCUREŞTI","ŞCOALA GIMNAZIALĂ NR.198",1191,"BUCUREŞTI SECTORUL 6",179196,1,PART,PRCNCT,PRSD,PRSD_SV_SECTOR,"2025-05-18 22:03:18",1676,1098,937,161,0,1080,18,1700,602,322,758
42,"MUNICIPIUL BUCUREŞTI","ŞCOALA GIMNAZIALĂ ”CONSTANTIN BRÂNCUŞI”",1192,"BUCUREŞTI SECTORUL 6",179196,1,PART,PRCNCT,PRSD,PRSD_SV_SECTOR,"2025-05-18 21:48:19",1292,852,652,200,0,837,15,1300,448,241,596
42,"MUNICIPIUL BUCUREŞTI","ŞCOALA GIMNAZIALĂ ”CONSTANTIN BRÂNCUŞI”",1193,"BUCUREŞTI SECTORUL 6",179196,1,PART,PRCNCT,PRSD,PRSD_SV_SECTOR,"2025-05-18 22:26:38",1264,920,709,210,1,901,19,1600,680,215,686
42,"MUNICIPIUL BUCUREŞTI","ŞCOALA GIMNAZIALĂ ”CONSTANTIN BRÂNCUŞI”",1194,"BUCUREŞTI SECTORUL 6",179196,1,PART,PRCNCT,PRSD,PRSD_SV_SECTOR,"2025-05-18 21:51:53",1280,832,694,118,20,822,10,1400,568,231,591
42,"MUNICIPIUL BUCUREŞTI","ŞCOALA GIMNAZIALĂ ”CONSTANTIN BRÂNCUŞI”",1195,"BUCUREŞTI SECTORUL 6",179196,1,PART,PRCNCT,PRSD,PRSD_SV_SECTOR,"2025-05-18 22:10:34",1095,633,565,68,0,617,16,1100,467,153,464
42,"MUNICIPIUL BUCUREŞTI","ŞCOALA GIMNAZIALĂ ”CONSTANTIN BRÂNCUŞI”",1196,"BUCUREŞTI SECTORUL 6",179196,1,PART,PRCNCT,PRSD,PRSD_SV_SECTOR,"2025-05-18 22:06:36",1457,852,799,53,0,838,14,1500,648,221,617
42,"MUNICIPIUL BUCUREŞTI","ŞCOALA GIMNAZIALĂ ”CONSTANTIN BRÂNCUŞI”",1197,"BUCUREŞTI SECTORUL 6",179196,1,PART,PRCNCT,PRSD,PRSD_SV_SECTOR,"2025-05-18 21:48:37",841,692,458,233,1,679,13,1000,308,155,524
42,"MUNICIPIUL BUCUREŞTI","ŞCOALA GIMNAZIALĂ ”CONSTANTIN BRÂNCUŞI”",1198,"BUCUREŞTI SECTORUL 6",179196,1,PART,PRCNCT,PRSD,PRSD_SV_SECTOR,"2025-05-18 21:43:36",888,627,504,122,1,607,20,1000,373,181,426
42,"MUNICIPIUL BUCUREŞTI","ŞCOALA GIMNAZIALĂ ”REGELE MIHAI I”",1199,"BUCUREŞTI SECTORUL 6",179196,1,PART,PRCNCT,PRSD,PRSD_SV_SECTOR,"2025-05-18 22:03:57",1335,956,746,209,1,943,13,1300,344,264,679
42,"MUNICIPIUL BUCUREŞTI","ŞCOALA GIMNAZIALĂ ”REGELE MIHAI I”",1200,"BUCUREŞTI SECTORUL 6",179196,1,PART,PRCNCT,PRSD,PRSD_SV_SECTOR,"2025-05-18 22:09:44",1165,807,654,152,1,801,6,1292,485,231,570
42,"MUNICIPIUL BUCUREŞTI","ŞCOALA GIMNAZIALĂ ”REGELE MIHAI I”",1201,"BUCUREŞTI SECTORUL 6",179196,1,PART,PRCNCT,PRSD,PRSD_SV_SECTOR,"2025-05-18 21:43:17",703,567,419,146,2,557,10,900,333,151,406
42,"MUNICIPIUL BUCUREŞTI","ŞCOALA GIMNAZIALĂ ”REGELE MIHAI I”",1202,"BUCUREŞTI SECTORUL 6",179196,2,PART,PRCNCT,PRSD,PRSD_SV_SECTOR,"2025-05-19 00:38:37",940,669,497,172,0,659,10,900,231,164,495
42,"MUNICIPIUL BUCUREŞTI","ŞCOALA GIMNAZIALĂ NR.156",1203,"BUCUREŞTI SECTORUL 6",179196,1,PART,PRCNCT,PRSD,PRSD_SV_SECTOR,"2025-05-18 22:39:13",1479,865,754,111,0,852,13,1400,535,243,609
42,"MUNICIPIUL BUCUREŞTI","ŞCOALA GIMNAZIALĂ NR.156",1204,"BUCUREŞTI SECTORUL 6",179196,1,PART,PRCNCT,PRSD,PRSD_SV_SECTOR,"2025-05-18 22:04:31",1684,1105,996,109,0,1093,12,1800,695,301,792
42,"MUNICIPIUL BUCUREŞTI","ŞCOALA GIMNAZIALĂ NR.156",1205,"BUCUREŞTI SECTORUL 6",179196,1,PART,PRCNCT,PRSD,PRSD_SV_SECTOR,"2025-05-18 23:01:06",1476,1013,802,210,1,995,18,1700,687,237,758
42,"MUNICIPIUL BUCUREŞTI","ŞCOALA GIMNAZIALĂ NR.156",1206,"BUCUREŞTI SECTORUL 6",179196,1,PART,PRCNCT,PRSD,PRSD_SV_SECTOR,"2025-05-18 22:08:39",1634,1207,886,319,2,1192,15,2008,801,306,886
42,"MUNICIPIUL BUCUREŞTI","ŞCOALA GIMNAZIALĂ NR.156",1207,"BUCUREŞTI SECTORUL 6",179196,1,PART,PRCNCT,PRSD,PRSD_SV_SECTOR,"2025-05-18 22:26:57",1564,1235,875,360,0,1219,16,2000,765,303,916
42,"MUNICIPIUL BUCUREŞTI","ŞCOALA GIMNAZIALĂ NR.156",1208,"BUCUREŞTI SECTORUL 6",179196,1,PART,PRCNCT,PRSD,PRSD_SV_SECTOR,"2025-05-18 22:45:33",1949,1372,1115,254,3,1355,17,2000,628,335,1020
42,"MUNICIPIUL BUCUREŞTI","ŞCOALA GIMNAZIALĂ NR.156",1209,"BUCUREŞTI SECTORUL 6",179196,1,PART,PRCNCT,PRSD,PRSD_SV_SECTOR,"2025-05-19 00:05:49",1819,1213,987,225,1,1190,23,1899,686,309,881
42,"MUNICIPIUL BUCUREŞTI","ŞCOALA GIMNAZIALĂ NR.156",1210,"BUCUREŞTI SECTORUL 6",179196,1,PART,PRCNCT,PRSD,PRSD_SV_SECTOR,"2025-05-18 23:50:18",1367,835,716,117,2,819,16,1400,565,206,613
42,"MUNICIPIUL BUCUREŞTI","ŞCOALA GIMNAZIALĂ NR.156",1211,"BUCUREŞTI SECTORUL 6",179196,1,PART,PRCNCT,PRSD,PRSD_SV_SECTOR,"2025-05-18 23:25:31",1452,917,735,180,2,911,6,1400,483,233,678
42,"MUNICIPIUL BUCUREŞTI","ŞCOALA GIMNAZIALĂ NR.156",1212,"BUCUREŞTI SECTORUL 6",179196,1,PART,PRCNCT,PRSD,PRSD_SV_SECTOR,"2025-05-18 22:32:54",1902,1242,1093,149,0,1233,9,2000,758,308,925
42,"MUNICIPIUL BUCUREŞTI","LICEUL TEHNOLOGIC ”COSTIN C. KIRIŢESCU”",1213,"BUCUREŞTI SECTORUL 6",179196,1,PART,PRCNCT,PRSD,PRSD_SV_SECTOR,"2025-05-18 22:41:55",1345,906,776,130,0,888,18,1400,494,193,695
42,"MUNICIPIUL BUCUREŞTI","LICEUL TEHNOLOGIC ”COSTIN C. KIRIŢESCU”",1214,"BUCUREŞTI SECTORUL 6",179196,1,PART,PRCNCT,PRSD,PRSD_SV_SECTOR,"2025-05-18 22:05:30",1389,937,743,194,0,926,11,1400,463,189,737
42,"MUNICIPIUL BUCUREŞTI","LICEUL TEHNOLOGIC ”COSTIN C. KIRIŢESCU”",1215,"BUCUREŞTI SECTORUL 6",179196,1,PART,PRCNCT,PRSD,PRSD_SV_SECTOR,"2025-05-18 21:51:27",1214,806,617,189,0,797,9,1300,494,179,618
42,"MUNICIPIUL BUCUREŞTI","LICEUL TEHNOLOGIC ”COSTIN C. KIRIŢESCU”",1216,"BUCUREŞTI SECTORUL 6",179196,1,PART,PRCNCT,PRSD,PRSD_SV_SECTOR,"2025-05-18 22:32:01",1232,770,630,140,0,759,11,1300,530,232,527
42,"MUNICIPIUL BUCUREŞTI","LICEUL TEHNOLOGIC ”COSTIN C. KIRIŢESCU”",1217,"BUCUREŞTI SECTORUL 6",179196,2,PART,PRCNCT,PRSD,PRSD_SV_SECTOR,"2025-05-18 23:19:24",1308,712,651,61,0,705,7,1300,588,179,526
42,"MUNICIPIUL BUCUREŞTI","LICEUL TEHNOLOGIC ”COSTIN C. KIRIŢESCU”",1218,"BUCUREŞTI SECTORUL 6",179196,1,PART,PRCNCT,PRSD,PRSD_SV_SECTOR,"2025-05-18 21:52:21",937,604,491,113,0,593,11,900,296,149,444
42,"MUNICIPIUL BUCUREŞTI","LICEUL TEHNOLOGIC ”COSTIN C. KIRIŢESCU”",1219,"BUCUREŞTI SECTORUL 6",179196,1,PART,PRCNCT,PRSD,PRSD_SV_SECTOR,"2025-05-18 22:26:31",1163,847,643,203,1,834,13,1300,453,167,667
42,"MUNICIPIUL BUCUREŞTI","LICEUL TEHNOLOGIC ”COSTIN C. KIRIŢESCU”",1220,"BUCUREŞTI SECTORUL 6",179196,1,PART,PRCNCT,PRSD,PRSD_SV_SECTOR,"2025-05-18 21:34:23",1080,753,586,167,0,742,11,1200,447,193,549
42,"MUNICIPIUL BUCUREŞTI","LICEUL TEHNOLOGIC ”COSTIN C. KIRIŢESCU”",1221,"BUCUREŞTI SECTORUL 6",179196,1,PART,PRCNCT,PRSD,PRSD_SV_SECTOR,"2025-05-18 22:17:43",1553,942,844,98,0,925,17,1600,658,213,712
42,"MUNICIPIUL BUCUREŞTI","LICEUL TEHNOLOGIC ”COSTIN C. KIRIŢESCU”",1222,"BUCUREŞTI SECTORUL 6",179196,1,PART,PRCNCT,PRSD,PRSD_SV_SECTOR,"2025-05-18 21:45:12",1662,1012,936,74,2,995,17,1700,688,272,723
42,"MUNICIPIUL BUCUREŞTI","LICEUL TEHNOLOGIC ”COSTIN C. KIRIŢESCU”",1223,"BUCUREŞTI SECTORUL 6",179196,1,PART,PRCNCT,PRSD,PRSD_SV_SECTOR,"2025-05-18 21:59:45",1718,980,931,49,0,971,9,1700,720,296,675
42,"MUNICIPIUL BUCUREŞTI","ŞCOALA GIMNAZIALĂ NR.142",1224,"BUCUREŞTI SECTORUL 6",179196,1,PART,PRCNCT,PRSD,PRSD_SV_SECTOR,"2025-05-18 22:11:22",1053,524,477,47,0,520,4,900,376,176,344
42,"MUNICIPIUL BUCUREŞTI","ŞCOALA GIMNAZIALĂ NR.142",1225,"BUCUREŞTI SECTORUL 6",179196,1,PART,PRCNCT,PRSD,PRSD_SV_SECTOR,"2025-05-18 22:09:27",1265,712,644,68,0,698,14,1200,488,192,506
42,"MUNICIPIUL BUCUREŞTI","ŞCOALA GIMNAZIALĂ NR.142",1226,"BUCUREŞTI SECTORUL 6",179196,1,PART,PRCNCT,PRSD,PRSD_SV_SECTOR,"2025-05-18 21:56:39",1460,892,828,64,0,878,14,1400,508,249,629
42,"MUNICIPIUL BUCUREŞTI","ŞCOALA GIMNAZIALĂ NR.142",1227,"BUCUREŞTI SECTORUL 6",179196,1,PART,PRCNCT,PRSD,PRSD_SV_SECTOR,"2025-05-18 21:33:33",1414,803,695,108,0,784,19,1400,597,281,503
42,"MUNICIPIUL BUCUREŞTI","ŞCOALA GIMNAZIALĂ NR.142",1228,"BUCUREŞTI SECTORUL 6",179196,2,PART,PRCNCT,PRSD,PRSD_SV_SECTOR,"2025-05-19 01:06:26",1174,951,653,298,0,942,9,1400,449,270,672
42,"MUNICIPIUL BUCUREŞTI","ŞCOALA GIMNAZIALĂ NR.142",1229,"BUCUREŞTI SECTORUL 6",179196,1,PART,PRCNCT,PRSD,PRSD_SV_SECTOR,"2025-05-18 22:34:14",1578,1263,831,432,0,1243,20,2000,737,352,891
42,"MUNICIPIUL BUCUREŞTI","ŞCOALA GIMNAZIALĂ NR.142",1230,"BUCUREŞTI SECTORUL 6",179196,1,PART,PRCNCT,PRSD,PRSD_SV_SECTOR,"2025-05-18 22:04:24",1342,957,669,288,0,945,12,1600,643,270,675
42,"MUNICIPIUL BUCUREŞTI","ŞCOALA GIMNAZIALĂ NR.142",1231,"BUCUREŞTI SECTORUL 6",179196,1,PART,PRCNCT,PRSD,PRSD_SV_SECTOR,"2025-05-18 21:45:41",1206,869,612,257,0,851,18,1400,531,231,620
42,"MUNICIPIUL BUCUREŞTI","ŞCOALA GIMNAZIALĂ NR.142",1232,"BUCUREŞTI SECTORUL 6",179196,1,PART,PRCNCT,PRSD,PRSD_SV_SECTOR,"2025-05-18 21:31:04",1311,791,695,96,0,772,19,1300,509,237,535
42,"MUNICIPIUL BUCUREŞTI","GRĂDINIȚA NR. 246",1233,"BUCUREŞTI SECTORUL 6",179196,1,PART,PRCNCT,PRSD,PRSD_SV_SECTOR,"2025-05-18 22:07:08",1331,1009,703,306,0,1002,7,1500,491,231,771
42,"MUNICIPIUL BUCUREŞTI","GRĂDINIȚA NR. 246",1234,"BUCUREŞTI SECTORUL 6",179196,1,PART,PRCNCT,PRSD,PRSD_SV_SECTOR,"2025-05-18 21:55:22",1582,1158,887,270,1,1144,14,1800,642,231,913
42,"MUNICIPIUL BUCUREŞTI","ŞCOALA GIMNAZIALĂ NR.117",1235,"BUCUREŞTI SECTORUL 6",179196,1,PART,PRCNCT,PRSD,PRSD_SV_SECTOR,"2025-05-18 22:06:59",1606,1068,906,161,1,1060,8,1800,732,181,879
42,"MUNICIPIUL BUCUREŞTI","ŞCOALA GIMNAZIALĂ NR.117",1236,"BUCUREŞTI SECTORUL 6",179196,2,PART,PRCNCT,PRSD,PRSD_SV_SECTOR,"2025-05-18 23:42:10",1598,1001,815,186,0,990,11,1700,699,285,705
42,"MUNICIPIUL BUCUREŞTI","ŞCOALA GIMNAZIALĂ NR.117",1237,"BUCUREŞTI SECTORUL 6",179196,1,PART,PRCNCT,PRSD,PRSD_SV_SECTOR,"2025-05-18 22:00:27",1410,1062,713,349,0,1050,12,1700,638,324,726
42,"MUNICIPIUL BUCUREŞTI","ŞCOALA GIMNAZIALĂ NR.117",1238,"BUCUREŞTI SECTORUL 6",179196,1,PART,PRCNCT,PRSD,PRSD_SV_SECTOR,"2025-05-18 21:34:38",1131,862,520,342,0,847,15,1300,438,233,614
42,"MUNICIPIUL BUCUREŞTI","ŞCOALA GIMNAZIALĂ NR.117",1239,"BUCUREŞTI SECTORUL 6",179196,1,PART,PRCNCT,PRSD,PRSD_SV_SECTOR,"2025-05-18 22:10:20",1421,1010,744,264,2,999,11,1600,590,221,778
42,"MUNICIPIUL BUCUREŞTI","LICEUL TEORETIC ”TUDOR VLADIMIRESCU”",1240,"BUCUREŞTI SECTORUL 6",179196,1,PART,PRCNCT,PRSD,PRSD_SV_SECTOR,"2025-05-18 22:43:52",1535,1540,838,701,1,1518,22,2200,660,257,1261
42,"MUNICIPIUL BUCUREŞTI","LICEUL TEORETIC ”TUDOR VLADIMIRESCU”",1241,"BUCUREŞTI SECTORUL 6",179196,1,PART,PRCNCT,PRSD,PRSD_SV_SECTOR,"2025-05-18 22:32:31",1655,1313,956,355,2,1294,19,2200,887,261,1033
42,"MUNICIPIUL BUCUREŞTI","LICEUL TEORETIC ”TUDOR VLADIMIRESCU”",1242,"BUCUREŞTI SECTORUL 6",179196,1,PART,PRCNCT,PRSD,PRSD_SV_SECTOR,"2025-05-18 23:03:52",1287,1330,690,637,3,1319,11,2000,670,203,1116
42,"MUNICIPIUL BUCUREŞTI","LICEUL TEORETIC ”TUDOR VLADIMIRESCU”",1243,"BUCUREŞTI SECTORUL 6",179196,1,PART,PRCNCT,PRSD,PRSD_SV_SECTOR,"2025-05-18 21:59:56",1374,1456,887,567,2,1445,11,2200,744,135,1310
42,"MUNICIPIUL BUCUREŞTI","LICEUL TEORETIC ”TUDOR VLADIMIRESCU”",1244,"BUCUREŞTI SECTORUL 6",179196,1,PART,PRCNCT,PRSD,PRSD_SV_SECTOR,"2025-05-18 23:09:26",1247,1239,670,568,1,1227,12,2000,761,204,1023
42,"MUNICIPIUL BUCUREŞTI","CLUBUL SPORTIV SCOLAR NR. 5",1245,"BUCUREŞTI SECTORUL 6",179196,1,PART,PRCNCT,PRSD,PRSD_SV_SECTOR,"2025-05-19 00:20:05",1441,1355,842,509,4,1343,12,2215,860,224,1119
42,"MUNICIPIUL BUCUREŞTI","COLEGIUL UCECOM ”SPIRU HARET”",1246,"BUCUREŞTI SECTORUL 6",179196,1,PART,PRCNCT,PRSD,PRSD_SV_SECTOR,"2025-05-19 00:18:24",1776,2386,930,1455,1,2364,22,2900,514,273,2091
42,"MUNICIPIUL BUCUREŞTI","COLEGIUL UCECOM ”SPIRU HARET”",1247,"BUCUREŞTI SECTORUL 6",179196,1,PART,PRCNCT,PRSD,PRSD_SV_SECTOR,"2025-05-18 23:34:28",1464,2273,823,1450,0,2267,6,2900,627,185,2082
42,"MUNICIPIUL BUCUREŞTI","ŞCOALA GIMNAZIALĂ NR.168",1248,"BUCUREŞTI SECTORUL 6",179196,1,PART,PRCNCT,PRSD,PRSD_SV_SECTOR,"2025-05-18 22:18:11",1666,1104,787,296,21,1100,4,1700,596,380,720
42,"MUNICIPIUL BUCUREŞTI","ŞCOALA GIMNAZIALĂ NR.168",1249,"BUCUREŞTI SECTORUL 6",179196,1,PART,PRCNCT,PRSD,PRSD_SV_SECTOR,"2025-05-18 22:25:22",1562,1079,723,328,28,1072,7,1600,521,275,797
42,"MUNICIPIUL BUCUREŞTI","ŞCOALA GIMNAZIALĂ NR.168",1250,"BUCUREŞTI SECTORUL 6",179196,1,PART,PRCNCT,PRSD,PRSD_SV_SECTOR,"2025-05-18 22:26:58",1671,1130,776,327,27,1114,16,1800,670,311,803
42,"MUNICIPIUL BUCUREŞTI","ŞCOALA GIMNAZIALĂ NR.168",1251,"BUCUREŞTI SECTORUL 6",179196,2,PART,PRCNCT,PRSD,PRSD_SV_SECTOR,"2025-05-19 00:40:24",1239,880,633,247,0,867,13,1300,420,233,634
42,"MUNICIPIUL BUCUREŞTI","ŞCOALA GIMNAZIALĂ NR.168",1252,"BUCUREŞTI SECTORUL 6",179196,1,PART,PRCNCT,PRSD,PRSD_SV_SECTOR,"2025-05-18 22:36:54",1587,1078,754,324,0,1064,14,1600,522,274,790
42,"MUNICIPIUL BUCUREŞTI","LICEUL TEORETIC ”MARIN PREDA”",1253,"BUCUREŞTI SECTORUL 6",179196,1,PART,PRCNCT,PRSD,PRSD_SV_SECTOR,"2025-05-18 22:08:58",1510,800,697,103,0,785,15,1600,800,240,545
42,"MUNICIPIUL BUCUREŞTI","LICEUL TEORETIC ”MARIN PREDA”",1254,"BUCUREŞTI SECTORUL 6",179196,1,PART,PRCNCT,PRSD,PRSD_SV_SECTOR,"2025-05-18 21:34:18",1575,818,769,48,1,806,12,1600,782,245,561
42,"MUNICIPIUL BUCUREŞTI","LICEUL TEORETIC ”MARIN PREDA”",1255,"BUCUREŞTI SECTORUL 6",179196,1,PART,PRCNCT,PRSD,PRSD_SV_SECTOR,"2025-05-18 21:45:59",1549,743,695,47,1,738,5,1600,857,212,526
42,"MUNICIPIUL BUCUREŞTI","LICEUL TEORETIC ”MARIN PREDA”",1256,"BUCUREŞTI SECTORUL 6",179196,1,PART,PRCNCT,PRSD,PRSD_SV_SECTOR,"2025-05-18 21:57:02",1299,853,653,200,0,840,13,1300,447,227,613
42,"MUNICIPIUL BUCUREŞTI","LICEUL TEORETIC ”MARIN PREDA”",1257,"BUCUREŞTI SECTORUL 6",179196,1,PART,PRCNCT,PRSD,PRSD_SV_SECTOR,"2025-05-18 22:00:42",1189,759,652,107,0,746,13,1200,441,242,504
42,"MUNICIPIUL BUCUREŞTI","LICEUL TEORETIC ”MARIN PREDA”",1258,"BUCUREŞTI SECTORUL 6",179196,1,PART,PRCNCT,PRSD,PRSD_SV_SECTOR,"2025-05-18 22:15:09",1386,834,763,71,0,821,13,1400,566,285,536
42,"MUNICIPIUL BUCUREŞTI","LICEUL TEORETIC ”MARIN PREDA”",1259,"BUCUREŞTI SECTORUL 6",179196,1,PART,PRCNCT,PRSD,PRSD_SV_SECTOR,"2025-05-18 21:44:16",1531,786,743,41,2,772,14,1600,814,280,492
42,"MUNICIPIUL BUCUREŞTI","LICEUL TEORETIC ”MARIN PREDA”",1260,"BUCUREŞTI SECTORUL 6",179196,1,PART,PRCNCT,PRSD,PRSD_SV_SECTOR,"2025-05-18 21:46:19",1216,739,708,31,0,731,8,1300,561,239,492
42,"MUNICIPIUL BUCUREŞTI","LICEUL TEORETIC ”MARIN PREDA”",1261,"BUCUREŞTI SECTORUL 6",179196,1,PART,PRCNCT,PRSD,PRSD_SV_SECTOR,"2025-05-18 22:29:25",1373,795,747,48,0,772,23,1300,505,249,523
42,"MUNICIPIUL BUCUREŞTI","LICEUL TEORETIC ”MARIN PREDA”",1262,"BUCUREŞTI SECTORUL 6",179196,1,PART,PRCNCT,PRSD,PRSD_SV_SECTOR,"2025-05-18 22:14:56",1297,730,696,34,0,718,12,1300,570,218,500
42,"MUNICIPIUL BUCUREŞTI","COLEGIUL TEHNIC ”CAROL I”",1263,"BUCUREŞTI SECTORUL 6",179196,1,PART,PRCNCT,PRSD,PRSD_SV_SECTOR,"2025-05-18 22:01:04",1143,878,588,288,2,866,12,1300,422,260,606
42,"MUNICIPIUL BUCUREŞTI","COLEGIUL TEHNIC ”CAROL I”",1264,"BUCUREŞTI SECTORUL 6",179196,1,PART,PRCNCT,PRSD,PRSD_SV_SECTOR,"2025-05-18 22:22:19",1074,824,547,276,1,811,13,1200,376,227,584
42,"MUNICIPIUL BUCUREŞTI","COLEGIUL TEHNIC ”CAROL I”",1265,"BUCUREŞTI SECTORUL 6",179196,1,PART,PRCNCT,PRSD,PRSD_SV_SECTOR,"2025-05-18 22:03:50",1242,775,644,131,0,761,14,1300,525,180,581
42,"MUNICIPIUL BUCUREŞTI","COLEGIUL TEHNIC ”CAROL I”",1266,"BUCUREŞTI SECTORUL 6",179196,1,PART,PRCNCT,PRSD,PRSD_SV_SECTOR,"2025-05-18 21:59:04",1225,759,649,109,1,748,11,1300,541,185,563
42,"MUNICIPIUL BUCUREŞTI","ŞCOALA GIMNAZIALĂ NR.163",1267,"BUCUREŞTI SECTORUL 6",179196,1,PART,PRCNCT,PRSD,PRSD_SV_SECTOR,"2025-05-18 22:04:24",1508,835,753,82,0,822,13,1500,665,224,598
42,"MUNICIPIUL BUCUREŞTI","ŞCOALA GIMNAZIALĂ NR.163",1268,"BUCUREŞTI SECTORUL 6",179196,1,PART,PRCNCT,PRSD,PRSD_SV_SECTOR,"2025-05-18 22:01:04",1389,775,692,83,0,757,18,1299,524,235,522
42,"MUNICIPIUL BUCUREŞTI","ŞCOALA GIMNAZIALĂ NR.163",1269,"BUCUREŞTI SECTORUL 6",179196,1,PART,PRCNCT,PRSD,PRSD_SV_SECTOR,"2025-05-18 22:19:12",1117,669,577,92,0,653,16,1200,531,190,463
42,"MUNICIPIUL BUCUREŞTI","ŞCOALA GIMNAZIALĂ NR.163",1270,"BUCUREŞTI SECTORUL 6",179196,1,PART,PRCNCT,PRSD,PRSD_SV_SECTOR,"2025-05-18 22:07:21",1043,618,559,57,2,610,8,900,282,185,425
42,"MUNICIPIUL BUCUREŞTI","ŞCOALA GIMNAZIALĂ NR.163",1271,"BUCUREŞTI SECTORUL 6",179196,1,PART,PRCNCT,PRSD,PRSD_SV_SECTOR,"2025-05-18 21:38:49",1205,701,623,78,0,686,15,1200,499,200,486
42,"MUNICIPIUL BUCUREŞTI","ŞCOALA GIMNAZIALĂ NR.163",1272,"BUCUREŞTI SECTORUL 6",179196,1,PART,PRCNCT,PRSD,PRSD_SV_SECTOR,"2025-05-18 22:47:17",1098,626,575,50,1,611,15,1000,374,222,389
42,"MUNICIPIUL BUCUREŞTI","ŞCOALA GIMNAZIALĂ NR.163",1273,"BUCUREŞTI SECTORUL 6",179196,1,PART,PRCNCT,PRSD,PRSD_SV_SECTOR,"2025-05-18 21:47:54",1178,797,671,126,0,786,11,1200,403,271,515
42,"MUNICIPIUL BUCUREŞTI","ŞCOALA GIMNAZIALĂ NR.167",1274,"BUCUREŞTI SECTORUL 6",179196,1,PART,PRCNCT,PRSD,PRSD_SV_SECTOR,"2025-05-18 21:55:06",1226,712,526,186,0,707,5,1200,488,196,511
42,"MUNICIPIUL BUCUREŞTI","ŞCOALA GIMNAZIALĂ NR.167",1275,"BUCUREŞTI SECTORUL 6",179196,1,PART,PRCNCT,PRSD,PRSD_SV_SECTOR,"2025-05-18 21:41:48",1338,801,624,177,0,788,13,1300,499,212,576
42,"MUNICIPIUL BUCUREŞTI","ŞCOALA GIMNAZIALĂ NR.167",1276,"BUCUREŞTI SECTORUL 6",179196,1,PART,PRCNCT,PRSD,PRSD_SV_SECTOR,"2025-05-18 21:58:36",1074,743,587,154,2,736,7,1200,457,232,504
42,"MUNICIPIUL BUCUREŞTI","ŞCOALA GIMNAZIALĂ NR.167",1277,"BUCUREŞTI SECTORUL 6",179196,1,PART,PRCNCT,PRSD,PRSD_SV_SECTOR,"2025-05-18 22:15:50",997,666,460,206,0,661,5,1000,334,188,473
42,"MUNICIPIUL BUCUREŞTI","ŞCOALA GIMNAZIALĂ NR.167",1278,"BUCUREŞTI SECTORUL 6",179196,1,PART,PRCNCT,PRSD,PRSD_SV_SECTOR,"2025-05-18 21:44:00",1551,879,802,74,3,868,11,1500,621,211,657
42,"MUNICIPIUL BUCUREŞTI","ŞCOALA GIMNAZIALĂ NR.167",1279,"BUCUREŞTI SECTORUL 6",179196,1,PART,PRCNCT,PRSD,PRSD_SV_SECTOR,"2025-05-18 22:13:45",1413,843,697,146,0,828,15,1400,557,244,584
42,"MUNICIPIUL BUCUREŞTI","ŞCOALA GIMNAZIALĂ NR.167",1280,"BUCUREŞTI SECTORUL 6",179196,1,PART,PRCNCT,PRSD,PRSD_SV_SECTOR,"2025-05-18 21:38:57",978,586,504,82,0,575,11,900,314,138,437
42,"MUNICIPIUL BUCUREŞTI","ŞCOALA GIMNAZIALĂ NR.167",1281,"BUCUREŞTI SECTORUL 6",179196,1,PART,PRCNCT,PRSD,PRSD_SV_SECTOR,"2025-05-18 21:55:38",1049,639,535,103,1,628,11,900,261,180,448
42,"MUNICIPIUL BUCUREŞTI","ŞCOALA GIMNAZIALĂ NR.167",1282,"BUCUREŞTI SECTORUL 6",179196,1,PART,PRCNCT,PRSD,PRSD_SV_SECTOR,"2025-05-18 22:32:30",1244,695,635,59,1,678,17,1200,505,203,475
42,"MUNICIPIUL BUCUREŞTI","ŞCOALA GIMNAZIALĂ NR.162",1283,"BUCUREŞTI SECTORUL 6",179196,1,PART,PRCNCT,PRSD,PRSD_SV_SECTOR,"2025-05-18 22:28:03",1067,644,584,60,0,636,8,1000,356,233,403
42,"MUNICIPIUL BUCUREŞTI","ŞCOALA GIMNAZIALĂ NR.162",1284,"BUCUREŞTI SECTORUL 6",179196,1,PART,PRCNCT,PRSD,PRSD_SV_SECTOR,"2025-05-18 21:51:47",1718,947,884,63,0,934,13,1700,753,371,563
42,"MUNICIPIUL BUCUREŞTI","ŞCOALA GIMNAZIALĂ NR.153",1285,"BUCUREŞTI SECTORUL 6",179196,1,PART,PRCNCT,PRSD,PRSD_SV_SECTOR,"2025-05-18 21:58:13",1166,581,523,58,0,569,12,1100,519,353,216
42,"MUNICIPIUL BUCUREŞTI","ŞCOALA GIMNAZIALĂ NR.153",1286,"BUCUREŞTI SECTORUL 6",179196,1,PART,PRCNCT,PRSD,PRSD_SV_SECTOR,"2025-05-18 21:38:14",1543,747,698,49,0,738,9,1500,753,417,321
42,"MUNICIPIUL BUCUREŞTI","ŞCOALA GIMNAZIALĂ NR.153",1287,"BUCUREŞTI SECTORUL 6",179196,1,PART,PRCNCT,PRSD,PRSD_SV_SECTOR,"2025-05-18 21:46:00",1052,499,445,54,0,490,9,900,401,292,198
42,"MUNICIPIUL BUCUREŞTI","ŞCOALA GIMNAZIALĂ NR.161",1288,"BUCUREŞTI SECTORUL 6",179196,1,PART,PRCNCT,PRSD,PRSD_SV_SECTOR,"2025-05-18 21:31:47",1203,532,463,69,0,528,4,1200,668,314,214
42,"MUNICIPIUL BUCUREŞTI","SCOALA NR. 161",1289,"BUCUREŞTI SECTORUL 6",179196,1,PART,PRCNCT,PRSD,PRSD_SV_SECTOR,"2025-05-18 21:38:18",1301,679,637,41,1,670,9,1200,521,339,331
